,start,stop,length,is_marginal,ind,scaffold
0,1,342000,341999,True,0,scaffold_1
1,368001,391000,22999,False,0,scaffold_1
2,469001,498000,28999,False,0,scaffold_1
3,570001,643000,72999,False,0,scaffold_1
4,686001,743000,56999,False,0,scaffold_1
5,1073001,1087000,13999,False,0,scaffold_1
6,1281001,1292000,10999,False,0,scaffold_1
7,1815001,1898000,82999,False,0,scaffold_1
8,1954001,1964000,9999,False,0,scaffold_1
9,1965001,1984000,18999,False,0,scaffold_1
10,2449001,2517000,67999,False,0,scaffold_1
11,2729001,2746000,16999,False,0,scaffold_1
12,3181001,3208000,26999,False,0,scaffold_1
13,3714001,3738000,23999,False,0,scaffold_1
14,3915001,3941000,25999,False,0,scaffold_1
15,4065001,4111000,45999,False,0,scaffold_1
16,4322001,4355000,32999,False,0,scaffold_1
17,4796001,4811000,14999,False,0,scaffold_1
18,4928001,4984000,55999,False,0,scaffold_1
19,5484001,5511000,26999,False,0,scaffold_1
20,5536001,5569000,32999,False,0,scaffold_1
21,5858001,5872000,13999,False,0,scaffold_1
22,6108001,6153000,44999,False,0,scaffold_1
23,6228001,6379000,150999,False,0,scaffold_1
24,6384001,6507000,122999,False,0,scaffold_1
25,6543001,6557000,13999,False,0,scaffold_1
26,7038001,7247000,208999,False,0,scaffold_1
27,7248001,7588000,339999,False,0,scaffold_1
28,7590001,8477000,886999,False,0,scaffold_1
29,8478001,8656000,177999,False,0,scaffold_1
30,8658001,9584000,925999,False,0,scaffold_1
31,9586001,10354000,767999,False,0,scaffold_1
32,10461001,10639000,177999,False,0,scaffold_1
33,10808001,10811000,2999,False,0,scaffold_1
34,10839001,10857000,17999,False,0,scaffold_1
35,11351001,11504000,152999,False,0,scaffold_1
36,11616001,11951000,334999,False,0,scaffold_1
37,12184001,12204000,19999,False,0,scaffold_1
38,12662001,12722000,59999,False,0,scaffold_1
39,12777001,12888000,110999,False,0,scaffold_1
40,13113001,13211000,97999,False,0,scaffold_1
41,13347001,13377000,29999,False,0,scaffold_1
42,14595001,14598000,2999,False,0,scaffold_1
0,21001,48000,26999,False,0,scaffold_2
1,93001,159000,65999,False,0,scaffold_2
2,168001,177000,8999,False,0,scaffold_2
3,302001,318000,15999,False,0,scaffold_2
4,332001,374000,41999,False,0,scaffold_2
5,2336001,2358000,21999,False,0,scaffold_2
6,2404001,2424000,19999,False,0,scaffold_2
7,2441001,2599000,157999,False,0,scaffold_2
8,2660001,2689000,28999,False,0,scaffold_2
9,2694001,2742000,47999,False,0,scaffold_2
10,2993001,3021000,27999,False,0,scaffold_2
11,3454001,3463000,8999,False,0,scaffold_2
12,3761001,3783000,21999,False,0,scaffold_2
13,4383001,4409000,25999,False,0,scaffold_2
14,4427001,4457000,29999,False,0,scaffold_2
15,4520001,4556000,35999,False,0,scaffold_2
16,4606001,4654000,47999,False,0,scaffold_2
17,4918001,4954000,35999,False,0,scaffold_2
18,5022001,5031000,8999,False,0,scaffold_2
19,5033001,5061000,27999,False,0,scaffold_2
20,5456001,5475000,18999,False,0,scaffold_2
21,5491001,5511000,19999,False,0,scaffold_2
22,5668001,5704000,35999,False,0,scaffold_2
23,6261001,6330000,68999,False,0,scaffold_2
24,6331001,6351000,19999,False,0,scaffold_2
25,6411001,6449000,37999,False,0,scaffold_2
26,6611001,6626000,14999,False,0,scaffold_2
27,7019001,7036000,16999,False,0,scaffold_2
28,7439001,7472000,32999,False,0,scaffold_2
29,7563001,7697000,133999,False,0,scaffold_2
30,7786001,7890000,103999,False,0,scaffold_2
31,7933001,7967000,33999,False,0,scaffold_2
32,7983001,8092000,108999,False,0,scaffold_2
33,8331001,8333000,1999,False,0,scaffold_2
34,8346001,8453000,106999,False,0,scaffold_2
35,8509001,8557000,47999,False,0,scaffold_2
36,11367001,11375000,7999,False,0,scaffold_2
37,11520001,11785000,264999,False,0,scaffold_2
0,1,2000,1999,True,0,scaffold_3
1,51001,55000,3999,False,0,scaffold_3
2,799001,900000,100999,False,0,scaffold_3
3,2085001,2108000,22999,False,0,scaffold_3
4,2291001,2321000,29999,False,0,scaffold_3
5,2498001,2533000,34999,False,0,scaffold_3
6,3772001,3809000,36999,False,0,scaffold_3
7,3826001,3860000,33999,False,0,scaffold_3
8,4108001,4397000,288999,False,0,scaffold_3
9,4418001,4519000,100999,False,0,scaffold_3
10,4547001,4558000,10999,False,0,scaffold_3
11,4646001,4685000,38999,False,0,scaffold_3
12,5494001,5509000,14999,False,0,scaffold_3
13,6909001,6962000,52999,False,0,scaffold_3
14,6980001,7079000,98999,False,0,scaffold_3
15,7451001,7458000,6999,False,0,scaffold_3
16,7522001,7556000,33999,False,0,scaffold_3
17,7692001,7731000,38999,False,0,scaffold_3
18,7775001,7799000,23999,False,0,scaffold_3
19,7819001,7847000,27999,False,0,scaffold_3
20,8208001,8253000,44999,False,0,scaffold_3
21,8462001,8527000,64999,False,0,scaffold_3
22,8575001,8594000,18999,False,0,scaffold_3
23,9968001,9996000,27999,False,0,scaffold_3
24,10461001,10483000,21999,False,0,scaffold_3
25,10587001,11165000,577999,False,0,scaffold_3
0,17001,32000,14999,False,0,scaffold_4
1,48001,88000,39999,False,0,scaffold_4
2,132001,146000,13999,False,0,scaffold_4
3,147001,151000,3999,False,0,scaffold_4
4,155001,215000,59999,False,0,scaffold_4
5,218001,226000,7999,False,0,scaffold_4
6,227001,266000,38999,False,0,scaffold_4
7,316001,344000,27999,False,0,scaffold_4
8,355001,374000,18999,False,0,scaffold_4
9,375001,380000,4999,False,0,scaffold_4
10,393001,410000,16999,False,0,scaffold_4
11,412001,425000,12999,False,0,scaffold_4
12,429001,502000,72999,False,0,scaffold_4
13,545001,599000,53999,False,0,scaffold_4
14,608001,691000,82999,False,0,scaffold_4
15,695001,697000,1999,False,0,scaffold_4
16,701001,717000,15999,False,0,scaffold_4
17,1121001,1136000,14999,False,0,scaffold_4
18,1137001,1178000,40999,False,0,scaffold_4
19,1199001,1208000,8999,False,0,scaffold_4
20,1210001,1226000,15999,False,0,scaffold_4
21,1254001,1262000,7999,False,0,scaffold_4
22,1265001,1279000,13999,False,0,scaffold_4
23,1283001,1315000,31999,False,0,scaffold_4
24,1372001,1597000,224999,False,0,scaffold_4
25,1613001,1692000,78999,False,0,scaffold_4
26,1725001,1849000,123999,False,0,scaffold_4
27,1850001,1957000,106999,False,0,scaffold_4
28,1958001,2004000,45999,False,0,scaffold_4
29,2026001,2065000,38999,False,0,scaffold_4
30,2211001,2218000,6999,False,0,scaffold_4
31,2269001,2279000,9999,False,0,scaffold_4
32,2284001,2339000,54999,False,0,scaffold_4
33,2476001,2535000,58999,False,0,scaffold_4
34,2599001,2635000,35999,False,0,scaffold_4
35,3335001,3632000,296999,False,0,scaffold_4
36,3675001,3760000,84999,False,0,scaffold_4
37,4941001,4984000,42999,False,0,scaffold_4
38,5476001,5506000,29999,False,0,scaffold_4
39,5515001,5620000,104999,False,0,scaffold_4
40,5658001,5784000,125999,False,0,scaffold_4
41,5786001,5815000,28999,False,0,scaffold_4
42,6145001,6197000,51999,False,0,scaffold_4
43,6805001,6817000,11999,False,0,scaffold_4
44,7036001,7077000,40999,False,0,scaffold_4
45,8846001,9699000,852999,False,0,scaffold_4
46,9700001,9845951,145950,True,0,scaffold_4
0,1,4000,3999,True,0,scaffold_5
1,296001,300000,3999,False,0,scaffold_5
2,317001,368000,50999,False,0,scaffold_5
3,463001,523000,59999,False,0,scaffold_5
4,836001,838000,1999,False,0,scaffold_5
5,839001,842000,2999,False,0,scaffold_5
6,933001,947000,13999,False,0,scaffold_5
7,2565001,2582000,16999,False,0,scaffold_5
8,2625001,2738000,112999,False,0,scaffold_5
9,2814001,2871000,56999,False,0,scaffold_5
10,3137001,3185000,47999,False,0,scaffold_5
11,3218001,3247000,28999,False,0,scaffold_5
12,3322001,3438000,115999,False,0,scaffold_5
13,3449001,3497000,47999,False,0,scaffold_5
14,3962001,4101000,138999,False,0,scaffold_5
15,4121001,4219000,97999,False,0,scaffold_5
16,4233001,4265000,31999,False,0,scaffold_5
17,4446001,4505000,58999,False,0,scaffold_5
18,4603001,4667000,63999,False,0,scaffold_5
19,4690001,4717000,26999,False,0,scaffold_5
20,4761001,4861000,99999,False,0,scaffold_5
21,4885001,4919000,33999,False,0,scaffold_5
22,5287001,5312000,24999,False,0,scaffold_5
23,5314001,5346000,31999,False,0,scaffold_5
24,6510001,6566000,55999,False,0,scaffold_5
25,6584001,6627000,42999,False,0,scaffold_5
26,7373001,7387000,13999,False,0,scaffold_5
27,7580001,7610000,29999,False,0,scaffold_5
28,7622001,7637000,14999,False,0,scaffold_5
29,8553001,8597000,43999,False,0,scaffold_5
30,8667001,8686000,18999,False,0,scaffold_5
31,8730001,9363000,632999,False,0,scaffold_5
32,9364001,9364176,175,True,0,scaffold_5
0,79001,113000,33999,False,0,scaffold_6
1,239001,254000,14999,False,0,scaffold_6
2,256001,261000,4999,False,0,scaffold_6
3,267001,283000,15999,False,0,scaffold_6
4,1236001,1258000,21999,False,0,scaffold_6
5,1479001,1546000,66999,False,0,scaffold_6
6,1868001,1906000,37999,False,0,scaffold_6
7,2023001,2088000,64999,False,0,scaffold_6
8,2134001,2169000,34999,False,0,scaffold_6
9,2349001,2595000,245999,False,0,scaffold_6
10,2596001,2653000,56999,False,0,scaffold_6
11,2660001,2691000,30999,False,0,scaffold_6
12,2731001,2852000,120999,False,0,scaffold_6
13,2928001,3014000,85999,False,0,scaffold_6
14,3102001,3174000,71999,False,0,scaffold_6
15,3224001,3301000,76999,False,0,scaffold_6
16,3408001,3428000,19999,False,0,scaffold_6
17,3461001,3767000,305999,False,0,scaffold_6
18,3899001,3913000,13999,False,0,scaffold_6
19,4018001,4070000,51999,False,0,scaffold_6
20,4081001,4195000,113999,False,0,scaffold_6
21,6010001,6070000,59999,False,0,scaffold_6
22,7281001,7337000,55999,False,0,scaffold_6
23,7557001,7681000,123999,False,0,scaffold_6
24,7683001,7797000,113999,False,0,scaffold_6
25,7811001,8268281,457280,True,0,scaffold_6
0,1,7000,6999,True,0,scaffold_7
1,13001,34000,20999,False,0,scaffold_7
2,50001,54000,3999,False,0,scaffold_7
3,169001,171000,1999,False,0,scaffold_7
4,323001,340000,16999,False,0,scaffold_7
5,342001,507000,164999,False,0,scaffold_7
6,554001,563000,8999,False,0,scaffold_7
7,571001,577000,5999,False,0,scaffold_7
8,706001,736000,29999,False,0,scaffold_7
9,764001,809000,44999,False,0,scaffold_7
10,859001,864000,4999,False,0,scaffold_7
11,879001,884000,4999,False,0,scaffold_7
12,982001,1044000,61999,False,0,scaffold_7
13,1048001,1099000,50999,False,0,scaffold_7
14,1203001,1512000,308999,False,0,scaffold_7
15,1588001,1694000,105999,False,0,scaffold_7
16,3325001,3369000,43999,False,0,scaffold_7
17,3593001,3649000,55999,False,0,scaffold_7
18,4416001,4535000,118999,False,0,scaffold_7
19,4658001,4730000,71999,False,0,scaffold_7
20,4979001,5060000,80999,False,0,scaffold_7
21,5074001,5114000,39999,False,0,scaffold_7
22,5485001,5515000,29999,False,0,scaffold_7
23,5609001,5627000,17999,False,0,scaffold_7
24,6954001,7502216,548215,True,0,scaffold_7
0,66001,85000,18999,False,0,scaffold_8
1,2445001,2470000,24999,False,0,scaffold_8
2,2494001,2503000,8999,False,0,scaffold_8
3,2656001,2683000,26999,False,0,scaffold_8
4,2742001,2757000,14999,False,0,scaffold_8
5,2809001,2844000,34999,False,0,scaffold_8
6,3059001,3525000,465999,False,0,scaffold_8
7,3584001,3612000,27999,False,0,scaffold_8
8,3615001,3937000,321999,False,0,scaffold_8
9,5114001,5135000,20999,False,0,scaffold_8
10,5200001,5241000,40999,False,0,scaffold_8
11,6331001,6334544,3543,True,0,scaffold_8
0,109001,117000,7999,False,0,scaffold_9
1,121001,137000,15999,False,0,scaffold_9
2,303001,315000,11999,False,0,scaffold_9
3,319001,333000,13999,False,0,scaffold_9
4,366001,411000,44999,False,0,scaffold_9
5,413001,434000,20999,False,0,scaffold_9
6,490001,531000,40999,False,0,scaffold_9
7,671001,697000,25999,False,0,scaffold_9
8,732001,742000,9999,False,0,scaffold_9
9,815001,843000,27999,False,0,scaffold_9
10,886001,986000,99999,False,0,scaffold_9
11,988001,995000,6999,False,0,scaffold_9
12,1001001,1007000,5999,False,0,scaffold_9
13,1009001,1031000,21999,False,0,scaffold_9
14,1035001,1085000,49999,False,0,scaffold_9
15,1087001,1150000,62999,False,0,scaffold_9
16,1151001,1160000,8999,False,0,scaffold_9
17,1312001,1377000,64999,False,0,scaffold_9
18,1764001,1791000,26999,False,0,scaffold_9
19,2601001,2616000,14999,False,0,scaffold_9
20,2782001,2803000,20999,False,0,scaffold_9
21,2872001,3381000,508999,False,0,scaffold_9
22,3383001,5107000,1723999,False,0,scaffold_9
23,5112001,5115000,2999,False,0,scaffold_9
24,5116001,5237000,120999,False,0,scaffold_9
25,5239001,5298000,58999,False,0,scaffold_9
26,5300001,5491000,190999,False,0,scaffold_9
27,5493001,6331288,838287,True,0,scaffold_9
0,1,233000,232999,True,0,scaffold_10
1,288001,405000,116999,False,0,scaffold_10
2,471001,482000,10999,False,0,scaffold_10
3,483001,582000,98999,False,0,scaffold_10
4,603001,754000,150999,False,0,scaffold_10
5,784001,794000,9999,False,0,scaffold_10
6,888001,919000,30999,False,0,scaffold_10
7,922001,962000,39999,False,0,scaffold_10
8,1087001,1112000,24999,False,0,scaffold_10
9,2346001,2367000,20999,False,0,scaffold_10
10,3272001,3274000,1999,False,0,scaffold_10
11,4002001,4009000,6999,False,0,scaffold_10
12,4052001,4091000,38999,False,0,scaffold_10
13,4154001,4174000,19999,False,0,scaffold_10
14,4443001,4462000,18999,False,0,scaffold_10
15,4515001,4523000,7999,False,0,scaffold_10
16,4526001,4548000,21999,False,0,scaffold_10
17,4575001,4596000,20999,False,0,scaffold_10
18,4679001,4688000,8999,False,0,scaffold_10
19,4734001,4776000,41999,False,0,scaffold_10
20,4798001,4824000,25999,False,0,scaffold_10
21,4827001,4843000,15999,False,0,scaffold_10
22,4848001,4861000,12999,False,0,scaffold_10
23,4865001,4866973,1972,True,0,scaffold_10
0,11001,34000,22999,False,0,scaffold_11
1,39001,93000,53999,False,0,scaffold_11
2,149001,167000,17999,False,0,scaffold_11
3,169001,191000,21999,False,0,scaffold_11
4,210001,235000,24999,False,0,scaffold_11
5,240001,252000,11999,False,0,scaffold_11
6,296001,312000,15999,False,0,scaffold_11
7,419001,431000,11999,False,0,scaffold_11
8,648001,656000,7999,False,0,scaffold_11
9,1025001,1034000,8999,False,0,scaffold_11
10,1404001,1409000,4999,False,0,scaffold_11
11,1423001,1426000,2999,False,0,scaffold_11
12,2701001,2874000,172999,False,0,scaffold_11
13,3084001,3120000,35999,False,0,scaffold_11
14,3211001,3254000,42999,False,0,scaffold_11
15,3331001,3383000,51999,False,0,scaffold_11
16,3702001,3927000,224999,False,0,scaffold_11
17,4134001,4155000,20999,False,0,scaffold_11
18,4321001,4710000,388999,False,0,scaffold_11
19,4713001,4766820,53819,True,0,scaffold_11
0,1,369000,368999,True,0,scaffold_12
1,474001,537000,62999,False,0,scaffold_12
2,582001,730000,147999,False,0,scaffold_12
3,739001,857000,117999,False,0,scaffold_12
4,865001,1468000,602999,False,0,scaffold_12
5,1720001,1733000,12999,False,0,scaffold_12
6,2571001,2619000,47999,False,0,scaffold_12
7,2685001,2699000,13999,False,0,scaffold_12
0,1,340000,339999,True,1,scaffold_1
1,482001,498000,15999,False,1,scaffold_1
2,574001,643000,68999,False,1,scaffold_1
3,686001,715000,28999,False,1,scaffold_1
4,723001,743000,19999,False,1,scaffold_1
5,1281001,1292000,10999,False,1,scaffold_1
6,1954001,1964000,9999,False,1,scaffold_1
7,1965001,1984000,18999,False,1,scaffold_1
8,2449001,2517000,67999,False,1,scaffold_1
9,2729001,2746000,16999,False,1,scaffold_1
10,3181001,3208000,26999,False,1,scaffold_1
11,3716001,3732000,15999,False,1,scaffold_1
12,3915001,3941000,25999,False,1,scaffold_1
13,4062001,4112000,49999,False,1,scaffold_1
14,4322001,4354000,31999,False,1,scaffold_1
15,4929001,4963000,33999,False,1,scaffold_1
16,4969001,4983000,13999,False,1,scaffold_1
17,5484001,5511000,26999,False,1,scaffold_1
18,5537001,5568000,30999,False,1,scaffold_1
19,6108001,6153000,44999,False,1,scaffold_1
20,6228001,6379000,150999,False,1,scaffold_1
21,6384001,6507000,122999,False,1,scaffold_1
22,6545001,6554000,8999,False,1,scaffold_1
23,7038001,7247000,208999,False,1,scaffold_1
24,7248001,7588000,339999,False,1,scaffold_1
25,7590001,8656000,1065999,False,1,scaffold_1
26,8658001,9584000,925999,False,1,scaffold_1
27,9586001,10355000,768999,False,1,scaffold_1
28,10461001,10630000,168999,False,1,scaffold_1
29,10808001,10811000,2999,False,1,scaffold_1
30,10836001,10858000,21999,False,1,scaffold_1
31,11352001,11504000,151999,False,1,scaffold_1
32,11643001,11951000,307999,False,1,scaffold_1
33,12184001,12204000,19999,False,1,scaffold_1
34,12678001,12722000,43999,False,1,scaffold_1
35,12777001,12888000,110999,False,1,scaffold_1
36,13114001,13135000,20999,False,1,scaffold_1
37,13179001,13211000,31999,False,1,scaffold_1
38,13347001,13377000,29999,False,1,scaffold_1
39,14595001,14598000,2999,False,1,scaffold_1
0,22001,48000,25999,False,1,scaffold_2
1,93001,159000,65999,False,1,scaffold_2
2,168001,177000,8999,False,1,scaffold_2
3,303001,318000,14999,False,1,scaffold_2
4,333001,374000,40999,False,1,scaffold_2
5,2336001,2358000,21999,False,1,scaffold_2
6,2405001,2424000,18999,False,1,scaffold_2
7,2441001,2553000,111999,False,1,scaffold_2
8,2660001,2689000,28999,False,1,scaffold_2
9,2694001,2742000,47999,False,1,scaffold_2
10,2996001,3009000,12999,False,1,scaffold_2
11,3454001,3463000,8999,False,1,scaffold_2
12,3761001,3783000,21999,False,1,scaffold_2
13,4385001,4409000,23999,False,1,scaffold_2
14,4428001,4457000,28999,False,1,scaffold_2
15,4521001,4555000,33999,False,1,scaffold_2
16,4608001,4653000,44999,False,1,scaffold_2
17,4783001,4790000,6999,False,1,scaffold_2
18,5022001,5031000,8999,False,1,scaffold_2
19,5033001,5061000,27999,False,1,scaffold_2
20,5491001,5511000,19999,False,1,scaffold_2
21,5672001,5704000,31999,False,1,scaffold_2
22,6261001,6330000,68999,False,1,scaffold_2
23,6331001,6341000,9999,False,1,scaffold_2
24,6427001,6449000,21999,False,1,scaffold_2
25,7439001,7472000,32999,False,1,scaffold_2
26,7563001,7697000,133999,False,1,scaffold_2
27,7786001,7890000,103999,False,1,scaffold_2
28,7934001,7969000,34999,False,1,scaffold_2
29,7981001,8088000,106999,False,1,scaffold_2
30,8331001,8333000,1999,False,1,scaffold_2
31,8346001,8389000,42999,False,1,scaffold_2
32,8509001,8535000,25999,False,1,scaffold_2
33,11367001,11373000,5999,False,1,scaffold_2
34,11520001,11786000,265999,False,1,scaffold_2
0,1,2000,1999,True,1,scaffold_3
1,51001,55000,3999,False,1,scaffold_3
2,102001,104000,1999,False,1,scaffold_3
3,800001,901000,100999,False,1,scaffold_3
4,2085001,2108000,22999,False,1,scaffold_3
5,2291001,2321000,29999,False,1,scaffold_3
6,2510001,2533000,22999,False,1,scaffold_3
7,4150001,4403000,252999,False,1,scaffold_3
8,4410001,4518000,107999,False,1,scaffold_3
9,4547001,4558000,10999,False,1,scaffold_3
10,4654001,4678000,23999,False,1,scaffold_3
11,6911001,6962000,50999,False,1,scaffold_3
12,6979001,7046000,66999,False,1,scaffold_3
13,7540001,7556000,15999,False,1,scaffold_3
14,7692001,7727000,34999,False,1,scaffold_3
15,7820001,7838000,17999,False,1,scaffold_3
16,8208001,8255000,46999,False,1,scaffold_3
17,8462001,8527000,64999,False,1,scaffold_3
18,8575001,8594000,18999,False,1,scaffold_3
19,9968001,9996000,27999,False,1,scaffold_3
20,10461001,10483000,21999,False,1,scaffold_3
21,10587001,11164000,576999,False,1,scaffold_3
0,49001,88000,38999,False,1,scaffold_4
1,136001,146000,9999,False,1,scaffold_4
2,147001,151000,3999,False,1,scaffold_4
3,155001,160000,4999,False,1,scaffold_4
4,161001,215000,53999,False,1,scaffold_4
5,217001,226000,8999,False,1,scaffold_4
6,227001,266000,38999,False,1,scaffold_4
7,293001,310000,16999,False,1,scaffold_4
8,313001,344000,30999,False,1,scaffold_4
9,355001,374000,18999,False,1,scaffold_4
10,375001,380000,4999,False,1,scaffold_4
11,389001,410000,20999,False,1,scaffold_4
12,412001,425000,12999,False,1,scaffold_4
13,429001,498000,68999,False,1,scaffold_4
14,545001,597000,51999,False,1,scaffold_4
15,600001,606000,5999,False,1,scaffold_4
16,608001,661000,52999,False,1,scaffold_4
17,670001,691000,20999,False,1,scaffold_4
18,701001,712000,10999,False,1,scaffold_4
19,1121001,1136000,14999,False,1,scaffold_4
20,1137001,1178000,40999,False,1,scaffold_4
21,1199001,1208000,8999,False,1,scaffold_4
22,1210001,1226000,15999,False,1,scaffold_4
23,1229001,1231000,1999,False,1,scaffold_4
24,1254001,1262000,7999,False,1,scaffold_4
25,1265001,1279000,13999,False,1,scaffold_4
26,1283001,1313000,29999,False,1,scaffold_4
27,1372001,1591000,218999,False,1,scaffold_4
28,1749001,1817000,67999,False,1,scaffold_4
29,1827001,1849000,21999,False,1,scaffold_4
30,1850001,1864000,13999,False,1,scaffold_4
31,1940001,1957000,16999,False,1,scaffold_4
32,1958001,1999000,40999,False,1,scaffold_4
33,2284001,2339000,54999,False,1,scaffold_4
34,2480001,2550000,69999,False,1,scaffold_4
35,3335001,3632000,296999,False,1,scaffold_4
36,3676001,3760000,83999,False,1,scaffold_4
37,4944001,4984000,39999,False,1,scaffold_4
38,5477001,5506000,28999,False,1,scaffold_4
39,5516001,5620000,103999,False,1,scaffold_4
40,5667001,5784000,116999,False,1,scaffold_4
41,7037001,7062000,24999,False,1,scaffold_4
42,8849001,9699000,849999,False,1,scaffold_4
43,9711001,9845951,134950,True,1,scaffold_4
0,191001,204000,12999,False,1,scaffold_5
1,296001,299000,2999,False,1,scaffold_5
2,318001,326000,7999,False,1,scaffold_5
3,327001,368000,40999,False,1,scaffold_5
4,469001,480000,10999,False,1,scaffold_5
5,498001,523000,24999,False,1,scaffold_5
6,933001,947000,13999,False,1,scaffold_5
7,1062001,1068000,5999,False,1,scaffold_5
8,2565001,2581000,15999,False,1,scaffold_5
9,2625001,2737000,111999,False,1,scaffold_5
10,2817001,2871000,53999,False,1,scaffold_5
11,3167001,3184000,16999,False,1,scaffold_5
12,3322001,3438000,115999,False,1,scaffold_5
13,3451001,3497000,45999,False,1,scaffold_5
14,3962001,4101000,138999,False,1,scaffold_5
15,4121001,4141000,19999,False,1,scaffold_5
16,4156001,4219000,62999,False,1,scaffold_5
17,4246001,4262000,15999,False,1,scaffold_5
18,4446001,4488000,41999,False,1,scaffold_5
19,4601001,4649000,47999,False,1,scaffold_5
20,4691001,4717000,25999,False,1,scaffold_5
21,4816001,4861000,44999,False,1,scaffold_5
22,4897001,4918000,20999,False,1,scaffold_5
23,5318001,5344000,25999,False,1,scaffold_5
24,7373001,7387000,13999,False,1,scaffold_5
25,8730001,9363000,632999,False,1,scaffold_5
0,65001,74000,8999,False,1,scaffold_6
1,79001,84000,4999,False,1,scaffold_6
2,86001,112000,25999,False,1,scaffold_6
3,240001,253000,12999,False,1,scaffold_6
4,1229001,1256000,26999,False,1,scaffold_6
5,1479001,1546000,66999,False,1,scaffold_6
6,2023001,2086000,62999,False,1,scaffold_6
7,2131001,2169000,37999,False,1,scaffold_6
8,2371001,2595000,223999,False,1,scaffold_6
9,2596001,2653000,56999,False,1,scaffold_6
10,2655001,2691000,35999,False,1,scaffold_6
11,2731001,2851000,119999,False,1,scaffold_6
12,2935001,3014000,78999,False,1,scaffold_6
13,3115001,3148000,32999,False,1,scaffold_6
14,3223001,3301000,77999,False,1,scaffold_6
15,3407001,3428000,20999,False,1,scaffold_6
16,3462001,3766000,303999,False,1,scaffold_6
17,3901001,3912000,10999,False,1,scaffold_6
18,4019001,4040000,20999,False,1,scaffold_6
19,4085001,4193000,107999,False,1,scaffold_6
20,6010001,6060000,49999,False,1,scaffold_6
21,7283001,7336000,52999,False,1,scaffold_6
22,7560001,7795000,234999,False,1,scaffold_6
23,7811001,8268281,457280,True,1,scaffold_6
0,1,7000,6999,True,1,scaffold_7
1,13001,34000,20999,False,1,scaffold_7
2,323001,340000,16999,False,1,scaffold_7
3,342001,507000,164999,False,1,scaffold_7
4,554001,563000,8999,False,1,scaffold_7
5,571001,577000,5999,False,1,scaffold_7
6,706001,736000,29999,False,1,scaffold_7
7,743001,753000,9999,False,1,scaffold_7
8,764001,809000,44999,False,1,scaffold_7
9,859001,864000,4999,False,1,scaffold_7
10,982001,1044000,61999,False,1,scaffold_7
11,1048001,1079000,30999,False,1,scaffold_7
12,1191001,1512000,320999,False,1,scaffold_7
13,1588001,1688000,99999,False,1,scaffold_7
14,3304001,3311000,6999,False,1,scaffold_7
15,3326001,3369000,42999,False,1,scaffold_7
16,3595001,3649000,53999,False,1,scaffold_7
17,4418001,4535000,116999,False,1,scaffold_7
18,4658001,4682000,23999,False,1,scaffold_7
19,4979001,5030000,50999,False,1,scaffold_7
20,5077001,5111000,33999,False,1,scaffold_7
21,5609001,5627000,17999,False,1,scaffold_7
22,6955001,7270000,314999,False,1,scaffold_7
23,7271001,7502216,231215,True,1,scaffold_7
0,67001,85000,17999,False,1,scaffold_8
1,2653001,2683000,29999,False,1,scaffold_8
2,2745001,2756000,10999,False,1,scaffold_8
3,3060001,3525000,464999,False,1,scaffold_8
4,3623001,3913000,289999,False,1,scaffold_8
5,5200001,5241000,40999,False,1,scaffold_8
6,6332001,6334544,2543,True,1,scaffold_8
0,1001,22000,20999,False,1,scaffold_9
1,109001,117000,7999,False,1,scaffold_9
2,236001,242000,5999,False,1,scaffold_9
3,303001,315000,11999,False,1,scaffold_9
4,319001,333000,13999,False,1,scaffold_9
5,367001,411000,43999,False,1,scaffold_9
6,413001,434000,20999,False,1,scaffold_9
7,502001,531000,28999,False,1,scaffold_9
8,670001,696000,25999,False,1,scaffold_9
9,732001,742000,9999,False,1,scaffold_9
10,816001,843000,26999,False,1,scaffold_9
11,850001,862000,11999,False,1,scaffold_9
12,885001,986000,100999,False,1,scaffold_9
13,988001,995000,6999,False,1,scaffold_9
14,1001001,1006000,4999,False,1,scaffold_9
15,1010001,1031000,20999,False,1,scaffold_9
16,1035001,1085000,49999,False,1,scaffold_9
17,1087001,1150000,62999,False,1,scaffold_9
18,1151001,1165000,13999,False,1,scaffold_9
19,1313001,1377000,63999,False,1,scaffold_9
20,1770001,1787000,16999,False,1,scaffold_9
21,2599001,2616000,16999,False,1,scaffold_9
22,2874001,3381000,506999,False,1,scaffold_9
23,3383001,5107000,1723999,False,1,scaffold_9
24,5112001,5114000,1999,False,1,scaffold_9
25,5116001,5238000,121999,False,1,scaffold_9
26,5239001,5298000,58999,False,1,scaffold_9
27,5300001,5490000,189999,False,1,scaffold_9
28,5493001,6331288,838287,True,1,scaffold_9
0,1,197000,196999,True,1,scaffold_10
1,375001,405000,29999,False,1,scaffold_10
2,472001,482000,9999,False,1,scaffold_10
3,483001,576000,92999,False,1,scaffold_10
4,603001,748000,144999,False,1,scaffold_10
5,888001,916000,27999,False,1,scaffold_10
6,924001,962000,37999,False,1,scaffold_10
7,1087001,1105000,17999,False,1,scaffold_10
8,2346001,2367000,20999,False,1,scaffold_10
9,3264001,3268000,3999,False,1,scaffold_10
10,4054001,4091000,36999,False,1,scaffold_10
11,4154001,4174000,19999,False,1,scaffold_10
12,4443001,4462000,18999,False,1,scaffold_10
13,4467001,4477000,9999,False,1,scaffold_10
14,4515001,4523000,7999,False,1,scaffold_10
15,4526001,4548000,21999,False,1,scaffold_10
16,4576001,4596000,19999,False,1,scaffold_10
17,4680001,4688000,7999,False,1,scaffold_10
18,4735001,4766000,30999,False,1,scaffold_10
19,4769001,4776000,6999,False,1,scaffold_10
20,4798001,4824000,25999,False,1,scaffold_10
21,4827001,4843000,15999,False,1,scaffold_10
22,4848001,4861000,12999,False,1,scaffold_10
23,4865001,4866973,1972,True,1,scaffold_10
0,10001,34000,23999,False,1,scaffold_11
1,40001,93000,52999,False,1,scaffold_11
2,149001,167000,17999,False,1,scaffold_11
3,169001,191000,21999,False,1,scaffold_11
4,213001,235000,21999,False,1,scaffold_11
5,240001,247000,6999,False,1,scaffold_11
6,419001,431000,11999,False,1,scaffold_11
7,648001,656000,7999,False,1,scaffold_11
8,1025001,1034000,8999,False,1,scaffold_11
9,1305001,1307000,1999,False,1,scaffold_11
10,1423001,1427000,3999,False,1,scaffold_11
11,1474001,1477000,2999,False,1,scaffold_11
12,2701001,2873000,171999,False,1,scaffold_11
13,3213001,3254000,40999,False,1,scaffold_11
14,3331001,3364000,32999,False,1,scaffold_11
15,3702001,3926000,223999,False,1,scaffold_11
16,4322001,4710000,387999,False,1,scaffold_11
17,4713001,4766820,53819,True,1,scaffold_11
0,1,240000,239999,True,1,scaffold_12
1,291001,369000,77999,False,1,scaffold_12
2,474001,537000,62999,False,1,scaffold_12
3,582001,856000,273999,False,1,scaffold_12
4,865001,1355000,489999,False,1,scaffold_12
5,1720001,1733000,12999,False,1,scaffold_12
6,2571001,2610000,38999,False,1,scaffold_12
7,2685001,2699000,13999,False,1,scaffold_12
0,1,340000,339999,True,2,scaffold_1
1,482001,498000,15999,False,2,scaffold_1
2,571001,643000,71999,False,2,scaffold_1
3,686001,713000,26999,False,2,scaffold_1
4,736001,741000,4999,False,2,scaffold_1
5,1281001,1292000,10999,False,2,scaffold_1
6,1954001,1964000,9999,False,2,scaffold_1
7,1965001,1984000,18999,False,2,scaffold_1
8,2449001,2516000,66999,False,2,scaffold_1
9,2729001,2746000,16999,False,2,scaffold_1
10,3181001,3208000,26999,False,2,scaffold_1
11,3715001,3734000,18999,False,2,scaffold_1
12,3916001,3941000,24999,False,2,scaffold_1
13,4087001,4110000,22999,False,2,scaffold_1
14,4322001,4354000,31999,False,2,scaffold_1
15,4928001,4983000,54999,False,2,scaffold_1
16,5481001,5511000,29999,False,2,scaffold_1
17,6108001,6153000,44999,False,2,scaffold_1
18,6228001,6316000,87999,False,2,scaffold_1
19,6332001,6381000,48999,False,2,scaffold_1
20,6384001,6507000,122999,False,2,scaffold_1
21,6545001,6554000,8999,False,2,scaffold_1
22,7038001,7247000,208999,False,2,scaffold_1
23,7248001,7584000,335999,False,2,scaffold_1
24,7590001,8656000,1065999,False,2,scaffold_1
25,8658001,9584000,925999,False,2,scaffold_1
26,9586001,10354000,767999,False,2,scaffold_1
27,10461001,10627000,165999,False,2,scaffold_1
28,10808001,10811000,2999,False,2,scaffold_1
29,10836001,10858000,21999,False,2,scaffold_1
30,11352001,11504000,151999,False,2,scaffold_1
31,11648001,11951000,302999,False,2,scaffold_1
32,12184001,12205000,20999,False,2,scaffold_1
33,12670001,12722000,51999,False,2,scaffold_1
34,12777001,12888000,110999,False,2,scaffold_1
35,13114001,13135000,20999,False,2,scaffold_1
36,13179001,13211000,31999,False,2,scaffold_1
37,13347001,13377000,29999,False,2,scaffold_1
38,14595001,14599000,3999,False,2,scaffold_1
0,22001,48000,25999,False,2,scaffold_2
1,93001,159000,65999,False,2,scaffold_2
2,168001,177000,8999,False,2,scaffold_2
3,312001,318000,5999,False,2,scaffold_2
4,330001,374000,43999,False,2,scaffold_2
5,2336001,2358000,21999,False,2,scaffold_2
6,2410001,2415000,4999,False,2,scaffold_2
7,2416001,2421000,4999,False,2,scaffold_2
8,2441001,2553000,111999,False,2,scaffold_2
9,2660001,2689000,28999,False,2,scaffold_2
10,2694001,2742000,47999,False,2,scaffold_2
11,2868001,2897000,28999,False,2,scaffold_2
12,2994001,3012000,17999,False,2,scaffold_2
13,3454001,3463000,8999,False,2,scaffold_2
14,3769001,3781000,11999,False,2,scaffold_2
15,4385001,4409000,23999,False,2,scaffold_2
16,4429001,4456000,26999,False,2,scaffold_2
17,4521001,4554000,32999,False,2,scaffold_2
18,4598001,4653000,54999,False,2,scaffold_2
19,5022001,5031000,8999,False,2,scaffold_2
20,5033001,5061000,27999,False,2,scaffold_2
21,5491001,5511000,19999,False,2,scaffold_2
22,5668001,5704000,35999,False,2,scaffold_2
23,6261001,6330000,68999,False,2,scaffold_2
24,6331001,6350000,18999,False,2,scaffold_2
25,7020001,7035000,14999,False,2,scaffold_2
26,7439001,7472000,32999,False,2,scaffold_2
27,7563001,7697000,133999,False,2,scaffold_2
28,7786001,7890000,103999,False,2,scaffold_2
29,7934001,7965000,30999,False,2,scaffold_2
30,7985001,8088000,102999,False,2,scaffold_2
31,8331001,8333000,1999,False,2,scaffold_2
32,8346001,8389000,42999,False,2,scaffold_2
33,8509001,8535000,25999,False,2,scaffold_2
34,11520001,11785000,264999,False,2,scaffold_2
0,1,2000,1999,True,2,scaffold_3
1,51001,55000,3999,False,2,scaffold_3
2,102001,104000,1999,False,2,scaffold_3
3,292001,295000,2999,False,2,scaffold_3
4,800001,900000,99999,False,2,scaffold_3
5,2085001,2108000,22999,False,2,scaffold_3
6,2291001,2321000,29999,False,2,scaffold_3
7,2510001,2533000,22999,False,2,scaffold_3
8,4150001,4383000,232999,False,2,scaffold_3
9,4418001,4518000,99999,False,2,scaffold_3
10,4547001,4558000,10999,False,2,scaffold_3
11,4654001,4678000,23999,False,2,scaffold_3
12,6911001,6962000,50999,False,2,scaffold_3
13,6980001,7075000,94999,False,2,scaffold_3
14,7540001,7556000,15999,False,2,scaffold_3
15,7692001,7724000,31999,False,2,scaffold_3
16,7822001,7839000,16999,False,2,scaffold_3
17,8208001,8253000,44999,False,2,scaffold_3
18,8462001,8527000,64999,False,2,scaffold_3
19,8575001,8594000,18999,False,2,scaffold_3
20,9968001,9996000,27999,False,2,scaffold_3
21,10461001,10483000,21999,False,2,scaffold_3
22,10587001,11164000,576999,False,2,scaffold_3
0,17001,32000,14999,False,2,scaffold_4
1,48001,88000,39999,False,2,scaffold_4
2,132001,146000,13999,False,2,scaffold_4
3,147001,151000,3999,False,2,scaffold_4
4,155001,215000,59999,False,2,scaffold_4
5,217001,226000,8999,False,2,scaffold_4
6,227001,238000,10999,False,2,scaffold_4
7,239001,266000,26999,False,2,scaffold_4
8,289001,307000,17999,False,2,scaffold_4
9,355001,374000,18999,False,2,scaffold_4
10,375001,380000,4999,False,2,scaffold_4
11,412001,425000,12999,False,2,scaffold_4
12,429001,500000,70999,False,2,scaffold_4
13,545001,606000,60999,False,2,scaffold_4
14,608001,661000,52999,False,2,scaffold_4
15,670001,691000,20999,False,2,scaffold_4
16,695001,697000,1999,False,2,scaffold_4
17,701001,714000,12999,False,2,scaffold_4
18,1121001,1136000,14999,False,2,scaffold_4
19,1137001,1198000,60999,False,2,scaffold_4
20,1199001,1208000,8999,False,2,scaffold_4
21,1210001,1226000,15999,False,2,scaffold_4
22,1235001,1246000,10999,False,2,scaffold_4
23,1248001,1253000,4999,False,2,scaffold_4
24,1254001,1262000,7999,False,2,scaffold_4
25,1265001,1279000,13999,False,2,scaffold_4
26,1283001,1319000,35999,False,2,scaffold_4
27,1372001,1591000,218999,False,2,scaffold_4
28,1749001,1799000,49999,False,2,scaffold_4
29,1940001,1957000,16999,False,2,scaffold_4
30,1958001,1996000,37999,False,2,scaffold_4
31,2037001,2065000,27999,False,2,scaffold_4
32,2211001,2246000,34999,False,2,scaffold_4
33,2247001,2268000,20999,False,2,scaffold_4
34,2269001,2279000,9999,False,2,scaffold_4
35,2284001,2340000,55999,False,2,scaffold_4
36,2480001,2533000,52999,False,2,scaffold_4
37,3335001,3632000,296999,False,2,scaffold_4
38,3676001,3759000,82999,False,2,scaffold_4
39,4944001,4984000,39999,False,2,scaffold_4
40,5477001,5506000,28999,False,2,scaffold_4
41,5514001,5620000,105999,False,2,scaffold_4
42,5669001,5784000,114999,False,2,scaffold_4
43,6177001,6190000,12999,False,2,scaffold_4
44,7036001,7062000,25999,False,2,scaffold_4
45,8849001,9699000,849999,False,2,scaffold_4
46,9700001,9845951,145950,True,2,scaffold_4
0,296001,299000,2999,False,2,scaffold_5
1,318001,326000,7999,False,2,scaffold_5
2,327001,368000,40999,False,2,scaffold_5
3,469001,478000,8999,False,2,scaffold_5
4,508001,523000,14999,False,2,scaffold_5
5,933001,947000,13999,False,2,scaffold_5
6,2565001,2581000,15999,False,2,scaffold_5
7,2625001,2732000,106999,False,2,scaffold_5
8,2816001,2871000,54999,False,2,scaffold_5
9,3167001,3184000,16999,False,2,scaffold_5
10,3322001,3438000,115999,False,2,scaffold_5
11,3451001,3497000,45999,False,2,scaffold_5
12,3962001,4101000,138999,False,2,scaffold_5
13,4121001,4142000,20999,False,2,scaffold_5
14,4155001,4219000,63999,False,2,scaffold_5
15,4246001,4262000,15999,False,2,scaffold_5
16,4446001,4483000,36999,False,2,scaffold_5
17,4603001,4649000,45999,False,2,scaffold_5
18,4691001,4717000,25999,False,2,scaffold_5
19,4789001,4861000,71999,False,2,scaffold_5
20,4904001,4917000,12999,False,2,scaffold_5
21,5318001,5346000,27999,False,2,scaffold_5
22,7373001,7387000,13999,False,2,scaffold_5
23,7582001,7609000,26999,False,2,scaffold_5
24,7622001,7636000,13999,False,2,scaffold_5
25,8730001,9363000,632999,False,2,scaffold_5
0,79001,112000,32999,False,2,scaffold_6
1,240001,253000,12999,False,2,scaffold_6
2,257001,262000,4999,False,2,scaffold_6
3,267001,283000,15999,False,2,scaffold_6
4,1238001,1255000,16999,False,2,scaffold_6
5,1479001,1546000,66999,False,2,scaffold_6
6,2023001,2086000,62999,False,2,scaffold_6
7,2131001,2168000,36999,False,2,scaffold_6
8,2371001,2595000,223999,False,2,scaffold_6
9,2596001,2653000,56999,False,2,scaffold_6
10,2660001,2691000,30999,False,2,scaffold_6
11,2731001,2852000,120999,False,2,scaffold_6
12,2933001,3014000,80999,False,2,scaffold_6
13,3115001,3149000,33999,False,2,scaffold_6
14,3224001,3301000,76999,False,2,scaffold_6
15,3407001,3428000,20999,False,2,scaffold_6
16,3462001,3766000,303999,False,2,scaffold_6
17,3901001,3912000,10999,False,2,scaffold_6
18,4019001,4040000,20999,False,2,scaffold_6
19,4081001,4193000,111999,False,2,scaffold_6
20,6011001,6060000,48999,False,2,scaffold_6
21,7282001,7337000,54999,False,2,scaffold_6
22,7541001,7795000,253999,False,2,scaffold_6
23,7811001,8268281,457280,True,2,scaffold_6
0,13001,34000,20999,False,2,scaffold_7
1,323001,340000,16999,False,2,scaffold_7
2,342001,508000,165999,False,2,scaffold_7
3,554001,563000,8999,False,2,scaffold_7
4,571001,577000,5999,False,2,scaffold_7
5,706001,736000,29999,False,2,scaffold_7
6,764001,809000,44999,False,2,scaffold_7
7,853001,856000,2999,False,2,scaffold_7
8,859001,864000,4999,False,2,scaffold_7
9,953001,963000,9999,False,2,scaffold_7
10,964001,980000,15999,False,2,scaffold_7
11,982001,1044000,61999,False,2,scaffold_7
12,1048001,1079000,30999,False,2,scaffold_7
13,1203001,1512000,308999,False,2,scaffold_7
14,1588001,1688000,99999,False,2,scaffold_7
15,3326001,3369000,42999,False,2,scaffold_7
16,3596001,3649000,52999,False,2,scaffold_7
17,4418001,4535000,116999,False,2,scaffold_7
18,4658001,4682000,23999,False,2,scaffold_7
19,4979001,5111000,131999,False,2,scaffold_7
20,5609001,5628000,18999,False,2,scaffold_7
21,6955001,7270000,314999,False,2,scaffold_7
22,7271001,7502216,231215,True,2,scaffold_7
0,66001,85000,18999,False,2,scaffold_8
1,2662001,2683000,20999,False,2,scaffold_8
2,2742001,2757000,14999,False,2,scaffold_8
3,3058001,3525000,466999,False,2,scaffold_8
4,3584001,3612000,27999,False,2,scaffold_8
5,3615001,3913000,297999,False,2,scaffold_8
6,5200001,5241000,40999,False,2,scaffold_8
7,6332001,6334544,2543,True,2,scaffold_8
0,1001,19000,17999,False,2,scaffold_9
1,109001,117000,7999,False,2,scaffold_9
2,301001,315000,13999,False,2,scaffold_9
3,319001,333000,13999,False,2,scaffold_9
4,367001,411000,43999,False,2,scaffold_9
5,413001,434000,20999,False,2,scaffold_9
6,502001,531000,28999,False,2,scaffold_9
7,652001,665000,12999,False,2,scaffold_9
8,670001,696000,25999,False,2,scaffold_9
9,732001,742000,9999,False,2,scaffold_9
10,816001,842000,25999,False,2,scaffold_9
11,872001,986000,113999,False,2,scaffold_9
12,987001,995000,7999,False,2,scaffold_9
13,1001001,1007000,5999,False,2,scaffold_9
14,1010001,1031000,20999,False,2,scaffold_9
15,1035001,1085000,49999,False,2,scaffold_9
16,1087001,1150000,62999,False,2,scaffold_9
17,1151001,1164000,12999,False,2,scaffold_9
18,1312001,1377000,64999,False,2,scaffold_9
19,1770001,1783000,12999,False,2,scaffold_9
20,2601001,2616000,14999,False,2,scaffold_9
21,2874001,3381000,506999,False,2,scaffold_9
22,3383001,5099000,1715999,False,2,scaffold_9
23,5101001,5107000,5999,False,2,scaffold_9
24,5112001,5115000,2999,False,2,scaffold_9
25,5116001,5238000,121999,False,2,scaffold_9
26,5239001,5298000,58999,False,2,scaffold_9
27,5300001,5490000,189999,False,2,scaffold_9
28,5493001,6331288,838287,True,2,scaffold_9
0,1,136000,135999,True,2,scaffold_10
1,137001,197000,59999,False,2,scaffold_10
2,375001,414000,38999,False,2,scaffold_10
3,472001,482000,9999,False,2,scaffold_10
4,483001,576000,92999,False,2,scaffold_10
5,603001,750000,146999,False,2,scaffold_10
6,888001,916000,27999,False,2,scaffold_10
7,924001,962000,37999,False,2,scaffold_10
8,1087001,1105000,17999,False,2,scaffold_10
9,2346001,2366000,19999,False,2,scaffold_10
10,3272001,3274000,1999,False,2,scaffold_10
11,4052001,4091000,38999,False,2,scaffold_10
12,4154001,4174000,19999,False,2,scaffold_10
13,4467001,4477000,9999,False,2,scaffold_10
14,4503001,4513000,9999,False,2,scaffold_10
15,4515001,4523000,7999,False,2,scaffold_10
16,4526001,4548000,21999,False,2,scaffold_10
17,4576001,4595000,18999,False,2,scaffold_10
18,4680001,4688000,7999,False,2,scaffold_10
19,4734001,4766000,31999,False,2,scaffold_10
20,4768001,4776000,7999,False,2,scaffold_10
21,4798001,4824000,25999,False,2,scaffold_10
22,4828001,4843000,14999,False,2,scaffold_10
23,4848001,4861000,12999,False,2,scaffold_10
24,4865001,4866973,1972,True,2,scaffold_10
0,10001,34000,23999,False,2,scaffold_11
1,40001,92000,51999,False,2,scaffold_11
2,149001,167000,17999,False,2,scaffold_11
3,169001,191000,21999,False,2,scaffold_11
4,213001,235000,21999,False,2,scaffold_11
5,419001,431000,11999,False,2,scaffold_11
6,649001,656000,6999,False,2,scaffold_11
7,1025001,1034000,8999,False,2,scaffold_11
8,1305001,1307000,1999,False,2,scaffold_11
9,1423001,1426000,2999,False,2,scaffold_11
10,2701001,2872000,170999,False,2,scaffold_11
11,3211001,3254000,42999,False,2,scaffold_11
12,3331001,3371000,39999,False,2,scaffold_11
13,3702001,3926000,223999,False,2,scaffold_11
14,4322001,4710000,387999,False,2,scaffold_11
15,4713001,4766820,53819,True,2,scaffold_11
0,1,241000,240999,True,2,scaffold_12
1,251001,369000,117999,False,2,scaffold_12
2,474001,537000,62999,False,2,scaffold_12
3,582001,731000,148999,False,2,scaffold_12
4,739001,856000,116999,False,2,scaffold_12
5,865001,1354000,488999,False,2,scaffold_12
6,1720001,1733000,12999,False,2,scaffold_12
7,2571001,2609000,37999,False,2,scaffold_12
8,2747001,2747968,967,True,2,scaffold_12
0,1,342000,341999,True,3,scaffold_1
1,380001,440000,59999,False,3,scaffold_1
2,481001,498000,16999,False,3,scaffold_1
3,553001,643000,89999,False,3,scaffold_1
4,686001,749000,62999,False,3,scaffold_1
5,1181001,1192000,10999,False,3,scaffold_1
6,1281001,1292000,10999,False,3,scaffold_1
7,1607001,1660000,52999,False,3,scaffold_1
8,1768001,1786000,17999,False,3,scaffold_1
9,1809001,1935000,125999,False,3,scaffold_1
10,1954001,1964000,9999,False,3,scaffold_1
11,1965001,1985000,19999,False,3,scaffold_1
12,1988001,2002000,13999,False,3,scaffold_1
13,2355001,2387000,31999,False,3,scaffold_1
14,2449001,2517000,67999,False,3,scaffold_1
15,2729001,2746000,16999,False,3,scaffold_1
16,2985001,3023000,37999,False,3,scaffold_1
17,3174001,3209000,34999,False,3,scaffold_1
18,3446001,3496000,49999,False,3,scaffold_1
19,3712001,3878000,165999,False,3,scaffold_1
20,3901001,3941000,39999,False,3,scaffold_1
21,3990001,4030000,39999,False,3,scaffold_1
22,4062001,4119000,56999,False,3,scaffold_1
23,4310001,4375000,64999,False,3,scaffold_1
24,4719001,4784000,64999,False,3,scaffold_1
25,4796001,4819000,22999,False,3,scaffold_1
26,4927001,5020000,92999,False,3,scaffold_1
27,5087001,5110000,22999,False,3,scaffold_1
28,5481001,5512000,30999,False,3,scaffold_1
29,5535001,5573000,37999,False,3,scaffold_1
30,5854001,5916000,61999,False,3,scaffold_1
31,6108001,6176000,67999,False,3,scaffold_1
32,6219001,6380000,160999,False,3,scaffold_1
33,6382001,6574000,191999,False,3,scaffold_1
34,7038001,7247000,208999,False,3,scaffold_1
35,7248001,7584000,335999,False,3,scaffold_1
36,7590001,8656000,1065999,False,3,scaffold_1
37,8658001,9584000,925999,False,3,scaffold_1
38,9586001,10361000,774999,False,3,scaffold_1
39,10455001,10636000,180999,False,3,scaffold_1
40,10808001,10811000,2999,False,3,scaffold_1
41,10836001,10857000,20999,False,3,scaffold_1
42,10919001,10943000,23999,False,3,scaffold_1
43,11017001,11029000,11999,False,3,scaffold_1
44,11272001,11509000,236999,False,3,scaffold_1
45,11560001,11963000,402999,False,3,scaffold_1
46,12184001,12204000,19999,False,3,scaffold_1
47,12425001,12444000,18999,False,3,scaffold_1
48,12643001,12888000,244999,False,3,scaffold_1
49,12965001,13002000,36999,False,3,scaffold_1
50,13113001,13216000,102999,False,3,scaffold_1
51,13346001,13431000,84999,False,3,scaffold_1
52,13558001,13589000,30999,False,3,scaffold_1
53,13789001,13845000,55999,False,3,scaffold_1
54,13959001,13976000,16999,False,3,scaffold_1
55,14290001,14313000,22999,False,3,scaffold_1
0,6001,48000,41999,False,3,scaffold_2
1,93001,159000,65999,False,3,scaffold_2
2,297001,318000,20999,False,3,scaffold_2
3,332001,374000,41999,False,3,scaffold_2
4,1536001,1554000,17999,False,3,scaffold_2
5,2085001,2102000,16999,False,3,scaffold_2
6,2336001,2609000,272999,False,3,scaffold_2
7,2626001,2639000,12999,False,3,scaffold_2
8,2659001,2689000,29999,False,3,scaffold_2
9,2694001,2745000,50999,False,3,scaffold_2
10,2766001,2788000,21999,False,3,scaffold_2
11,2840001,2855000,14999,False,3,scaffold_2
12,2877001,2910000,32999,False,3,scaffold_2
13,2974001,3012000,37999,False,3,scaffold_2
14,3332001,3345000,12999,False,3,scaffold_2
15,3449001,3467000,17999,False,3,scaffold_2
16,3669001,3690000,20999,False,3,scaffold_2
17,3754001,3784000,29999,False,3,scaffold_2
18,4243001,4319000,75999,False,3,scaffold_2
19,4342001,4409000,66999,False,3,scaffold_2
20,4426001,4458000,31999,False,3,scaffold_2
21,4516001,4790000,273999,False,3,scaffold_2
22,4793001,4799000,5999,False,3,scaffold_2
23,4918001,4950000,31999,False,3,scaffold_2
24,5018001,5104000,85999,False,3,scaffold_2
25,5360001,5480000,119999,False,3,scaffold_2
26,5491001,5515000,23999,False,3,scaffold_2
27,5658001,5759000,100999,False,3,scaffold_2
28,5840001,5888000,47999,False,3,scaffold_2
29,5905001,6036000,130999,False,3,scaffold_2
30,6102001,6140000,37999,False,3,scaffold_2
31,6233001,6350000,116999,False,3,scaffold_2
32,6366001,6466000,99999,False,3,scaffold_2
33,6581001,6628000,46999,False,3,scaffold_2
34,6947001,6979000,31999,False,3,scaffold_2
35,7008001,7038000,29999,False,3,scaffold_2
36,7050001,7097000,46999,False,3,scaffold_2
37,7428001,7477000,48999,False,3,scaffold_2
38,7491001,7518000,26999,False,3,scaffold_2
39,7567001,7697000,129999,False,3,scaffold_2
40,7785001,7891000,105999,False,3,scaffold_2
41,7934001,8177000,242999,False,3,scaffold_2
42,8261001,8313000,51999,False,3,scaffold_2
43,8331001,8333000,1999,False,3,scaffold_2
44,8346001,8455000,108999,False,3,scaffold_2
45,8468001,8564000,95999,False,3,scaffold_2
46,9347001,9382000,34999,False,3,scaffold_2
47,9602001,9623000,20999,False,3,scaffold_2
48,11395001,11424000,28999,False,3,scaffold_2
49,11520001,11785000,264999,False,3,scaffold_2
0,618001,646000,27999,False,3,scaffold_3
1,796001,900000,103999,False,3,scaffold_3
2,1936001,1980000,43999,False,3,scaffold_3
3,2007001,2108000,100999,False,3,scaffold_3
4,2110001,2126000,15999,False,3,scaffold_3
5,2166001,2178000,11999,False,3,scaffold_3
6,2285001,2338000,52999,False,3,scaffold_3
7,2486001,2532000,45999,False,3,scaffold_3
8,2647001,2760000,112999,False,3,scaffold_3
9,3606001,3643000,36999,False,3,scaffold_3
10,3768001,3821000,52999,False,3,scaffold_3
11,3822001,3892000,69999,False,3,scaffold_3
12,3926001,3946000,19999,False,3,scaffold_3
13,4007001,4033000,25999,False,3,scaffold_3
14,4070001,4403000,332999,False,3,scaffold_3
15,4410001,4520000,109999,False,3,scaffold_3
16,4546001,4558000,11999,False,3,scaffold_3
17,4637001,4686000,48999,False,3,scaffold_3
18,4900001,4901000,999,False,3,scaffold_3
19,5000001,5019000,18999,False,3,scaffold_3
20,5157001,5279000,121999,False,3,scaffold_3
21,5485001,5509000,23999,False,3,scaffold_3
22,5589001,5615000,25999,False,3,scaffold_3
23,5805001,5918000,112999,False,3,scaffold_3
24,5919001,6022000,102999,False,3,scaffold_3
25,6756001,6786000,29999,False,3,scaffold_3
26,6909001,7097000,187999,False,3,scaffold_3
27,7283001,7317000,33999,False,3,scaffold_3
28,7337001,7362000,24999,False,3,scaffold_3
29,7369001,7418000,48999,False,3,scaffold_3
30,7426001,7445000,18999,False,3,scaffold_3
31,7518001,7556000,37999,False,3,scaffold_3
32,7676001,7856000,179999,False,3,scaffold_3
33,8028001,8114000,85999,False,3,scaffold_3
34,8141001,8144000,2999,False,3,scaffold_3
35,8175001,8253000,77999,False,3,scaffold_3
36,8396001,8527000,130999,False,3,scaffold_3
37,8575001,8593000,17999,False,3,scaffold_3
38,8757001,8770000,12999,False,3,scaffold_3
39,9001001,9075000,73999,False,3,scaffold_3
40,9121001,9151000,29999,False,3,scaffold_3
41,9968001,9996000,27999,False,3,scaffold_3
42,10587001,11168000,580999,False,3,scaffold_3
0,11001,13000,1999,False,3,scaffold_4
1,17001,32000,14999,False,3,scaffold_4
2,48001,88000,39999,False,3,scaffold_4
3,136001,146000,9999,False,3,scaffold_4
4,147001,151000,3999,False,3,scaffold_4
5,155001,215000,59999,False,3,scaffold_4
6,217001,226000,8999,False,3,scaffold_4
7,227001,266000,38999,False,3,scaffold_4
8,283001,307000,23999,False,3,scaffold_4
9,313001,353000,39999,False,3,scaffold_4
10,355001,374000,18999,False,3,scaffold_4
11,391001,410000,18999,False,3,scaffold_4
12,412001,425000,12999,False,3,scaffold_4
13,429001,498000,68999,False,3,scaffold_4
14,541001,606000,64999,False,3,scaffold_4
15,608001,691000,82999,False,3,scaffold_4
16,701001,712000,10999,False,3,scaffold_4
17,1087001,1097000,9999,False,3,scaffold_4
18,1098001,1109000,10999,False,3,scaffold_4
19,1113001,1208000,94999,False,3,scaffold_4
20,1210001,1226000,15999,False,3,scaffold_4
21,1239001,1253000,13999,False,3,scaffold_4
22,1266001,1279000,12999,False,3,scaffold_4
23,1283001,1336000,52999,False,3,scaffold_4
24,1354001,1598000,243999,False,3,scaffold_4
25,1613001,2206000,592999,False,3,scaffold_4
26,2207001,2218000,10999,False,3,scaffold_4
27,2219001,2280000,60999,False,3,scaffold_4
28,2283001,2461000,177999,False,3,scaffold_4
29,2476001,2635000,158999,False,3,scaffold_4
30,2676001,2795000,118999,False,3,scaffold_4
31,2926001,2955000,28999,False,3,scaffold_4
32,3032001,3133000,100999,False,3,scaffold_4
33,3204001,3769000,564999,False,3,scaffold_4
34,4056001,4077000,20999,False,3,scaffold_4
35,4941001,5053000,111999,False,3,scaffold_4
36,5172001,5243000,70999,False,3,scaffold_4
37,5292001,5356000,63999,False,3,scaffold_4
38,5476001,5506000,29999,False,3,scaffold_4
39,5516001,5784000,267999,False,3,scaffold_4
40,5786001,5827000,40999,False,3,scaffold_4
41,6145001,6196000,50999,False,3,scaffold_4
42,6222001,6242000,19999,False,3,scaffold_4
43,6285001,6370000,84999,False,3,scaffold_4
44,6615001,6617000,1999,False,3,scaffold_4
45,6764001,6817000,52999,False,3,scaffold_4
46,6897001,6924000,26999,False,3,scaffold_4
47,6951001,6995000,43999,False,3,scaffold_4
48,7036001,7093000,56999,False,3,scaffold_4
49,7209001,7323000,113999,False,3,scaffold_4
50,7352001,7373000,20999,False,3,scaffold_4
51,7639001,7665000,25999,False,3,scaffold_4
52,7856001,7912000,55999,False,3,scaffold_4
53,8742001,8759000,16999,False,3,scaffold_4
54,8844001,9699000,854999,False,3,scaffold_4
55,9703001,9845951,142950,True,3,scaffold_4
0,142001,174000,31999,False,3,scaffold_5
1,189001,207000,17999,False,3,scaffold_5
2,318001,398000,79999,False,3,scaffold_5
3,445001,525000,79999,False,3,scaffold_5
4,672001,720000,47999,False,3,scaffold_5
5,933001,947000,13999,False,3,scaffold_5
6,1062001,1070000,7999,False,3,scaffold_5
7,2081001,2104000,22999,False,3,scaffold_5
8,2472001,2494000,21999,False,3,scaffold_5
9,2556001,2871000,314999,False,3,scaffold_5
10,3133001,3520000,386999,False,3,scaffold_5
11,3617001,3659000,41999,False,3,scaffold_5
12,3962001,4101000,138999,False,3,scaffold_5
13,4121001,4221000,99999,False,3,scaffold_5
14,4246001,4269000,22999,False,3,scaffold_5
15,4312001,4322000,9999,False,3,scaffold_5
16,4329001,4357000,27999,False,3,scaffold_5
17,4443001,4541000,97999,False,3,scaffold_5
18,4600001,4925000,324999,False,3,scaffold_5
19,4973001,4991000,17999,False,3,scaffold_5
20,5258001,5312000,53999,False,3,scaffold_5
21,5314001,5345000,30999,False,3,scaffold_5
22,5726001,5737000,10999,False,3,scaffold_5
23,6406001,6654000,247999,False,3,scaffold_5
24,6887001,6905000,17999,False,3,scaffold_5
25,7455001,7514000,58999,False,3,scaffold_5
26,7548001,7619000,70999,False,3,scaffold_5
27,7620001,7661000,40999,False,3,scaffold_5
28,7704001,7747000,42999,False,3,scaffold_5
29,8550001,8617000,66999,False,3,scaffold_5
30,8658001,8689000,30999,False,3,scaffold_5
31,8705001,9363000,657999,False,3,scaffold_5
32,9364001,9364176,175,True,3,scaffold_5
0,79001,84000,4999,False,3,scaffold_6
1,86001,113000,26999,False,3,scaffold_6
2,165001,208000,42999,False,3,scaffold_6
3,241001,253000,11999,False,3,scaffold_6
4,266001,317000,50999,False,3,scaffold_6
5,640001,665000,24999,False,3,scaffold_6
6,833001,848000,14999,False,3,scaffold_6
7,989001,999000,9999,False,3,scaffold_6
8,1020001,1037000,16999,False,3,scaffold_6
9,1146001,1198000,51999,False,3,scaffold_6
10,1233001,1265000,31999,False,3,scaffold_6
11,1284001,1309000,24999,False,3,scaffold_6
12,1478001,1599000,120999,False,3,scaffold_6
13,1657001,1716000,58999,False,3,scaffold_6
14,1823001,1902000,78999,False,3,scaffold_6
15,2023001,2193000,169999,False,3,scaffold_6
16,2236001,2268000,31999,False,3,scaffold_6
17,2336001,2595000,258999,False,3,scaffold_6
18,2596001,2654000,57999,False,3,scaffold_6
19,2655001,2852000,196999,False,3,scaffold_6
20,2933001,3032000,98999,False,3,scaffold_6
21,3097001,3191000,93999,False,3,scaffold_6
22,3222001,3795000,572999,False,3,scaffold_6
23,3880001,3913000,32999,False,3,scaffold_6
24,3973001,4195000,221999,False,3,scaffold_6
25,4835001,4869000,33999,False,3,scaffold_6
26,5939001,5972000,32999,False,3,scaffold_6
27,6009001,6082000,72999,False,3,scaffold_6
28,6141001,6199000,57999,False,3,scaffold_6
29,6783001,6804000,20999,False,3,scaffold_6
30,7184001,7339000,154999,False,3,scaffold_6
31,7390001,7476000,85999,False,3,scaffold_6
32,7541001,8268281,727280,True,3,scaffold_6
0,13001,34000,20999,False,3,scaffold_7
1,228001,235000,6999,False,3,scaffold_7
2,243001,249000,5999,False,3,scaffold_7
3,323001,340000,16999,False,3,scaffold_7
4,342001,509000,166999,False,3,scaffold_7
5,554001,563000,8999,False,3,scaffold_7
6,571001,579000,7999,False,3,scaffold_7
7,623001,641000,17999,False,3,scaffold_7
8,706001,736000,29999,False,3,scaffold_7
9,741001,753000,11999,False,3,scaffold_7
10,764001,829000,64999,False,3,scaffold_7
11,830001,843000,12999,False,3,scaffold_7
12,859001,864000,4999,False,3,scaffold_7
13,865001,938000,72999,False,3,scaffold_7
14,953001,963000,9999,False,3,scaffold_7
15,964001,966000,1999,False,3,scaffold_7
16,968001,980000,11999,False,3,scaffold_7
17,982001,1044000,61999,False,3,scaffold_7
18,1048001,1100000,51999,False,3,scaffold_7
19,1191001,1460000,268999,False,3,scaffold_7
20,1461001,1512000,50999,False,3,scaffold_7
21,1588001,1695000,106999,False,3,scaffold_7
22,1732001,1782000,49999,False,3,scaffold_7
23,1851001,1901000,49999,False,3,scaffold_7
24,1975001,2015000,39999,False,3,scaffold_7
25,3295001,3370000,74999,False,3,scaffold_7
26,3519001,3766000,246999,False,3,scaffold_7
27,4022001,4062000,39999,False,3,scaffold_7
28,4415001,4512000,96999,False,3,scaffold_7
29,4658001,4736000,77999,False,3,scaffold_7
30,4754001,4820000,65999,False,3,scaffold_7
31,4979001,5149000,169999,False,3,scaffold_7
32,5482001,5536000,53999,False,3,scaffold_7
33,6061001,6094000,32999,False,3,scaffold_7
34,6171001,6202000,30999,False,3,scaffold_7
35,6636001,6676000,39999,False,3,scaffold_7
36,6752001,6796000,43999,False,3,scaffold_7
37,6954001,7502216,548215,True,3,scaffold_7
0,1,7000,6999,True,3,scaffold_8
1,67001,85000,17999,False,3,scaffold_8
2,541001,549000,7999,False,3,scaffold_8
3,2442001,2531000,88999,False,3,scaffold_8
4,2536001,2551000,14999,False,3,scaffold_8
5,2648001,2683000,34999,False,3,scaffold_8
6,2684001,2844000,159999,False,3,scaffold_8
7,2847001,2910000,62999,False,3,scaffold_8
8,2997001,3125000,127999,False,3,scaffold_8
9,3126001,3549000,422999,False,3,scaffold_8
10,3580001,3939000,358999,False,3,scaffold_8
11,4034001,4104000,69999,False,3,scaffold_8
12,4176001,4221000,44999,False,3,scaffold_8
13,4400001,4434000,33999,False,3,scaffold_8
14,5083001,5137000,53999,False,3,scaffold_8
15,5163001,5241000,77999,False,3,scaffold_8
16,5651001,5723000,71999,False,3,scaffold_8
17,5760001,5774000,13999,False,3,scaffold_8
18,6320001,6334544,14543,True,3,scaffold_8
0,109001,118000,8999,False,3,scaffold_9
1,121001,138000,16999,False,3,scaffold_9
2,366001,411000,44999,False,3,scaffold_9
3,413001,434000,20999,False,3,scaffold_9
4,488001,531000,42999,False,3,scaffold_9
5,652001,665000,12999,False,3,scaffold_9
6,670001,697000,26999,False,3,scaffold_9
7,730001,742000,11999,False,3,scaffold_9
8,815001,842000,26999,False,3,scaffold_9
9,875001,882000,6999,False,3,scaffold_9
10,883001,986000,102999,False,3,scaffold_9
11,987001,995000,7999,False,3,scaffold_9
12,1001001,1007000,5999,False,3,scaffold_9
13,1010001,1150000,139999,False,3,scaffold_9
14,1151001,1161000,9999,False,3,scaffold_9
15,1313001,1403000,89999,False,3,scaffold_9
16,1412001,1422000,9999,False,3,scaffold_9
17,1428001,1441000,12999,False,3,scaffold_9
18,1457001,1464000,6999,False,3,scaffold_9
19,1487001,1499000,11999,False,3,scaffold_9
20,1544001,1592000,47999,False,3,scaffold_9
21,1599001,1625000,25999,False,3,scaffold_9
22,1638001,1692000,53999,False,3,scaffold_9
23,1751001,1791000,39999,False,3,scaffold_9
24,1893001,1907000,13999,False,3,scaffold_9
25,1923001,1953000,29999,False,3,scaffold_9
26,1970001,2058000,87999,False,3,scaffold_9
27,2073001,2135000,61999,False,3,scaffold_9
28,2137001,2171000,33999,False,3,scaffold_9
29,2173001,2239000,65999,False,3,scaffold_9
30,2600001,2665000,64999,False,3,scaffold_9
31,2735001,3381000,645999,False,3,scaffold_9
32,3383001,5107000,1723999,False,3,scaffold_9
33,5112001,5298000,185999,False,3,scaffold_9
34,5299001,5490000,190999,False,3,scaffold_9
35,5493001,6331288,838287,True,3,scaffold_9
0,1,237000,236999,True,3,scaffold_10
1,256001,414000,157999,False,3,scaffold_10
2,415001,482000,66999,False,3,scaffold_10
3,483001,582000,98999,False,3,scaffold_10
4,600001,758000,157999,False,3,scaffold_10
5,783001,794000,10999,False,3,scaffold_10
6,812001,877000,64999,False,3,scaffold_10
7,888001,1069000,180999,False,3,scaffold_10
8,1073001,1152000,78999,False,3,scaffold_10
9,1388001,1472000,83999,False,3,scaffold_10
10,1605001,1675000,69999,False,3,scaffold_10
11,1805001,1817000,11999,False,3,scaffold_10
12,2066001,2107000,40999,False,3,scaffold_10
13,2140001,2248000,107999,False,3,scaffold_10
14,2262001,2475000,212999,False,3,scaffold_10
15,2512001,2520000,7999,False,3,scaffold_10
16,2550001,2583000,32999,False,3,scaffold_10
17,2600001,2652000,51999,False,3,scaffold_10
18,2674001,2697000,22999,False,3,scaffold_10
19,2714001,2733000,18999,False,3,scaffold_10
20,2735001,2770000,34999,False,3,scaffold_10
21,2815001,2832000,16999,False,3,scaffold_10
22,2938001,2953000,14999,False,3,scaffold_10
23,3468001,3476000,7999,False,3,scaffold_10
24,4002001,4011000,8999,False,3,scaffold_10
25,4051001,4091000,39999,False,3,scaffold_10
26,4154001,4174000,19999,False,3,scaffold_10
27,4335001,4359000,23999,False,3,scaffold_10
28,4467001,4502000,34999,False,3,scaffold_10
29,4503001,4513000,9999,False,3,scaffold_10
30,4527001,4548000,20999,False,3,scaffold_10
31,4574001,4596000,21999,False,3,scaffold_10
32,4680001,4688000,7999,False,3,scaffold_10
33,4734001,4776000,41999,False,3,scaffold_10
34,4791001,4796000,4999,False,3,scaffold_10
35,4798001,4824000,25999,False,3,scaffold_10
36,4827001,4843000,15999,False,3,scaffold_10
37,4848001,4861000,12999,False,3,scaffold_10
38,4865001,4866973,1972,True,3,scaffold_10
0,10001,37000,26999,False,3,scaffold_11
1,38001,99000,60999,False,3,scaffold_11
2,132001,167000,34999,False,3,scaffold_11
3,169001,191000,21999,False,3,scaffold_11
4,213001,235000,21999,False,3,scaffold_11
5,240001,252000,11999,False,3,scaffold_11
6,296001,320000,23999,False,3,scaffold_11
7,419001,431000,11999,False,3,scaffold_11
8,648001,656000,7999,False,3,scaffold_11
9,1403001,1409000,5999,False,3,scaffold_11
10,1474001,1478000,3999,False,3,scaffold_11
11,1971001,1983000,11999,False,3,scaffold_11
12,2701001,2877000,175999,False,3,scaffold_11
13,2957001,3018000,60999,False,3,scaffold_11
14,3083001,3175000,91999,False,3,scaffold_11
15,3185001,3383000,197999,False,3,scaffold_11
16,3419001,3481000,61999,False,3,scaffold_11
17,3521001,4159000,637999,False,3,scaffold_11
18,4180001,4710000,529999,False,3,scaffold_11
19,4712001,4766820,54819,True,3,scaffold_11
0,1,1498000,1497999,True,3,scaffold_12
1,1720001,1733000,12999,False,3,scaffold_12
2,1783001,1811000,27999,False,3,scaffold_12
3,2024001,2041000,16999,False,3,scaffold_12
4,2043001,2104000,60999,False,3,scaffold_12
5,2130001,2179000,48999,False,3,scaffold_12
6,2340001,2377000,36999,False,3,scaffold_12
7,2571001,2609000,37999,False,3,scaffold_12
8,2685001,2699000,13999,False,3,scaffold_12
0,1,340000,339999,True,4,scaffold_1
1,482001,498000,15999,False,4,scaffold_1
2,571001,643000,71999,False,4,scaffold_1
3,686001,743000,56999,False,4,scaffold_1
4,1281001,1292000,10999,False,4,scaffold_1
5,1954001,1964000,9999,False,4,scaffold_1
6,1965001,1984000,18999,False,4,scaffold_1
7,2449001,2517000,67999,False,4,scaffold_1
8,2729001,2746000,16999,False,4,scaffold_1
9,3181001,3208000,26999,False,4,scaffold_1
10,3388001,3390000,1999,False,4,scaffold_1
11,3715001,3732000,16999,False,4,scaffold_1
12,3916001,3941000,24999,False,4,scaffold_1
13,4062001,4111000,48999,False,4,scaffold_1
14,4316001,4354000,37999,False,4,scaffold_1
15,4927001,4963000,35999,False,4,scaffold_1
16,4969001,4983000,13999,False,4,scaffold_1
17,5482001,5511000,28999,False,4,scaffold_1
18,5536001,5569000,32999,False,4,scaffold_1
19,6108001,6153000,44999,False,4,scaffold_1
20,6228001,6380000,151999,False,4,scaffold_1
21,6383001,6507000,123999,False,4,scaffold_1
22,6545001,6554000,8999,False,4,scaffold_1
23,7038001,7247000,208999,False,4,scaffold_1
24,7248001,7588000,339999,False,4,scaffold_1
25,7590001,8656000,1065999,False,4,scaffold_1
26,8658001,9584000,925999,False,4,scaffold_1
27,9586001,10354000,767999,False,4,scaffold_1
28,10461001,10637000,175999,False,4,scaffold_1
29,10839001,10858000,18999,False,4,scaffold_1
30,11351001,11504000,152999,False,4,scaffold_1
31,11615001,11951000,335999,False,4,scaffold_1
32,12184001,12204000,19999,False,4,scaffold_1
33,12678001,12722000,43999,False,4,scaffold_1
34,12777001,12888000,110999,False,4,scaffold_1
35,13114001,13134000,19999,False,4,scaffold_1
36,13179001,13211000,31999,False,4,scaffold_1
37,13347001,13377000,29999,False,4,scaffold_1
38,13900001,13903000,2999,False,4,scaffold_1
39,14297001,14307000,9999,False,4,scaffold_1
40,14605001,14609000,3999,False,4,scaffold_1
0,21001,48000,26999,False,4,scaffold_2
1,93001,159000,65999,False,4,scaffold_2
2,168001,177000,8999,False,4,scaffold_2
3,333001,374000,40999,False,4,scaffold_2
4,2336001,2358000,21999,False,4,scaffold_2
5,2405001,2424000,18999,False,4,scaffold_2
6,2441001,2553000,111999,False,4,scaffold_2
7,2645001,2689000,43999,False,4,scaffold_2
8,2694001,2742000,47999,False,4,scaffold_2
9,2868001,2897000,28999,False,4,scaffold_2
10,2994001,3012000,17999,False,4,scaffold_2
11,3454001,3464000,9999,False,4,scaffold_2
12,3759001,3783000,23999,False,4,scaffold_2
13,4385001,4409000,23999,False,4,scaffold_2
14,4429001,4456000,26999,False,4,scaffold_2
15,4523001,4554000,30999,False,4,scaffold_2
16,4597001,4653000,55999,False,4,scaffold_2
17,5022001,5031000,8999,False,4,scaffold_2
18,5033001,5061000,27999,False,4,scaffold_2
19,5491001,5511000,19999,False,4,scaffold_2
20,5672001,5704000,31999,False,4,scaffold_2
21,6261001,6330000,68999,False,4,scaffold_2
22,6331001,6342000,10999,False,4,scaffold_2
23,7439001,7472000,32999,False,4,scaffold_2
24,7563001,7697000,133999,False,4,scaffold_2
25,7786001,7890000,103999,False,4,scaffold_2
26,7934001,7965000,30999,False,4,scaffold_2
27,7985001,8135000,149999,False,4,scaffold_2
28,8331001,8333000,1999,False,4,scaffold_2
29,8346001,8389000,42999,False,4,scaffold_2
30,8509001,8535000,25999,False,4,scaffold_2
31,11367001,11371000,3999,False,4,scaffold_2
32,11520001,11785000,264999,False,4,scaffold_2
0,51001,55000,3999,False,4,scaffold_3
1,799001,900000,100999,False,4,scaffold_3
2,2085001,2108000,22999,False,4,scaffold_3
3,2291001,2321000,29999,False,4,scaffold_3
4,2506001,2533000,26999,False,4,scaffold_3
5,3826001,3845000,18999,False,4,scaffold_3
6,3852001,3859000,6999,False,4,scaffold_3
7,4109001,4397000,287999,False,4,scaffold_3
8,4418001,4518000,99999,False,4,scaffold_3
9,4547001,4558000,10999,False,4,scaffold_3
10,4653001,4678000,24999,False,4,scaffold_3
11,5578001,5581000,2999,False,4,scaffold_3
12,6911001,6962000,50999,False,4,scaffold_3
13,6980001,7078000,97999,False,4,scaffold_3
14,7524001,7556000,31999,False,4,scaffold_3
15,7692001,7729000,36999,False,4,scaffold_3
16,7822001,7838000,15999,False,4,scaffold_3
17,8208001,8255000,46999,False,4,scaffold_3
18,8462001,8527000,64999,False,4,scaffold_3
19,8575001,8594000,18999,False,4,scaffold_3
20,9968001,9995000,26999,False,4,scaffold_3
21,10461001,10483000,21999,False,4,scaffold_3
22,10587001,11164000,576999,False,4,scaffold_3
0,11001,13000,1999,False,4,scaffold_4
1,17001,32000,14999,False,4,scaffold_4
2,49001,88000,38999,False,4,scaffold_4
3,143001,146000,2999,False,4,scaffold_4
4,147001,151000,3999,False,4,scaffold_4
5,155001,215000,59999,False,4,scaffold_4
6,217001,226000,8999,False,4,scaffold_4
7,227001,266000,38999,False,4,scaffold_4
8,291001,308000,16999,False,4,scaffold_4
9,313001,344000,30999,False,4,scaffold_4
10,355001,374000,18999,False,4,scaffold_4
11,375001,380000,4999,False,4,scaffold_4
12,393001,410000,16999,False,4,scaffold_4
13,412001,425000,12999,False,4,scaffold_4
14,429001,498000,68999,False,4,scaffold_4
15,545001,592000,46999,False,4,scaffold_4
16,608001,667000,58999,False,4,scaffold_4
17,668001,691000,22999,False,4,scaffold_4
18,701001,714000,12999,False,4,scaffold_4
19,1121001,1136000,14999,False,4,scaffold_4
20,1137001,1198000,60999,False,4,scaffold_4
21,1199001,1208000,8999,False,4,scaffold_4
22,1210001,1226000,15999,False,4,scaffold_4
23,1254001,1262000,7999,False,4,scaffold_4
24,1265001,1279000,13999,False,4,scaffold_4
25,1283001,1337000,53999,False,4,scaffold_4
26,1372001,1591000,218999,False,4,scaffold_4
27,1749001,1849000,99999,False,4,scaffold_4
28,1850001,1863000,12999,False,4,scaffold_4
29,1904001,1957000,52999,False,4,scaffold_4
30,2036001,2068000,31999,False,4,scaffold_4
31,2247001,2279000,31999,False,4,scaffold_4
32,2284001,2340000,55999,False,4,scaffold_4
33,2429001,2461000,31999,False,4,scaffold_4
34,2476001,2533000,56999,False,4,scaffold_4
35,3335001,3632000,296999,False,4,scaffold_4
36,3676001,3760000,83999,False,4,scaffold_4
37,4944001,4985000,40999,False,4,scaffold_4
38,5176001,5208000,31999,False,4,scaffold_4
39,5477001,5506000,28999,False,4,scaffold_4
40,5514001,5620000,105999,False,4,scaffold_4
41,5667001,5784000,116999,False,4,scaffold_4
42,6145001,6190000,44999,False,4,scaffold_4
43,6804001,6817000,12999,False,4,scaffold_4
44,7036001,7062000,25999,False,4,scaffold_4
45,8846001,9699000,852999,False,4,scaffold_4
46,9701001,9845951,144950,True,4,scaffold_4
0,296001,300000,3999,False,4,scaffold_5
1,318001,368000,49999,False,4,scaffold_5
2,463001,523000,59999,False,4,scaffold_5
3,933001,947000,13999,False,4,scaffold_5
4,1036001,1038000,1999,False,4,scaffold_5
5,1062001,1068000,5999,False,4,scaffold_5
6,2565001,2581000,15999,False,4,scaffold_5
7,2619001,2737000,117999,False,4,scaffold_5
8,2816001,2871000,54999,False,4,scaffold_5
9,3167001,3185000,17999,False,4,scaffold_5
10,3322001,3437000,114999,False,4,scaffold_5
11,3451001,3497000,45999,False,4,scaffold_5
12,3962001,4101000,138999,False,4,scaffold_5
13,4121001,4142000,20999,False,4,scaffold_5
14,4155001,4219000,63999,False,4,scaffold_5
15,4246001,4262000,15999,False,4,scaffold_5
16,4446001,4483000,36999,False,4,scaffold_5
17,4602001,4649000,46999,False,4,scaffold_5
18,4691001,4717000,25999,False,4,scaffold_5
19,4789001,4861000,71999,False,4,scaffold_5
20,5318001,5346000,27999,False,4,scaffold_5
21,7582001,7608000,25999,False,4,scaffold_5
22,7623001,7637000,13999,False,4,scaffold_5
23,8730001,9363000,632999,False,4,scaffold_5
0,79001,84000,4999,False,4,scaffold_6
1,86001,112000,25999,False,4,scaffold_6
2,239001,254000,14999,False,4,scaffold_6
3,257001,262000,4999,False,4,scaffold_6
4,267001,283000,15999,False,4,scaffold_6
5,1229001,1257000,27999,False,4,scaffold_6
6,1478001,1546000,67999,False,4,scaffold_6
7,2023001,2086000,62999,False,4,scaffold_6
8,2130001,2169000,38999,False,4,scaffold_6
9,2350001,2595000,244999,False,4,scaffold_6
10,2596001,2652000,55999,False,4,scaffold_6
11,2661001,2691000,29999,False,4,scaffold_6
12,2731001,2851000,119999,False,4,scaffold_6
13,2933001,3014000,80999,False,4,scaffold_6
14,3115001,3149000,33999,False,4,scaffold_6
15,3224001,3301000,76999,False,4,scaffold_6
16,3408001,3428000,19999,False,4,scaffold_6
17,3461001,3766000,304999,False,4,scaffold_6
18,3901001,3912000,10999,False,4,scaffold_6
19,4018001,4068000,49999,False,4,scaffold_6
20,4086001,4192000,105999,False,4,scaffold_6
21,6010001,6060000,49999,False,4,scaffold_6
22,7283001,7336000,52999,False,4,scaffold_6
23,7541001,7795000,253999,False,4,scaffold_6
24,7811001,8268281,457280,True,4,scaffold_6
0,1,8000,7999,True,4,scaffold_7
1,13001,31000,17999,False,4,scaffold_7
2,323001,340000,16999,False,4,scaffold_7
3,342001,507000,164999,False,4,scaffold_7
4,554001,563000,8999,False,4,scaffold_7
5,571001,577000,5999,False,4,scaffold_7
6,706001,736000,29999,False,4,scaffold_7
7,741001,753000,11999,False,4,scaffold_7
8,764001,809000,44999,False,4,scaffold_7
9,859001,864000,4999,False,4,scaffold_7
10,964001,966000,1999,False,4,scaffold_7
11,968001,980000,11999,False,4,scaffold_7
12,982001,1044000,61999,False,4,scaffold_7
13,1048001,1089000,40999,False,4,scaffold_7
14,1203001,1512000,308999,False,4,scaffold_7
15,1588001,1688000,99999,False,4,scaffold_7
16,3326001,3369000,42999,False,4,scaffold_7
17,3595001,3649000,53999,False,4,scaffold_7
18,4416001,4517000,100999,False,4,scaffold_7
19,4658001,4681000,22999,False,4,scaffold_7
20,4979001,5113000,133999,False,4,scaffold_7
21,5498001,5514000,15999,False,4,scaffold_7
22,6954001,7270000,315999,False,4,scaffold_7
23,7271001,7502216,231215,True,4,scaffold_7
0,1,7000,6999,True,4,scaffold_8
1,66001,85000,18999,False,4,scaffold_8
2,93001,101000,7999,False,4,scaffold_8
3,2444001,2470000,25999,False,4,scaffold_8
4,2662001,2683000,20999,False,4,scaffold_8
5,2745001,2756000,10999,False,4,scaffold_8
6,2816001,2844000,27999,False,4,scaffold_8
7,3060001,3525000,464999,False,4,scaffold_8
8,3584001,3612000,27999,False,4,scaffold_8
9,3615001,3913000,297999,False,4,scaffold_8
10,5200001,5241000,40999,False,4,scaffold_8
11,6332001,6334544,2543,True,4,scaffold_8
0,109001,117000,7999,False,4,scaffold_9
1,367001,411000,43999,False,4,scaffold_9
2,413001,434000,20999,False,4,scaffold_9
3,502001,531000,28999,False,4,scaffold_9
4,652001,664000,11999,False,4,scaffold_9
5,671001,696000,24999,False,4,scaffold_9
6,732001,742000,9999,False,4,scaffold_9
7,816001,842000,25999,False,4,scaffold_9
8,873001,986000,112999,False,4,scaffold_9
9,988001,995000,6999,False,4,scaffold_9
10,1001001,1007000,5999,False,4,scaffold_9
11,1010001,1031000,20999,False,4,scaffold_9
12,1035001,1085000,49999,False,4,scaffold_9
13,1087001,1150000,62999,False,4,scaffold_9
14,1151001,1164000,12999,False,4,scaffold_9
15,1312001,1377000,64999,False,4,scaffold_9
16,1770001,1783000,12999,False,4,scaffold_9
17,2601001,2616000,14999,False,4,scaffold_9
18,2870001,3381000,510999,False,4,scaffold_9
19,3383001,5107000,1723999,False,4,scaffold_9
20,5112001,5115000,2999,False,4,scaffold_9
21,5116001,5238000,121999,False,4,scaffold_9
22,5239001,5298000,58999,False,4,scaffold_9
23,5300001,5490000,189999,False,4,scaffold_9
24,5493001,6331288,838287,True,4,scaffold_9
0,1,198000,197999,True,4,scaffold_10
1,372001,414000,41999,False,4,scaffold_10
2,472001,482000,9999,False,4,scaffold_10
3,508001,580000,71999,False,4,scaffold_10
4,603001,749000,145999,False,4,scaffold_10
5,888001,917000,28999,False,4,scaffold_10
6,924001,962000,37999,False,4,scaffold_10
7,1087001,1111000,23999,False,4,scaffold_10
8,2346001,2367000,20999,False,4,scaffold_10
9,3272001,3274000,1999,False,4,scaffold_10
10,4053001,4091000,37999,False,4,scaffold_10
11,4154001,4174000,19999,False,4,scaffold_10
12,4443001,4462000,18999,False,4,scaffold_10
13,4467001,4476000,8999,False,4,scaffold_10
14,4503001,4513000,9999,False,4,scaffold_10
15,4515001,4523000,7999,False,4,scaffold_10
16,4526001,4548000,21999,False,4,scaffold_10
17,4565001,4596000,30999,False,4,scaffold_10
18,4681001,4688000,6999,False,4,scaffold_10
19,4734001,4766000,31999,False,4,scaffold_10
20,4769001,4776000,6999,False,4,scaffold_10
21,4798001,4824000,25999,False,4,scaffold_10
22,4827001,4843000,15999,False,4,scaffold_10
23,4848001,4861000,12999,False,4,scaffold_10
24,4865001,4866973,1972,True,4,scaffold_10
0,10001,34000,23999,False,4,scaffold_11
1,40001,91000,50999,False,4,scaffold_11
2,149001,167000,17999,False,4,scaffold_11
3,169001,191000,21999,False,4,scaffold_11
4,213001,235000,21999,False,4,scaffold_11
5,240001,248000,7999,False,4,scaffold_11
6,419001,431000,11999,False,4,scaffold_11
7,648001,656000,7999,False,4,scaffold_11
8,1025001,1034000,8999,False,4,scaffold_11
9,1305001,1307000,1999,False,4,scaffold_11
10,1423001,1426000,2999,False,4,scaffold_11
11,1474001,1477000,2999,False,4,scaffold_11
12,1552001,1556000,3999,False,4,scaffold_11
13,2701001,2873000,171999,False,4,scaffold_11
14,3205001,3254000,48999,False,4,scaffold_11
15,3328001,3383000,54999,False,4,scaffold_11
16,3702001,3926000,223999,False,4,scaffold_11
17,4320001,4710000,389999,False,4,scaffold_11
18,4713001,4766820,53819,True,4,scaffold_11
0,1,370000,369999,True,4,scaffold_12
1,474001,537000,62999,False,4,scaffold_12
2,582001,856000,273999,False,4,scaffold_12
3,865001,1354000,488999,False,4,scaffold_12
4,1719001,1733000,13999,False,4,scaffold_12
5,2571001,2619000,47999,False,4,scaffold_12
6,2685001,2698000,12999,False,4,scaffold_12
0,1,342000,341999,True,5,scaffold_1
1,482001,498000,15999,False,5,scaffold_1
2,555001,643000,87999,False,5,scaffold_1
3,686001,750000,63999,False,5,scaffold_1
4,1561001,1578000,16999,False,5,scaffold_1
5,1613001,1660000,46999,False,5,scaffold_1
6,1810001,1935000,124999,False,5,scaffold_1
7,1950001,1984000,33999,False,5,scaffold_1
8,1987001,2016000,28999,False,5,scaffold_1
9,2449001,2517000,67999,False,5,scaffold_1
10,2563001,2582000,18999,False,5,scaffold_1
11,2725001,2746000,20999,False,5,scaffold_1
12,3172001,3209000,36999,False,5,scaffold_1
13,3388001,3390000,1999,False,5,scaffold_1
14,3704001,3879000,174999,False,5,scaffold_1
15,3901001,3941000,39999,False,5,scaffold_1
16,3954001,4030000,75999,False,5,scaffold_1
17,4062001,4112000,49999,False,5,scaffold_1
18,4314001,4378000,63999,False,5,scaffold_1
19,4707001,4741000,33999,False,5,scaffold_1
20,4796001,4815000,18999,False,5,scaffold_1
21,4920001,5024000,103999,False,5,scaffold_1
22,5088001,5111000,22999,False,5,scaffold_1
23,5142001,5199000,56999,False,5,scaffold_1
24,5437001,5457000,19999,False,5,scaffold_1
25,5481001,5511000,29999,False,5,scaffold_1
26,5535001,5581000,45999,False,5,scaffold_1
27,5856001,5909000,52999,False,5,scaffold_1
28,6108001,6153000,44999,False,5,scaffold_1
29,6154001,6178000,23999,False,5,scaffold_1
30,6201001,6559000,357999,False,5,scaffold_1
31,7038001,7247000,208999,False,5,scaffold_1
32,7248001,7589000,340999,False,5,scaffold_1
33,7590001,8656000,1065999,False,5,scaffold_1
34,8658001,9584000,925999,False,5,scaffold_1
35,9586001,10361000,774999,False,5,scaffold_1
36,10461001,10636000,174999,False,5,scaffold_1
37,10832001,10858000,25999,False,5,scaffold_1
38,10918001,10940000,21999,False,5,scaffold_1
39,11015001,11030000,14999,False,5,scaffold_1
40,11274001,11509000,234999,False,5,scaffold_1
41,11559001,11963000,403999,False,5,scaffold_1
42,12184001,12205000,20999,False,5,scaffold_1
43,12425001,12449000,23999,False,5,scaffold_1
44,12532001,12581000,48999,False,5,scaffold_1
45,12627001,12723000,95999,False,5,scaffold_1
46,12733001,12888000,154999,False,5,scaffold_1
47,12975001,13002000,26999,False,5,scaffold_1
48,13113001,13212000,98999,False,5,scaffold_1
49,13343001,13456000,112999,False,5,scaffold_1
50,13557001,13590000,32999,False,5,scaffold_1
51,13591001,13608000,16999,False,5,scaffold_1
52,13789001,13845000,55999,False,5,scaffold_1
53,13959001,13973000,13999,False,5,scaffold_1
54,14285001,14308000,22999,False,5,scaffold_1
55,14471001,14476000,4999,False,5,scaffold_1
56,14648001,14664000,15999,False,5,scaffold_1
57,14734001,14737000,2999,False,5,scaffold_1
0,8001,48000,39999,False,5,scaffold_2
1,93001,159000,65999,False,5,scaffold_2
2,168001,177000,8999,False,5,scaffold_2
3,179001,185000,5999,False,5,scaffold_2
4,278001,288000,9999,False,5,scaffold_2
5,331001,374000,42999,False,5,scaffold_2
6,379001,381000,1999,False,5,scaffold_2
7,1359001,1415000,55999,False,5,scaffold_2
8,1525001,1554000,28999,False,5,scaffold_2
9,1691001,1716000,24999,False,5,scaffold_2
10,1881001,1899000,17999,False,5,scaffold_2
11,2084001,2133000,48999,False,5,scaffold_2
12,2336001,2609000,272999,False,5,scaffold_2
13,2627001,2639000,11999,False,5,scaffold_2
14,2645001,2689000,43999,False,5,scaffold_2
15,2694001,2745000,50999,False,5,scaffold_2
16,2766001,2788000,21999,False,5,scaffold_2
17,2831001,2855000,23999,False,5,scaffold_2
18,2877001,2905000,27999,False,5,scaffold_2
19,2975001,3012000,36999,False,5,scaffold_2
20,3174001,3186000,11999,False,5,scaffold_2
21,3330001,3344000,13999,False,5,scaffold_2
22,3362001,3388000,25999,False,5,scaffold_2
23,3449001,3553000,103999,False,5,scaffold_2
24,3655001,3691000,35999,False,5,scaffold_2
25,3754001,3784000,29999,False,5,scaffold_2
26,4242001,4285000,42999,False,5,scaffold_2
27,4291001,4319000,27999,False,5,scaffold_2
28,4334001,4409000,74999,False,5,scaffold_2
29,4426001,4461000,34999,False,5,scaffold_2
30,4512001,4790000,277999,False,5,scaffold_2
31,4793001,4810000,16999,False,5,scaffold_2
32,4917001,4954000,36999,False,5,scaffold_2
33,5018001,5104000,85999,False,5,scaffold_2
34,5350001,5515000,164999,False,5,scaffold_2
35,5607001,5759000,151999,False,5,scaffold_2
36,5840001,5889000,48999,False,5,scaffold_2
37,5907001,5994000,86999,False,5,scaffold_2
38,6005001,6035000,29999,False,5,scaffold_2
39,6121001,6140000,18999,False,5,scaffold_2
40,6251001,6351000,99999,False,5,scaffold_2
41,6365001,6449000,83999,False,5,scaffold_2
42,6589001,6628000,38999,False,5,scaffold_2
43,6940001,6979000,38999,False,5,scaffold_2
44,7005001,7038000,32999,False,5,scaffold_2
45,7062001,7097000,34999,False,5,scaffold_2
46,7167001,7210000,42999,False,5,scaffold_2
47,7211001,7215000,3999,False,5,scaffold_2
48,7428001,7473000,44999,False,5,scaffold_2
49,7491001,7517000,25999,False,5,scaffold_2
50,7550001,7561000,10999,False,5,scaffold_2
51,7563001,7698000,134999,False,5,scaffold_2
52,7786001,7917000,130999,False,5,scaffold_2
53,7933001,8199000,265999,False,5,scaffold_2
54,8259001,8327000,67999,False,5,scaffold_2
55,8331001,8333000,1999,False,5,scaffold_2
56,8334001,8345000,10999,False,5,scaffold_2
57,8346001,8454000,107999,False,5,scaffold_2
58,8495001,8564000,68999,False,5,scaffold_2
59,9139001,9168000,28999,False,5,scaffold_2
60,9868001,9905000,36999,False,5,scaffold_2
61,9927001,9944000,16999,False,5,scaffold_2
62,10757001,10766000,8999,False,5,scaffold_2
63,11367001,11425000,57999,False,5,scaffold_2
64,11519001,11786000,266999,False,5,scaffold_2
65,11797001,11802476,5475,True,5,scaffold_2
0,618001,646000,27999,False,5,scaffold_3
1,798001,902000,103999,False,5,scaffold_3
2,2012001,2108000,95999,False,5,scaffold_3
3,2109001,2126000,16999,False,5,scaffold_3
4,2206001,2231000,24999,False,5,scaffold_3
5,2287001,2336000,48999,False,5,scaffold_3
6,2402001,2428000,25999,False,5,scaffold_3
7,2433001,2533000,99999,False,5,scaffold_3
8,2641001,2736000,94999,False,5,scaffold_3
9,3094001,3124000,29999,False,5,scaffold_3
10,3227001,3279000,51999,False,5,scaffold_3
11,3559001,3582000,22999,False,5,scaffold_3
12,3603001,3644000,40999,False,5,scaffold_3
13,3713001,3736000,22999,False,5,scaffold_3
14,3769001,3821000,51999,False,5,scaffold_3
15,3822001,3891000,68999,False,5,scaffold_3
16,3926001,3953000,26999,False,5,scaffold_3
17,3998001,4033000,34999,False,5,scaffold_3
18,4066001,4398000,331999,False,5,scaffold_3
19,4412001,4519000,106999,False,5,scaffold_3
20,4547001,4558000,10999,False,5,scaffold_3
21,4642001,4680000,37999,False,5,scaffold_3
22,4998001,5033000,34999,False,5,scaffold_3
23,5158001,5206000,47999,False,5,scaffold_3
24,5236001,5272000,35999,False,5,scaffold_3
25,5493001,5509000,15999,False,5,scaffold_3
26,5588001,5676000,87999,False,5,scaffold_3
27,5804001,6027000,222999,False,5,scaffold_3
28,6743001,6784000,40999,False,5,scaffold_3
29,6887001,7097000,209999,False,5,scaffold_3
30,7109001,7157000,47999,False,5,scaffold_3
31,7254001,7317000,62999,False,5,scaffold_3
32,7338001,7361000,22999,False,5,scaffold_3
33,7369001,7445000,75999,False,5,scaffold_3
34,7483001,7556000,72999,False,5,scaffold_3
35,7578001,7629000,50999,False,5,scaffold_3
36,7680001,7856000,175999,False,5,scaffold_3
37,8028001,8075000,46999,False,5,scaffold_3
38,8121001,8156000,34999,False,5,scaffold_3
39,8175001,8253000,77999,False,5,scaffold_3
40,8428001,8447000,18999,False,5,scaffold_3
41,8462001,8528000,65999,False,5,scaffold_3
42,8575001,8594000,18999,False,5,scaffold_3
43,9004001,9080000,75999,False,5,scaffold_3
44,9119001,9171000,51999,False,5,scaffold_3
45,9200001,9236000,35999,False,5,scaffold_3
46,9967001,9996000,28999,False,5,scaffold_3
47,10461001,10483000,21999,False,5,scaffold_3
48,10587001,11165000,577999,False,5,scaffold_3
0,11001,13000,1999,False,5,scaffold_4
1,17001,32000,14999,False,5,scaffold_4
2,48001,88000,39999,False,5,scaffold_4
3,121001,146000,24999,False,5,scaffold_4
4,147001,151000,3999,False,5,scaffold_4
5,155001,215000,59999,False,5,scaffold_4
6,217001,226000,8999,False,5,scaffold_4
7,227001,266000,38999,False,5,scaffold_4
8,289001,344000,54999,False,5,scaffold_4
9,345001,353000,7999,False,5,scaffold_4
10,355001,374000,18999,False,5,scaffold_4
11,375001,380000,4999,False,5,scaffold_4
12,412001,425000,12999,False,5,scaffold_4
13,429001,498000,68999,False,5,scaffold_4
14,545001,599000,53999,False,5,scaffold_4
15,600001,606000,5999,False,5,scaffold_4
16,608001,691000,82999,False,5,scaffold_4
17,701001,714000,12999,False,5,scaffold_4
18,1120001,1136000,15999,False,5,scaffold_4
19,1137001,1198000,60999,False,5,scaffold_4
20,1199001,1226000,26999,False,5,scaffold_4
21,1238001,1253000,14999,False,5,scaffold_4
22,1283001,1337000,53999,False,5,scaffold_4
23,1353001,1605000,251999,False,5,scaffold_4
24,1613001,2185000,571999,False,5,scaffold_4
25,2188001,2206000,17999,False,5,scaffold_4
26,2207001,2218000,10999,False,5,scaffold_4
27,2219001,2279000,59999,False,5,scaffold_4
28,2283001,2461000,177999,False,5,scaffold_4
29,2476001,2635000,158999,False,5,scaffold_4
30,2651001,2675000,23999,False,5,scaffold_4
31,2676001,2800000,123999,False,5,scaffold_4
32,2892001,2963000,70999,False,5,scaffold_4
33,3001001,3137000,135999,False,5,scaffold_4
34,3160001,3332000,171999,False,5,scaffold_4
35,3334001,3774000,439999,False,5,scaffold_4
36,4010001,4046000,35999,False,5,scaffold_4
37,4058001,4087000,28999,False,5,scaffold_4
38,4900001,5084000,183999,False,5,scaffold_4
39,5172001,5224000,51999,False,5,scaffold_4
40,5338001,5402000,63999,False,5,scaffold_4
41,5429001,5506000,76999,False,5,scaffold_4
42,5514001,5784000,269999,False,5,scaffold_4
43,5786001,5828000,41999,False,5,scaffold_4
44,5929001,5967000,37999,False,5,scaffold_4
45,6146001,6195000,48999,False,5,scaffold_4
46,6326001,6375000,48999,False,5,scaffold_4
47,6754001,6817000,62999,False,5,scaffold_4
48,6893001,6924000,30999,False,5,scaffold_4
49,6926001,6939000,12999,False,5,scaffold_4
50,6949001,6995000,45999,False,5,scaffold_4
51,7036001,7180000,143999,False,5,scaffold_4
52,7226001,7276000,49999,False,5,scaffold_4
53,7352001,7381000,28999,False,5,scaffold_4
54,7628001,7665000,36999,False,5,scaffold_4
55,7864001,7912000,47999,False,5,scaffold_4
56,8453001,8466000,12999,False,5,scaffold_4
57,8845001,9699000,853999,False,5,scaffold_4
58,9700001,9845951,145950,True,5,scaffold_4
0,1,4000,3999,True,5,scaffold_5
1,320001,382000,61999,False,5,scaffold_5
2,463001,523000,59999,False,5,scaffold_5
3,672001,694000,21999,False,5,scaffold_5
4,933001,947000,13999,False,5,scaffold_5
5,1668001,1685000,16999,False,5,scaffold_5
6,2091001,2104000,12999,False,5,scaffold_5
7,2475001,2493000,17999,False,5,scaffold_5
8,2510001,2515000,4999,False,5,scaffold_5
9,2516001,2529000,12999,False,5,scaffold_5
10,2555001,2873000,317999,False,5,scaffold_5
11,3133001,3519000,385999,False,5,scaffold_5
12,3532001,3554000,21999,False,5,scaffold_5
13,3616001,3658000,41999,False,5,scaffold_5
14,3962001,4101000,138999,False,5,scaffold_5
15,4118001,4222000,103999,False,5,scaffold_5
16,4238001,4357000,118999,False,5,scaffold_5
17,4445001,4554000,108999,False,5,scaffold_5
18,4597001,4924000,326999,False,5,scaffold_5
19,5059001,5097000,37999,False,5,scaffold_5
20,5249001,5346000,96999,False,5,scaffold_5
21,5512001,5533000,20999,False,5,scaffold_5
22,6393001,6428000,34999,False,5,scaffold_5
23,6453001,6671000,217999,False,5,scaffold_5
24,7172001,7233000,60999,False,5,scaffold_5
25,7294001,7328000,33999,False,5,scaffold_5
26,7406001,7440000,33999,False,5,scaffold_5
27,7454001,7513000,58999,False,5,scaffold_5
28,7559001,7619000,59999,False,5,scaffold_5
29,7621001,7746000,124999,False,5,scaffold_5
30,8552001,8616000,63999,False,5,scaffold_5
31,8659001,8689000,29999,False,5,scaffold_5
32,8702001,9364176,662175,True,5,scaffold_5
0,78001,84000,5999,False,5,scaffold_6
1,86001,116000,29999,False,5,scaffold_6
2,148001,208000,59999,False,5,scaffold_6
3,240001,255000,14999,False,5,scaffold_6
4,467001,497000,29999,False,5,scaffold_6
5,553001,564000,10999,False,5,scaffold_6
6,926001,947000,20999,False,5,scaffold_6
7,1122001,1226000,103999,False,5,scaffold_6
8,1229001,1258000,28999,False,5,scaffold_6
9,1284001,1311000,26999,False,5,scaffold_6
10,1478001,1546000,67999,False,5,scaffold_6
11,1561001,1598000,36999,False,5,scaffold_6
12,1657001,1699000,41999,False,5,scaffold_6
13,1841001,1905000,63999,False,5,scaffold_6
14,1978001,2019000,40999,False,5,scaffold_6
15,2023001,2104000,80999,False,5,scaffold_6
16,2126001,2213000,86999,False,5,scaffold_6
17,2237001,2265000,27999,False,5,scaffold_6
18,2335001,2595000,259999,False,5,scaffold_6
19,2596001,2654000,57999,False,5,scaffold_6
20,2655001,2872000,216999,False,5,scaffold_6
21,2934001,3050000,115999,False,5,scaffold_6
22,3097001,3210000,112999,False,5,scaffold_6
23,3223001,3350000,126999,False,5,scaffold_6
24,3351001,3767000,415999,False,5,scaffold_6
25,3830001,3848000,17999,False,5,scaffold_6
26,3879001,3928000,48999,False,5,scaffold_6
27,4018001,4195000,176999,False,5,scaffold_6
28,4838001,4872000,33999,False,5,scaffold_6
29,4890001,4916000,25999,False,5,scaffold_6
30,4925001,4997000,71999,False,5,scaffold_6
31,5862001,5972000,109999,False,5,scaffold_6
32,6004001,6081000,76999,False,5,scaffold_6
33,6123001,6191000,67999,False,5,scaffold_6
34,6770001,6804000,33999,False,5,scaffold_6
35,7221001,7247000,25999,False,5,scaffold_6
36,7256001,7338000,81999,False,5,scaffold_6
37,7389001,7485000,95999,False,5,scaffold_6
38,7543001,8268281,725280,True,5,scaffold_6
0,13001,34000,20999,False,5,scaffold_7
1,323001,340000,16999,False,5,scaffold_7
2,342001,508000,165999,False,5,scaffold_7
3,554001,563000,8999,False,5,scaffold_7
4,571001,577000,5999,False,5,scaffold_7
5,706001,736000,29999,False,5,scaffold_7
6,740001,753000,12999,False,5,scaffold_7
7,764001,829000,64999,False,5,scaffold_7
8,859001,864000,4999,False,5,scaffold_7
9,909001,938000,28999,False,5,scaffold_7
10,964001,980000,15999,False,5,scaffold_7
11,982001,1044000,61999,False,5,scaffold_7
12,1048001,1104000,55999,False,5,scaffold_7
13,1172001,1187000,14999,False,5,scaffold_7
14,1191001,1261000,69999,False,5,scaffold_7
15,1262001,1459000,196999,False,5,scaffold_7
16,1461001,1512000,50999,False,5,scaffold_7
17,1588001,1721000,132999,False,5,scaffold_7
18,1738001,1782000,43999,False,5,scaffold_7
19,1850001,1897000,46999,False,5,scaffold_7
20,1977001,2015000,37999,False,5,scaffold_7
21,2682001,2701000,18999,False,5,scaffold_7
22,2825001,2842000,16999,False,5,scaffold_7
23,3297001,3370000,72999,False,5,scaffold_7
24,3521001,3766000,244999,False,5,scaffold_7
25,4414001,4512000,97999,False,5,scaffold_7
26,4635001,4737000,101999,False,5,scaffold_7
27,4752001,4840000,87999,False,5,scaffold_7
28,4978001,5166000,187999,False,5,scaffold_7
29,5481001,5537000,55999,False,5,scaffold_7
30,5568001,5584000,15999,False,5,scaffold_7
31,6167001,6236000,68999,False,5,scaffold_7
32,6579001,6675000,95999,False,5,scaffold_7
33,6696001,6714000,17999,False,5,scaffold_7
34,6750001,6793000,42999,False,5,scaffold_7
35,6950001,7270000,319999,False,5,scaffold_7
36,7271001,7502216,231215,True,5,scaffold_7
0,1,10000,9999,True,5,scaffold_8
1,66001,85000,18999,False,5,scaffold_8
2,93001,101000,7999,False,5,scaffold_8
3,2091001,2153000,61999,False,5,scaffold_8
4,2362001,2371000,8999,False,5,scaffold_8
5,2384001,2528000,143999,False,5,scaffold_8
6,2536001,2553000,16999,False,5,scaffold_8
7,2652001,2844000,191999,False,5,scaffold_8
8,2845001,2902000,56999,False,5,scaffold_8
9,2999001,3526000,526999,False,5,scaffold_8
10,3580001,3612000,31999,False,5,scaffold_8
11,3615001,3810000,194999,False,5,scaffold_8
12,3811001,3939000,127999,False,5,scaffold_8
13,4007001,4146000,138999,False,5,scaffold_8
14,4172001,4221000,48999,False,5,scaffold_8
15,4396001,4432000,35999,False,5,scaffold_8
16,4799001,4848000,48999,False,5,scaffold_8
17,5088001,5244000,155999,False,5,scaffold_8
18,5651001,5723000,71999,False,5,scaffold_8
19,5750001,5775000,24999,False,5,scaffold_8
20,5776001,5804000,27999,False,5,scaffold_8
21,5841001,5879000,37999,False,5,scaffold_8
22,5881001,5908000,26999,False,5,scaffold_8
23,6227001,6285000,57999,False,5,scaffold_8
24,6320001,6334544,14543,True,5,scaffold_8
0,1,22000,21999,True,5,scaffold_9
1,109001,117000,7999,False,5,scaffold_9
2,121001,137000,15999,False,5,scaffold_9
3,298001,315000,16999,False,5,scaffold_9
4,319001,334000,14999,False,5,scaffold_9
5,366001,411000,44999,False,5,scaffold_9
6,413001,434000,20999,False,5,scaffold_9
7,484001,531000,46999,False,5,scaffold_9
8,547001,563000,15999,False,5,scaffold_9
9,655001,665000,9999,False,5,scaffold_9
10,671001,697000,25999,False,5,scaffold_9
11,732001,741000,8999,False,5,scaffold_9
12,815001,842000,26999,False,5,scaffold_9
13,872001,986000,113999,False,5,scaffold_9
14,988001,995000,6999,False,5,scaffold_9
15,1001001,1007000,5999,False,5,scaffold_9
16,1009001,1085000,75999,False,5,scaffold_9
17,1087001,1150000,62999,False,5,scaffold_9
18,1151001,1161000,9999,False,5,scaffold_9
19,1311001,1383000,71999,False,5,scaffold_9
20,1428001,1438000,9999,False,5,scaffold_9
21,1486001,1499000,12999,False,5,scaffold_9
22,1502001,1591000,88999,False,5,scaffold_9
23,1593001,1621000,27999,False,5,scaffold_9
24,1637001,1691000,53999,False,5,scaffold_9
25,1749001,1791000,41999,False,5,scaffold_9
26,1826001,1857000,30999,False,5,scaffold_9
27,1885001,1952000,66999,False,5,scaffold_9
28,1986001,2133000,146999,False,5,scaffold_9
29,2136001,2171000,34999,False,5,scaffold_9
30,2174001,2286000,111999,False,5,scaffold_9
31,2313001,2354000,40999,False,5,scaffold_9
32,2413001,2467000,53999,False,5,scaffold_9
33,2516001,2545000,28999,False,5,scaffold_9
34,2599001,2673000,73999,False,5,scaffold_9
35,2737001,3381000,643999,False,5,scaffold_9
36,3383001,5110000,1726999,False,5,scaffold_9
37,5112001,5115000,2999,False,5,scaffold_9
38,5116001,5238000,121999,False,5,scaffold_9
39,5239001,5298000,58999,False,5,scaffold_9
40,5299001,5490000,190999,False,5,scaffold_9
41,5493001,6331288,838287,True,5,scaffold_9
0,1,414000,413999,True,5,scaffold_10
1,415001,482000,66999,False,5,scaffold_10
2,483001,581000,97999,False,5,scaffold_10
3,602001,877000,274999,False,5,scaffold_10
4,888001,921000,32999,False,5,scaffold_10
5,923001,963000,39999,False,5,scaffold_10
6,1037001,1069000,31999,False,5,scaffold_10
7,1087001,1146000,58999,False,5,scaffold_10
8,1313001,1336000,22999,False,5,scaffold_10
9,1370001,1473000,102999,False,5,scaffold_10
10,1707001,1755000,47999,False,5,scaffold_10
11,1806001,1835000,28999,False,5,scaffold_10
12,1862001,1895000,32999,False,5,scaffold_10
13,2076001,2103000,26999,False,5,scaffold_10
14,2136001,2229000,92999,False,5,scaffold_10
15,2267001,2332000,64999,False,5,scaffold_10
16,2334001,2476000,141999,False,5,scaffold_10
17,2521001,2653000,131999,False,5,scaffold_10
18,2673001,2706000,32999,False,5,scaffold_10
19,2714001,2812000,97999,False,5,scaffold_10
20,2817001,2861000,43999,False,5,scaffold_10
21,2938001,2953000,14999,False,5,scaffold_10
22,3154001,3177000,22999,False,5,scaffold_10
23,3575001,3582000,6999,False,5,scaffold_10
24,4053001,4092000,38999,False,5,scaffold_10
25,4154001,4174000,19999,False,5,scaffold_10
26,4336001,4359000,22999,False,5,scaffold_10
27,4443001,4462000,18999,False,5,scaffold_10
28,4515001,4522000,6999,False,5,scaffold_10
29,4527001,4548000,20999,False,5,scaffold_10
30,4554001,4562000,7999,False,5,scaffold_10
31,4574001,4596000,21999,False,5,scaffold_10
32,4734001,4776000,41999,False,5,scaffold_10
33,4785001,4789000,3999,False,5,scaffold_10
34,4791001,4797000,5999,False,5,scaffold_10
35,4798001,4824000,25999,False,5,scaffold_10
36,4827001,4843000,15999,False,5,scaffold_10
37,4848001,4861000,12999,False,5,scaffold_10
38,4865001,4866973,1972,True,5,scaffold_10
0,10001,92000,81999,False,5,scaffold_11
1,148001,167000,18999,False,5,scaffold_11
2,169001,235000,65999,False,5,scaffold_11
3,240001,252000,11999,False,5,scaffold_11
4,296001,312000,15999,False,5,scaffold_11
5,419001,431000,11999,False,5,scaffold_11
6,648001,656000,7999,False,5,scaffold_11
7,1025001,1034000,8999,False,5,scaffold_11
8,1305001,1314000,8999,False,5,scaffold_11
9,1392001,1398000,5999,False,5,scaffold_11
10,1474001,1478000,3999,False,5,scaffold_11
11,1854001,1884000,29999,False,5,scaffold_11
12,2020001,2058000,37999,False,5,scaffold_11
13,2131001,2158000,26999,False,5,scaffold_11
14,2201001,2224000,22999,False,5,scaffold_11
15,2701001,2905000,203999,False,5,scaffold_11
16,2953001,3027000,73999,False,5,scaffold_11
17,3081001,3175000,93999,False,5,scaffold_11
18,3186001,3297000,110999,False,5,scaffold_11
19,3299001,3383000,83999,False,5,scaffold_11
20,3421001,3477000,55999,False,5,scaffold_11
21,3520001,3972000,451999,False,5,scaffold_11
22,3980001,4159000,178999,False,5,scaffold_11
23,4179001,4710000,530999,False,5,scaffold_11
24,4713001,4766820,53819,True,5,scaffold_11
0,1,1469000,1468999,True,5,scaffold_12
1,1641001,1656000,14999,False,5,scaffold_12
2,1719001,1733000,13999,False,5,scaffold_12
3,1882001,1962000,79999,False,5,scaffold_12
4,1971001,2004000,32999,False,5,scaffold_12
5,2043001,2103000,59999,False,5,scaffold_12
6,2137001,2177000,39999,False,5,scaffold_12
7,2344001,2382000,37999,False,5,scaffold_12
8,2571001,2611000,39999,False,5,scaffold_12
9,2685001,2699000,13999,False,5,scaffold_12
0,1,342000,341999,True,6,scaffold_1
1,482001,498000,15999,False,6,scaffold_1
2,571001,643000,71999,False,6,scaffold_1
3,687001,754000,66999,False,6,scaffold_1
4,1281001,1292000,10999,False,6,scaffold_1
5,1607001,1669000,61999,False,6,scaffold_1
6,1817001,1898000,80999,False,6,scaffold_1
7,1923001,1964000,40999,False,6,scaffold_1
8,1965001,1984000,18999,False,6,scaffold_1
9,2372001,2387000,14999,False,6,scaffold_1
10,2449001,2531000,81999,False,6,scaffold_1
11,2564001,2621000,56999,False,6,scaffold_1
12,2719001,2746000,26999,False,6,scaffold_1
13,2900001,2929000,28999,False,6,scaffold_1
14,2956001,3019000,62999,False,6,scaffold_1
15,3050001,3058000,7999,False,6,scaffold_1
16,3160001,3209000,48999,False,6,scaffold_1
17,3451001,3493000,41999,False,6,scaffold_1
18,3578001,3617000,38999,False,6,scaffold_1
19,3714001,3753000,38999,False,6,scaffold_1
20,3803001,3878000,74999,False,6,scaffold_1
21,3910001,4031000,120999,False,6,scaffold_1
22,4063001,4112000,48999,False,6,scaffold_1
23,4314001,4354000,39999,False,6,scaffold_1
24,4720001,4749000,28999,False,6,scaffold_1
25,4928001,5025000,96999,False,6,scaffold_1
26,5087001,5111000,23999,False,6,scaffold_1
27,5481001,5512000,30999,False,6,scaffold_1
28,5535001,5579000,43999,False,6,scaffold_1
29,5862001,5879000,16999,False,6,scaffold_1
30,6107001,6381000,273999,False,6,scaffold_1
31,6384001,6530000,145999,False,6,scaffold_1
32,6542001,6575000,32999,False,6,scaffold_1
33,6642001,6656000,13999,False,6,scaffold_1
34,6837001,6852000,14999,False,6,scaffold_1
35,7037001,7247000,209999,False,6,scaffold_1
36,7248001,7588000,339999,False,6,scaffold_1
37,7590001,8656000,1065999,False,6,scaffold_1
38,8658001,9584000,925999,False,6,scaffold_1
39,9586001,10363000,776999,False,6,scaffold_1
40,10460001,10640000,179999,False,6,scaffold_1
41,10664001,10766000,101999,False,6,scaffold_1
42,10839001,10858000,18999,False,6,scaffold_1
43,10920001,10938000,17999,False,6,scaffold_1
44,11318001,11532000,213999,False,6,scaffold_1
45,11559001,11962000,402999,False,6,scaffold_1
46,12182001,12238000,55999,False,6,scaffold_1
47,12637001,12722000,84999,False,6,scaffold_1
48,12777001,12888000,110999,False,6,scaffold_1
49,12915001,12930000,14999,False,6,scaffold_1
50,12968001,13005000,36999,False,6,scaffold_1
51,13094001,13216000,121999,False,6,scaffold_1
52,13347001,13405000,57999,False,6,scaffold_1
53,14291001,14307000,15999,False,6,scaffold_1
54,14471001,14479000,7999,False,6,scaffold_1
0,1,48000,47999,True,6,scaffold_2
1,93001,159000,65999,False,6,scaffold_2
2,168001,177000,8999,False,6,scaffold_2
3,297001,318000,20999,False,6,scaffold_2
4,333001,374000,40999,False,6,scaffold_2
5,2336001,2351000,14999,False,6,scaffold_2
6,2404001,2609000,204999,False,6,scaffold_2
7,2627001,2639000,11999,False,6,scaffold_2
8,2645001,2689000,43999,False,6,scaffold_2
9,2694001,2745000,50999,False,6,scaffold_2
10,2820001,2866000,45999,False,6,scaffold_2
11,2868001,2900000,31999,False,6,scaffold_2
12,2974001,3018000,43999,False,6,scaffold_2
13,3176001,3187000,10999,False,6,scaffold_2
14,3335001,3343000,7999,False,6,scaffold_2
15,3367001,3390000,22999,False,6,scaffold_2
16,3450001,3485000,34999,False,6,scaffold_2
17,3755001,3790000,34999,False,6,scaffold_2
18,4243001,4275000,31999,False,6,scaffold_2
19,4342001,4409000,66999,False,6,scaffold_2
20,4426001,4460000,33999,False,6,scaffold_2
21,4471001,4790000,318999,False,6,scaffold_2
22,4793001,4810000,16999,False,6,scaffold_2
23,4916001,4955000,38999,False,6,scaffold_2
24,5021001,5104000,82999,False,6,scaffold_2
25,5210001,5220000,9999,False,6,scaffold_2
26,5285001,5303000,17999,False,6,scaffold_2
27,5371001,5394000,22999,False,6,scaffold_2
28,5413001,5481000,67999,False,6,scaffold_2
29,5490001,5515000,24999,False,6,scaffold_2
30,5658001,5704000,45999,False,6,scaffold_2
31,5719001,5761000,41999,False,6,scaffold_2
32,5840001,5887000,46999,False,6,scaffold_2
33,5914001,5964000,49999,False,6,scaffold_2
34,6244001,6330000,85999,False,6,scaffold_2
35,6331001,6349000,17999,False,6,scaffold_2
36,6389001,6449000,59999,False,6,scaffold_2
37,6591001,6628000,36999,False,6,scaffold_2
38,6810001,6914000,103999,False,6,scaffold_2
39,7006001,7039000,32999,False,6,scaffold_2
40,7049001,7225000,175999,False,6,scaffold_2
41,7331001,7473000,141999,False,6,scaffold_2
42,7550001,7561000,10999,False,6,scaffold_2
43,7563001,7707000,143999,False,6,scaffold_2
44,7786001,7920000,133999,False,6,scaffold_2
45,7934001,8220000,285999,False,6,scaffold_2
46,8260001,8313000,52999,False,6,scaffold_2
47,8331001,8333000,1999,False,6,scaffold_2
48,8335001,8344000,8999,False,6,scaffold_2
49,8346001,8454000,107999,False,6,scaffold_2
50,8508001,8564000,55999,False,6,scaffold_2
51,8994001,9050000,55999,False,6,scaffold_2
52,9141001,9167000,25999,False,6,scaffold_2
53,9239001,9273000,33999,False,6,scaffold_2
54,9329001,9381000,51999,False,6,scaffold_2
55,9599001,9635000,35999,False,6,scaffold_2
56,9868001,9904000,35999,False,6,scaffold_2
57,10087001,10118000,30999,False,6,scaffold_2
58,10404001,10431000,26999,False,6,scaffold_2
59,10531001,10563000,31999,False,6,scaffold_2
60,10758001,10766000,7999,False,6,scaffold_2
61,11041001,11066000,24999,False,6,scaffold_2
62,11366001,11381000,14999,False,6,scaffold_2
63,11394001,11427000,32999,False,6,scaffold_2
64,11453001,11502000,48999,False,6,scaffold_2
65,11518001,11580000,61999,False,6,scaffold_2
66,11581001,11786000,204999,False,6,scaffold_2
0,51001,55000,3999,False,6,scaffold_3
1,528001,539000,10999,False,6,scaffold_3
2,540001,548000,7999,False,6,scaffold_3
3,618001,646000,27999,False,6,scaffold_3
4,798001,901000,102999,False,6,scaffold_3
5,2007001,2108000,100999,False,6,scaffold_3
6,2274001,2336000,61999,False,6,scaffold_3
7,2434001,2531000,96999,False,6,scaffold_3
8,3714001,3733000,18999,False,6,scaffold_3
9,3763001,3894000,130999,False,6,scaffold_3
10,3926001,3947000,20999,False,6,scaffold_3
11,4094001,4403000,308999,False,6,scaffold_3
12,4415001,4522000,106999,False,6,scaffold_3
13,4531001,4560000,28999,False,6,scaffold_3
14,4566001,4599000,32999,False,6,scaffold_3
15,4637001,4686000,48999,False,6,scaffold_3
16,5180001,5192000,11999,False,6,scaffold_3
17,5807001,5954000,146999,False,6,scaffold_3
18,5975001,6010000,34999,False,6,scaffold_3
19,6659001,6784000,124999,False,6,scaffold_3
20,6908001,7101000,192999,False,6,scaffold_3
21,7105001,7157000,51999,False,6,scaffold_3
22,7255001,7328000,72999,False,6,scaffold_3
23,7333001,7398000,64999,False,6,scaffold_3
24,7483001,7556000,72999,False,6,scaffold_3
25,7599001,7612000,12999,False,6,scaffold_3
26,7680001,7857000,176999,False,6,scaffold_3
27,7910001,7942000,31999,False,6,scaffold_3
28,8175001,8254000,78999,False,6,scaffold_3
29,8398001,8528000,129999,False,6,scaffold_3
30,8575001,8594000,18999,False,6,scaffold_3
31,9014001,9047000,32999,False,6,scaffold_3
32,9058001,9077000,18999,False,6,scaffold_3
33,9968001,9999000,30999,False,6,scaffold_3
34,10064001,10086000,21999,False,6,scaffold_3
35,10278001,10301000,22999,False,6,scaffold_3
36,10433001,10458000,24999,False,6,scaffold_3
37,10461001,10485000,23999,False,6,scaffold_3
38,10527001,10572000,44999,False,6,scaffold_3
39,10574001,11162000,587999,False,6,scaffold_3
0,11001,13000,1999,False,6,scaffold_4
1,17001,33000,15999,False,6,scaffold_4
2,48001,87000,38999,False,6,scaffold_4
3,120001,146000,25999,False,6,scaffold_4
4,147001,151000,3999,False,6,scaffold_4
5,155001,160000,4999,False,6,scaffold_4
6,161001,215000,53999,False,6,scaffold_4
7,217001,226000,8999,False,6,scaffold_4
8,227001,266000,38999,False,6,scaffold_4
9,289001,311000,21999,False,6,scaffold_4
10,318001,353000,34999,False,6,scaffold_4
11,355001,374000,18999,False,6,scaffold_4
12,390001,425000,34999,False,6,scaffold_4
13,429001,498000,68999,False,6,scaffold_4
14,542001,592000,49999,False,6,scaffold_4
15,593001,606000,12999,False,6,scaffold_4
16,608001,691000,82999,False,6,scaffold_4
17,695001,697000,1999,False,6,scaffold_4
18,1087001,1097000,9999,False,6,scaffold_4
19,1098001,1136000,37999,False,6,scaffold_4
20,1137001,1198000,60999,False,6,scaffold_4
21,1199001,1208000,8999,False,6,scaffold_4
22,1210001,1226000,15999,False,6,scaffold_4
23,1254001,1262000,7999,False,6,scaffold_4
24,1265001,1279000,13999,False,6,scaffold_4
25,1283001,1293000,9999,False,6,scaffold_4
26,1294001,1337000,42999,False,6,scaffold_4
27,1353001,1597000,243999,False,6,scaffold_4
28,1613001,1849000,235999,False,6,scaffold_4
29,1850001,1957000,106999,False,6,scaffold_4
30,1958001,2114000,155999,False,6,scaffold_4
31,2210001,2218000,7999,False,6,scaffold_4
32,2219001,2246000,26999,False,6,scaffold_4
33,2247001,2268000,20999,False,6,scaffold_4
34,2269001,2310000,40999,False,6,scaffold_4
35,2312001,2460000,147999,False,6,scaffold_4
36,2476001,2635000,158999,False,6,scaffold_4
37,3038001,3063000,24999,False,6,scaffold_4
38,3092001,3125000,32999,False,6,scaffold_4
39,3335001,3785000,449999,False,6,scaffold_4
40,4051001,4072000,20999,False,6,scaffold_4
41,4709001,4736000,26999,False,6,scaffold_4
42,4901001,5055000,153999,False,6,scaffold_4
43,5170001,5237000,66999,False,6,scaffold_4
44,5475001,5506000,30999,False,6,scaffold_4
45,5514001,5784000,269999,False,6,scaffold_4
46,5786001,5804000,17999,False,6,scaffold_4
47,5918001,5957000,38999,False,6,scaffold_4
48,6145001,6197000,51999,False,6,scaffold_4
49,6888001,6924000,35999,False,6,scaffold_4
50,6926001,6935000,8999,False,6,scaffold_4
51,6974001,6995000,20999,False,6,scaffold_4
52,7036001,7124000,87999,False,6,scaffold_4
53,7192001,7308000,115999,False,6,scaffold_4
54,7362001,7371000,8999,False,6,scaffold_4
55,7641001,7665000,23999,False,6,scaffold_4
56,8844001,9699000,854999,False,6,scaffold_4
57,9700001,9845951,145950,True,6,scaffold_4
0,142001,175000,32999,False,6,scaffold_5
1,189001,204000,14999,False,6,scaffold_5
2,318001,401000,82999,False,6,scaffold_5
3,402001,419000,16999,False,6,scaffold_5
4,461001,523000,61999,False,6,scaffold_5
5,664001,697000,32999,False,6,scaffold_5
6,933001,947000,13999,False,6,scaffold_5
7,2257001,2278000,20999,False,6,scaffold_5
8,2476001,2497000,20999,False,6,scaffold_5
9,2509001,2515000,5999,False,6,scaffold_5
10,2563001,2871000,307999,False,6,scaffold_5
11,3096001,3514000,417999,False,6,scaffold_5
12,3621001,3659000,37999,False,6,scaffold_5
13,3962001,4063000,100999,False,6,scaffold_5
14,4065001,4221000,155999,False,6,scaffold_5
15,4228001,4365000,136999,False,6,scaffold_5
16,4446001,4546000,99999,False,6,scaffold_5
17,4594001,4751000,156999,False,6,scaffold_5
18,4752001,4926000,173999,False,6,scaffold_5
19,4969001,5029000,59999,False,6,scaffold_5
20,5055001,5106000,50999,False,6,scaffold_5
21,5218001,5305000,86999,False,6,scaffold_5
22,5318001,5346000,27999,False,6,scaffold_5
23,5869001,5889000,19999,False,6,scaffold_5
24,6394001,6420000,25999,False,6,scaffold_5
25,6453001,6727000,273999,False,6,scaffold_5
26,7049001,7080000,30999,False,6,scaffold_5
27,7298001,7328000,29999,False,6,scaffold_5
28,7406001,7439000,32999,False,6,scaffold_5
29,7454001,7494000,39999,False,6,scaffold_5
30,7502001,7510000,7999,False,6,scaffold_5
31,7547001,7619000,71999,False,6,scaffold_5
32,7620001,7660000,39999,False,6,scaffold_5
33,7680001,7749000,68999,False,6,scaffold_5
34,7945001,7974000,28999,False,6,scaffold_5
35,8258001,8280000,21999,False,6,scaffold_5
36,8413001,8470000,56999,False,6,scaffold_5
37,8553001,8617000,63999,False,6,scaffold_5
38,8677001,8683000,5999,False,6,scaffold_5
39,8714001,9364176,650175,True,6,scaffold_5
0,64001,75000,10999,False,6,scaffold_6
1,86001,121000,34999,False,6,scaffold_6
2,162001,208000,45999,False,6,scaffold_6
3,239001,254000,14999,False,6,scaffold_6
4,1235001,1259000,23999,False,6,scaffold_6
5,1426001,1547000,120999,False,6,scaffold_6
6,1558001,1599000,40999,False,6,scaffold_6
7,1658001,1712000,53999,False,6,scaffold_6
8,1832001,1906000,73999,False,6,scaffold_6
9,2025001,2104000,78999,False,6,scaffold_6
10,2117001,2212000,94999,False,6,scaffold_6
11,2236001,2284000,47999,False,6,scaffold_6
12,2336001,2691000,354999,False,6,scaffold_6
13,2711001,2865000,153999,False,6,scaffold_6
14,2928001,3031000,102999,False,6,scaffold_6
15,3097001,3193000,95999,False,6,scaffold_6
16,3224001,3333000,108999,False,6,scaffold_6
17,3407001,3766000,358999,False,6,scaffold_6
18,3881001,3916000,34999,False,6,scaffold_6
19,3966001,4195000,228999,False,6,scaffold_6
20,4961001,4997000,35999,False,6,scaffold_6
21,5589001,5741000,151999,False,6,scaffold_6
22,6008001,6082000,73999,False,6,scaffold_6
23,6776001,6804000,27999,False,6,scaffold_6
24,7169001,7247000,77999,False,6,scaffold_6
25,7257001,7338000,80999,False,6,scaffold_6
26,7390001,7444000,53999,False,6,scaffold_6
27,7549001,8268281,719280,True,6,scaffold_6
0,1,7000,6999,True,6,scaffold_7
1,13001,31000,17999,False,6,scaffold_7
2,323001,340000,16999,False,6,scaffold_7
3,342001,507000,164999,False,6,scaffold_7
4,624001,640000,15999,False,6,scaffold_7
5,706001,736000,29999,False,6,scaffold_7
6,763001,809000,45999,False,6,scaffold_7
7,859001,864000,4999,False,6,scaffold_7
8,868001,872000,3999,False,6,scaffold_7
9,874001,945000,70999,False,6,scaffold_7
10,950001,963000,12999,False,6,scaffold_7
11,964001,966000,1999,False,6,scaffold_7
12,968001,981000,12999,False,6,scaffold_7
13,982001,1044000,61999,False,6,scaffold_7
14,1048001,1104000,55999,False,6,scaffold_7
15,1106001,1124000,17999,False,6,scaffold_7
16,1191001,1512000,320999,False,6,scaffold_7
17,1588001,1689000,100999,False,6,scaffold_7
18,2931001,2960000,28999,False,6,scaffold_7
19,3293001,3370000,76999,False,6,scaffold_7
20,3520001,3809000,288999,False,6,scaffold_7
21,4416001,4517000,100999,False,6,scaffold_7
22,4546001,4597000,50999,False,6,scaffold_7
23,4629001,4841000,211999,False,6,scaffold_7
24,4979001,5149000,169999,False,6,scaffold_7
25,5473001,5536000,62999,False,6,scaffold_7
26,6081001,6094000,12999,False,6,scaffold_7
27,6755001,6796000,40999,False,6,scaffold_7
28,6953001,7270000,316999,False,6,scaffold_7
29,7271001,7502216,231215,True,6,scaffold_7
0,1,6000,5999,True,6,scaffold_8
1,38001,63000,24999,False,6,scaffold_8
2,67001,85000,17999,False,6,scaffold_8
3,722001,725000,2999,False,6,scaffold_8
4,1393001,1422000,28999,False,6,scaffold_8
5,1858001,1978000,119999,False,6,scaffold_8
6,2087001,2133000,45999,False,6,scaffold_8
7,2336001,2553000,216999,False,6,scaffold_8
8,2558001,2585000,26999,False,6,scaffold_8
9,2650001,2683000,32999,False,6,scaffold_8
10,2736001,2764000,27999,False,6,scaffold_8
11,2797001,2841000,43999,False,6,scaffold_8
12,3030001,3125000,94999,False,6,scaffold_8
13,3126001,3554000,427999,False,6,scaffold_8
14,3577001,3614000,36999,False,6,scaffold_8
15,3615001,3946000,330999,False,6,scaffold_8
16,4036001,4106000,69999,False,6,scaffold_8
17,4173001,4261000,87999,False,6,scaffold_8
18,4330001,4426000,95999,False,6,scaffold_8
19,4902001,4915000,12999,False,6,scaffold_8
20,5072001,5138000,65999,False,6,scaffold_8
21,5163001,5241000,77999,False,6,scaffold_8
22,5511001,5537000,25999,False,6,scaffold_8
23,5655001,5684000,28999,False,6,scaffold_8
24,6328001,6334544,6543,True,6,scaffold_8
0,1,22000,21999,True,6,scaffold_9
1,109001,117000,7999,False,6,scaffold_9
2,121001,138000,16999,False,6,scaffold_9
3,366001,411000,44999,False,6,scaffold_9
4,413001,434000,20999,False,6,scaffold_9
5,436001,439000,2999,False,6,scaffold_9
6,483001,531000,47999,False,6,scaffold_9
7,552001,563000,10999,False,6,scaffold_9
8,661001,665000,3999,False,6,scaffold_9
9,671001,696000,24999,False,6,scaffold_9
10,732001,741000,8999,False,6,scaffold_9
11,815001,843000,27999,False,6,scaffold_9
12,885001,986000,100999,False,6,scaffold_9
13,987001,996000,8999,False,6,scaffold_9
14,1009001,1085000,75999,False,6,scaffold_9
15,1087001,1150000,62999,False,6,scaffold_9
16,1151001,1165000,13999,False,6,scaffold_9
17,1312001,1378000,65999,False,6,scaffold_9
18,1750001,1804000,53999,False,6,scaffold_9
19,2601001,2616000,14999,False,6,scaffold_9
20,2736001,3381000,644999,False,6,scaffold_9
21,3383001,5107000,1723999,False,6,scaffold_9
22,5112001,5298000,185999,False,6,scaffold_9
23,5300001,5490000,189999,False,6,scaffold_9
24,5493001,6331288,838287,True,6,scaffold_9
0,1,235000,234999,True,6,scaffold_10
1,257001,414000,156999,False,6,scaffold_10
2,415001,482000,66999,False,6,scaffold_10
3,483001,577000,93999,False,6,scaffold_10
4,603001,877000,273999,False,6,scaffold_10
5,888001,917000,28999,False,6,scaffold_10
6,924001,963000,38999,False,6,scaffold_10
7,996001,1069000,72999,False,6,scaffold_10
8,1073001,1147000,73999,False,6,scaffold_10
9,2141001,2167000,25999,False,6,scaffold_10
10,2346001,2391000,44999,False,6,scaffold_10
11,4000001,4011000,10999,False,6,scaffold_10
12,4049001,4094000,44999,False,6,scaffold_10
13,4154001,4174000,19999,False,6,scaffold_10
14,4335001,4359000,23999,False,6,scaffold_10
15,4442001,4513000,70999,False,6,scaffold_10
16,4515001,4523000,7999,False,6,scaffold_10
17,4526001,4548000,21999,False,6,scaffold_10
18,4576001,4596000,19999,False,6,scaffold_10
19,4679001,4688000,8999,False,6,scaffold_10
20,4734001,4776000,41999,False,6,scaffold_10
21,4798001,4824000,25999,False,6,scaffold_10
22,4825001,4846000,20999,False,6,scaffold_10
23,4848001,4863000,14999,False,6,scaffold_10
24,4865001,4866973,1972,True,6,scaffold_10
0,11001,96000,84999,False,6,scaffold_11
1,132001,167000,34999,False,6,scaffold_11
2,169001,191000,21999,False,6,scaffold_11
3,213001,236000,22999,False,6,scaffold_11
4,240001,249000,8999,False,6,scaffold_11
5,419001,431000,11999,False,6,scaffold_11
6,648001,656000,7999,False,6,scaffold_11
7,895001,897000,1999,False,6,scaffold_11
8,1423001,1426000,2999,False,6,scaffold_11
9,1474001,1477000,2999,False,6,scaffold_11
10,2700001,2872000,171999,False,6,scaffold_11
11,2954001,3019000,64999,False,6,scaffold_11
12,3093001,3146000,52999,False,6,scaffold_11
13,3185001,3262000,76999,False,6,scaffold_11
14,3317001,3383000,65999,False,6,scaffold_11
15,3552001,3658000,105999,False,6,scaffold_11
16,3702001,3971000,268999,False,6,scaffold_11
17,3996001,4162000,165999,False,6,scaffold_11
18,4256001,4710000,453999,False,6,scaffold_11
19,4713001,4766820,53819,True,6,scaffold_11
0,1,856000,855999,True,6,scaffold_12
1,865001,1469000,603999,False,6,scaffold_12
2,1720001,1733000,12999,False,6,scaffold_12
3,2571001,2610000,38999,False,6,scaffold_12
4,2686001,2699000,12999,False,6,scaffold_12
0,1,340000,339999,True,7,scaffold_1
1,482001,498000,15999,False,7,scaffold_1
2,571001,643000,71999,False,7,scaffold_1
3,686001,759000,72999,False,7,scaffold_1
4,1281001,1292000,10999,False,7,scaffold_1
5,1952001,1964000,11999,False,7,scaffold_1
6,1965001,1984000,18999,False,7,scaffold_1
7,2449001,2517000,67999,False,7,scaffold_1
8,2729001,2746000,16999,False,7,scaffold_1
9,3181001,3208000,26999,False,7,scaffold_1
10,3715001,3733000,17999,False,7,scaffold_1
11,3916001,3941000,24999,False,7,scaffold_1
12,4063001,4111000,47999,False,7,scaffold_1
13,4322001,4354000,31999,False,7,scaffold_1
14,4928001,4996000,67999,False,7,scaffold_1
15,5482001,5511000,28999,False,7,scaffold_1
16,5536001,5569000,32999,False,7,scaffold_1
17,6108001,6153000,44999,False,7,scaffold_1
18,6228001,6381000,152999,False,7,scaffold_1
19,6384001,6507000,122999,False,7,scaffold_1
20,6545001,6554000,8999,False,7,scaffold_1
21,7038001,7247000,208999,False,7,scaffold_1
22,7248001,7588000,339999,False,7,scaffold_1
23,7590001,8477000,886999,False,7,scaffold_1
24,8478001,8656000,177999,False,7,scaffold_1
25,8658001,9584000,925999,False,7,scaffold_1
26,9586001,10354000,767999,False,7,scaffold_1
27,10461001,10627000,165999,False,7,scaffold_1
28,10835001,10857000,21999,False,7,scaffold_1
29,11351001,11504000,152999,False,7,scaffold_1
30,11615001,11929000,313999,False,7,scaffold_1
31,12184001,12204000,19999,False,7,scaffold_1
32,12664001,12722000,57999,False,7,scaffold_1
33,12777001,12888000,110999,False,7,scaffold_1
34,13113001,13211000,97999,False,7,scaffold_1
35,13347001,13378000,30999,False,7,scaffold_1
36,14298001,14306000,7999,False,7,scaffold_1
37,14471001,14479000,7999,False,7,scaffold_1
0,22001,48000,25999,False,7,scaffold_2
1,117001,159000,41999,False,7,scaffold_2
2,168001,177000,8999,False,7,scaffold_2
3,297001,318000,20999,False,7,scaffold_2
4,330001,374000,43999,False,7,scaffold_2
5,2336001,2358000,21999,False,7,scaffold_2
6,2441001,2553000,111999,False,7,scaffold_2
7,2660001,2689000,28999,False,7,scaffold_2
8,2694001,2742000,47999,False,7,scaffold_2
9,2997001,3009000,11999,False,7,scaffold_2
10,3454001,3463000,8999,False,7,scaffold_2
11,3767001,3781000,13999,False,7,scaffold_2
12,4385001,4409000,23999,False,7,scaffold_2
13,4427001,4457000,29999,False,7,scaffold_2
14,4524001,4553000,28999,False,7,scaffold_2
15,4593001,4654000,60999,False,7,scaffold_2
16,5022001,5061000,38999,False,7,scaffold_2
17,5491001,5511000,19999,False,7,scaffold_2
18,5672001,5704000,31999,False,7,scaffold_2
19,6261001,6350000,88999,False,7,scaffold_2
20,6430001,6448000,17999,False,7,scaffold_2
21,7020001,7034000,13999,False,7,scaffold_2
22,7439001,7472000,32999,False,7,scaffold_2
23,7563001,7698000,134999,False,7,scaffold_2
24,7786001,7890000,103999,False,7,scaffold_2
25,7934001,8101000,166999,False,7,scaffold_2
26,8102001,8108000,5999,False,7,scaffold_2
27,8331001,8333000,1999,False,7,scaffold_2
28,8346001,8389000,42999,False,7,scaffold_2
29,8437001,8452000,14999,False,7,scaffold_2
30,8509001,8535000,25999,False,7,scaffold_2
31,9140001,9167000,26999,False,7,scaffold_2
32,11367001,11371000,3999,False,7,scaffold_2
33,11520001,11785000,264999,False,7,scaffold_2
0,1,2000,1999,True,7,scaffold_3
1,51001,55000,3999,False,7,scaffold_3
2,204001,207000,2999,False,7,scaffold_3
3,618001,647000,28999,False,7,scaffold_3
4,799001,900000,100999,False,7,scaffold_3
5,2085001,2108000,22999,False,7,scaffold_3
6,2291001,2321000,29999,False,7,scaffold_3
7,2508001,2533000,24999,False,7,scaffold_3
8,3831001,3844000,12999,False,7,scaffold_3
9,4147001,4383000,235999,False,7,scaffold_3
10,4417001,4518000,100999,False,7,scaffold_3
11,4547001,4558000,10999,False,7,scaffold_3
12,4653001,4678000,24999,False,7,scaffold_3
13,6911001,6962000,50999,False,7,scaffold_3
14,6979001,7078000,98999,False,7,scaffold_3
15,7451001,7458000,6999,False,7,scaffold_3
16,7540001,7556000,15999,False,7,scaffold_3
17,7692001,7727000,34999,False,7,scaffold_3
18,7822001,7838000,15999,False,7,scaffold_3
19,8208001,8253000,44999,False,7,scaffold_3
20,8462001,8527000,64999,False,7,scaffold_3
21,8575001,8593000,17999,False,7,scaffold_3
22,9968001,9996000,27999,False,7,scaffold_3
23,10461001,10483000,21999,False,7,scaffold_3
24,10587001,11163000,575999,False,7,scaffold_3
0,3001,7000,3999,False,7,scaffold_4
1,17001,32000,14999,False,7,scaffold_4
2,49001,88000,38999,False,7,scaffold_4
3,133001,146000,12999,False,7,scaffold_4
4,147001,151000,3999,False,7,scaffold_4
5,155001,160000,4999,False,7,scaffold_4
6,161001,215000,53999,False,7,scaffold_4
7,217001,226000,8999,False,7,scaffold_4
8,227001,266000,38999,False,7,scaffold_4
9,290001,311000,20999,False,7,scaffold_4
10,335001,344000,8999,False,7,scaffold_4
11,355001,374000,18999,False,7,scaffold_4
12,375001,380000,4999,False,7,scaffold_4
13,394001,410000,15999,False,7,scaffold_4
14,411001,425000,13999,False,7,scaffold_4
15,429001,498000,68999,False,7,scaffold_4
16,545001,592000,46999,False,7,scaffold_4
17,608001,659000,50999,False,7,scaffold_4
18,670001,691000,20999,False,7,scaffold_4
19,701001,714000,12999,False,7,scaffold_4
20,1121001,1136000,14999,False,7,scaffold_4
21,1137001,1178000,40999,False,7,scaffold_4
22,1199001,1208000,8999,False,7,scaffold_4
23,1210001,1226000,15999,False,7,scaffold_4
24,1265001,1279000,13999,False,7,scaffold_4
25,1283001,1315000,31999,False,7,scaffold_4
26,1359001,1598000,238999,False,7,scaffold_4
27,1749001,1864000,114999,False,7,scaffold_4
28,1904001,1957000,52999,False,7,scaffold_4
29,1958001,2001000,42999,False,7,scaffold_4
30,2036001,2065000,28999,False,7,scaffold_4
31,2223001,2246000,22999,False,7,scaffold_4
32,2247001,2279000,31999,False,7,scaffold_4
33,2284001,2310000,25999,False,7,scaffold_4
34,2312001,2340000,27999,False,7,scaffold_4
35,2480001,2533000,52999,False,7,scaffold_4
36,3336001,3633000,296999,False,7,scaffold_4
37,3676001,3760000,83999,False,7,scaffold_4
38,4944001,4984000,39999,False,7,scaffold_4
39,5175001,5208000,32999,False,7,scaffold_4
40,5477001,5506000,28999,False,7,scaffold_4
41,5514001,5620000,105999,False,7,scaffold_4
42,5662001,5784000,121999,False,7,scaffold_4
43,7036001,7062000,25999,False,7,scaffold_4
44,8849001,9699000,849999,False,7,scaffold_4
45,9700001,9710000,9999,False,7,scaffold_4
46,9711001,9766000,54999,False,7,scaffold_4
47,9767001,9845951,78950,True,7,scaffold_4
0,190001,204000,13999,False,7,scaffold_5
1,296001,300000,3999,False,7,scaffold_5
2,318001,326000,7999,False,7,scaffold_5
3,327001,368000,40999,False,7,scaffold_5
4,469001,480000,10999,False,7,scaffold_5
5,498001,523000,24999,False,7,scaffold_5
6,839001,842000,2999,False,7,scaffold_5
7,933001,947000,13999,False,7,scaffold_5
8,2565001,2581000,15999,False,7,scaffold_5
9,2625001,2733000,107999,False,7,scaffold_5
10,2816001,2871000,54999,False,7,scaffold_5
11,3134001,3185000,50999,False,7,scaffold_5
12,3322001,3437000,114999,False,7,scaffold_5
13,3451001,3498000,46999,False,7,scaffold_5
14,3962001,4101000,138999,False,7,scaffold_5
15,4121001,4142000,20999,False,7,scaffold_5
16,4154001,4219000,64999,False,7,scaffold_5
17,4246001,4262000,15999,False,7,scaffold_5
18,4446001,4483000,36999,False,7,scaffold_5
19,4601001,4650000,48999,False,7,scaffold_5
20,4691001,4717000,25999,False,7,scaffold_5
21,4789001,4861000,71999,False,7,scaffold_5
22,4892001,4918000,25999,False,7,scaffold_5
23,5318001,5346000,27999,False,7,scaffold_5
24,7581001,7609000,27999,False,7,scaffold_5
25,8730001,9363000,632999,False,7,scaffold_5
0,79001,84000,4999,False,7,scaffold_6
1,86001,112000,25999,False,7,scaffold_6
2,240001,254000,13999,False,7,scaffold_6
3,268001,283000,14999,False,7,scaffold_6
4,1238001,1255000,16999,False,7,scaffold_6
5,1479001,1546000,66999,False,7,scaffold_6
6,1869001,1906000,36999,False,7,scaffold_6
7,2023001,2086000,62999,False,7,scaffold_6
8,2130001,2169000,38999,False,7,scaffold_6
9,2351001,2595000,243999,False,7,scaffold_6
10,2596001,2653000,56999,False,7,scaffold_6
11,2661001,2691000,29999,False,7,scaffold_6
12,2731001,2851000,119999,False,7,scaffold_6
13,2933001,3014000,80999,False,7,scaffold_6
14,3115001,3148000,32999,False,7,scaffold_6
15,3224001,3301000,76999,False,7,scaffold_6
16,3408001,3427000,18999,False,7,scaffold_6
17,3462001,3766000,303999,False,7,scaffold_6
18,3901001,3912000,10999,False,7,scaffold_6
19,4018001,4070000,51999,False,7,scaffold_6
20,4085001,4193000,107999,False,7,scaffold_6
21,6010001,6074000,63999,False,7,scaffold_6
22,7264001,7337000,72999,False,7,scaffold_6
23,7553001,7795000,241999,False,7,scaffold_6
24,7811001,8268281,457280,True,7,scaffold_6
0,1,8000,7999,True,7,scaffold_7
1,11001,34000,22999,False,7,scaffold_7
2,323001,505000,181999,False,7,scaffold_7
3,554001,563000,8999,False,7,scaffold_7
4,571001,577000,5999,False,7,scaffold_7
5,706001,736000,29999,False,7,scaffold_7
6,764001,809000,44999,False,7,scaffold_7
7,859001,864000,4999,False,7,scaffold_7
8,952001,963000,10999,False,7,scaffold_7
9,989001,1044000,54999,False,7,scaffold_7
10,1067001,1089000,21999,False,7,scaffold_7
11,1203001,1512000,308999,False,7,scaffold_7
12,1589001,1688000,98999,False,7,scaffold_7
13,3325001,3370000,44999,False,7,scaffold_7
14,3595001,3649000,53999,False,7,scaffold_7
15,4416001,4517000,100999,False,7,scaffold_7
16,4658001,4681000,22999,False,7,scaffold_7
17,4979001,5115000,135999,False,7,scaffold_7
18,5486001,5515000,28999,False,7,scaffold_7
19,6954001,7270000,315999,False,7,scaffold_7
20,7271001,7502216,231215,True,7,scaffold_7
0,67001,85000,17999,False,7,scaffold_8
1,2492001,2524000,31999,False,7,scaffold_8
2,2656001,2683000,26999,False,7,scaffold_8
3,2745001,2756000,10999,False,7,scaffold_8
4,2809001,2844000,34999,False,7,scaffold_8
5,3058001,3525000,466999,False,7,scaffold_8
6,3581001,3611000,29999,False,7,scaffold_8
7,3621001,3913000,291999,False,7,scaffold_8
8,4038001,4096000,57999,False,7,scaffold_8
9,5122001,5135000,12999,False,7,scaffold_8
10,5200001,5241000,40999,False,7,scaffold_8
11,6320001,6334544,14543,True,7,scaffold_8
0,109001,117000,7999,False,7,scaffold_9
1,303001,315000,11999,False,7,scaffold_9
2,319001,333000,13999,False,7,scaffold_9
3,367001,411000,43999,False,7,scaffold_9
4,413001,434000,20999,False,7,scaffold_9
5,502001,531000,28999,False,7,scaffold_9
6,671001,696000,24999,False,7,scaffold_9
7,731001,742000,10999,False,7,scaffold_9
8,815001,841000,25999,False,7,scaffold_9
9,886001,986000,99999,False,7,scaffold_9
10,987001,995000,7999,False,7,scaffold_9
11,1001001,1007000,5999,False,7,scaffold_9
12,1009001,1031000,21999,False,7,scaffold_9
13,1035001,1085000,49999,False,7,scaffold_9
14,1087001,1150000,62999,False,7,scaffold_9
15,1151001,1164000,12999,False,7,scaffold_9
16,1313001,1377000,63999,False,7,scaffold_9
17,1487001,1499000,11999,False,7,scaffold_9
18,1767001,1790000,22999,False,7,scaffold_9
19,2601001,2616000,14999,False,7,scaffold_9
20,2874001,3381000,506999,False,7,scaffold_9
21,3383001,5107000,1723999,False,7,scaffold_9
22,5112001,5115000,2999,False,7,scaffold_9
23,5116001,5238000,121999,False,7,scaffold_9
24,5239001,5298000,58999,False,7,scaffold_9
25,5300001,5490000,189999,False,7,scaffold_9
26,5493001,6331288,838287,True,7,scaffold_9
0,1,197000,196999,True,7,scaffold_10
1,373001,405000,31999,False,7,scaffold_10
2,472001,482000,9999,False,7,scaffold_10
3,507001,582000,74999,False,7,scaffold_10
4,602001,753000,150999,False,7,scaffold_10
5,888001,916000,27999,False,7,scaffold_10
6,924001,962000,37999,False,7,scaffold_10
7,1087001,1112000,24999,False,7,scaffold_10
8,2346001,2367000,20999,False,7,scaffold_10
9,4054001,4091000,36999,False,7,scaffold_10
10,4154001,4174000,19999,False,7,scaffold_10
11,4443001,4461000,17999,False,7,scaffold_10
12,4515001,4523000,7999,False,7,scaffold_10
13,4526001,4548000,21999,False,7,scaffold_10
14,4575001,4595000,19999,False,7,scaffold_10
15,4680001,4688000,7999,False,7,scaffold_10
16,4734001,4766000,31999,False,7,scaffold_10
17,4769001,4776000,6999,False,7,scaffold_10
18,4798001,4824000,25999,False,7,scaffold_10
19,4827001,4843000,15999,False,7,scaffold_10
20,4848001,4861000,12999,False,7,scaffold_10
21,4865001,4866973,1972,True,7,scaffold_10
0,10001,34000,23999,False,7,scaffold_11
1,40001,93000,52999,False,7,scaffold_11
2,124001,128000,3999,False,7,scaffold_11
3,149001,167000,17999,False,7,scaffold_11
4,169001,191000,21999,False,7,scaffold_11
5,213001,235000,21999,False,7,scaffold_11
6,240001,247000,6999,False,7,scaffold_11
7,419001,431000,11999,False,7,scaffold_11
8,648001,656000,7999,False,7,scaffold_11
9,1025001,1034000,8999,False,7,scaffold_11
10,1423001,1427000,3999,False,7,scaffold_11
11,1474001,1477000,2999,False,7,scaffold_11
12,2701001,2872000,170999,False,7,scaffold_11
13,3188001,3254000,65999,False,7,scaffold_11
14,3331001,3383000,51999,False,7,scaffold_11
15,3702001,3926000,223999,False,7,scaffold_11
16,4321001,4710000,388999,False,7,scaffold_11
17,4713001,4766820,53819,True,7,scaffold_11
0,1,242000,241999,True,7,scaffold_12
1,249001,369000,119999,False,7,scaffold_12
2,474001,537000,62999,False,7,scaffold_12
3,582001,856000,273999,False,7,scaffold_12
4,865001,1357000,491999,False,7,scaffold_12
5,1720001,1733000,12999,False,7,scaffold_12
6,2571001,2612000,40999,False,7,scaffold_12
0,1,342000,341999,True,8,scaffold_1
1,482001,498000,15999,False,8,scaffold_1
2,572001,643000,70999,False,8,scaffold_1
3,686001,743000,56999,False,8,scaffold_1
4,1282001,1292000,9999,False,8,scaffold_1
5,1630001,1660000,29999,False,8,scaffold_1
6,1814001,1898000,83999,False,8,scaffold_1
7,1954001,1964000,9999,False,8,scaffold_1
8,1965001,1984000,18999,False,8,scaffold_1
9,2449001,2517000,67999,False,8,scaffold_1
10,2729001,2746000,16999,False,8,scaffold_1
11,3179001,3208000,28999,False,8,scaffold_1
12,3715001,3736000,20999,False,8,scaffold_1
13,3912001,3941000,28999,False,8,scaffold_1
14,4064001,4111000,46999,False,8,scaffold_1
15,4315001,4354000,38999,False,8,scaffold_1
16,4927001,4997000,69999,False,8,scaffold_1
17,5482001,5511000,28999,False,8,scaffold_1
18,5536001,5570000,33999,False,8,scaffold_1
19,6108001,6153000,44999,False,8,scaffold_1
20,6228001,6382000,153999,False,8,scaffold_1
21,6384001,6508000,123999,False,8,scaffold_1
22,6543001,6555000,11999,False,8,scaffold_1
23,7038001,7247000,208999,False,8,scaffold_1
24,7248001,7584000,335999,False,8,scaffold_1
25,7590001,8477000,886999,False,8,scaffold_1
26,8478001,8656000,177999,False,8,scaffold_1
27,8658001,9584000,925999,False,8,scaffold_1
28,9586001,10355000,768999,False,8,scaffold_1
29,10461001,10636000,174999,False,8,scaffold_1
30,10808001,10811000,2999,False,8,scaffold_1
31,10840001,10856000,15999,False,8,scaffold_1
32,11344001,11504000,159999,False,8,scaffold_1
33,11614001,11951000,336999,False,8,scaffold_1
34,12184001,12203000,18999,False,8,scaffold_1
35,12663001,12722000,58999,False,8,scaffold_1
36,12777001,12888000,110999,False,8,scaffold_1
37,12975001,12992000,16999,False,8,scaffold_1
38,13113001,13211000,97999,False,8,scaffold_1
39,13347001,13404000,56999,False,8,scaffold_1
40,14162001,14164000,1999,False,8,scaffold_1
41,14285001,14309000,23999,False,8,scaffold_1
0,21001,48000,26999,False,8,scaffold_2
1,93001,159000,65999,False,8,scaffold_2
2,168001,177000,8999,False,8,scaffold_2
3,296001,318000,21999,False,8,scaffold_2
4,330001,374000,43999,False,8,scaffold_2
5,2336001,2358000,21999,False,8,scaffold_2
6,2404001,2424000,19999,False,8,scaffold_2
7,2441001,2553000,111999,False,8,scaffold_2
8,2627001,2639000,11999,False,8,scaffold_2
9,2660001,2689000,28999,False,8,scaffold_2
10,2694001,2746000,51999,False,8,scaffold_2
11,2998001,3009000,10999,False,8,scaffold_2
12,3174001,3186000,11999,False,8,scaffold_2
13,3336001,3341000,4999,False,8,scaffold_2
14,3454001,3463000,8999,False,8,scaffold_2
15,3754001,3783000,28999,False,8,scaffold_2
16,4385001,4409000,23999,False,8,scaffold_2
17,4427001,4457000,29999,False,8,scaffold_2
18,4521001,4585000,63999,False,8,scaffold_2
19,4591001,4656000,64999,False,8,scaffold_2
20,5021001,5031000,9999,False,8,scaffold_2
21,5033001,5061000,27999,False,8,scaffold_2
22,5491001,5515000,23999,False,8,scaffold_2
23,5668001,5693000,24999,False,8,scaffold_2
24,5694001,5706000,11999,False,8,scaffold_2
25,6261001,6330000,68999,False,8,scaffold_2
26,6331001,6341000,9999,False,8,scaffold_2
27,6427001,6449000,21999,False,8,scaffold_2
28,7439001,7472000,32999,False,8,scaffold_2
29,7563001,7697000,133999,False,8,scaffold_2
30,7786001,7890000,103999,False,8,scaffold_2
31,7934001,8155000,220999,False,8,scaffold_2
32,8261001,8294000,32999,False,8,scaffold_2
33,8331001,8333000,1999,False,8,scaffold_2
34,8339001,8345000,5999,False,8,scaffold_2
35,8346001,8389000,42999,False,8,scaffold_2
36,8436001,8453000,16999,False,8,scaffold_2
37,8509001,8553000,43999,False,8,scaffold_2
38,11367001,11374000,6999,False,8,scaffold_2
39,11520001,11785000,264999,False,8,scaffold_2
0,1,2000,1999,True,8,scaffold_3
1,51001,55000,3999,False,8,scaffold_3
2,618001,646000,27999,False,8,scaffold_3
3,798001,901000,102999,False,8,scaffold_3
4,1086001,1091000,4999,False,8,scaffold_3
5,2084001,2108000,23999,False,8,scaffold_3
6,2291001,2335000,43999,False,8,scaffold_3
7,2488001,2533000,44999,False,8,scaffold_3
8,3826001,3874000,47999,False,8,scaffold_3
9,4110001,4397000,286999,False,8,scaffold_3
10,4418001,4518000,99999,False,8,scaffold_3
11,4547001,4558000,10999,False,8,scaffold_3
12,4567001,4577000,9999,False,8,scaffold_3
13,4652001,4682000,29999,False,8,scaffold_3
14,5991001,6019000,27999,False,8,scaffold_3
15,6907001,6962000,54999,False,8,scaffold_3
16,6979001,7038000,58999,False,8,scaffold_3
17,7522001,7556000,33999,False,8,scaffold_3
18,7692001,7798000,105999,False,8,scaffold_3
19,7819001,7839000,19999,False,8,scaffold_3
20,8176001,8253000,76999,False,8,scaffold_3
21,8462001,8527000,64999,False,8,scaffold_3
22,8575001,8593000,17999,False,8,scaffold_3
23,9968001,9995000,26999,False,8,scaffold_3
24,10461001,10484000,22999,False,8,scaffold_3
25,10587001,11167000,579999,False,8,scaffold_3
0,11001,13000,1999,False,8,scaffold_4
1,17001,32000,14999,False,8,scaffold_4
2,48001,88000,39999,False,8,scaffold_4
3,133001,146000,12999,False,8,scaffold_4
4,147001,151000,3999,False,8,scaffold_4
5,155001,160000,4999,False,8,scaffold_4
6,161001,215000,53999,False,8,scaffold_4
7,217001,226000,8999,False,8,scaffold_4
8,227001,266000,38999,False,8,scaffold_4
9,293001,307000,13999,False,8,scaffold_4
10,318001,344000,25999,False,8,scaffold_4
11,355001,374000,18999,False,8,scaffold_4
12,375001,380000,4999,False,8,scaffold_4
13,412001,425000,12999,False,8,scaffold_4
14,429001,498000,68999,False,8,scaffold_4
15,543001,592000,48999,False,8,scaffold_4
16,593001,606000,12999,False,8,scaffold_4
17,608001,691000,82999,False,8,scaffold_4
18,701001,714000,12999,False,8,scaffold_4
19,1120001,1136000,15999,False,8,scaffold_4
20,1137001,1178000,40999,False,8,scaffold_4
21,1199001,1226000,26999,False,8,scaffold_4
22,1254001,1262000,7999,False,8,scaffold_4
23,1265001,1279000,13999,False,8,scaffold_4
24,1283001,1318000,34999,False,8,scaffold_4
25,1372001,1596000,223999,False,8,scaffold_4
26,1613001,1849000,235999,False,8,scaffold_4
27,1850001,1866000,15999,False,8,scaffold_4
28,1904001,1999000,94999,False,8,scaffold_4
29,2021001,2065000,43999,False,8,scaffold_4
30,2207001,2229000,21999,False,8,scaffold_4
31,2284001,2339000,54999,False,8,scaffold_4
32,2429001,2445000,15999,False,8,scaffold_4
33,2447001,2461000,13999,False,8,scaffold_4
34,2476001,2535000,58999,False,8,scaffold_4
35,3333001,3633000,299999,False,8,scaffold_4
36,3676001,3760000,83999,False,8,scaffold_4
37,4944001,4985000,40999,False,8,scaffold_4
38,5477001,5506000,28999,False,8,scaffold_4
39,5514001,5620000,105999,False,8,scaffold_4
40,5660001,5784000,123999,False,8,scaffold_4
41,6177001,6190000,12999,False,8,scaffold_4
42,7036001,7062000,25999,False,8,scaffold_4
43,8846001,9699000,852999,False,8,scaffold_4
44,9700001,9845951,145950,True,8,scaffold_4
0,296001,300000,3999,False,8,scaffold_5
1,318001,326000,7999,False,8,scaffold_5
2,327001,368000,40999,False,8,scaffold_5
3,464001,485000,20999,False,8,scaffold_5
4,495001,523000,27999,False,8,scaffold_5
5,933001,947000,13999,False,8,scaffold_5
6,2564001,2582000,17999,False,8,scaffold_5
7,2624001,2732000,107999,False,8,scaffold_5
8,2814001,2871000,56999,False,8,scaffold_5
9,3133001,3185000,51999,False,8,scaffold_5
10,3322001,3507000,184999,False,8,scaffold_5
11,3962001,4101000,138999,False,8,scaffold_5
12,4121001,4219000,97999,False,8,scaffold_5
13,4246001,4262000,15999,False,8,scaffold_5
14,4446001,4484000,37999,False,8,scaffold_5
15,4602001,4662000,59999,False,8,scaffold_5
16,4691001,4717000,25999,False,8,scaffold_5
17,4771001,4862000,90999,False,8,scaffold_5
18,4892001,4919000,26999,False,8,scaffold_5
19,5288001,5312000,23999,False,8,scaffold_5
20,5314001,5344000,29999,False,8,scaffold_5
21,6408001,6420000,11999,False,8,scaffold_5
22,6511001,6566000,54999,False,8,scaffold_5
23,7454001,7483000,28999,False,8,scaffold_5
24,7580001,7609000,28999,False,8,scaffold_5
25,7622001,7641000,18999,False,8,scaffold_5
26,8730001,9364176,634175,True,8,scaffold_5
0,79001,84000,4999,False,8,scaffold_6
1,86001,113000,26999,False,8,scaffold_6
2,240001,253000,12999,False,8,scaffold_6
3,257001,262000,4999,False,8,scaffold_6
4,267001,283000,15999,False,8,scaffold_6
5,553001,568000,14999,False,8,scaffold_6
6,1478001,1546000,67999,False,8,scaffold_6
7,1868001,1906000,37999,False,8,scaffold_6
8,2023001,2087000,63999,False,8,scaffold_6
9,2130001,2193000,62999,False,8,scaffold_6
10,2336001,2595000,258999,False,8,scaffold_6
11,2596001,2691000,94999,False,8,scaffold_6
12,2731001,2852000,120999,False,8,scaffold_6
13,2933001,3015000,81999,False,8,scaffold_6
14,3115001,3149000,33999,False,8,scaffold_6
15,3224001,3301000,76999,False,8,scaffold_6
16,3408001,3427000,18999,False,8,scaffold_6
17,3461001,3767000,305999,False,8,scaffold_6
18,3901001,3912000,10999,False,8,scaffold_6
19,4016001,4069000,52999,False,8,scaffold_6
20,4080001,4195000,114999,False,8,scaffold_6
21,6010001,6060000,49999,False,8,scaffold_6
22,7264001,7337000,72999,False,8,scaffold_6
23,7543001,7795000,251999,False,8,scaffold_6
24,7811001,8268281,457280,True,8,scaffold_6
0,13001,31000,17999,False,8,scaffold_7
1,169001,171000,1999,False,8,scaffold_7
2,243001,249000,5999,False,8,scaffold_7
3,323001,340000,16999,False,8,scaffold_7
4,342001,505000,162999,False,8,scaffold_7
5,554001,563000,8999,False,8,scaffold_7
6,571001,577000,5999,False,8,scaffold_7
7,706001,753000,46999,False,8,scaffold_7
8,764001,829000,64999,False,8,scaffold_7
9,832001,843000,10999,False,8,scaffold_7
10,859001,864000,4999,False,8,scaffold_7
11,865001,885000,19999,False,8,scaffold_7
12,982001,1044000,61999,False,8,scaffold_7
13,1048001,1100000,51999,False,8,scaffold_7
14,1204001,1261000,56999,False,8,scaffold_7
15,1262001,1459000,196999,False,8,scaffold_7
16,1461001,1512000,50999,False,8,scaffold_7
17,1588001,1688000,99999,False,8,scaffold_7
18,3326001,3369000,42999,False,8,scaffold_7
19,3595001,3659000,63999,False,8,scaffold_7
20,4416001,4517000,100999,False,8,scaffold_7
21,4658001,4682000,23999,False,8,scaffold_7
22,4979001,5115000,135999,False,8,scaffold_7
23,5482001,5536000,53999,False,8,scaffold_7
24,6955001,7270000,314999,False,8,scaffold_7
25,7271001,7502216,231215,True,8,scaffold_7
0,67001,85000,17999,False,8,scaffold_8
1,2444001,2470000,25999,False,8,scaffold_8
2,2492001,2512000,19999,False,8,scaffold_8
3,2538001,2548000,9999,False,8,scaffold_8
4,2653001,2683000,29999,False,8,scaffold_8
5,2745001,2756000,10999,False,8,scaffold_8
6,2808001,2844000,35999,False,8,scaffold_8
7,3059001,3125000,65999,False,8,scaffold_8
8,3126001,3525000,398999,False,8,scaffold_8
9,3585001,3612000,26999,False,8,scaffold_8
10,3617001,3913000,295999,False,8,scaffold_8
11,5198001,5241000,42999,False,8,scaffold_8
12,6329001,6334544,5543,True,8,scaffold_8
0,109001,117000,7999,False,8,scaffold_9
1,121001,138000,16999,False,8,scaffold_9
2,319001,332000,12999,False,8,scaffold_9
3,366001,411000,44999,False,8,scaffold_9
4,413001,434000,20999,False,8,scaffold_9
5,501001,531000,29999,False,8,scaffold_9
6,548001,563000,14999,False,8,scaffold_9
7,670001,696000,25999,False,8,scaffold_9
8,731001,742000,10999,False,8,scaffold_9
9,794001,803000,8999,False,8,scaffold_9
10,814001,842000,27999,False,8,scaffold_9
11,855001,862000,6999,False,8,scaffold_9
12,872001,986000,113999,False,8,scaffold_9
13,987001,995000,7999,False,8,scaffold_9
14,1001001,1007000,5999,False,8,scaffold_9
15,1009001,1031000,21999,False,8,scaffold_9
16,1035001,1085000,49999,False,8,scaffold_9
17,1087001,1150000,62999,False,8,scaffold_9
18,1151001,1162000,10999,False,8,scaffold_9
19,1312001,1378000,65999,False,8,scaffold_9
20,1599001,1612000,12999,False,8,scaffold_9
21,1765001,1791000,25999,False,8,scaffold_9
22,2601001,2616000,14999,False,8,scaffold_9
23,2782001,2837000,54999,False,8,scaffold_9
24,2872001,3381000,508999,False,8,scaffold_9
25,3383001,5107000,1723999,False,8,scaffold_9
26,5112001,5115000,2999,False,8,scaffold_9
27,5116001,5238000,121999,False,8,scaffold_9
28,5239001,5298000,58999,False,8,scaffold_9
29,5300001,5490000,189999,False,8,scaffold_9
30,5493001,6331288,838287,True,8,scaffold_9
0,1,201000,200999,True,8,scaffold_10
1,340001,405000,64999,False,8,scaffold_10
2,472001,482000,9999,False,8,scaffold_10
3,483001,576000,92999,False,8,scaffold_10
4,603001,756000,152999,False,8,scaffold_10
5,888001,916000,27999,False,8,scaffold_10
6,924001,962000,37999,False,8,scaffold_10
7,1060001,1069000,8999,False,8,scaffold_10
8,1088001,1105000,16999,False,8,scaffold_10
9,2141001,2166000,24999,False,8,scaffold_10
10,2346001,2367000,20999,False,8,scaffold_10
11,3590001,3595000,4999,False,8,scaffold_10
12,4054001,4091000,36999,False,8,scaffold_10
13,4154001,4174000,19999,False,8,scaffold_10
14,4443001,4462000,18999,False,8,scaffold_10
15,4467001,4476000,8999,False,8,scaffold_10
16,4515001,4523000,7999,False,8,scaffold_10
17,4526001,4548000,21999,False,8,scaffold_10
18,4574001,4596000,21999,False,8,scaffold_10
19,4681001,4688000,6999,False,8,scaffold_10
20,4735001,4751000,15999,False,8,scaffold_10
21,4752001,4766000,13999,False,8,scaffold_10
22,4769001,4776000,6999,False,8,scaffold_10
23,4798001,4824000,25999,False,8,scaffold_10
24,4827001,4843000,15999,False,8,scaffold_10
25,4848001,4861000,12999,False,8,scaffold_10
26,4865001,4866973,1972,True,8,scaffold_10
0,10001,91000,80999,False,8,scaffold_11
1,149001,167000,17999,False,8,scaffold_11
2,169001,191000,21999,False,8,scaffold_11
3,214001,235000,20999,False,8,scaffold_11
4,419001,431000,11999,False,8,scaffold_11
5,649001,656000,6999,False,8,scaffold_11
6,1025001,1034000,8999,False,8,scaffold_11
7,1423001,1426000,2999,False,8,scaffold_11
8,2701001,2874000,172999,False,8,scaffold_11
9,3188001,3254000,65999,False,8,scaffold_11
10,3331001,3383000,51999,False,8,scaffold_11
11,3702001,3726000,23999,False,8,scaffold_11
12,3742001,3927000,184999,False,8,scaffold_11
13,4317001,4710000,392999,False,8,scaffold_11
14,4713001,4766820,53819,True,8,scaffold_11
0,1,370000,369999,True,8,scaffold_12
1,474001,538000,63999,False,8,scaffold_12
2,580001,857000,276999,False,8,scaffold_12
3,865001,1360000,494999,False,8,scaffold_12
4,1720001,1733000,12999,False,8,scaffold_12
5,2559001,2570000,10999,False,8,scaffold_12
6,2571001,2618000,46999,False,8,scaffold_12
7,2726001,2728000,1999,False,8,scaffold_12
8,2747001,2747968,967,True,8,scaffold_12
0,1,342000,341999,True,9,scaffold_1
1,482001,498000,15999,False,9,scaffold_1
2,572001,643000,70999,False,9,scaffold_1
3,686001,743000,56999,False,9,scaffold_1
4,1954001,1964000,9999,False,9,scaffold_1
5,1965001,1984000,18999,False,9,scaffold_1
6,2449001,2517000,67999,False,9,scaffold_1
7,2727001,2746000,18999,False,9,scaffold_1
8,3181001,3208000,26999,False,9,scaffold_1
9,3715001,3733000,17999,False,9,scaffold_1
10,3916001,3941000,24999,False,9,scaffold_1
11,4062001,4111000,48999,False,9,scaffold_1
12,4315001,4354000,38999,False,9,scaffold_1
13,4928001,4996000,67999,False,9,scaffold_1
14,5481001,5511000,29999,False,9,scaffold_1
15,6108001,6153000,44999,False,9,scaffold_1
16,6154001,6176000,21999,False,9,scaffold_1
17,6228001,6381000,152999,False,9,scaffold_1
18,6384001,6507000,122999,False,9,scaffold_1
19,6545001,6554000,8999,False,9,scaffold_1
20,7038001,7247000,208999,False,9,scaffold_1
21,7248001,7584000,335999,False,9,scaffold_1
22,7590001,8477000,886999,False,9,scaffold_1
23,8478001,8656000,177999,False,9,scaffold_1
24,8658001,9584000,925999,False,9,scaffold_1
25,9586001,10354000,767999,False,9,scaffold_1
26,10461001,10632000,170999,False,9,scaffold_1
27,10808001,10811000,2999,False,9,scaffold_1
28,10832001,10858000,25999,False,9,scaffold_1
29,11352001,11504000,151999,False,9,scaffold_1
30,11609001,11951000,341999,False,9,scaffold_1
31,12184001,12204000,19999,False,9,scaffold_1
32,12653001,12722000,68999,False,9,scaffold_1
33,12777001,12888000,110999,False,9,scaffold_1
34,13113001,13135000,21999,False,9,scaffold_1
35,13178001,13211000,32999,False,9,scaffold_1
36,13347001,13377000,29999,False,9,scaffold_1
37,14298001,14306000,7999,False,9,scaffold_1
38,14513001,14515000,1999,False,9,scaffold_1
39,14595001,14597000,1999,False,9,scaffold_1
0,22001,48000,25999,False,9,scaffold_2
1,93001,159000,65999,False,9,scaffold_2
2,168001,177000,8999,False,9,scaffold_2
3,333001,374000,40999,False,9,scaffold_2
4,2336001,2358000,21999,False,9,scaffold_2
5,2441001,2553000,111999,False,9,scaffold_2
6,2645001,2689000,43999,False,9,scaffold_2
7,2694001,2745000,50999,False,9,scaffold_2
8,2868001,2898000,29999,False,9,scaffold_2
9,2994001,3012000,17999,False,9,scaffold_2
10,3334001,3343000,8999,False,9,scaffold_2
11,3454001,3463000,8999,False,9,scaffold_2
12,3766001,3782000,15999,False,9,scaffold_2
13,4385001,4409000,23999,False,9,scaffold_2
14,4429001,4456000,26999,False,9,scaffold_2
15,4521001,4656000,134999,False,9,scaffold_2
16,5022001,5031000,8999,False,9,scaffold_2
17,5033001,5061000,27999,False,9,scaffold_2
18,5371001,5394000,22999,False,9,scaffold_2
19,5491001,5512000,20999,False,9,scaffold_2
20,5672001,5704000,31999,False,9,scaffold_2
21,6261001,6330000,68999,False,9,scaffold_2
22,6331001,6350000,18999,False,9,scaffold_2
23,6430001,6447000,16999,False,9,scaffold_2
24,7439001,7472000,32999,False,9,scaffold_2
25,7563001,7697000,133999,False,9,scaffold_2
26,7786001,7890000,103999,False,9,scaffold_2
27,7934001,8161000,226999,False,9,scaffold_2
28,8331001,8333000,1999,False,9,scaffold_2
29,8340001,8344000,3999,False,9,scaffold_2
30,8346001,8389000,42999,False,9,scaffold_2
31,8509001,8559000,49999,False,9,scaffold_2
32,11367001,11373000,5999,False,9,scaffold_2
33,11520001,11786000,265999,False,9,scaffold_2
0,51001,55000,3999,False,9,scaffold_3
1,102001,104000,1999,False,9,scaffold_3
2,800001,900000,99999,False,9,scaffold_3
3,2085001,2108000,22999,False,9,scaffold_3
4,2291001,2321000,29999,False,9,scaffold_3
5,2487001,2533000,45999,False,9,scaffold_3
6,4108001,4403000,294999,False,9,scaffold_3
7,4416001,4518000,101999,False,9,scaffold_3
8,4547001,4558000,10999,False,9,scaffold_3
9,4654001,4678000,23999,False,9,scaffold_3
10,5988001,6023000,34999,False,9,scaffold_3
11,6909001,6962000,52999,False,9,scaffold_3
12,6979001,7047000,67999,False,9,scaffold_3
13,7540001,7555000,14999,False,9,scaffold_3
14,7692001,7798000,105999,False,9,scaffold_3
15,7822001,7839000,16999,False,9,scaffold_3
16,8183001,8253000,69999,False,9,scaffold_3
17,8462001,8527000,64999,False,9,scaffold_3
18,8575001,8593000,17999,False,9,scaffold_3
19,9968001,9995000,26999,False,9,scaffold_3
20,10461001,10483000,21999,False,9,scaffold_3
21,10587001,11165000,577999,False,9,scaffold_3
0,17001,32000,14999,False,9,scaffold_4
1,48001,88000,39999,False,9,scaffold_4
2,136001,146000,9999,False,9,scaffold_4
3,147001,151000,3999,False,9,scaffold_4
4,155001,160000,4999,False,9,scaffold_4
5,161001,215000,53999,False,9,scaffold_4
6,217001,226000,8999,False,9,scaffold_4
7,227001,266000,38999,False,9,scaffold_4
8,294001,310000,15999,False,9,scaffold_4
9,320001,344000,23999,False,9,scaffold_4
10,355001,374000,18999,False,9,scaffold_4
11,375001,380000,4999,False,9,scaffold_4
12,412001,425000,12999,False,9,scaffold_4
13,429001,498000,68999,False,9,scaffold_4
14,545001,606000,60999,False,9,scaffold_4
15,608001,661000,52999,False,9,scaffold_4
16,670001,691000,20999,False,9,scaffold_4
17,695001,697000,1999,False,9,scaffold_4
18,701001,714000,12999,False,9,scaffold_4
19,1120001,1136000,15999,False,9,scaffold_4
20,1137001,1179000,41999,False,9,scaffold_4
21,1199001,1208000,8999,False,9,scaffold_4
22,1210001,1226000,15999,False,9,scaffold_4
23,1254001,1262000,7999,False,9,scaffold_4
24,1265001,1279000,13999,False,9,scaffold_4
25,1283001,1319000,35999,False,9,scaffold_4
26,1372001,1593000,220999,False,9,scaffold_4
27,1653001,1692000,38999,False,9,scaffold_4
28,1725001,1868000,142999,False,9,scaffold_4
29,1904001,1957000,52999,False,9,scaffold_4
30,1958001,2003000,44999,False,9,scaffold_4
31,2036001,2090000,53999,False,9,scaffold_4
32,2119001,2129000,9999,False,9,scaffold_4
33,2211001,2232000,20999,False,9,scaffold_4
34,2270001,2279000,8999,False,9,scaffold_4
35,2284001,2340000,55999,False,9,scaffold_4
36,2480001,2581000,100999,False,9,scaffold_4
37,2599001,2635000,35999,False,9,scaffold_4
38,3336001,3633000,296999,False,9,scaffold_4
39,3675001,3760000,84999,False,9,scaffold_4
40,4943001,4984000,40999,False,9,scaffold_4
41,5477001,5506000,28999,False,9,scaffold_4
42,5514001,5620000,105999,False,9,scaffold_4
43,5667001,5784000,116999,False,9,scaffold_4
44,6145001,6190000,44999,False,9,scaffold_4
45,6801001,6817000,15999,False,9,scaffold_4
46,6910001,6924000,13999,False,9,scaffold_4
47,7037001,7062000,24999,False,9,scaffold_4
48,8846001,9699000,852999,False,9,scaffold_4
49,9703001,9845951,142950,True,9,scaffold_4
0,1,4000,3999,True,9,scaffold_5
1,318001,326000,7999,False,9,scaffold_5
2,327001,368000,40999,False,9,scaffold_5
3,463001,483000,19999,False,9,scaffold_5
4,495001,525000,29999,False,9,scaffold_5
5,933001,947000,13999,False,9,scaffold_5
6,2475001,2493000,17999,False,9,scaffold_5
7,2555001,2581000,25999,False,9,scaffold_5
8,2625001,2732000,106999,False,9,scaffold_5
9,2816001,2871000,54999,False,9,scaffold_5
10,3167001,3184000,16999,False,9,scaffold_5
11,3322001,3438000,115999,False,9,scaffold_5
12,3450001,3497000,46999,False,9,scaffold_5
13,3962001,4101000,138999,False,9,scaffold_5
14,4121001,4219000,97999,False,9,scaffold_5
15,4246001,4262000,15999,False,9,scaffold_5
16,4446001,4488000,41999,False,9,scaffold_5
17,4602001,4660000,57999,False,9,scaffold_5
18,4691001,4717000,25999,False,9,scaffold_5
19,4789001,4861000,71999,False,9,scaffold_5
20,4904001,4917000,12999,False,9,scaffold_5
21,5318001,5346000,27999,False,9,scaffold_5
22,6506001,6566000,59999,False,9,scaffold_5
23,7373001,7386000,12999,False,9,scaffold_5
24,7582001,7608000,25999,False,9,scaffold_5
25,7622001,7651000,28999,False,9,scaffold_5
26,8668001,8689000,20999,False,9,scaffold_5
27,8730001,9363000,632999,False,9,scaffold_5
28,9364001,9364176,175,True,9,scaffold_5
0,79001,84000,4999,False,9,scaffold_6
1,86001,113000,26999,False,9,scaffold_6
2,239001,254000,14999,False,9,scaffold_6
3,257001,262000,4999,False,9,scaffold_6
4,267001,278000,10999,False,9,scaffold_6
5,543001,546000,2999,False,9,scaffold_6
6,1235001,1256000,20999,False,9,scaffold_6
7,1479001,1546000,66999,False,9,scaffold_6
8,2023001,2087000,63999,False,9,scaffold_6
9,2130001,2193000,62999,False,9,scaffold_6
10,2338001,2595000,256999,False,9,scaffold_6
11,2596001,2653000,56999,False,9,scaffold_6
12,2661001,2691000,29999,False,9,scaffold_6
13,2731001,2851000,119999,False,9,scaffold_6
14,2934001,3015000,80999,False,9,scaffold_6
15,3115001,3151000,35999,False,9,scaffold_6
16,3224001,3301000,76999,False,9,scaffold_6
17,3407001,3428000,20999,False,9,scaffold_6
18,3462001,3767000,304999,False,9,scaffold_6
19,3899001,3913000,13999,False,9,scaffold_6
20,4018001,4047000,28999,False,9,scaffold_6
21,4081001,4193000,111999,False,9,scaffold_6
22,6011001,6060000,48999,False,9,scaffold_6
23,7282001,7337000,54999,False,9,scaffold_6
24,7392001,7414000,21999,False,9,scaffold_6
25,7550001,7795000,244999,False,9,scaffold_6
26,7811001,8268281,457280,True,9,scaffold_6
0,1,7000,6999,True,9,scaffold_7
1,13001,31000,17999,False,9,scaffold_7
2,323001,340000,16999,False,9,scaffold_7
3,342001,508000,165999,False,9,scaffold_7
4,554001,563000,8999,False,9,scaffold_7
5,571001,577000,5999,False,9,scaffold_7
6,706001,724000,17999,False,9,scaffold_7
7,725001,736000,10999,False,9,scaffold_7
8,741001,753000,11999,False,9,scaffold_7
9,764001,829000,64999,False,9,scaffold_7
10,830001,843000,12999,False,9,scaffold_7
11,859001,864000,4999,False,9,scaffold_7
12,951001,963000,11999,False,9,scaffold_7
13,964001,966000,1999,False,9,scaffold_7
14,982001,1044000,61999,False,9,scaffold_7
15,1191001,1512000,320999,False,9,scaffold_7
16,1588001,1690000,101999,False,9,scaffold_7
17,3326001,3369000,42999,False,9,scaffold_7
18,3593001,3661000,67999,False,9,scaffold_7
19,3698001,3766000,67999,False,9,scaffold_7
20,4416001,4535000,118999,False,9,scaffold_7
21,4658001,4682000,23999,False,9,scaffold_7
22,4979001,5030000,50999,False,9,scaffold_7
23,5073001,5149000,75999,False,9,scaffold_7
24,5498001,5512000,13999,False,9,scaffold_7
25,5609001,5626000,16999,False,9,scaffold_7
26,6955001,7270000,314999,False,9,scaffold_7
27,7271001,7502216,231215,True,9,scaffold_7
0,66001,85000,18999,False,9,scaffold_8
1,93001,101000,7999,False,9,scaffold_8
2,2448001,2468000,19999,False,9,scaffold_8
3,2494001,2507000,12999,False,9,scaffold_8
4,2538001,2548000,9999,False,9,scaffold_8
5,2656001,2683000,26999,False,9,scaffold_8
6,2742001,2756000,13999,False,9,scaffold_8
7,3060001,3525000,464999,False,9,scaffold_8
8,3584001,3612000,27999,False,9,scaffold_8
9,3617001,3913000,295999,False,9,scaffold_8
10,4040001,4099000,58999,False,9,scaffold_8
11,5106001,5136000,29999,False,9,scaffold_8
12,5199001,5241000,41999,False,9,scaffold_8
13,6331001,6334544,3543,True,9,scaffold_8
0,109001,117000,7999,False,9,scaffold_9
1,319001,332000,12999,False,9,scaffold_9
2,367001,411000,43999,False,9,scaffold_9
3,413001,423000,9999,False,9,scaffold_9
4,504001,531000,26999,False,9,scaffold_9
5,671001,696000,24999,False,9,scaffold_9
6,732001,742000,9999,False,9,scaffold_9
7,794001,803000,8999,False,9,scaffold_9
8,814001,841000,26999,False,9,scaffold_9
9,872001,986000,113999,False,9,scaffold_9
10,988001,995000,6999,False,9,scaffold_9
11,1001001,1007000,5999,False,9,scaffold_9
12,1010001,1031000,20999,False,9,scaffold_9
13,1035001,1085000,49999,False,9,scaffold_9
14,1087001,1150000,62999,False,9,scaffold_9
15,1151001,1164000,12999,False,9,scaffold_9
16,1312001,1377000,64999,False,9,scaffold_9
17,1766001,1791000,24999,False,9,scaffold_9
18,2599001,2616000,16999,False,9,scaffold_9
19,2870001,3381000,510999,False,9,scaffold_9
20,3383001,5107000,1723999,False,9,scaffold_9
21,5112001,5115000,2999,False,9,scaffold_9
22,5116001,5238000,121999,False,9,scaffold_9
23,5239001,5298000,58999,False,9,scaffold_9
24,5300001,6331288,1031287,True,9,scaffold_9
0,1,136000,135999,True,9,scaffold_10
1,137001,199000,61999,False,9,scaffold_10
2,372001,405000,32999,False,9,scaffold_10
3,472001,482000,9999,False,9,scaffold_10
4,483001,582000,98999,False,9,scaffold_10
5,603001,720000,116999,False,9,scaffold_10
6,888001,921000,32999,False,9,scaffold_10
7,923001,962000,38999,False,9,scaffold_10
8,1087001,1105000,17999,False,9,scaffold_10
9,2346001,2366000,19999,False,9,scaffold_10
10,2702001,2708000,5999,False,9,scaffold_10
11,4054001,4091000,36999,False,9,scaffold_10
12,4154001,4174000,19999,False,9,scaffold_10
13,4443001,4462000,18999,False,9,scaffold_10
14,4467001,4477000,9999,False,9,scaffold_10
15,4506001,4513000,6999,False,9,scaffold_10
16,4515001,4523000,7999,False,9,scaffold_10
17,4526001,4548000,21999,False,9,scaffold_10
18,4575001,4596000,20999,False,9,scaffold_10
19,4681001,4688000,6999,False,9,scaffold_10
20,4735001,4766000,30999,False,9,scaffold_10
21,4768001,4776000,7999,False,9,scaffold_10
22,4798001,4824000,25999,False,9,scaffold_10
23,4828001,4843000,14999,False,9,scaffold_10
24,4848001,4861000,12999,False,9,scaffold_10
25,4865001,4866973,1972,True,9,scaffold_10
0,10001,34000,23999,False,9,scaffold_11
1,38001,99000,60999,False,9,scaffold_11
2,149001,167000,17999,False,9,scaffold_11
3,169001,191000,21999,False,9,scaffold_11
4,213001,235000,21999,False,9,scaffold_11
5,240001,248000,7999,False,9,scaffold_11
6,419001,431000,11999,False,9,scaffold_11
7,648001,656000,7999,False,9,scaffold_11
8,1025001,1034000,8999,False,9,scaffold_11
9,1423001,1426000,2999,False,9,scaffold_11
10,2701001,2873000,171999,False,9,scaffold_11
11,2985001,3014000,28999,False,9,scaffold_11
12,3212001,3259000,46999,False,9,scaffold_11
13,3331001,3382000,50999,False,9,scaffold_11
14,3702001,3926000,223999,False,9,scaffold_11
15,4316001,4710000,393999,False,9,scaffold_11
16,4713001,4766820,53819,True,9,scaffold_11
0,1,370000,369999,True,9,scaffold_12
1,474001,537000,62999,False,9,scaffold_12
2,582001,730000,147999,False,9,scaffold_12
3,739001,856000,116999,False,9,scaffold_12
4,865001,1426000,560999,False,9,scaffold_12
5,1720001,1733000,12999,False,9,scaffold_12
6,2571001,2616000,44999,False,9,scaffold_12
7,2685001,2698000,12999,False,9,scaffold_12
0,1,342000,341999,True,10,scaffold_1
1,481001,498000,16999,False,10,scaffold_1
2,570001,643000,72999,False,10,scaffold_1
3,686001,748000,61999,False,10,scaffold_1
4,1281001,1292000,10999,False,10,scaffold_1
5,1604001,1660000,55999,False,10,scaffold_1
6,1812001,1898000,85999,False,10,scaffold_1
7,1954001,1964000,9999,False,10,scaffold_1
8,1965001,1984000,18999,False,10,scaffold_1
9,2449001,2517000,67999,False,10,scaffold_1
10,2729001,2746000,16999,False,10,scaffold_1
11,3175001,3209000,33999,False,10,scaffold_1
12,3714001,3751000,36999,False,10,scaffold_1
13,3916001,3941000,24999,False,10,scaffold_1
14,4004001,4028000,23999,False,10,scaffold_1
15,4063001,4113000,49999,False,10,scaffold_1
16,4316001,4355000,38999,False,10,scaffold_1
17,4796001,4806000,9999,False,10,scaffold_1
18,4927001,5011000,83999,False,10,scaffold_1
19,5481001,5511000,29999,False,10,scaffold_1
20,5536001,5570000,33999,False,10,scaffold_1
21,5857001,5870000,12999,False,10,scaffold_1
22,6108001,6153000,44999,False,10,scaffold_1
23,6154001,6176000,21999,False,10,scaffold_1
24,6228001,6381000,152999,False,10,scaffold_1
25,6384001,6507000,122999,False,10,scaffold_1
26,6544001,6554000,9999,False,10,scaffold_1
27,7038001,7247000,208999,False,10,scaffold_1
28,7248001,7588000,339999,False,10,scaffold_1
29,7590001,8477000,886999,False,10,scaffold_1
30,8478001,8656000,177999,False,10,scaffold_1
31,8658001,9584000,925999,False,10,scaffold_1
32,9586001,10358000,771999,False,10,scaffold_1
33,10461001,10638000,176999,False,10,scaffold_1
34,10808001,10811000,2999,False,10,scaffold_1
35,10835001,10857000,21999,False,10,scaffold_1
36,11344001,11504000,159999,False,10,scaffold_1
37,11609001,11957000,347999,False,10,scaffold_1
38,12184001,12204000,19999,False,10,scaffold_1
39,12427001,12444000,16999,False,10,scaffold_1
40,12650001,12722000,71999,False,10,scaffold_1
41,12775001,12888000,112999,False,10,scaffold_1
42,12974001,12992000,17999,False,10,scaffold_1
43,13113001,13216000,102999,False,10,scaffold_1
44,13347001,13431000,83999,False,10,scaffold_1
45,14285001,14309000,23999,False,10,scaffold_1
0,1,48000,47999,True,10,scaffold_2
1,95001,159000,63999,False,10,scaffold_2
2,168001,177000,8999,False,10,scaffold_2
3,302001,318000,15999,False,10,scaffold_2
4,332001,374000,41999,False,10,scaffold_2
5,2086001,2099000,12999,False,10,scaffold_2
6,2336001,2358000,21999,False,10,scaffold_2
7,2397001,2415000,17999,False,10,scaffold_2
8,2416001,2424000,7999,False,10,scaffold_2
9,2437001,2600000,162999,False,10,scaffold_2
10,2627001,2639000,11999,False,10,scaffold_2
11,2645001,2689000,43999,False,10,scaffold_2
12,2694001,2742000,47999,False,10,scaffold_2
13,2841001,2855000,13999,False,10,scaffold_2
14,2996001,3021000,24999,False,10,scaffold_2
15,3022001,3044000,21999,False,10,scaffold_2
16,3452001,3465000,12999,False,10,scaffold_2
17,3754001,3783000,28999,False,10,scaffold_2
18,4361001,4409000,47999,False,10,scaffold_2
19,4426001,4457000,30999,False,10,scaffold_2
20,4521001,4656000,134999,False,10,scaffold_2
21,4782001,4790000,7999,False,10,scaffold_2
22,4917001,4960000,42999,False,10,scaffold_2
23,5021001,5061000,39999,False,10,scaffold_2
24,5357001,5393000,35999,False,10,scaffold_2
25,5491001,5513000,21999,False,10,scaffold_2
26,5667001,5704000,36999,False,10,scaffold_2
27,5719001,5759000,39999,False,10,scaffold_2
28,6261001,6330000,68999,False,10,scaffold_2
29,6331001,6343000,11999,False,10,scaffold_2
30,6413001,6449000,35999,False,10,scaffold_2
31,6613001,6624000,10999,False,10,scaffold_2
32,7428001,7473000,44999,False,10,scaffold_2
33,7550001,7561000,10999,False,10,scaffold_2
34,7585001,7697000,111999,False,10,scaffold_2
35,7786001,7890000,103999,False,10,scaffold_2
36,7933001,8161000,227999,False,10,scaffold_2
37,8262001,8294000,31999,False,10,scaffold_2
38,8331001,8333000,1999,False,10,scaffold_2
39,8335001,8345000,9999,False,10,scaffold_2
40,8346001,8392000,45999,False,10,scaffold_2
41,8433001,8455000,21999,False,10,scaffold_2
42,8495001,8560000,64999,False,10,scaffold_2
43,9924001,9944000,19999,False,10,scaffold_2
44,11520001,11786000,265999,False,10,scaffold_2
0,1,2000,1999,True,10,scaffold_3
1,51001,55000,3999,False,10,scaffold_3
2,528001,539000,10999,False,10,scaffold_3
3,618001,646000,27999,False,10,scaffold_3
4,798001,900000,101999,False,10,scaffold_3
5,2038001,2108000,69999,False,10,scaffold_3
6,2109001,2116000,6999,False,10,scaffold_3
7,2291001,2321000,29999,False,10,scaffold_3
8,2487001,2532000,44999,False,10,scaffold_3
9,2659001,2667000,7999,False,10,scaffold_3
10,2719001,2727000,7999,False,10,scaffold_3
11,3261001,3271000,9999,False,10,scaffold_3
12,3826001,3894000,67999,False,10,scaffold_3
13,4070001,4398000,327999,False,10,scaffold_3
14,4418001,4518000,99999,False,10,scaffold_3
15,4545001,4558000,12999,False,10,scaffold_3
16,4643001,4686000,42999,False,10,scaffold_3
17,5493001,5509000,15999,False,10,scaffold_3
18,5974001,6020000,45999,False,10,scaffold_3
19,6757001,6779000,21999,False,10,scaffold_3
20,6908001,6962000,53999,False,10,scaffold_3
21,6963001,7088000,124999,False,10,scaffold_3
22,7369001,7398000,28999,False,10,scaffold_3
23,7506001,7556000,49999,False,10,scaffold_3
24,7692001,7836000,143999,False,10,scaffold_3
25,8176001,8253000,76999,False,10,scaffold_3
26,8428001,8447000,18999,False,10,scaffold_3
27,8462001,8527000,64999,False,10,scaffold_3
28,8575001,8594000,18999,False,10,scaffold_3
29,9059001,9079000,19999,False,10,scaffold_3
30,9968001,9996000,27999,False,10,scaffold_3
31,10066001,10087000,20999,False,10,scaffold_3
32,10461001,10484000,22999,False,10,scaffold_3
33,10587001,11166000,578999,False,10,scaffold_3
0,17001,32000,14999,False,10,scaffold_4
1,48001,88000,39999,False,10,scaffold_4
2,132001,146000,13999,False,10,scaffold_4
3,147001,151000,3999,False,10,scaffold_4
4,155001,215000,59999,False,10,scaffold_4
5,217001,266000,48999,False,10,scaffold_4
6,288001,311000,22999,False,10,scaffold_4
7,312001,344000,31999,False,10,scaffold_4
8,355001,374000,18999,False,10,scaffold_4
9,375001,380000,4999,False,10,scaffold_4
10,381001,410000,28999,False,10,scaffold_4
11,412001,425000,12999,False,10,scaffold_4
12,429001,504000,74999,False,10,scaffold_4
13,545001,592000,46999,False,10,scaffold_4
14,593001,606000,12999,False,10,scaffold_4
15,608001,691000,82999,False,10,scaffold_4
16,1087001,1108000,20999,False,10,scaffold_4
17,1113001,1136000,22999,False,10,scaffold_4
18,1137001,1208000,70999,False,10,scaffold_4
19,1210001,1226000,15999,False,10,scaffold_4
20,1254001,1279000,24999,False,10,scaffold_4
21,1283001,1336000,52999,False,10,scaffold_4
22,1358001,1597000,238999,False,10,scaffold_4
23,1613001,2114000,500999,False,10,scaffold_4
24,2145001,2183000,37999,False,10,scaffold_4
25,2193001,2206000,12999,False,10,scaffold_4
26,2219001,2246000,26999,False,10,scaffold_4
27,2247001,2268000,20999,False,10,scaffold_4
28,2269001,2281000,11999,False,10,scaffold_4
29,2283001,2387000,103999,False,10,scaffold_4
30,2390001,2445000,54999,False,10,scaffold_4
31,2447001,2461000,13999,False,10,scaffold_4
32,2477001,2635000,157999,False,10,scaffold_4
33,3091001,3127000,35999,False,10,scaffold_4
34,3336001,3633000,296999,False,10,scaffold_4
35,3646001,3766000,119999,False,10,scaffold_4
36,4051001,4072000,20999,False,10,scaffold_4
37,4900001,4985000,84999,False,10,scaffold_4
38,5027001,5054000,26999,False,10,scaffold_4
39,5176001,5206000,29999,False,10,scaffold_4
40,5476001,5506000,29999,False,10,scaffold_4
41,5514001,5784000,269999,False,10,scaffold_4
42,5786001,5824000,37999,False,10,scaffold_4
43,6146001,6197000,50999,False,10,scaffold_4
44,6789001,6817000,27999,False,10,scaffold_4
45,6895001,6924000,28999,False,10,scaffold_4
46,6970001,6995000,24999,False,10,scaffold_4
47,7036001,7062000,25999,False,10,scaffold_4
48,8846001,9699000,852999,False,10,scaffold_4
49,9703001,9845951,142950,True,10,scaffold_4
0,1,5000,4999,True,10,scaffold_5
1,28001,32000,3999,False,10,scaffold_5
2,318001,326000,7999,False,10,scaffold_5
3,327001,385000,57999,False,10,scaffold_5
4,463001,524000,60999,False,10,scaffold_5
5,669001,680000,10999,False,10,scaffold_5
6,829001,832000,2999,False,10,scaffold_5
7,933001,947000,13999,False,10,scaffold_5
8,2475001,2494000,18999,False,10,scaffold_5
9,2565001,2741000,175999,False,10,scaffold_5
10,2813001,2868000,54999,False,10,scaffold_5
11,3133001,3185000,51999,False,10,scaffold_5
12,3217001,3248000,30999,False,10,scaffold_5
13,3322001,3511000,188999,False,10,scaffold_5
14,3962001,4101000,138999,False,10,scaffold_5
15,4121001,4222000,100999,False,10,scaffold_5
16,4232001,4275000,42999,False,10,scaffold_5
17,4445001,4506000,60999,False,10,scaffold_5
18,4603001,4683000,79999,False,10,scaffold_5
19,4690001,4925000,234999,False,10,scaffold_5
20,5249001,5274000,24999,False,10,scaffold_5
21,5318001,5346000,27999,False,10,scaffold_5
22,5859001,5888000,28999,False,10,scaffold_5
23,6407001,6420000,12999,False,10,scaffold_5
24,6456001,6633000,176999,False,10,scaffold_5
25,7373001,7387000,13999,False,10,scaffold_5
26,7454001,7513000,58999,False,10,scaffold_5
27,7542001,7609000,66999,False,10,scaffold_5
28,8556001,8616000,59999,False,10,scaffold_5
29,8676001,8685000,8999,False,10,scaffold_5
30,8730001,9363000,632999,False,10,scaffold_5
0,79001,85000,5999,False,10,scaffold_6
1,86001,113000,26999,False,10,scaffold_6
2,166001,208000,41999,False,10,scaffold_6
3,238001,255000,16999,False,10,scaffold_6
4,257001,296000,38999,False,10,scaffold_6
5,367001,376000,8999,False,10,scaffold_6
6,1229001,1258000,28999,False,10,scaffold_6
7,1286001,1309000,22999,False,10,scaffold_6
8,1479001,1554000,74999,False,10,scaffold_6
9,1557001,1594000,36999,False,10,scaffold_6
10,1867001,1906000,38999,False,10,scaffold_6
11,2026001,2104000,77999,False,10,scaffold_6
12,2129001,2207000,77999,False,10,scaffold_6
13,2237001,2281000,43999,False,10,scaffold_6
14,2336001,2595000,258999,False,10,scaffold_6
15,2596001,2691000,94999,False,10,scaffold_6
16,2712001,2852000,139999,False,10,scaffold_6
17,2934001,3016000,81999,False,10,scaffold_6
18,3115001,3191000,75999,False,10,scaffold_6
19,3223001,3301000,77999,False,10,scaffold_6
20,3406001,3430000,23999,False,10,scaffold_6
21,3461001,3787000,325999,False,10,scaffold_6
22,3899001,3913000,13999,False,10,scaffold_6
23,4018001,4072000,53999,False,10,scaffold_6
24,4073001,4193000,119999,False,10,scaffold_6
25,5945001,5969000,23999,False,10,scaffold_6
26,6009001,6087000,77999,False,10,scaffold_6
27,7258001,7337000,78999,False,10,scaffold_6
28,7390001,7436000,45999,False,10,scaffold_6
29,7541001,8268281,727280,True,10,scaffold_6
0,1,8000,7999,True,10,scaffold_7
1,13001,34000,20999,False,10,scaffold_7
2,323001,340000,16999,False,10,scaffold_7
3,342001,508000,165999,False,10,scaffold_7
4,553001,563000,9999,False,10,scaffold_7
5,571001,577000,5999,False,10,scaffold_7
6,654001,673000,18999,False,10,scaffold_7
7,689001,736000,46999,False,10,scaffold_7
8,740001,753000,12999,False,10,scaffold_7
9,764001,825000,60999,False,10,scaffold_7
10,859001,864000,4999,False,10,scaffold_7
11,869001,872000,2999,False,10,scaffold_7
12,874001,885000,10999,False,10,scaffold_7
13,887001,963000,75999,False,10,scaffold_7
14,964001,980000,15999,False,10,scaffold_7
15,982001,1044000,61999,False,10,scaffold_7
16,1048001,1104000,55999,False,10,scaffold_7
17,1180001,1187000,6999,False,10,scaffold_7
18,1190001,1512000,321999,False,10,scaffold_7
19,1588001,1690000,101999,False,10,scaffold_7
20,3325001,3370000,44999,False,10,scaffold_7
21,3518001,3557000,38999,False,10,scaffold_7
22,3593001,3767000,173999,False,10,scaffold_7
23,4415001,4580000,164999,False,10,scaffold_7
24,4658001,4734000,75999,False,10,scaffold_7
25,4979001,5149000,169999,False,10,scaffold_7
26,5482001,5516000,33999,False,10,scaffold_7
27,5609001,5627000,17999,False,10,scaffold_7
28,6949001,7502216,553215,True,10,scaffold_7
0,1,6000,5999,True,10,scaffold_8
1,67001,85000,17999,False,10,scaffold_8
2,262001,273000,10999,False,10,scaffold_8
3,2442001,2530000,87999,False,10,scaffold_8
4,2652001,2693000,40999,False,10,scaffold_8
5,2742001,2763000,20999,False,10,scaffold_8
6,2798001,2844000,45999,False,10,scaffold_8
7,3059001,3125000,65999,False,10,scaffold_8
8,3126001,3526000,399999,False,10,scaffold_8
9,3584001,3612000,27999,False,10,scaffold_8
10,3615001,3913000,297999,False,10,scaffold_8
11,4039001,4108000,68999,False,10,scaffold_8
12,5124001,5135000,10999,False,10,scaffold_8
13,5173001,5241000,67999,False,10,scaffold_8
14,5579001,5595000,15999,False,10,scaffold_8
15,5661001,5692000,30999,False,10,scaffold_8
16,6319001,6334544,15543,True,10,scaffold_8
0,109001,117000,7999,False,10,scaffold_9
1,121001,137000,15999,False,10,scaffold_9
2,366001,411000,44999,False,10,scaffold_9
3,413001,434000,20999,False,10,scaffold_9
4,501001,531000,29999,False,10,scaffold_9
5,670001,697000,26999,False,10,scaffold_9
6,732001,742000,9999,False,10,scaffold_9
7,815001,843000,27999,False,10,scaffold_9
8,872001,986000,113999,False,10,scaffold_9
9,987001,996000,8999,False,10,scaffold_9
10,997001,1007000,9999,False,10,scaffold_9
11,1010001,1031000,20999,False,10,scaffold_9
12,1039001,1085000,45999,False,10,scaffold_9
13,1087001,1150000,62999,False,10,scaffold_9
14,1151001,1165000,13999,False,10,scaffold_9
15,1311001,1382000,70999,False,10,scaffold_9
16,1428001,1438000,9999,False,10,scaffold_9
17,1457001,1464000,6999,False,10,scaffold_9
18,1599001,1615000,15999,False,10,scaffold_9
19,1750001,1791000,40999,False,10,scaffold_9
20,2148001,2171000,22999,False,10,scaffold_9
21,2176001,2195000,18999,False,10,scaffold_9
22,2599001,2616000,16999,False,10,scaffold_9
23,2768001,3381000,612999,False,10,scaffold_9
24,3383001,5106000,1722999,False,10,scaffold_9
25,5112001,5238000,125999,False,10,scaffold_9
26,5239001,5298000,58999,False,10,scaffold_9
27,5300001,5490000,189999,False,10,scaffold_9
28,5493001,6331288,838287,True,10,scaffold_9
0,1,414000,413999,True,10,scaffold_10
1,415001,482000,66999,False,10,scaffold_10
2,483001,580000,96999,False,10,scaffold_10
3,603001,794000,190999,False,10,scaffold_10
4,812001,840000,27999,False,10,scaffold_10
5,888001,962000,73999,False,10,scaffold_10
6,1086001,1145000,58999,False,10,scaffold_10
7,2141001,2168000,26999,False,10,scaffold_10
8,2282001,2326000,43999,False,10,scaffold_10
9,2346001,2368000,21999,False,10,scaffold_10
10,2787001,2813000,25999,False,10,scaffold_10
11,3575001,3582000,6999,False,10,scaffold_10
12,4053001,4093000,39999,False,10,scaffold_10
13,4154001,4174000,19999,False,10,scaffold_10
14,4337001,4358000,20999,False,10,scaffold_10
15,4443001,4502000,58999,False,10,scaffold_10
16,4503001,4513000,9999,False,10,scaffold_10
17,4515001,4523000,7999,False,10,scaffold_10
18,4526001,4548000,21999,False,10,scaffold_10
19,4554001,4562000,7999,False,10,scaffold_10
20,4574001,4596000,21999,False,10,scaffold_10
21,4681001,4688000,6999,False,10,scaffold_10
22,4734001,4766000,31999,False,10,scaffold_10
23,4768001,4776000,7999,False,10,scaffold_10
24,4798001,4824000,25999,False,10,scaffold_10
25,4828001,4843000,14999,False,10,scaffold_10
26,4848001,4861000,12999,False,10,scaffold_10
0,10001,91000,80999,False,10,scaffold_11
1,132001,167000,34999,False,10,scaffold_11
2,169001,191000,21999,False,10,scaffold_11
3,213001,236000,22999,False,10,scaffold_11
4,240001,252000,11999,False,10,scaffold_11
5,296001,318000,21999,False,10,scaffold_11
6,419001,431000,11999,False,10,scaffold_11
7,648001,656000,7999,False,10,scaffold_11
8,781001,785000,3999,False,10,scaffold_11
9,1025001,1034000,8999,False,10,scaffold_11
10,1423001,1426000,2999,False,10,scaffold_11
11,1474001,1477000,2999,False,10,scaffold_11
12,2701001,2874000,172999,False,10,scaffold_11
13,3093001,3123000,29999,False,10,scaffold_11
14,3187001,3292000,104999,False,10,scaffold_11
15,3331001,3383000,51999,False,10,scaffold_11
16,3521001,3650000,128999,False,10,scaffold_11
17,3702001,3928000,225999,False,10,scaffold_11
18,4004001,4159000,154999,False,10,scaffold_11
19,4189001,4710000,520999,False,10,scaffold_11
20,4713001,4766820,53819,True,10,scaffold_11
0,1,372000,371999,True,10,scaffold_12
1,403001,856000,452999,False,10,scaffold_12
2,865001,1492000,626999,False,10,scaffold_12
3,1720001,1733000,12999,False,10,scaffold_12
4,2043001,2087000,43999,False,10,scaffold_12
5,2088001,2103000,14999,False,10,scaffold_12
6,2571001,2610000,38999,False,10,scaffold_12
0,1,340000,339999,True,11,scaffold_1
1,482001,498000,15999,False,11,scaffold_1
2,570001,643000,72999,False,11,scaffold_1
3,686001,743000,56999,False,11,scaffold_1
4,1281001,1294000,12999,False,11,scaffold_1
5,1815001,1898000,82999,False,11,scaffold_1
6,1954001,1984000,29999,False,11,scaffold_1
7,1987001,1993000,5999,False,11,scaffold_1
8,2449001,2517000,67999,False,11,scaffold_1
9,2729001,2746000,16999,False,11,scaffold_1
10,3181001,3208000,26999,False,11,scaffold_1
11,3715001,3735000,19999,False,11,scaffold_1
12,3916001,3941000,24999,False,11,scaffold_1
13,4063001,4111000,47999,False,11,scaffold_1
14,4322001,4354000,31999,False,11,scaffold_1
15,4928001,4997000,68999,False,11,scaffold_1
16,5483001,5511000,27999,False,11,scaffold_1
17,6108001,6153000,44999,False,11,scaffold_1
18,6171001,6173000,1999,False,11,scaffold_1
19,6228001,6381000,152999,False,11,scaffold_1
20,6384001,6507000,122999,False,11,scaffold_1
21,6545001,6554000,8999,False,11,scaffold_1
22,7038001,7247000,208999,False,11,scaffold_1
23,7248001,7584000,335999,False,11,scaffold_1
24,7590001,8656000,1065999,False,11,scaffold_1
25,8658001,9584000,925999,False,11,scaffold_1
26,9586001,10356000,769999,False,11,scaffold_1
27,10461001,10627000,165999,False,11,scaffold_1
28,10808001,10811000,2999,False,11,scaffold_1
29,10840001,10855000,14999,False,11,scaffold_1
30,11346001,11504000,157999,False,11,scaffold_1
31,11614001,11951000,336999,False,11,scaffold_1
32,12184001,12204000,19999,False,11,scaffold_1
33,12653001,12722000,68999,False,11,scaffold_1
34,12777001,12888000,110999,False,11,scaffold_1
35,13113001,13211000,97999,False,11,scaffold_1
36,13347001,13404000,56999,False,11,scaffold_1
37,14560001,14562000,1999,False,11,scaffold_1
38,14605001,14610000,4999,False,11,scaffold_1
0,21001,48000,26999,False,11,scaffold_2
1,93001,159000,65999,False,11,scaffold_2
2,168001,177000,8999,False,11,scaffold_2
3,302001,318000,15999,False,11,scaffold_2
4,332001,374000,41999,False,11,scaffold_2
5,2336001,2358000,21999,False,11,scaffold_2
6,2405001,2424000,18999,False,11,scaffold_2
7,2441001,2553000,111999,False,11,scaffold_2
8,2645001,2689000,43999,False,11,scaffold_2
9,2694001,2742000,47999,False,11,scaffold_2
10,2868001,2900000,31999,False,11,scaffold_2
11,2993001,3013000,19999,False,11,scaffold_2
12,3454001,3463000,8999,False,11,scaffold_2
13,3764001,3783000,18999,False,11,scaffold_2
14,4381001,4409000,27999,False,11,scaffold_2
15,4427001,4457000,29999,False,11,scaffold_2
16,4520001,4653000,132999,False,11,scaffold_2
17,4918001,4937000,18999,False,11,scaffold_2
18,5022001,5031000,8999,False,11,scaffold_2
19,5033001,5061000,27999,False,11,scaffold_2
20,5491001,5512000,20999,False,11,scaffold_2
21,5668001,5704000,35999,False,11,scaffold_2
22,6261001,6330000,68999,False,11,scaffold_2
23,6331001,6342000,10999,False,11,scaffold_2
24,6430001,6447000,16999,False,11,scaffold_2
25,6610001,6626000,15999,False,11,scaffold_2
26,7018001,7037000,18999,False,11,scaffold_2
27,7439001,7472000,32999,False,11,scaffold_2
28,7563001,7697000,133999,False,11,scaffold_2
29,7786001,7890000,103999,False,11,scaffold_2
30,7934001,7966000,31999,False,11,scaffold_2
31,7984001,8136000,151999,False,11,scaffold_2
32,8261001,8297000,35999,False,11,scaffold_2
33,8331001,8333000,1999,False,11,scaffold_2
34,8335001,8345000,9999,False,11,scaffold_2
35,8346001,8453000,106999,False,11,scaffold_2
36,8509001,8556000,46999,False,11,scaffold_2
37,11366001,11374000,7999,False,11,scaffold_2
38,11520001,11785000,264999,False,11,scaffold_2
0,1,2000,1999,True,11,scaffold_3
1,51001,55000,3999,False,11,scaffold_3
2,799001,901000,101999,False,11,scaffold_3
3,1086001,1093000,6999,False,11,scaffold_3
4,2081001,2108000,26999,False,11,scaffold_3
5,2291001,2321000,29999,False,11,scaffold_3
6,2487001,2533000,45999,False,11,scaffold_3
7,3772001,3820000,47999,False,11,scaffold_3
8,3823001,3845000,21999,False,11,scaffold_3
9,4108001,4383000,274999,False,11,scaffold_3
10,4418001,4518000,99999,False,11,scaffold_3
11,4546001,4558000,11999,False,11,scaffold_3
12,4653001,4678000,24999,False,11,scaffold_3
13,5496001,5509000,12999,False,11,scaffold_3
14,5991001,6008000,16999,False,11,scaffold_3
15,6909001,6962000,52999,False,11,scaffold_3
16,6980001,7074000,93999,False,11,scaffold_3
17,7370001,7397000,26999,False,11,scaffold_3
18,7523001,7556000,32999,False,11,scaffold_3
19,7692001,7799000,106999,False,11,scaffold_3
20,7822001,7855000,32999,False,11,scaffold_3
21,8176001,8253000,76999,False,11,scaffold_3
22,8462001,8527000,64999,False,11,scaffold_3
23,8575001,8594000,18999,False,11,scaffold_3
24,9968001,9996000,27999,False,11,scaffold_3
25,10461001,10483000,21999,False,11,scaffold_3
26,10587001,11165000,577999,False,11,scaffold_3
0,11001,13000,1999,False,11,scaffold_4
1,17001,32000,14999,False,11,scaffold_4
2,48001,88000,39999,False,11,scaffold_4
3,121001,146000,24999,False,11,scaffold_4
4,147001,151000,3999,False,11,scaffold_4
5,155001,160000,4999,False,11,scaffold_4
6,161001,215000,53999,False,11,scaffold_4
7,218001,226000,7999,False,11,scaffold_4
8,227001,266000,38999,False,11,scaffold_4
9,355001,374000,18999,False,11,scaffold_4
10,375001,380000,4999,False,11,scaffold_4
11,392001,410000,17999,False,11,scaffold_4
12,411001,425000,13999,False,11,scaffold_4
13,429001,500000,70999,False,11,scaffold_4
14,543001,596000,52999,False,11,scaffold_4
15,608001,691000,82999,False,11,scaffold_4
16,701001,717000,15999,False,11,scaffold_4
17,1113001,1136000,22999,False,11,scaffold_4
18,1138001,1178000,39999,False,11,scaffold_4
19,1199001,1226000,26999,False,11,scaffold_4
20,1235001,1246000,10999,False,11,scaffold_4
21,1248001,1253000,4999,False,11,scaffold_4
22,1271001,1279000,7999,False,11,scaffold_4
23,1283001,1319000,35999,False,11,scaffold_4
24,1370001,1595000,224999,False,11,scaffold_4
25,1721001,1817000,95999,False,11,scaffold_4
26,1824001,1999000,174999,False,11,scaffold_4
27,2016001,2065000,48999,False,11,scaffold_4
28,2247001,2279000,31999,False,11,scaffold_4
29,2284001,2340000,55999,False,11,scaffold_4
30,2480001,2533000,52999,False,11,scaffold_4
31,2599001,2635000,35999,False,11,scaffold_4
32,3334001,3633000,298999,False,11,scaffold_4
33,3676001,3760000,83999,False,11,scaffold_4
34,4943001,4985000,41999,False,11,scaffold_4
35,4987001,4999000,11999,False,11,scaffold_4
36,5477001,5506000,28999,False,11,scaffold_4
37,5514001,5620000,105999,False,11,scaffold_4
38,5669001,5784000,114999,False,11,scaffold_4
39,5786001,5824000,37999,False,11,scaffold_4
40,6145001,6191000,45999,False,11,scaffold_4
41,7036001,7062000,25999,False,11,scaffold_4
42,8849001,9699000,849999,False,11,scaffold_4
43,9700001,9845951,145950,True,11,scaffold_4
0,1,4000,3999,True,11,scaffold_5
1,191001,204000,12999,False,11,scaffold_5
2,296001,300000,3999,False,11,scaffold_5
3,318001,368000,49999,False,11,scaffold_5
4,463001,523000,59999,False,11,scaffold_5
5,933001,947000,13999,False,11,scaffold_5
6,1062001,1068000,5999,False,11,scaffold_5
7,2564001,2583000,18999,False,11,scaffold_5
8,2618001,2732000,113999,False,11,scaffold_5
9,2816001,2871000,54999,False,11,scaffold_5
10,3138001,3185000,46999,False,11,scaffold_5
11,3322001,3498000,175999,False,11,scaffold_5
12,3962001,4101000,138999,False,11,scaffold_5
13,4121001,4222000,100999,False,11,scaffold_5
14,4246001,4263000,16999,False,11,scaffold_5
15,4446001,4499000,52999,False,11,scaffold_5
16,4603001,4666000,62999,False,11,scaffold_5
17,4691001,4717000,25999,False,11,scaffold_5
18,4766001,4861000,94999,False,11,scaffold_5
19,4892001,4919000,26999,False,11,scaffold_5
20,5318001,5344000,25999,False,11,scaffold_5
21,6535001,6566000,30999,False,11,scaffold_5
22,7454001,7483000,28999,False,11,scaffold_5
23,7582001,7608000,25999,False,11,scaffold_5
24,7622001,7642000,19999,False,11,scaffold_5
25,8730001,9363000,632999,False,11,scaffold_5
0,79001,84000,4999,False,11,scaffold_6
1,86001,112000,25999,False,11,scaffold_6
2,239001,254000,14999,False,11,scaffold_6
3,257001,262000,4999,False,11,scaffold_6
4,267001,283000,15999,False,11,scaffold_6
5,569001,574000,4999,False,11,scaffold_6
6,1238001,1255000,16999,False,11,scaffold_6
7,1478001,1546000,67999,False,11,scaffold_6
8,2023001,2087000,63999,False,11,scaffold_6
9,2130001,2193000,62999,False,11,scaffold_6
10,2336001,2595000,258999,False,11,scaffold_6
11,2596001,2653000,56999,False,11,scaffold_6
12,2660001,2691000,30999,False,11,scaffold_6
13,2713001,2872000,158999,False,11,scaffold_6
14,2934001,3014000,79999,False,11,scaffold_6
15,3115001,3174000,58999,False,11,scaffold_6
16,3223001,3301000,77999,False,11,scaffold_6
17,3407001,3428000,20999,False,11,scaffold_6
18,3462001,3767000,304999,False,11,scaffold_6
19,3900001,3912000,11999,False,11,scaffold_6
20,4018001,4046000,27999,False,11,scaffold_6
21,4081001,4193000,111999,False,11,scaffold_6
22,6011001,6062000,50999,False,11,scaffold_6
23,7264001,7337000,72999,False,11,scaffold_6
24,7550001,7795000,244999,False,11,scaffold_6
25,7811001,8268281,457280,True,11,scaffold_6
0,1,7000,6999,True,11,scaffold_7
1,13001,31000,17999,False,11,scaffold_7
2,323001,341000,17999,False,11,scaffold_7
3,342001,508000,165999,False,11,scaffold_7
4,554001,563000,8999,False,11,scaffold_7
5,571001,577000,5999,False,11,scaffold_7
6,706001,736000,29999,False,11,scaffold_7
7,742001,754000,11999,False,11,scaffold_7
8,763001,818000,54999,False,11,scaffold_7
9,859001,864000,4999,False,11,scaffold_7
10,951001,963000,11999,False,11,scaffold_7
11,964001,966000,1999,False,11,scaffold_7
12,968001,980000,11999,False,11,scaffold_7
13,982001,1044000,61999,False,11,scaffold_7
14,1048001,1100000,51999,False,11,scaffold_7
15,1203001,1460000,256999,False,11,scaffold_7
16,1461001,1512000,50999,False,11,scaffold_7
17,1588001,1695000,106999,False,11,scaffold_7
18,3326001,3370000,43999,False,11,scaffold_7
19,3595001,3649000,53999,False,11,scaffold_7
20,4415001,4517000,101999,False,11,scaffold_7
21,4658001,4682000,23999,False,11,scaffold_7
22,4979001,5030000,50999,False,11,scaffold_7
23,5073001,5148000,74999,False,11,scaffold_7
24,5484001,5536000,51999,False,11,scaffold_7
25,6949001,7270000,320999,False,11,scaffold_7
26,7271001,7502216,231215,True,11,scaffold_7
0,66001,85000,18999,False,11,scaffold_8
1,2445001,2469000,23999,False,11,scaffold_8
2,2492001,2527000,34999,False,11,scaffold_8
3,2537001,2549000,11999,False,11,scaffold_8
4,2662001,2683000,20999,False,11,scaffold_8
5,2742001,2757000,14999,False,11,scaffold_8
6,2798001,2844000,45999,False,11,scaffold_8
7,3059001,3525000,465999,False,11,scaffold_8
8,3584001,3612000,27999,False,11,scaffold_8
9,3615001,3913000,297999,False,11,scaffold_8
10,4039001,4100000,60999,False,11,scaffold_8
11,5199001,5241000,41999,False,11,scaffold_8
12,6320001,6334544,14543,True,11,scaffold_8
0,109001,118000,8999,False,11,scaffold_9
1,319001,332000,12999,False,11,scaffold_9
2,367001,411000,43999,False,11,scaffold_9
3,413001,434000,20999,False,11,scaffold_9
4,502001,531000,28999,False,11,scaffold_9
5,670001,696000,25999,False,11,scaffold_9
6,732001,742000,9999,False,11,scaffold_9
7,794001,800000,5999,False,11,scaffold_9
8,816001,843000,26999,False,11,scaffold_9
9,873001,986000,112999,False,11,scaffold_9
10,988001,996000,7999,False,11,scaffold_9
11,1002001,1007000,4999,False,11,scaffold_9
12,1009001,1031000,21999,False,11,scaffold_9
13,1037001,1085000,47999,False,11,scaffold_9
14,1087001,1150000,62999,False,11,scaffold_9
15,1151001,1165000,13999,False,11,scaffold_9
16,1312001,1377000,64999,False,11,scaffold_9
17,1764001,1791000,26999,False,11,scaffold_9
18,2598001,2616000,17999,False,11,scaffold_9
19,2781001,2810000,28999,False,11,scaffold_9
20,2870001,3381000,510999,False,11,scaffold_9
21,3383001,5107000,1723999,False,11,scaffold_9
22,5112001,5238000,125999,False,11,scaffold_9
23,5239001,5298000,58999,False,11,scaffold_9
24,5300001,6331288,1031287,True,11,scaffold_9
0,1,235000,234999,True,11,scaffold_10
1,371001,405000,33999,False,11,scaffold_10
2,472001,482000,9999,False,11,scaffold_10
3,483001,576000,92999,False,11,scaffold_10
4,603001,756000,152999,False,11,scaffold_10
5,888001,917000,28999,False,11,scaffold_10
6,923001,963000,39999,False,11,scaffold_10
7,1087001,1105000,17999,False,11,scaffold_10
8,2146001,2165000,18999,False,11,scaffold_10
9,4054001,4091000,36999,False,11,scaffold_10
10,4154001,4174000,19999,False,11,scaffold_10
11,4443001,4462000,18999,False,11,scaffold_10
12,4467001,4477000,9999,False,11,scaffold_10
13,4503001,4513000,9999,False,11,scaffold_10
14,4515001,4523000,7999,False,11,scaffold_10
15,4526001,4548000,21999,False,11,scaffold_10
16,4576001,4596000,19999,False,11,scaffold_10
17,4679001,4688000,8999,False,11,scaffold_10
18,4734001,4751000,16999,False,11,scaffold_10
19,4752001,4766000,13999,False,11,scaffold_10
20,4798001,4824000,25999,False,11,scaffold_10
21,4828001,4843000,14999,False,11,scaffold_10
22,4848001,4861000,12999,False,11,scaffold_10
23,4865001,4866973,1972,True,11,scaffold_10
0,10001,33000,22999,False,11,scaffold_11
1,42001,91000,48999,False,11,scaffold_11
2,149001,167000,17999,False,11,scaffold_11
3,169001,191000,21999,False,11,scaffold_11
4,213001,235000,21999,False,11,scaffold_11
5,240001,248000,7999,False,11,scaffold_11
6,419001,431000,11999,False,11,scaffold_11
7,648001,656000,7999,False,11,scaffold_11
8,1025001,1034000,8999,False,11,scaffold_11
9,1403001,1409000,5999,False,11,scaffold_11
10,1423001,1426000,2999,False,11,scaffold_11
11,2701001,2872000,170999,False,11,scaffold_11
12,2982001,3011000,28999,False,11,scaffold_11
13,3195001,3283000,87999,False,11,scaffold_11
14,3330001,3383000,52999,False,11,scaffold_11
15,3702001,3927000,224999,False,11,scaffold_11
16,4133001,4159000,25999,False,11,scaffold_11
17,4320001,4710000,389999,False,11,scaffold_11
18,4713001,4766820,53819,True,11,scaffold_11
0,1,370000,369999,True,11,scaffold_12
1,473001,537000,63999,False,11,scaffold_12
2,582001,856000,273999,False,11,scaffold_12
3,865001,1357000,491999,False,11,scaffold_12
4,1720001,1733000,12999,False,11,scaffold_12
5,2571001,2610000,38999,False,11,scaffold_12
6,2747001,2747968,967,True,11,scaffold_12
0,1,342000,341999,True,12,scaffold_1
1,482001,498000,15999,False,12,scaffold_1
2,572001,643000,70999,False,12,scaffold_1
3,686001,743000,56999,False,12,scaffold_1
4,1281001,1292000,10999,False,12,scaffold_1
5,1954001,1964000,9999,False,12,scaffold_1
6,1965001,1984000,18999,False,12,scaffold_1
7,2449001,2467000,17999,False,12,scaffold_1
8,2477001,2514000,36999,False,12,scaffold_1
9,2729001,2746000,16999,False,12,scaffold_1
10,3180001,3208000,27999,False,12,scaffold_1
11,3715001,3733000,17999,False,12,scaffold_1
12,3916001,3941000,24999,False,12,scaffold_1
13,4062001,4111000,48999,False,12,scaffold_1
14,4322001,4354000,31999,False,12,scaffold_1
15,4928001,4984000,55999,False,12,scaffold_1
16,5484001,5511000,26999,False,12,scaffold_1
17,6108001,6153000,44999,False,12,scaffold_1
18,6154001,6176000,21999,False,12,scaffold_1
19,6228001,6381000,152999,False,12,scaffold_1
20,6384001,6507000,122999,False,12,scaffold_1
21,6545001,6554000,8999,False,12,scaffold_1
22,7038001,7247000,208999,False,12,scaffold_1
23,7248001,7583000,334999,False,12,scaffold_1
24,7590001,8656000,1065999,False,12,scaffold_1
25,8658001,9584000,925999,False,12,scaffold_1
26,9586001,10354000,767999,False,12,scaffold_1
27,10461001,10626000,164999,False,12,scaffold_1
28,10808001,10811000,2999,False,12,scaffold_1
29,10836001,10858000,21999,False,12,scaffold_1
30,11352001,11504000,151999,False,12,scaffold_1
31,11646001,11951000,304999,False,12,scaffold_1
32,12184001,12204000,19999,False,12,scaffold_1
33,12664001,12722000,57999,False,12,scaffold_1
34,12777001,12888000,110999,False,12,scaffold_1
35,13114001,13135000,20999,False,12,scaffold_1
36,13179001,13211000,31999,False,12,scaffold_1
37,13347001,13377000,29999,False,12,scaffold_1
38,14007001,14009000,1999,False,12,scaffold_1
0,22001,48000,25999,False,12,scaffold_2
1,93001,159000,65999,False,12,scaffold_2
2,168001,177000,8999,False,12,scaffold_2
3,305001,318000,12999,False,12,scaffold_2
4,332001,374000,41999,False,12,scaffold_2
5,2336001,2358000,21999,False,12,scaffold_2
6,2405001,2415000,9999,False,12,scaffold_2
7,2416001,2424000,7999,False,12,scaffold_2
8,2441001,2553000,111999,False,12,scaffold_2
9,2660001,2689000,28999,False,12,scaffold_2
10,2694001,2742000,47999,False,12,scaffold_2
11,2780001,2788000,7999,False,12,scaffold_2
12,3454001,3463000,8999,False,12,scaffold_2
13,3769001,3781000,11999,False,12,scaffold_2
14,4385001,4409000,23999,False,12,scaffold_2
15,4429001,4456000,26999,False,12,scaffold_2
16,4525001,4553000,27999,False,12,scaffold_2
17,4608001,4653000,44999,False,12,scaffold_2
18,5022001,5031000,8999,False,12,scaffold_2
19,5033001,5061000,27999,False,12,scaffold_2
20,5491001,5511000,19999,False,12,scaffold_2
21,5672001,5704000,31999,False,12,scaffold_2
22,6261001,6330000,68999,False,12,scaffold_2
23,6331001,6342000,10999,False,12,scaffold_2
24,7439001,7472000,32999,False,12,scaffold_2
25,7563001,7697000,133999,False,12,scaffold_2
26,7786001,7890000,103999,False,12,scaffold_2
27,7934001,7965000,30999,False,12,scaffold_2
28,7984001,8088000,103999,False,12,scaffold_2
29,8331001,8333000,1999,False,12,scaffold_2
30,8346001,8389000,42999,False,12,scaffold_2
31,8509001,8559000,49999,False,12,scaffold_2
32,11367001,11371000,3999,False,12,scaffold_2
33,11520001,11785000,264999,False,12,scaffold_2
0,1,2000,1999,True,12,scaffold_3
1,51001,55000,3999,False,12,scaffold_3
2,102001,104000,1999,False,12,scaffold_3
3,800001,900000,99999,False,12,scaffold_3
4,2084001,2108000,23999,False,12,scaffold_3
5,2291001,2321000,29999,False,12,scaffold_3
6,2510001,2533000,22999,False,12,scaffold_3
7,4149001,4403000,253999,False,12,scaffold_3
8,4410001,4518000,107999,False,12,scaffold_3
9,4547001,4558000,10999,False,12,scaffold_3
10,4654001,4678000,23999,False,12,scaffold_3
11,6910001,6962000,51999,False,12,scaffold_3
12,6979001,7074000,94999,False,12,scaffold_3
13,7540001,7556000,15999,False,12,scaffold_3
14,7692001,7796000,103999,False,12,scaffold_3
15,7823001,7838000,14999,False,12,scaffold_3
16,8177001,8253000,75999,False,12,scaffold_3
17,8462001,8527000,64999,False,12,scaffold_3
18,8575001,8594000,18999,False,12,scaffold_3
19,9968001,9996000,27999,False,12,scaffold_3
20,10461001,10484000,22999,False,12,scaffold_3
21,10587001,11163000,575999,False,12,scaffold_3
0,17001,32000,14999,False,12,scaffold_4
1,49001,88000,38999,False,12,scaffold_4
2,155001,215000,59999,False,12,scaffold_4
3,217001,226000,8999,False,12,scaffold_4
4,227001,266000,38999,False,12,scaffold_4
5,294001,305000,10999,False,12,scaffold_4
6,336001,344000,7999,False,12,scaffold_4
7,355001,374000,18999,False,12,scaffold_4
8,375001,380000,4999,False,12,scaffold_4
9,412001,425000,12999,False,12,scaffold_4
10,429001,439000,9999,False,12,scaffold_4
11,450001,505000,54999,False,12,scaffold_4
12,545001,592000,46999,False,12,scaffold_4
13,593001,606000,12999,False,12,scaffold_4
14,608001,661000,52999,False,12,scaffold_4
15,670001,691000,20999,False,12,scaffold_4
16,701001,713000,11999,False,12,scaffold_4
17,1121001,1136000,14999,False,12,scaffold_4
18,1137001,1179000,41999,False,12,scaffold_4
19,1199001,1208000,8999,False,12,scaffold_4
20,1210001,1226000,15999,False,12,scaffold_4
21,1235001,1246000,10999,False,12,scaffold_4
22,1248001,1253000,4999,False,12,scaffold_4
23,1254001,1262000,7999,False,12,scaffold_4
24,1265001,1279000,13999,False,12,scaffold_4
25,1283001,1337000,53999,False,12,scaffold_4
26,1372001,1591000,218999,False,12,scaffold_4
27,1749001,1817000,67999,False,12,scaffold_4
28,1906001,1957000,50999,False,12,scaffold_4
29,1958001,1971000,12999,False,12,scaffold_4
30,2037001,2065000,27999,False,12,scaffold_4
31,2211001,2218000,6999,False,12,scaffold_4
32,2284001,2340000,55999,False,12,scaffold_4
33,2480001,2543000,62999,False,12,scaffold_4
34,2552001,2581000,28999,False,12,scaffold_4
35,3336001,3632000,295999,False,12,scaffold_4
36,3676001,3760000,83999,False,12,scaffold_4
37,4944001,4984000,39999,False,12,scaffold_4
38,5477001,5506000,28999,False,12,scaffold_4
39,5514001,5620000,105999,False,12,scaffold_4
40,5669001,5784000,114999,False,12,scaffold_4
41,6802001,6817000,14999,False,12,scaffold_4
42,7037001,7062000,24999,False,12,scaffold_4
43,8849001,9699000,849999,False,12,scaffold_4
44,9700001,9845951,145950,True,12,scaffold_4
0,191001,204000,12999,False,12,scaffold_5
1,296001,299000,2999,False,12,scaffold_5
2,318001,326000,7999,False,12,scaffold_5
3,327001,368000,40999,False,12,scaffold_5
4,469001,478000,8999,False,12,scaffold_5
5,509001,522000,12999,False,12,scaffold_5
6,933001,947000,13999,False,12,scaffold_5
7,2565001,2581000,15999,False,12,scaffold_5
8,2619001,2732000,112999,False,12,scaffold_5
9,2816001,2871000,54999,False,12,scaffold_5
10,3167001,3184000,16999,False,12,scaffold_5
11,3322001,3438000,115999,False,12,scaffold_5
12,3451001,3497000,45999,False,12,scaffold_5
13,3962001,4101000,138999,False,12,scaffold_5
14,4121001,4219000,97999,False,12,scaffold_5
15,4246001,4262000,15999,False,12,scaffold_5
16,4446001,4483000,36999,False,12,scaffold_5
17,4603001,4650000,46999,False,12,scaffold_5
18,4691001,4717000,25999,False,12,scaffold_5
19,4816001,4861000,44999,False,12,scaffold_5
20,4904001,4917000,12999,False,12,scaffold_5
21,5318001,5346000,27999,False,12,scaffold_5
22,7097001,7100000,2999,False,12,scaffold_5
23,7373001,7386000,12999,False,12,scaffold_5
24,7583001,7608000,24999,False,12,scaffold_5
25,7622001,7641000,18999,False,12,scaffold_5
26,8730001,9364176,634175,True,12,scaffold_5
0,79001,84000,4999,False,12,scaffold_6
1,86001,112000,25999,False,12,scaffold_6
2,239001,253000,13999,False,12,scaffold_6
3,267001,278000,10999,False,12,scaffold_6
4,1240001,1255000,14999,False,12,scaffold_6
5,1479001,1546000,66999,False,12,scaffold_6
6,2023001,2086000,62999,False,12,scaffold_6
7,2131001,2169000,37999,False,12,scaffold_6
8,2371001,2595000,223999,False,12,scaffold_6
9,2596001,2653000,56999,False,12,scaffold_6
10,2660001,2691000,30999,False,12,scaffold_6
11,2731001,2851000,119999,False,12,scaffold_6
12,2933001,3014000,80999,False,12,scaffold_6
13,3115001,3149000,33999,False,12,scaffold_6
14,3224001,3301000,76999,False,12,scaffold_6
15,3408001,3427000,18999,False,12,scaffold_6
16,3462001,3766000,303999,False,12,scaffold_6
17,3901001,3912000,10999,False,12,scaffold_6
18,4019001,4042000,22999,False,12,scaffold_6
19,4086001,4195000,108999,False,12,scaffold_6
20,6011001,6060000,48999,False,12,scaffold_6
21,7269001,7337000,67999,False,12,scaffold_6
22,7549001,7796000,246999,False,12,scaffold_6
23,7811001,8268281,457280,True,12,scaffold_6
0,1,7000,6999,True,12,scaffold_7
1,13001,34000,20999,False,12,scaffold_7
2,323001,340000,16999,False,12,scaffold_7
3,342001,508000,165999,False,12,scaffold_7
4,554001,563000,8999,False,12,scaffold_7
5,571001,577000,5999,False,12,scaffold_7
6,706001,736000,29999,False,12,scaffold_7
7,749001,753000,3999,False,12,scaffold_7
8,764001,809000,44999,False,12,scaffold_7
9,859001,864000,4999,False,12,scaffold_7
10,967001,980000,12999,False,12,scaffold_7
11,982001,1044000,61999,False,12,scaffold_7
12,1191001,1261000,69999,False,12,scaffold_7
13,1262001,1459000,196999,False,12,scaffold_7
14,1461001,1512000,50999,False,12,scaffold_7
15,1588001,1688000,99999,False,12,scaffold_7
16,3326001,3369000,42999,False,12,scaffold_7
17,3596001,3649000,52999,False,12,scaffold_7
18,4416001,4535000,118999,False,12,scaffold_7
19,4658001,4727000,68999,False,12,scaffold_7
20,4979001,5030000,50999,False,12,scaffold_7
21,5077001,5112000,34999,False,12,scaffold_7
22,5498001,5513000,14999,False,12,scaffold_7
23,5609001,5626000,16999,False,12,scaffold_7
24,6954001,7270000,315999,False,12,scaffold_7
25,7271001,7502216,231215,True,12,scaffold_7
0,66001,85000,18999,False,12,scaffold_8
1,722001,724000,1999,False,12,scaffold_8
2,2446001,2469000,22999,False,12,scaffold_8
3,2492001,2514000,21999,False,12,scaffold_8
4,2661001,2683000,21999,False,12,scaffold_8
5,2745001,2756000,10999,False,12,scaffold_8
6,3060001,3525000,464999,False,12,scaffold_8
7,3584001,3612000,27999,False,12,scaffold_8
8,3615001,3913000,297999,False,12,scaffold_8
9,5125001,5135000,9999,False,12,scaffold_8
10,5200001,5241000,40999,False,12,scaffold_8
11,6330001,6334544,4543,True,12,scaffold_8
0,1001,17000,15999,False,12,scaffold_9
1,109001,117000,7999,False,12,scaffold_9
2,121001,138000,16999,False,12,scaffold_9
3,144001,148000,3999,False,12,scaffold_9
4,303001,315000,11999,False,12,scaffold_9
5,319001,332000,12999,False,12,scaffold_9
6,367001,411000,43999,False,12,scaffold_9
7,413001,434000,20999,False,12,scaffold_9
8,504001,531000,26999,False,12,scaffold_9
9,671001,696000,24999,False,12,scaffold_9
10,732001,742000,9999,False,12,scaffold_9
11,794001,803000,8999,False,12,scaffold_9
12,815001,842000,26999,False,12,scaffold_9
13,850001,861000,10999,False,12,scaffold_9
14,873001,986000,112999,False,12,scaffold_9
15,988001,995000,6999,False,12,scaffold_9
16,1001001,1006000,4999,False,12,scaffold_9
17,1010001,1031000,20999,False,12,scaffold_9
18,1035001,1085000,49999,False,12,scaffold_9
19,1087001,1150000,62999,False,12,scaffold_9
20,1151001,1160000,8999,False,12,scaffold_9
21,1312001,1377000,64999,False,12,scaffold_9
22,1767001,1790000,22999,False,12,scaffold_9
23,2601001,2616000,14999,False,12,scaffold_9
24,2871001,3381000,509999,False,12,scaffold_9
25,3383001,5100000,1716999,False,12,scaffold_9
26,5101001,5107000,5999,False,12,scaffold_9
27,5112001,5115000,2999,False,12,scaffold_9
28,5116001,5238000,121999,False,12,scaffold_9
29,5239001,5298000,58999,False,12,scaffold_9
30,5300001,5490000,189999,False,12,scaffold_9
31,5491001,6331288,840287,True,12,scaffold_9
0,1,199000,198999,True,12,scaffold_10
1,375001,414000,38999,False,12,scaffold_10
2,472001,482000,9999,False,12,scaffold_10
3,483001,576000,92999,False,12,scaffold_10
4,603001,748000,144999,False,12,scaffold_10
5,888001,916000,27999,False,12,scaffold_10
6,924001,962000,37999,False,12,scaffold_10
7,1087001,1105000,17999,False,12,scaffold_10
8,2347001,2364000,16999,False,12,scaffold_10
9,3264001,3268000,3999,False,12,scaffold_10
10,4054001,4091000,36999,False,12,scaffold_10
11,4154001,4174000,19999,False,12,scaffold_10
12,4467001,4476000,8999,False,12,scaffold_10
13,4515001,4523000,7999,False,12,scaffold_10
14,4526001,4548000,21999,False,12,scaffold_10
15,4576001,4596000,19999,False,12,scaffold_10
16,4679001,4688000,8999,False,12,scaffold_10
17,4734001,4776000,41999,False,12,scaffold_10
18,4798001,4824000,25999,False,12,scaffold_10
19,4827001,4843000,15999,False,12,scaffold_10
20,4848001,4861000,12999,False,12,scaffold_10
21,4865001,4866973,1972,True,12,scaffold_10
0,10001,34000,23999,False,12,scaffold_11
1,40001,91000,50999,False,12,scaffold_11
2,149001,167000,17999,False,12,scaffold_11
3,169001,191000,21999,False,12,scaffold_11
4,213001,236000,22999,False,12,scaffold_11
5,419001,431000,11999,False,12,scaffold_11
6,648001,656000,7999,False,12,scaffold_11
7,921001,927000,5999,False,12,scaffold_11
8,1025001,1034000,8999,False,12,scaffold_11
9,1423001,1426000,2999,False,12,scaffold_11
10,2712001,2873000,160999,False,12,scaffold_11
11,3190001,3255000,64999,False,12,scaffold_11
12,3331001,3382000,50999,False,12,scaffold_11
13,3702001,3926000,223999,False,12,scaffold_11
14,4321001,4710000,388999,False,12,scaffold_11
15,4712001,4766820,54819,True,12,scaffold_11
0,1,240000,239999,True,12,scaffold_12
1,289001,369000,79999,False,12,scaffold_12
2,474001,537000,62999,False,12,scaffold_12
3,582001,730000,147999,False,12,scaffold_12
4,739001,856000,116999,False,12,scaffold_12
5,865001,1354000,488999,False,12,scaffold_12
6,1720001,1733000,12999,False,12,scaffold_12
7,2571001,2610000,38999,False,12,scaffold_12
0,1,445000,444999,True,13,scaffold_1
1,482001,500000,17999,False,13,scaffold_1
2,507001,524000,16999,False,13,scaffold_1
3,525001,643000,117999,False,13,scaffold_1
4,686001,749000,62999,False,13,scaffold_1
5,794001,825000,30999,False,13,scaffold_1
6,872001,941000,68999,False,13,scaffold_1
7,1169001,1195000,25999,False,13,scaffold_1
8,1281001,1292000,10999,False,13,scaffold_1
9,1553001,1579000,25999,False,13,scaffold_1
10,1608001,1660000,51999,False,13,scaffold_1
11,1661001,1695000,33999,False,13,scaffold_1
12,1811001,1964000,152999,False,13,scaffold_1
13,1965001,1984000,18999,False,13,scaffold_1
14,1988001,2017000,28999,False,13,scaffold_1
15,2345001,2415000,69999,False,13,scaffold_1
16,2449001,2535000,85999,False,13,scaffold_1
17,2563001,2582000,18999,False,13,scaffold_1
18,2725001,2746000,20999,False,13,scaffold_1
19,2960001,3023000,62999,False,13,scaffold_1
20,3172001,3240000,67999,False,13,scaffold_1
21,3442001,3662000,219999,False,13,scaffold_1
22,3702001,3941000,238999,False,13,scaffold_1
23,3942001,4112000,169999,False,13,scaffold_1
24,4307001,4518000,210999,False,13,scaffold_1
25,4642001,4664000,21999,False,13,scaffold_1
26,4717001,4790000,72999,False,13,scaffold_1
27,4796001,4898000,101999,False,13,scaffold_1
28,4906001,5026000,119999,False,13,scaffold_1
29,5087001,5118000,30999,False,13,scaffold_1
30,5165001,5194000,28999,False,13,scaffold_1
31,5437001,5451000,13999,False,13,scaffold_1
32,5481001,5521000,39999,False,13,scaffold_1
33,5534001,5595000,60999,False,13,scaffold_1
34,5858001,5873000,14999,False,13,scaffold_1
35,6108001,6153000,44999,False,13,scaffold_1
36,6154001,6178000,23999,False,13,scaffold_1
37,6202001,6381000,178999,False,13,scaffold_1
38,6384001,6575000,190999,False,13,scaffold_1
39,6809001,6862000,52999,False,13,scaffold_1
40,6936001,6952000,15999,False,13,scaffold_1
41,7038001,7247000,208999,False,13,scaffold_1
42,7248001,7589000,340999,False,13,scaffold_1
43,7590001,8656000,1065999,False,13,scaffold_1
44,8658001,9584000,925999,False,13,scaffold_1
45,9586001,10369000,782999,False,13,scaffold_1
46,10442001,10638000,195999,False,13,scaffold_1
47,10737001,10767000,29999,False,13,scaffold_1
48,10835001,10857000,21999,False,13,scaffold_1
49,10916001,10965000,48999,False,13,scaffold_1
50,11013001,11062000,48999,False,13,scaffold_1
51,11132001,11222000,89999,False,13,scaffold_1
52,11270001,11957000,686999,False,13,scaffold_1
53,12147001,12167000,19999,False,13,scaffold_1
54,12184001,12243000,58999,False,13,scaffold_1
55,12329001,12367000,37999,False,13,scaffold_1
56,12425001,12467000,41999,False,13,scaffold_1
57,12485001,12586000,100999,False,13,scaffold_1
58,12624001,12888000,263999,False,13,scaffold_1
59,12963001,13051000,87999,False,13,scaffold_1
60,13095001,13216000,120999,False,13,scaffold_1
61,13322001,13448000,125999,False,13,scaffold_1
62,13557001,13586000,28999,False,13,scaffold_1
63,13668001,13710000,41999,False,13,scaffold_1
64,13790001,13845000,54999,False,13,scaffold_1
65,13847001,13853000,5999,False,13,scaffold_1
66,13917001,13927000,9999,False,13,scaffold_1
67,13958001,13972000,13999,False,13,scaffold_1
68,14285001,14310000,24999,False,13,scaffold_1
69,14649001,14664000,14999,False,13,scaffold_1
0,1,48000,47999,True,13,scaffold_2
1,93001,159000,65999,False,13,scaffold_2
2,168001,176000,7999,False,13,scaffold_2
3,302001,318000,15999,False,13,scaffold_2
4,332001,374000,41999,False,13,scaffold_2
5,459001,486000,26999,False,13,scaffold_2
6,1355001,1415000,59999,False,13,scaffold_2
7,1525001,1553000,27999,False,13,scaffold_2
8,1595001,1613000,17999,False,13,scaffold_2
9,1877001,1897000,19999,False,13,scaffold_2
10,2085001,2133000,47999,False,13,scaffold_2
11,2336001,2609000,272999,False,13,scaffold_2
12,2626001,2639000,12999,False,13,scaffold_2
13,2660001,2689000,28999,False,13,scaffold_2
14,2694001,2746000,51999,False,13,scaffold_2
15,2766001,2788000,21999,False,13,scaffold_2
16,2790001,2856000,65999,False,13,scaffold_2
17,2877001,3021000,143999,False,13,scaffold_2
18,3025001,3050000,24999,False,13,scaffold_2
19,3174001,3187000,12999,False,13,scaffold_2
20,3270001,3284000,13999,False,13,scaffold_2
21,3286001,3390000,103999,False,13,scaffold_2
22,3450001,3548000,97999,False,13,scaffold_2
23,3616001,3711000,94999,False,13,scaffold_2
24,3753001,3791000,37999,False,13,scaffold_2
25,3891001,3931000,39999,False,13,scaffold_2
26,4242001,4409000,166999,False,13,scaffold_2
27,4425001,4462000,36999,False,13,scaffold_2
28,4473001,4790000,316999,False,13,scaffold_2
29,4793001,4814000,20999,False,13,scaffold_2
30,4917001,4961000,43999,False,13,scaffold_2
31,5018001,5104000,85999,False,13,scaffold_2
32,5174001,5222000,47999,False,13,scaffold_2
33,5349001,5563000,213999,False,13,scaffold_2
34,5608001,5759000,150999,False,13,scaffold_2
35,5840001,5888000,47999,False,13,scaffold_2
36,5908001,6059000,150999,False,13,scaffold_2
37,6107001,6204000,96999,False,13,scaffold_2
38,6244001,6330000,85999,False,13,scaffold_2
39,6331001,6350000,18999,False,13,scaffold_2
40,6366001,6467000,100999,False,13,scaffold_2
41,6577001,6628000,50999,False,13,scaffold_2
42,6703001,6726000,22999,False,13,scaffold_2
43,6805001,6862000,56999,False,13,scaffold_2
44,6939001,7047000,107999,False,13,scaffold_2
45,7049001,7097000,47999,False,13,scaffold_2
46,7109001,7227000,117999,False,13,scaffold_2
47,7350001,7472000,121999,False,13,scaffold_2
48,7549001,7561000,11999,False,13,scaffold_2
49,7563001,7707000,143999,False,13,scaffold_2
50,7719001,7919000,199999,False,13,scaffold_2
51,7933001,8314000,380999,False,13,scaffold_2
52,8334001,8345000,10999,False,13,scaffold_2
53,8346001,8494000,147999,False,13,scaffold_2
54,8495001,8564000,68999,False,13,scaffold_2
55,9009001,9050000,40999,False,13,scaffold_2
56,9138001,9175000,36999,False,13,scaffold_2
57,9235001,9382000,146999,False,13,scaffold_2
58,9610001,9620000,9999,False,13,scaffold_2
59,9836001,9902000,65999,False,13,scaffold_2
60,9928001,9944000,15999,False,13,scaffold_2
61,10017001,10046000,28999,False,13,scaffold_2
62,10214001,10242000,27999,False,13,scaffold_2
63,10402001,10494000,91999,False,13,scaffold_2
64,10995001,10998000,2999,False,13,scaffold_2
65,11025001,11071000,45999,False,13,scaffold_2
66,11352001,11425000,72999,False,13,scaffold_2
67,11520001,11786000,265999,False,13,scaffold_2
68,11797001,11802476,5475,True,13,scaffold_2
0,218001,230000,11999,False,13,scaffold_3
1,373001,383000,9999,False,13,scaffold_3
2,618001,646000,27999,False,13,scaffold_3
3,798001,902000,103999,False,13,scaffold_3
4,960001,965000,4999,False,13,scaffold_3
5,1163001,1186000,22999,False,13,scaffold_3
6,1584001,1619000,34999,False,13,scaffold_3
7,1691001,1717000,25999,False,13,scaffold_3
8,1903001,1918000,14999,False,13,scaffold_3
9,1957001,1974000,16999,False,13,scaffold_3
10,2007001,2108000,100999,False,13,scaffold_3
11,2109001,2147000,37999,False,13,scaffold_3
12,2208001,2231000,22999,False,13,scaffold_3
13,2287001,2336000,48999,False,13,scaffold_3
14,2400001,2428000,27999,False,13,scaffold_3
15,2433001,2531000,97999,False,13,scaffold_3
16,2649001,2761000,111999,False,13,scaffold_3
17,2892001,2938000,45999,False,13,scaffold_3
18,3051001,3062000,10999,False,13,scaffold_3
19,3067001,3279000,211999,False,13,scaffold_3
20,3497001,3515000,17999,False,13,scaffold_3
21,3559001,3891000,331999,False,13,scaffold_3
22,3960001,4404000,443999,False,13,scaffold_3
23,4410001,4519000,108999,False,13,scaffold_3
24,4547001,4558000,10999,False,13,scaffold_3
25,4646001,4684000,37999,False,13,scaffold_3
26,4854001,4926000,71999,False,13,scaffold_3
27,4998001,5126000,127999,False,13,scaffold_3
28,5138001,5273000,134999,False,13,scaffold_3
29,5350001,5449000,98999,False,13,scaffold_3
30,5484001,5509000,24999,False,13,scaffold_3
31,5511001,5530000,18999,False,13,scaffold_3
32,5590001,5674000,83999,False,13,scaffold_3
33,5701001,5731000,29999,False,13,scaffold_3
34,5772001,6033000,260999,False,13,scaffold_3
35,6741001,6807000,65999,False,13,scaffold_3
36,6885001,7157000,271999,False,13,scaffold_3
37,7230001,7323000,92999,False,13,scaffold_3
38,7333001,7445000,111999,False,13,scaffold_3
39,7449001,7460000,10999,False,13,scaffold_3
40,7501001,7562000,60999,False,13,scaffold_3
41,7575001,7622000,46999,False,13,scaffold_3
42,7675001,7857000,181999,False,13,scaffold_3
43,8028001,8108000,79999,False,13,scaffold_3
44,8183001,8280000,96999,False,13,scaffold_3
45,8378001,8449000,70999,False,13,scaffold_3
46,8462001,8628000,165999,False,13,scaffold_3
47,8758001,8770000,11999,False,13,scaffold_3
48,8961001,9081000,119999,False,13,scaffold_3
49,9106001,9169000,62999,False,13,scaffold_3
50,9199001,9233000,33999,False,13,scaffold_3
51,9644001,9687000,42999,False,13,scaffold_3
52,9703001,9720000,16999,False,13,scaffold_3
53,9968001,9996000,27999,False,13,scaffold_3
54,10042001,10090000,47999,False,13,scaffold_3
55,10461001,10485000,23999,False,13,scaffold_3
56,10552001,10571000,18999,False,13,scaffold_3
57,10574001,11170000,595999,False,13,scaffold_3
58,11176001,11182071,6070,True,13,scaffold_3
0,17001,32000,14999,False,13,scaffold_4
1,48001,88000,39999,False,13,scaffold_4
2,120001,146000,25999,False,13,scaffold_4
3,147001,151000,3999,False,13,scaffold_4
4,155001,215000,59999,False,13,scaffold_4
5,217001,226000,8999,False,13,scaffold_4
6,227001,266000,38999,False,13,scaffold_4
7,318001,344000,25999,False,13,scaffold_4
8,355001,374000,18999,False,13,scaffold_4
9,375001,380000,4999,False,13,scaffold_4
10,390001,402000,11999,False,13,scaffold_4
11,404001,425000,20999,False,13,scaffold_4
12,429001,503000,73999,False,13,scaffold_4
13,541001,599000,57999,False,13,scaffold_4
14,600001,606000,5999,False,13,scaffold_4
15,608001,691000,82999,False,13,scaffold_4
16,1087001,1097000,9999,False,13,scaffold_4
17,1099001,1108000,8999,False,13,scaffold_4
18,1121001,1136000,14999,False,13,scaffold_4
19,1137001,1198000,60999,False,13,scaffold_4
20,1199001,1226000,26999,False,13,scaffold_4
21,1229001,1253000,23999,False,13,scaffold_4
22,1254001,1259000,4999,False,13,scaffold_4
23,1268001,1279000,10999,False,13,scaffold_4
24,1283001,1605000,321999,False,13,scaffold_4
25,1613001,2118000,504999,False,13,scaffold_4
26,2119001,2206000,86999,False,13,scaffold_4
27,2207001,2279000,71999,False,13,scaffold_4
28,2284001,2460000,175999,False,13,scaffold_4
29,2477001,2816000,338999,False,13,scaffold_4
30,2892001,3146000,253999,False,13,scaffold_4
31,3155001,3778000,622999,False,13,scaffold_4
32,3971001,3991000,19999,False,13,scaffold_4
33,3992001,4045000,52999,False,13,scaffold_4
34,4058001,4106000,47999,False,13,scaffold_4
35,4178001,4197000,18999,False,13,scaffold_4
36,4252001,4305000,52999,False,13,scaffold_4
37,4900001,5093000,192999,False,13,scaffold_4
38,5171001,5224000,52999,False,13,scaffold_4
39,5289001,5506000,216999,False,13,scaffold_4
40,5516001,5784000,267999,False,13,scaffold_4
41,5786001,6113000,326999,False,13,scaffold_4
42,6145001,6197000,51999,False,13,scaffold_4
43,6198001,6436000,237999,False,13,scaffold_4
44,6498001,6537000,38999,False,13,scaffold_4
45,6620001,6650000,29999,False,13,scaffold_4
46,6705001,6817000,111999,False,13,scaffold_4
47,6897001,6924000,26999,False,13,scaffold_4
48,6950001,6995000,44999,False,13,scaffold_4
49,7036001,7175000,138999,False,13,scaffold_4
50,7192001,7400000,207999,False,13,scaffold_4
51,7629001,7665000,35999,False,13,scaffold_4
52,7853001,7917000,63999,False,13,scaffold_4
53,7975001,8015000,39999,False,13,scaffold_4
54,8065001,8079000,13999,False,13,scaffold_4
55,8844001,9699000,854999,False,13,scaffold_4
56,9700001,9845951,145950,True,13,scaffold_4
0,151001,165000,13999,False,13,scaffold_5
1,318001,326000,7999,False,13,scaffold_5
2,327001,388000,60999,False,13,scaffold_5
3,463001,524000,60999,False,13,scaffold_5
4,669001,696000,26999,False,13,scaffold_5
5,932001,954000,21999,False,13,scaffold_5
6,1355001,1387000,31999,False,13,scaffold_5
7,1663001,1683000,19999,False,13,scaffold_5
8,2257001,2279000,21999,False,13,scaffold_5
9,2473001,2494000,20999,False,13,scaffold_5
10,2508001,2515000,6999,False,13,scaffold_5
11,2516001,2894000,377999,False,13,scaffold_5
12,3133001,3518000,384999,False,13,scaffold_5
13,3532001,3557000,24999,False,13,scaffold_5
14,3616001,3659000,42999,False,13,scaffold_5
15,3835001,3934000,98999,False,13,scaffold_5
16,3962001,4074000,111999,False,13,scaffold_5
17,4075001,4101000,25999,False,13,scaffold_5
18,4119001,4392000,272999,False,13,scaffold_5
19,4446001,5105000,658999,False,13,scaffold_5
20,5197001,5312000,114999,False,13,scaffold_5
21,5314001,5344000,29999,False,13,scaffold_5
22,5496001,5536000,39999,False,13,scaffold_5
23,5721001,5738000,16999,False,13,scaffold_5
24,6392001,6671000,278999,False,13,scaffold_5
25,6879001,6933000,53999,False,13,scaffold_5
26,7050001,7084000,33999,False,13,scaffold_5
27,7167001,7328000,160999,False,13,scaffold_5
28,7335001,7386000,50999,False,13,scaffold_5
29,7406001,7449000,42999,False,13,scaffold_5
30,7454001,7512000,57999,False,13,scaffold_5
31,7523001,7619000,95999,False,13,scaffold_5
32,7620001,7748000,127999,False,13,scaffold_5
33,7947001,7976000,28999,False,13,scaffold_5
34,8413001,8465000,51999,False,13,scaffold_5
35,8550001,8617000,66999,False,13,scaffold_5
36,8632001,8688000,55999,False,13,scaffold_5
37,8702001,9364176,662175,True,13,scaffold_5
0,43001,75000,31999,False,13,scaffold_6
1,78001,84000,5999,False,13,scaffold_6
2,86001,115000,28999,False,13,scaffold_6
3,162001,208000,45999,False,13,scaffold_6
4,240001,254000,13999,False,13,scaffold_6
5,908001,1038000,129999,False,13,scaffold_6
6,1120001,1226000,105999,False,13,scaffold_6
7,1229001,1265000,35999,False,13,scaffold_6
8,1284001,1311000,26999,False,13,scaffold_6
9,1430001,1631000,200999,False,13,scaffold_6
10,1657001,1753000,95999,False,13,scaffold_6
11,1803001,1906000,102999,False,13,scaffold_6
12,1907001,1935000,27999,False,13,scaffold_6
13,1976001,2019000,42999,False,13,scaffold_6
14,2023001,2105000,81999,False,13,scaffold_6
15,2123001,2213000,89999,False,13,scaffold_6
16,2236001,2283000,46999,False,13,scaffold_6
17,2316001,2595000,278999,False,13,scaffold_6
18,2596001,2872000,275999,False,13,scaffold_6
19,2927001,3210000,282999,False,13,scaffold_6
20,3223001,3350000,126999,False,13,scaffold_6
21,3351001,3806000,454999,False,13,scaffold_6
22,3810001,3928000,117999,False,13,scaffold_6
23,3966001,4195000,228999,False,13,scaffold_6
24,4700001,4727000,26999,False,13,scaffold_6
25,4836001,4916000,79999,False,13,scaffold_6
26,4925001,5005000,79999,False,13,scaffold_6
27,5678001,5742000,63999,False,13,scaffold_6
28,5862001,5972000,109999,False,13,scaffold_6
29,6004001,6095000,90999,False,13,scaffold_6
30,6124001,6190000,65999,False,13,scaffold_6
31,6766001,6804000,37999,False,13,scaffold_6
32,6834001,6865000,30999,False,13,scaffold_6
33,6911001,6953000,41999,False,13,scaffold_6
34,6974001,7009000,34999,False,13,scaffold_6
35,7181001,7339000,157999,False,13,scaffold_6
36,7389001,7436000,46999,False,13,scaffold_6
37,7531001,8268281,737280,True,13,scaffold_6
0,323001,340000,16999,False,13,scaffold_7
1,342001,508000,165999,False,13,scaffold_7
2,571001,577000,5999,False,13,scaffold_7
3,706001,736000,29999,False,13,scaffold_7
4,740001,753000,12999,False,13,scaffold_7
5,764001,809000,44999,False,13,scaffold_7
6,810001,829000,18999,False,13,scaffold_7
7,830001,843000,12999,False,13,scaffold_7
8,859001,864000,4999,False,13,scaffold_7
9,868001,872000,3999,False,13,scaffold_7
10,875001,948000,72999,False,13,scaffold_7
11,982001,1032000,49999,False,13,scaffold_7
12,1034001,1044000,9999,False,13,scaffold_7
13,1048001,1099000,50999,False,13,scaffold_7
14,1194001,1460000,265999,False,13,scaffold_7
15,1461001,1512000,50999,False,13,scaffold_7
16,1588001,1721000,132999,False,13,scaffold_7
17,1728001,1782000,53999,False,13,scaffold_7
18,1848001,1894000,45999,False,13,scaffold_7
19,1974001,2013000,38999,False,13,scaffold_7
20,2427001,2467000,39999,False,13,scaffold_7
21,2538001,2571000,32999,False,13,scaffold_7
22,2636001,2710000,73999,False,13,scaffold_7
23,2912001,2958000,45999,False,13,scaffold_7
24,3005001,3024000,18999,False,13,scaffold_7
25,3088001,3187000,98999,False,13,scaffold_7
26,3219001,3271000,51999,False,13,scaffold_7
27,3297001,3404000,106999,False,13,scaffold_7
28,3490001,3886000,395999,False,13,scaffold_7
29,3948001,3978000,29999,False,13,scaffold_7
30,4024001,4068000,43999,False,13,scaffold_7
31,4322001,4373000,50999,False,13,scaffold_7
32,4412001,4580000,167999,False,13,scaffold_7
33,4657001,4912000,254999,False,13,scaffold_7
34,4979001,5168000,188999,False,13,scaffold_7
35,5402001,5433000,30999,False,13,scaffold_7
36,5470001,5645000,174999,False,13,scaffold_7
37,5666001,5680000,13999,False,13,scaffold_7
38,6052001,6251000,198999,False,13,scaffold_7
39,6335001,6413000,77999,False,13,scaffold_7
40,6557001,6798000,240999,False,13,scaffold_7
41,6944001,7502216,558215,True,13,scaffold_7
0,1,6000,5999,True,13,scaffold_8
1,67001,87000,19999,False,13,scaffold_8
2,306001,309000,2999,False,13,scaffold_8
3,789001,792000,2999,False,13,scaffold_8
4,1367001,1420000,52999,False,13,scaffold_8
5,1859001,1931000,71999,False,13,scaffold_8
6,2071001,2155000,83999,False,13,scaffold_8
7,2299001,2390000,90999,False,13,scaffold_8
8,2413001,2597000,183999,False,13,scaffold_8
9,2650001,2844000,193999,False,13,scaffold_8
10,2846001,2932000,85999,False,13,scaffold_8
11,2950001,3125000,174999,False,13,scaffold_8
12,3126001,3612000,485999,False,13,scaffold_8
13,3615001,3949000,333999,False,13,scaffold_8
14,3997001,4149000,151999,False,13,scaffold_8
15,4171001,4268000,96999,False,13,scaffold_8
16,4390001,4431000,40999,False,13,scaffold_8
17,4603001,4679000,75999,False,13,scaffold_8
18,4718001,4775000,56999,False,13,scaffold_8
19,4798001,4875000,76999,False,13,scaffold_8
20,4892001,4927000,34999,False,13,scaffold_8
21,4983001,5041000,57999,False,13,scaffold_8
22,5076001,5241000,164999,False,13,scaffold_8
23,5524001,5597000,72999,False,13,scaffold_8
24,5650001,5710000,59999,False,13,scaffold_8
25,5727001,5804000,76999,False,13,scaffold_8
26,5841001,5943000,101999,False,13,scaffold_8
27,6015001,6113000,97999,False,13,scaffold_8
28,6218001,6334544,116543,True,13,scaffold_8
0,1,22000,21999,True,13,scaffold_9
1,109001,117000,7999,False,13,scaffold_9
2,121001,140000,18999,False,13,scaffold_9
3,356001,411000,54999,False,13,scaffold_9
4,413001,434000,20999,False,13,scaffold_9
5,501001,531000,29999,False,13,scaffold_9
6,671001,697000,25999,False,13,scaffold_9
7,814001,843000,28999,False,13,scaffold_9
8,850001,854000,3999,False,13,scaffold_9
9,855001,862000,6999,False,13,scaffold_9
10,872001,986000,113999,False,13,scaffold_9
11,987001,995000,7999,False,13,scaffold_9
12,997001,1007000,9999,False,13,scaffold_9
13,1009001,1085000,75999,False,13,scaffold_9
14,1087001,1150000,62999,False,13,scaffold_9
15,1151001,1160000,8999,False,13,scaffold_9
16,1312001,1382000,69999,False,13,scaffold_9
17,1428001,1437000,8999,False,13,scaffold_9
18,1545001,1590000,44999,False,13,scaffold_9
19,1600001,1623000,22999,False,13,scaffold_9
20,1637001,1688000,50999,False,13,scaffold_9
21,1749001,1791000,41999,False,13,scaffold_9
22,1828001,1857000,28999,False,13,scaffold_9
23,1885001,1942000,56999,False,13,scaffold_9
24,1987001,2135000,147999,False,13,scaffold_9
25,2137001,2171000,33999,False,13,scaffold_9
26,2174001,2377000,202999,False,13,scaffold_9
27,2388001,2442000,53999,False,13,scaffold_9
28,2515001,2582000,66999,False,13,scaffold_9
29,2584001,2697000,112999,False,13,scaffold_9
30,2735001,3381000,645999,False,13,scaffold_9
31,3383001,5107000,1723999,False,13,scaffold_9
32,5112001,5115000,2999,False,13,scaffold_9
33,5116001,5298000,181999,False,13,scaffold_9
34,5299001,5491000,191999,False,13,scaffold_9
35,5493001,6331288,838287,True,13,scaffold_9
0,1,414000,413999,True,13,scaffold_10
1,415001,482000,66999,False,13,scaffold_10
2,483001,585000,101999,False,13,scaffold_10
3,600001,878000,277999,False,13,scaffold_10
4,888001,1069000,180999,False,13,scaffold_10
5,1073001,1147000,73999,False,13,scaffold_10
6,1372001,1473000,100999,False,13,scaffold_10
7,1590001,1675000,84999,False,13,scaffold_10
8,1695001,1732000,36999,False,13,scaffold_10
9,1874001,1919000,44999,False,13,scaffold_10
10,2003001,2057000,53999,False,13,scaffold_10
11,2086001,2110000,23999,False,13,scaffold_10
12,2129001,2177000,47999,False,13,scaffold_10
13,2200001,2476000,275999,False,13,scaffold_10
14,2509001,2520000,10999,False,13,scaffold_10
15,2528001,2653000,124999,False,13,scaffold_10
16,2673001,2750000,76999,False,13,scaffold_10
17,2755001,2813000,57999,False,13,scaffold_10
18,2817001,2861000,43999,False,13,scaffold_10
19,2938001,2953000,14999,False,13,scaffold_10
20,3395001,3423000,27999,False,13,scaffold_10
21,4049001,4093000,43999,False,13,scaffold_10
22,4154001,4178000,23999,False,13,scaffold_10
23,4335001,4365000,29999,False,13,scaffold_10
24,4446001,4462000,15999,False,13,scaffold_10
25,4467001,4477000,9999,False,13,scaffold_10
26,4478001,4502000,23999,False,13,scaffold_10
27,4503001,4513000,9999,False,13,scaffold_10
28,4515001,4523000,7999,False,13,scaffold_10
29,4526001,4548000,21999,False,13,scaffold_10
30,4554001,4562000,7999,False,13,scaffold_10
31,4574001,4596000,21999,False,13,scaffold_10
32,4681001,4688000,6999,False,13,scaffold_10
33,4730001,4732000,1999,False,13,scaffold_10
34,4734001,4751000,16999,False,13,scaffold_10
35,4752001,4776000,23999,False,13,scaffold_10
36,4798001,4824000,25999,False,13,scaffold_10
37,4828001,4843000,14999,False,13,scaffold_10
38,4848001,4861000,12999,False,13,scaffold_10
39,4865001,4866973,1972,True,13,scaffold_10
0,10001,99000,88999,False,13,scaffold_11
1,132001,167000,34999,False,13,scaffold_11
2,169001,191000,21999,False,13,scaffold_11
3,214001,235000,20999,False,13,scaffold_11
4,240001,253000,12999,False,13,scaffold_11
5,288001,312000,23999,False,13,scaffold_11
6,419001,431000,11999,False,13,scaffold_11
7,648001,656000,7999,False,13,scaffold_11
8,1219001,1243000,23999,False,13,scaffold_11
9,1325001,1337000,11999,False,13,scaffold_11
10,1474001,1478000,3999,False,13,scaffold_11
11,1903001,2007000,103999,False,13,scaffold_11
12,2008001,2058000,49999,False,13,scaffold_11
13,2088001,2172000,83999,False,13,scaffold_11
14,2177001,2187000,9999,False,13,scaffold_11
15,2202001,2225000,22999,False,13,scaffold_11
16,2674001,2894000,219999,False,13,scaffold_11
17,2954001,3013000,58999,False,13,scaffold_11
18,3083001,3176000,92999,False,13,scaffold_11
19,3185001,3383000,197999,False,13,scaffold_11
20,3423001,3483000,59999,False,13,scaffold_11
21,3486001,3515000,28999,False,13,scaffold_11
22,3517001,3972000,454999,False,13,scaffold_11
23,3982001,4161000,178999,False,13,scaffold_11
24,4179001,4710000,530999,False,13,scaffold_11
25,4713001,4766820,53819,True,13,scaffold_11
0,1,1469000,1468999,True,13,scaffold_12
1,1565001,1587000,21999,False,13,scaffold_12
2,1646001,1673000,26999,False,13,scaffold_12
3,1718001,1733000,14999,False,13,scaffold_12
4,1764001,1809000,44999,False,13,scaffold_12
5,1882001,1962000,79999,False,13,scaffold_12
6,1973001,2003000,29999,False,13,scaffold_12
7,2024001,2041000,16999,False,13,scaffold_12
8,2043001,2105000,61999,False,13,scaffold_12
9,2135001,2189000,53999,False,13,scaffold_12
10,2308001,2378000,69999,False,13,scaffold_12
11,2571001,2609000,37999,False,13,scaffold_12
12,2747001,2747968,967,True,13,scaffold_12
0,1,340000,339999,True,14,scaffold_1
1,482001,498000,15999,False,14,scaffold_1
2,574001,643000,68999,False,14,scaffold_1
3,686001,714000,27999,False,14,scaffold_1
4,727001,743000,15999,False,14,scaffold_1
5,1281001,1292000,10999,False,14,scaffold_1
6,1954001,1964000,9999,False,14,scaffold_1
7,1965001,1984000,18999,False,14,scaffold_1
8,2449001,2467000,17999,False,14,scaffold_1
9,2477001,2514000,36999,False,14,scaffold_1
10,2729001,2746000,16999,False,14,scaffold_1
11,3181001,3208000,26999,False,14,scaffold_1
12,3715001,3733000,17999,False,14,scaffold_1
13,3916001,3941000,24999,False,14,scaffold_1
14,4089001,4109000,19999,False,14,scaffold_1
15,4322001,4354000,31999,False,14,scaffold_1
16,4929001,4962000,32999,False,14,scaffold_1
17,4969001,4997000,27999,False,14,scaffold_1
18,5481001,5511000,29999,False,14,scaffold_1
19,6108001,6153000,44999,False,14,scaffold_1
20,6228001,6507000,278999,False,14,scaffold_1
21,6545001,6554000,8999,False,14,scaffold_1
22,7038001,7247000,208999,False,14,scaffold_1
23,7248001,7584000,335999,False,14,scaffold_1
24,7590001,8656000,1065999,False,14,scaffold_1
25,8658001,9584000,925999,False,14,scaffold_1
26,9586001,10354000,767999,False,14,scaffold_1
27,10461001,10636000,174999,False,14,scaffold_1
28,10808001,10811000,2999,False,14,scaffold_1
29,10836001,10858000,21999,False,14,scaffold_1
30,11351001,11504000,152999,False,14,scaffold_1
31,11648001,11951000,302999,False,14,scaffold_1
32,12184001,12204000,19999,False,14,scaffold_1
33,12678001,12722000,43999,False,14,scaffold_1
34,12777001,12888000,110999,False,14,scaffold_1
35,13181001,13211000,29999,False,14,scaffold_1
36,13347001,13377000,29999,False,14,scaffold_1
37,13901001,13903000,1999,False,14,scaffold_1
0,22001,48000,25999,False,14,scaffold_2
1,93001,159000,65999,False,14,scaffold_2
2,168001,177000,8999,False,14,scaffold_2
3,297001,318000,20999,False,14,scaffold_2
4,331001,374000,42999,False,14,scaffold_2
5,2336001,2358000,21999,False,14,scaffold_2
6,2441001,2553000,111999,False,14,scaffold_2
7,2660001,2689000,28999,False,14,scaffold_2
8,2694001,2742000,47999,False,14,scaffold_2
9,2995001,3012000,16999,False,14,scaffold_2
10,3174001,3186000,11999,False,14,scaffold_2
11,3454001,3463000,8999,False,14,scaffold_2
12,3767001,3781000,13999,False,14,scaffold_2
13,4385001,4409000,23999,False,14,scaffold_2
14,4429001,4456000,26999,False,14,scaffold_2
15,4522001,4555000,32999,False,14,scaffold_2
16,4605001,4653000,47999,False,14,scaffold_2
17,5022001,5031000,8999,False,14,scaffold_2
18,5033001,5061000,27999,False,14,scaffold_2
19,5491001,5511000,19999,False,14,scaffold_2
20,5672001,5704000,31999,False,14,scaffold_2
21,6261001,6330000,68999,False,14,scaffold_2
22,6331001,6350000,18999,False,14,scaffold_2
23,7439001,7472000,32999,False,14,scaffold_2
24,7563001,7697000,133999,False,14,scaffold_2
25,7786001,7890000,103999,False,14,scaffold_2
26,7934001,7965000,30999,False,14,scaffold_2
27,7985001,8088000,102999,False,14,scaffold_2
28,8331001,8333000,1999,False,14,scaffold_2
29,8334001,8344000,9999,False,14,scaffold_2
30,8346001,8381000,34999,False,14,scaffold_2
31,8509001,8535000,25999,False,14,scaffold_2
32,11367001,11371000,3999,False,14,scaffold_2
33,11520001,11785000,264999,False,14,scaffold_2
0,1,2000,1999,True,14,scaffold_3
1,51001,55000,3999,False,14,scaffold_3
2,102001,104000,1999,False,14,scaffold_3
3,204001,207000,2999,False,14,scaffold_3
4,799001,900000,100999,False,14,scaffold_3
5,2085001,2108000,22999,False,14,scaffold_3
6,2291001,2321000,29999,False,14,scaffold_3
7,2510001,2531000,20999,False,14,scaffold_3
8,4150001,4403000,252999,False,14,scaffold_3
9,4410001,4518000,107999,False,14,scaffold_3
10,4547001,4558000,10999,False,14,scaffold_3
11,4650001,4679000,28999,False,14,scaffold_3
12,5578001,5581000,2999,False,14,scaffold_3
13,6911001,6962000,50999,False,14,scaffold_3
14,6980001,7034000,53999,False,14,scaffold_3
15,7449001,7458000,8999,False,14,scaffold_3
16,7540001,7556000,15999,False,14,scaffold_3
17,7692001,7724000,31999,False,14,scaffold_3
18,7822001,7838000,15999,False,14,scaffold_3
19,8208001,8255000,46999,False,14,scaffold_3
20,8462001,8527000,64999,False,14,scaffold_3
21,8575001,8594000,18999,False,14,scaffold_3
22,9968001,9996000,27999,False,14,scaffold_3
23,10461001,10480000,18999,False,14,scaffold_3
24,10587001,11164000,576999,False,14,scaffold_3
0,17001,32000,14999,False,14,scaffold_4
1,49001,88000,38999,False,14,scaffold_4
2,135001,146000,10999,False,14,scaffold_4
3,147001,151000,3999,False,14,scaffold_4
4,155001,215000,59999,False,14,scaffold_4
5,217001,226000,8999,False,14,scaffold_4
6,227001,266000,38999,False,14,scaffold_4
7,292001,310000,17999,False,14,scaffold_4
8,355001,374000,18999,False,14,scaffold_4
9,375001,380000,4999,False,14,scaffold_4
10,390001,410000,19999,False,14,scaffold_4
11,411001,425000,13999,False,14,scaffold_4
12,429001,502000,72999,False,14,scaffold_4
13,545001,606000,60999,False,14,scaffold_4
14,608001,661000,52999,False,14,scaffold_4
15,670001,691000,20999,False,14,scaffold_4
16,695001,697000,1999,False,14,scaffold_4
17,701001,717000,15999,False,14,scaffold_4
18,1121001,1136000,14999,False,14,scaffold_4
19,1137001,1178000,40999,False,14,scaffold_4
20,1199001,1208000,8999,False,14,scaffold_4
21,1210001,1226000,15999,False,14,scaffold_4
22,1235001,1246000,10999,False,14,scaffold_4
23,1248001,1253000,4999,False,14,scaffold_4
24,1254001,1262000,7999,False,14,scaffold_4
25,1265001,1279000,13999,False,14,scaffold_4
26,1283001,1313000,29999,False,14,scaffold_4
27,1372001,1591000,218999,False,14,scaffold_4
28,1749001,1816000,66999,False,14,scaffold_4
29,1940001,1957000,16999,False,14,scaffold_4
30,2037001,2065000,27999,False,14,scaffold_4
31,2247001,2268000,20999,False,14,scaffold_4
32,2269001,2279000,9999,False,14,scaffold_4
33,2284001,2340000,55999,False,14,scaffold_4
34,2480001,2533000,52999,False,14,scaffold_4
35,3336001,3632000,295999,False,14,scaffold_4
36,3676001,3759000,82999,False,14,scaffold_4
37,4944001,4984000,39999,False,14,scaffold_4
38,5477001,5506000,28999,False,14,scaffold_4
39,5514001,5620000,105999,False,14,scaffold_4
40,5669001,5784000,114999,False,14,scaffold_4
41,7037001,7062000,24999,False,14,scaffold_4
42,8846001,9699000,852999,False,14,scaffold_4
43,9700001,9845951,145950,True,14,scaffold_4
0,1,4000,3999,True,14,scaffold_5
1,318001,326000,7999,False,14,scaffold_5
2,327001,368000,40999,False,14,scaffold_5
3,469001,480000,10999,False,14,scaffold_5
4,498001,523000,24999,False,14,scaffold_5
5,933001,947000,13999,False,14,scaffold_5
6,1062001,1068000,5999,False,14,scaffold_5
7,2565001,2581000,15999,False,14,scaffold_5
8,2625001,2733000,107999,False,14,scaffold_5
9,2816001,2871000,54999,False,14,scaffold_5
10,3138001,3185000,46999,False,14,scaffold_5
11,3322001,3438000,115999,False,14,scaffold_5
12,3451001,3497000,45999,False,14,scaffold_5
13,3962001,4101000,138999,False,14,scaffold_5
14,4121001,4142000,20999,False,14,scaffold_5
15,4155001,4219000,63999,False,14,scaffold_5
16,4246001,4262000,15999,False,14,scaffold_5
17,4446001,4483000,36999,False,14,scaffold_5
18,4601001,4649000,47999,False,14,scaffold_5
19,4691001,4717000,25999,False,14,scaffold_5
20,4790001,4861000,70999,False,14,scaffold_5
21,5318001,5346000,27999,False,14,scaffold_5
22,8730001,9364176,634175,True,14,scaffold_5
0,79001,84000,4999,False,14,scaffold_6
1,86001,112000,25999,False,14,scaffold_6
2,239001,253000,13999,False,14,scaffold_6
3,257001,262000,4999,False,14,scaffold_6
4,267001,278000,10999,False,14,scaffold_6
5,1239001,1255000,15999,False,14,scaffold_6
6,1479001,1546000,66999,False,14,scaffold_6
7,2023001,2086000,62999,False,14,scaffold_6
8,2130001,2169000,38999,False,14,scaffold_6
9,2371001,2595000,223999,False,14,scaffold_6
10,2596001,2653000,56999,False,14,scaffold_6
11,2657001,2691000,33999,False,14,scaffold_6
12,2713001,2851000,137999,False,14,scaffold_6
13,2933001,3014000,80999,False,14,scaffold_6
14,3115001,3149000,33999,False,14,scaffold_6
15,3225001,3301000,75999,False,14,scaffold_6
16,3407001,3428000,20999,False,14,scaffold_6
17,3461001,3521000,59999,False,14,scaffold_6
18,3529001,3766000,236999,False,14,scaffold_6
19,3901001,3912000,10999,False,14,scaffold_6
20,4019001,4040000,20999,False,14,scaffold_6
21,4086001,4193000,106999,False,14,scaffold_6
22,6011001,6060000,48999,False,14,scaffold_6
23,7283001,7336000,52999,False,14,scaffold_6
24,7560001,7795000,234999,False,14,scaffold_6
25,7811001,8268281,457280,True,14,scaffold_6
0,1,7000,6999,True,14,scaffold_7
1,13001,31000,17999,False,14,scaffold_7
2,323001,340000,16999,False,14,scaffold_7
3,342001,508000,165999,False,14,scaffold_7
4,554001,563000,8999,False,14,scaffold_7
5,571001,577000,5999,False,14,scaffold_7
6,706001,736000,29999,False,14,scaffold_7
7,764001,817000,52999,False,14,scaffold_7
8,859001,864000,4999,False,14,scaffold_7
9,964001,966000,1999,False,14,scaffold_7
10,968001,980000,11999,False,14,scaffold_7
11,982001,1044000,61999,False,14,scaffold_7
12,1048001,1096000,47999,False,14,scaffold_7
13,1191001,1512000,320999,False,14,scaffold_7
14,1588001,1688000,99999,False,14,scaffold_7
15,3329001,3369000,39999,False,14,scaffold_7
16,3596001,3648000,51999,False,14,scaffold_7
17,4416001,4517000,100999,False,14,scaffold_7
18,4658001,4681000,22999,False,14,scaffold_7
19,4981001,5020000,38999,False,14,scaffold_7
20,5077001,5111000,33999,False,14,scaffold_7
21,6955001,7270000,314999,False,14,scaffold_7
22,7271001,7502216,231215,True,14,scaffold_7
0,67001,85000,17999,False,14,scaffold_8
1,722001,724000,1999,False,14,scaffold_8
2,2662001,2683000,20999,False,14,scaffold_8
3,2745001,2756000,10999,False,14,scaffold_8
4,3060001,3125000,64999,False,14,scaffold_8
5,3126001,3525000,398999,False,14,scaffold_8
6,3584001,3612000,27999,False,14,scaffold_8
7,3615001,3913000,297999,False,14,scaffold_8
8,5200001,5241000,40999,False,14,scaffold_8
9,6330001,6334544,4543,True,14,scaffold_8
0,109001,117000,7999,False,14,scaffold_9
1,303001,315000,11999,False,14,scaffold_9
2,319001,332000,12999,False,14,scaffold_9
3,367001,411000,43999,False,14,scaffold_9
4,413001,434000,20999,False,14,scaffold_9
5,502001,531000,28999,False,14,scaffold_9
6,671001,696000,24999,False,14,scaffold_9
7,732001,742000,9999,False,14,scaffold_9
8,794001,801000,6999,False,14,scaffold_9
9,816001,842000,25999,False,14,scaffold_9
10,873001,986000,112999,False,14,scaffold_9
11,988001,995000,6999,False,14,scaffold_9
12,1001001,1007000,5999,False,14,scaffold_9
13,1010001,1031000,20999,False,14,scaffold_9
14,1036001,1085000,48999,False,14,scaffold_9
15,1087001,1150000,62999,False,14,scaffold_9
16,1151001,1160000,8999,False,14,scaffold_9
17,1313001,1377000,63999,False,14,scaffold_9
18,1767001,1790000,22999,False,14,scaffold_9
19,2601001,2616000,14999,False,14,scaffold_9
20,2874001,3381000,506999,False,14,scaffold_9
21,3383001,5107000,1723999,False,14,scaffold_9
22,5112001,5115000,2999,False,14,scaffold_9
23,5116001,5238000,121999,False,14,scaffold_9
24,5239001,5298000,58999,False,14,scaffold_9
25,5300001,5490000,189999,False,14,scaffold_9
26,5492001,6331288,839287,True,14,scaffold_9
0,1,136000,135999,True,14,scaffold_10
1,137001,197000,59999,False,14,scaffold_10
2,375001,405000,29999,False,14,scaffold_10
3,472001,482000,9999,False,14,scaffold_10
4,483001,576000,92999,False,14,scaffold_10
5,603001,721000,117999,False,14,scaffold_10
6,888001,916000,27999,False,14,scaffold_10
7,924001,962000,37999,False,14,scaffold_10
8,1087001,1105000,17999,False,14,scaffold_10
9,2346001,2366000,19999,False,14,scaffold_10
10,4052001,4091000,38999,False,14,scaffold_10
11,4154001,4174000,19999,False,14,scaffold_10
12,4445001,4456000,10999,False,14,scaffold_10
13,4506001,4513000,6999,False,14,scaffold_10
14,4515001,4523000,7999,False,14,scaffold_10
15,4526001,4548000,21999,False,14,scaffold_10
16,4576001,4596000,19999,False,14,scaffold_10
17,4680001,4688000,7999,False,14,scaffold_10
18,4734001,4766000,31999,False,14,scaffold_10
19,4767001,4776000,8999,False,14,scaffold_10
20,4798001,4824000,25999,False,14,scaffold_10
21,4827001,4843000,15999,False,14,scaffold_10
22,4848001,4861000,12999,False,14,scaffold_10
23,4865001,4866973,1972,True,14,scaffold_10
0,10001,93000,82999,False,14,scaffold_11
1,149001,167000,17999,False,14,scaffold_11
2,169001,191000,21999,False,14,scaffold_11
3,213001,235000,21999,False,14,scaffold_11
4,240001,249000,8999,False,14,scaffold_11
5,419001,431000,11999,False,14,scaffold_11
6,648001,656000,7999,False,14,scaffold_11
7,1025001,1034000,8999,False,14,scaffold_11
8,1403001,1409000,5999,False,14,scaffold_11
9,1423001,1426000,2999,False,14,scaffold_11
10,2701001,2873000,171999,False,14,scaffold_11
11,3211001,3254000,42999,False,14,scaffold_11
12,3331001,3380000,48999,False,14,scaffold_11
13,3702001,3926000,223999,False,14,scaffold_11
14,4322001,4710000,387999,False,14,scaffold_11
15,4713001,4766820,53819,True,14,scaffold_11
0,1,240000,239999,True,14,scaffold_12
1,291001,369000,77999,False,14,scaffold_12
2,474001,511000,36999,False,14,scaffold_12
3,582001,730000,147999,False,14,scaffold_12
4,740001,856000,115999,False,14,scaffold_12
5,867001,1356000,488999,False,14,scaffold_12
6,1720001,1733000,12999,False,14,scaffold_12
7,2571001,2612000,40999,False,14,scaffold_12
8,2676001,2682000,5999,False,14,scaffold_12
9,2685001,2699000,13999,False,14,scaffold_12
0,1,6000,5999,True,15,scaffold_1
1,16001,19000,2999,False,15,scaffold_1
2,27001,30000,2999,False,15,scaffold_1
3,95001,101000,5999,False,15,scaffold_1
4,105001,111000,5999,False,15,scaffold_1
5,189001,193000,3999,False,15,scaffold_1
6,218001,221000,2999,False,15,scaffold_1
7,222001,227000,4999,False,15,scaffold_1
8,269001,276000,6999,False,15,scaffold_1
9,327001,329000,1999,False,15,scaffold_1
10,390001,392000,1999,False,15,scaffold_1
11,634001,638000,3999,False,15,scaffold_1
12,688001,693000,4999,False,15,scaffold_1
13,1044001,1046000,1999,False,15,scaffold_1
14,1168001,1182000,13999,False,15,scaffold_1
15,1311001,1315000,3999,False,15,scaffold_1
16,1329001,1332000,2999,False,15,scaffold_1
17,1606001,1611000,4999,False,15,scaffold_1
18,1657001,1659000,1999,False,15,scaffold_1
19,1725001,1727000,1999,False,15,scaffold_1
20,1728001,1731000,2999,False,15,scaffold_1
21,1738001,1741000,2999,False,15,scaffold_1
22,1745001,1756000,10999,False,15,scaffold_1
23,1961001,1964000,2999,False,15,scaffold_1
24,1976001,1984000,7999,False,15,scaffold_1
25,2335001,2337000,1999,False,15,scaffold_1
26,2371001,2373000,1999,False,15,scaffold_1
27,2378001,2387000,8999,False,15,scaffold_1
28,2460001,2464000,3999,False,15,scaffold_1
29,3057001,3064000,6999,False,15,scaffold_1
30,3195001,3197000,1999,False,15,scaffold_1
31,3225001,3227000,1999,False,15,scaffold_1
32,3297001,3300000,2999,False,15,scaffold_1
33,3555001,3557000,1999,False,15,scaffold_1
34,3687001,3690000,2999,False,15,scaffold_1
35,3775001,3782000,6999,False,15,scaffold_1
36,3864001,3869000,4999,False,15,scaffold_1
37,3895001,3897000,1999,False,15,scaffold_1
38,3992001,4007000,14999,False,15,scaffold_1
39,4108001,4111000,2999,False,15,scaffold_1
40,4268001,4271000,2999,False,15,scaffold_1
41,4289001,4293000,3999,False,15,scaffold_1
42,4313001,4319000,5999,False,15,scaffold_1
43,4330001,4332000,1999,False,15,scaffold_1
44,4687001,4691000,3999,False,15,scaffold_1
45,4846001,4849000,2999,False,15,scaffold_1
46,4939001,4950000,10999,False,15,scaffold_1
47,5059001,5064000,4999,False,15,scaffold_1
48,5088001,5093000,4999,False,15,scaffold_1
49,5191001,5196000,4999,False,15,scaffold_1
50,5438001,5442000,3999,False,15,scaffold_1
51,5498001,5512000,13999,False,15,scaffold_1
52,6217001,6223000,5999,False,15,scaffold_1
53,6227001,6237000,9999,False,15,scaffold_1
54,6384001,6392000,7999,False,15,scaffold_1
55,6438001,6441000,2999,False,15,scaffold_1
56,6866001,6875000,8999,False,15,scaffold_1
57,6879001,6883000,3999,False,15,scaffold_1
58,7042001,7048000,5999,False,15,scaffold_1
59,7053001,7061000,7999,False,15,scaffold_1
60,7091001,7093000,1999,False,15,scaffold_1
61,7119001,7122000,2999,False,15,scaffold_1
62,7136001,7142000,5999,False,15,scaffold_1
63,7175001,7177000,1999,False,15,scaffold_1
64,7195001,7198000,2999,False,15,scaffold_1
65,7355001,7360000,4999,False,15,scaffold_1
66,7371001,7377000,5999,False,15,scaffold_1
67,7378001,7380000,1999,False,15,scaffold_1
68,7389001,7397000,7999,False,15,scaffold_1
69,7398001,7424000,25999,False,15,scaffold_1
70,7477001,7483000,5999,False,15,scaffold_1
71,7484001,7491000,6999,False,15,scaffold_1
72,7555001,7561000,5999,False,15,scaffold_1
73,7590001,7598000,7999,False,15,scaffold_1
74,7603001,7610000,6999,False,15,scaffold_1
75,7653001,7657000,3999,False,15,scaffold_1
76,7684001,7692000,7999,False,15,scaffold_1
77,7766001,7773000,6999,False,15,scaffold_1
78,7784001,7788000,3999,False,15,scaffold_1
79,7881001,7886000,4999,False,15,scaffold_1
80,7896001,7899000,2999,False,15,scaffold_1
81,7927001,7930000,2999,False,15,scaffold_1
82,7960001,7971000,10999,False,15,scaffold_1
83,8081001,8089000,7999,False,15,scaffold_1
84,8106001,8109000,2999,False,15,scaffold_1
85,8114001,8125000,10999,False,15,scaffold_1
86,8173001,8176000,2999,False,15,scaffold_1
87,8183001,8185000,1999,False,15,scaffold_1
88,8221001,8236000,14999,False,15,scaffold_1
89,8257001,8259000,1999,False,15,scaffold_1
90,8260001,8263000,2999,False,15,scaffold_1
91,8316001,8326000,9999,False,15,scaffold_1
92,8328001,8331000,2999,False,15,scaffold_1
93,8333001,8339000,5999,False,15,scaffold_1
94,8505001,8519000,13999,False,15,scaffold_1
95,8636001,8638000,1999,False,15,scaffold_1
96,8683001,8685000,1999,False,15,scaffold_1
97,8723001,8726000,2999,False,15,scaffold_1
98,8811001,8813000,1999,False,15,scaffold_1
99,8818001,8820000,1999,False,15,scaffold_1
100,8862001,8870000,7999,False,15,scaffold_1
101,8873001,8879000,5999,False,15,scaffold_1
102,9005001,9009000,3999,False,15,scaffold_1
103,9154001,9169000,14999,False,15,scaffold_1
104,9206001,9212000,5999,False,15,scaffold_1
105,9274001,9277000,2999,False,15,scaffold_1
106,9348001,9351000,2999,False,15,scaffold_1
107,9357001,9362000,4999,False,15,scaffold_1
108,9367001,9369000,1999,False,15,scaffold_1
109,9452001,9454000,1999,False,15,scaffold_1
110,9474001,9477000,2999,False,15,scaffold_1
111,9479001,9482000,2999,False,15,scaffold_1
112,9564001,9567000,2999,False,15,scaffold_1
113,9611001,9616000,4999,False,15,scaffold_1
114,9634001,9636000,1999,False,15,scaffold_1
115,9727001,9730000,2999,False,15,scaffold_1
116,9746001,9752000,5999,False,15,scaffold_1
117,9767001,9770000,2999,False,15,scaffold_1
118,9780001,9786000,5999,False,15,scaffold_1
119,9953001,9962000,8999,False,15,scaffold_1
120,9994001,9999000,4999,False,15,scaffold_1
121,10031001,10033000,1999,False,15,scaffold_1
122,10046001,10048000,1999,False,15,scaffold_1
123,10056001,10058000,1999,False,15,scaffold_1
124,10144001,10147000,2999,False,15,scaffold_1
125,10173001,10175000,1999,False,15,scaffold_1
126,10244001,10246000,1999,False,15,scaffold_1
127,10252001,10254000,1999,False,15,scaffold_1
128,10260001,10266000,5999,False,15,scaffold_1
129,10347001,10351000,3999,False,15,scaffold_1
130,10398001,10400000,1999,False,15,scaffold_1
131,10517001,10519000,1999,False,15,scaffold_1
132,10801001,10804000,2999,False,15,scaffold_1
133,10980001,10983000,2999,False,15,scaffold_1
134,11028001,11039000,10999,False,15,scaffold_1
135,11283001,11291000,7999,False,15,scaffold_1
136,11322001,11330000,7999,False,15,scaffold_1
137,11421001,11425000,3999,False,15,scaffold_1
138,11487001,11489000,1999,False,15,scaffold_1
139,11670001,11676000,5999,False,15,scaffold_1
140,11832001,11835000,2999,False,15,scaffold_1
141,11925001,11927000,1999,False,15,scaffold_1
142,11948001,11951000,2999,False,15,scaffold_1
143,11960001,11964000,3999,False,15,scaffold_1
144,12386001,12390000,3999,False,15,scaffold_1
145,12425001,12432000,6999,False,15,scaffold_1
146,12624001,12627000,2999,False,15,scaffold_1
147,12752001,12755000,2999,False,15,scaffold_1
148,12916001,12919000,2999,False,15,scaffold_1
149,12983001,12990000,6999,False,15,scaffold_1
150,13126001,13130000,3999,False,15,scaffold_1
151,13387001,13397000,9999,False,15,scaffold_1
152,13410001,13412000,1999,False,15,scaffold_1
153,13697001,13709000,11999,False,15,scaffold_1
154,13810001,13829000,18999,False,15,scaffold_1
155,13832001,13845000,12999,False,15,scaffold_1
156,13959001,13974000,14999,False,15,scaffold_1
157,14162001,14164000,1999,False,15,scaffold_1
158,14304001,14310000,5999,False,15,scaffold_1
159,14318001,14320000,1999,False,15,scaffold_1
160,14423001,14427000,3999,False,15,scaffold_1
161,14455001,14457000,1999,False,15,scaffold_1
162,14501001,14507000,5999,False,15,scaffold_1
163,14509001,14511000,1999,False,15,scaffold_1
164,14541001,14574000,32999,False,15,scaffold_1
165,14578001,14582000,3999,False,15,scaffold_1
166,14583001,14591000,7999,False,15,scaffold_1
167,14619001,14621000,1999,False,15,scaffold_1
168,14672001,14674000,1999,False,15,scaffold_1
169,14690001,14692000,1999,False,15,scaffold_1
0,43001,48000,4999,False,15,scaffold_2
1,51001,55000,3999,False,15,scaffold_2
2,107001,112000,4999,False,15,scaffold_2
3,149001,151000,1999,False,15,scaffold_2
4,168001,177000,8999,False,15,scaffold_2
5,248001,260000,11999,False,15,scaffold_2
6,302001,308000,5999,False,15,scaffold_2
7,309001,318000,8999,False,15,scaffold_2
8,342001,347000,4999,False,15,scaffold_2
9,379001,381000,1999,False,15,scaffold_2
10,396001,403000,6999,False,15,scaffold_2
11,565001,571000,5999,False,15,scaffold_2
12,650001,656000,5999,False,15,scaffold_2
13,696001,702000,5999,False,15,scaffold_2
14,918001,922000,3999,False,15,scaffold_2
15,1325001,1333000,7999,False,15,scaffold_2
16,1423001,1427000,3999,False,15,scaffold_2
17,1631001,1636000,4999,False,15,scaffold_2
18,1725001,1730000,4999,False,15,scaffold_2
19,1738001,1744000,5999,False,15,scaffold_2
20,2090001,2096000,5999,False,15,scaffold_2
21,2103001,2124000,20999,False,15,scaffold_2
22,2178001,2180000,1999,False,15,scaffold_2
23,2283001,2285000,1999,False,15,scaffold_2
24,2316001,2320000,3999,False,15,scaffold_2
25,2517001,2521000,3999,False,15,scaffold_2
26,2598001,2600000,1999,False,15,scaffold_2
27,2767001,2778000,10999,False,15,scaffold_2
28,2868001,2871000,2999,False,15,scaffold_2
29,2933001,2938000,4999,False,15,scaffold_2
30,3073001,3076000,2999,False,15,scaffold_2
31,3146001,3148000,1999,False,15,scaffold_2
32,3330001,3337000,6999,False,15,scaffold_2
33,3489001,3515000,25999,False,15,scaffold_2
34,3756001,3758000,1999,False,15,scaffold_2
35,4365001,4371000,5999,False,15,scaffold_2
36,4398001,4402000,3999,False,15,scaffold_2
37,4453001,4457000,3999,False,15,scaffold_2
38,4530001,4533000,2999,False,15,scaffold_2
39,4537001,4553000,15999,False,15,scaffold_2
40,4710001,4713000,2999,False,15,scaffold_2
41,4755001,4759000,3999,False,15,scaffold_2
42,4788001,4790000,1999,False,15,scaffold_2
43,4844001,4848000,3999,False,15,scaffold_2
44,5027001,5031000,3999,False,15,scaffold_2
45,5155001,5158000,2999,False,15,scaffold_2
46,5264001,5269000,4999,False,15,scaffold_2
47,5293001,5295000,1999,False,15,scaffold_2
48,5527001,5529000,1999,False,15,scaffold_2
49,5658001,5661000,2999,False,15,scaffold_2
50,5831001,5846000,14999,False,15,scaffold_2
51,5871001,5873000,1999,False,15,scaffold_2
52,6020001,6023000,2999,False,15,scaffold_2
53,6029001,6035000,5999,False,15,scaffold_2
54,6269001,6274000,4999,False,15,scaffold_2
55,6437001,6439000,1999,False,15,scaffold_2
56,6458001,6463000,4999,False,15,scaffold_2
57,6481001,6484000,2999,False,15,scaffold_2
58,6738001,6740000,1999,False,15,scaffold_2
59,6760001,6762000,1999,False,15,scaffold_2
60,6833001,6836000,2999,False,15,scaffold_2
61,7572001,7575000,2999,False,15,scaffold_2
62,7685001,7699000,13999,False,15,scaffold_2
63,7705001,7708000,2999,False,15,scaffold_2
64,7803001,7806000,2999,False,15,scaffold_2
65,7822001,7827000,4999,False,15,scaffold_2
66,7912001,7917000,4999,False,15,scaffold_2
67,7928001,7931000,2999,False,15,scaffold_2
68,7979001,7982000,2999,False,15,scaffold_2
69,8247001,8249000,1999,False,15,scaffold_2
70,8331001,8333000,1999,False,15,scaffold_2
71,8472001,8481000,8999,False,15,scaffold_2
72,8726001,8728000,1999,False,15,scaffold_2
73,8823001,8826000,2999,False,15,scaffold_2
74,8844001,8848000,3999,False,15,scaffold_2
75,8989001,8991000,1999,False,15,scaffold_2
76,9048001,9050000,1999,False,15,scaffold_2
77,9328001,9338000,9999,False,15,scaffold_2
78,9436001,9439000,2999,False,15,scaffold_2
79,9617001,9620000,2999,False,15,scaffold_2
80,9914001,9917000,2999,False,15,scaffold_2
81,10428001,10431000,2999,False,15,scaffold_2
82,10705001,10708000,2999,False,15,scaffold_2
83,10995001,10998000,2999,False,15,scaffold_2
84,11000001,11004000,3999,False,15,scaffold_2
85,11345001,11347000,1999,False,15,scaffold_2
86,11567001,11570000,2999,False,15,scaffold_2
87,11727001,11731000,3999,False,15,scaffold_2
88,11750001,11752000,1999,False,15,scaffold_2
0,218001,228000,9999,False,15,scaffold_3
1,256001,259000,2999,False,15,scaffold_3
2,506001,510000,3999,False,15,scaffold_3
3,528001,531000,2999,False,15,scaffold_3
4,618001,620000,1999,False,15,scaffold_3
5,669001,672000,2999,False,15,scaffold_3
6,816001,820000,3999,False,15,scaffold_3
7,857001,862000,4999,False,15,scaffold_3
8,870001,883000,12999,False,15,scaffold_3
9,890001,895000,4999,False,15,scaffold_3
10,898001,900000,1999,False,15,scaffold_3
11,989001,993000,3999,False,15,scaffold_3
12,1011001,1013000,1999,False,15,scaffold_3
13,1160001,1162000,1999,False,15,scaffold_3
14,1307001,1311000,3999,False,15,scaffold_3
15,1488001,1491000,2999,False,15,scaffold_3
16,1497001,1505000,7999,False,15,scaffold_3
17,1549001,1556000,6999,False,15,scaffold_3
18,1562001,1564000,1999,False,15,scaffold_3
19,1584001,1588000,3999,False,15,scaffold_3
20,1598001,1602000,3999,False,15,scaffold_3
21,1609001,1611000,1999,False,15,scaffold_3
22,1666001,1672000,5999,False,15,scaffold_3
23,1692001,1694000,1999,False,15,scaffold_3
24,1740001,1742000,1999,False,15,scaffold_3
25,1834001,1840000,5999,False,15,scaffold_3
26,1853001,1860000,6999,False,15,scaffold_3
27,2042001,2045000,2999,False,15,scaffold_3
28,2047001,2063000,15999,False,15,scaffold_3
29,2164001,2167000,2999,False,15,scaffold_3
30,2801001,2809000,7999,False,15,scaffold_3
31,2811001,2814000,2999,False,15,scaffold_3
32,2903001,2906000,2999,False,15,scaffold_3
33,3055001,3060000,4999,False,15,scaffold_3
34,3105001,3121000,15999,False,15,scaffold_3
35,3132001,3139000,6999,False,15,scaffold_3
36,3409001,3421000,11999,False,15,scaffold_3
37,3423001,3426000,2999,False,15,scaffold_3
38,3712001,3715000,2999,False,15,scaffold_3
39,3805001,3808000,2999,False,15,scaffold_3
40,3908001,3911000,2999,False,15,scaffold_3
41,4095001,4117000,21999,False,15,scaffold_3
42,4275001,4281000,5999,False,15,scaffold_3
43,4354001,4358000,3999,False,15,scaffold_3
44,5167001,5177000,9999,False,15,scaffold_3
45,5607001,5616000,8999,False,15,scaffold_3
46,5681001,5684000,2999,False,15,scaffold_3
47,5693001,5696000,2999,False,15,scaffold_3
48,5743001,5746000,2999,False,15,scaffold_3
49,5978001,5994000,15999,False,15,scaffold_3
50,6022001,6023000,999,False,15,scaffold_3
51,6026001,6030000,3999,False,15,scaffold_3
52,6118001,6122000,3999,False,15,scaffold_3
53,6813001,6816000,2999,False,15,scaffold_3
54,6861001,6864000,2999,False,15,scaffold_3
55,6914001,6918000,3999,False,15,scaffold_3
56,6941001,6944000,2999,False,15,scaffold_3
57,7211001,7217000,5999,False,15,scaffold_3
58,7462001,7464000,1999,False,15,scaffold_3
59,7487001,7492000,4999,False,15,scaffold_3
60,7983001,7988000,4999,False,15,scaffold_3
61,8142001,8145000,2999,False,15,scaffold_3
62,8175001,8177000,1999,False,15,scaffold_3
63,8223001,8230000,6999,False,15,scaffold_3
64,8355001,8360000,4999,False,15,scaffold_3
65,8386001,8391000,4999,False,15,scaffold_3
66,8471001,8478000,6999,False,15,scaffold_3
67,8523001,8526000,2999,False,15,scaffold_3
68,8736001,8739000,2999,False,15,scaffold_3
69,8766001,8771000,4999,False,15,scaffold_3
70,9057001,9063000,5999,False,15,scaffold_3
71,9206001,9208000,1999,False,15,scaffold_3
72,9211001,9217000,5999,False,15,scaffold_3
73,9220001,9234000,13999,False,15,scaffold_3
74,9445001,9449000,3999,False,15,scaffold_3
75,9935001,9938000,2999,False,15,scaffold_3
76,10108001,10110000,1999,False,15,scaffold_3
77,10162001,10164000,1999,False,15,scaffold_3
78,10238001,10241000,2999,False,15,scaffold_3
79,10668001,10671000,2999,False,15,scaffold_3
80,10673001,10677000,3999,False,15,scaffold_3
81,10842001,10847000,4999,False,15,scaffold_3
82,10860001,10867000,6999,False,15,scaffold_3
83,10880001,10884000,3999,False,15,scaffold_3
84,10903001,10909000,5999,False,15,scaffold_3
85,10961001,10968000,6999,False,15,scaffold_3
86,10987001,10990000,2999,False,15,scaffold_3
87,11132001,11134000,1999,False,15,scaffold_3
88,11162001,11168000,5999,False,15,scaffold_3
89,11181001,11182071,1070,True,15,scaffold_3
0,11001,13000,1999,False,15,scaffold_4
1,25001,28000,2999,False,15,scaffold_4
2,30001,32000,1999,False,15,scaffold_4
3,48001,88000,39999,False,15,scaffold_4
4,109001,115000,5999,False,15,scaffold_4
5,147001,151000,3999,False,15,scaffold_4
6,155001,167000,11999,False,15,scaffold_4
7,175001,181000,5999,False,15,scaffold_4
8,200001,215000,14999,False,15,scaffold_4
9,217001,226000,8999,False,15,scaffold_4
10,248001,252000,3999,False,15,scaffold_4
11,290001,301000,10999,False,15,scaffold_4
12,302001,307000,4999,False,15,scaffold_4
13,318001,320000,1999,False,15,scaffold_4
14,355001,374000,18999,False,15,scaffold_4
15,400001,410000,9999,False,15,scaffold_4
16,412001,415000,2999,False,15,scaffold_4
17,416001,425000,8999,False,15,scaffold_4
18,485001,503000,17999,False,15,scaffold_4
19,526001,528000,1999,False,15,scaffold_4
20,583001,592000,8999,False,15,scaffold_4
21,593001,599000,5999,False,15,scaffold_4
22,600001,606000,5999,False,15,scaffold_4
23,610001,612000,1999,False,15,scaffold_4
24,613001,617000,3999,False,15,scaffold_4
25,653001,658000,4999,False,15,scaffold_4
26,684001,686000,1999,False,15,scaffold_4
27,688001,691000,2999,False,15,scaffold_4
28,889001,891000,1999,False,15,scaffold_4
29,1043001,1047000,3999,False,15,scaffold_4
30,1050001,1052000,1999,False,15,scaffold_4
31,1087001,1097000,9999,False,15,scaffold_4
32,1154001,1161000,6999,False,15,scaffold_4
33,1163001,1178000,14999,False,15,scaffold_4
34,1223001,1226000,2999,False,15,scaffold_4
35,1485001,1492000,6999,False,15,scaffold_4
36,1527001,1531000,3999,False,15,scaffold_4
37,1568001,1571000,2999,False,15,scaffold_4
38,1585001,1588000,2999,False,15,scaffold_4
39,1591001,1601000,9999,False,15,scaffold_4
40,1824001,1846000,21999,False,15,scaffold_4
41,1857001,1887000,29999,False,15,scaffold_4
42,1888001,1902000,13999,False,15,scaffold_4
43,1904001,1934000,29999,False,15,scaffold_4
44,1947001,1951000,3999,False,15,scaffold_4
45,1960001,1966000,5999,False,15,scaffold_4
46,1980001,2004000,23999,False,15,scaffold_4
47,2016001,2051000,34999,False,15,scaffold_4
48,2052001,2060000,7999,False,15,scaffold_4
49,2071001,2097000,25999,False,15,scaffold_4
50,2173001,2185000,11999,False,15,scaffold_4
51,2282001,2297000,14999,False,15,scaffold_4
52,2300001,2310000,9999,False,15,scaffold_4
53,2312001,2321000,8999,False,15,scaffold_4
54,2324001,2334000,9999,False,15,scaffold_4
55,2360001,2379000,18999,False,15,scaffold_4
56,2380001,2389000,8999,False,15,scaffold_4
57,2391001,2400000,8999,False,15,scaffold_4
58,2437001,2454000,16999,False,15,scaffold_4
59,2480001,2487000,6999,False,15,scaffold_4
60,2496001,2504000,7999,False,15,scaffold_4
61,2516001,2522000,5999,False,15,scaffold_4
62,2569001,2572000,2999,False,15,scaffold_4
63,2749001,2753000,3999,False,15,scaffold_4
64,2755001,2758000,2999,False,15,scaffold_4
65,2876001,2883000,6999,False,15,scaffold_4
66,3052001,3057000,4999,False,15,scaffold_4
67,3534001,3537000,2999,False,15,scaffold_4
68,3668001,3670000,1999,False,15,scaffold_4
69,3734001,3743000,8999,False,15,scaffold_4
70,4175001,4187000,11999,False,15,scaffold_4
71,4198001,4202000,3999,False,15,scaffold_4
72,4277001,4284000,6999,False,15,scaffold_4
73,4672001,4676000,3999,False,15,scaffold_4
74,4994001,4996000,1999,False,15,scaffold_4
75,5008001,5011000,2999,False,15,scaffold_4
76,5029001,5040000,10999,False,15,scaffold_4
77,5207001,5211000,3999,False,15,scaffold_4
78,5344001,5348000,3999,False,15,scaffold_4
79,5435001,5440000,4999,False,15,scaffold_4
80,5611001,5620000,8999,False,15,scaffold_4
81,5754001,5757000,2999,False,15,scaffold_4
82,5786001,5788000,1999,False,15,scaffold_4
83,6091001,6101000,9999,False,15,scaffold_4
84,6259001,6262000,2999,False,15,scaffold_4
85,6380001,6382000,1999,False,15,scaffold_4
86,6437001,6443000,5999,False,15,scaffold_4
87,6644001,6654000,9999,False,15,scaffold_4
88,6862001,6865000,2999,False,15,scaffold_4
89,6985001,6990000,4999,False,15,scaffold_4
90,7131001,7141000,9999,False,15,scaffold_4
91,7147001,7162000,14999,False,15,scaffold_4
92,7387001,7397000,9999,False,15,scaffold_4
93,7411001,7414000,2999,False,15,scaffold_4
94,7418001,7424000,5999,False,15,scaffold_4
95,7432001,7440000,7999,False,15,scaffold_4
96,7644001,7646000,1999,False,15,scaffold_4
97,7658001,7661000,2999,False,15,scaffold_4
98,7669001,7671000,1999,False,15,scaffold_4
99,7746001,7750000,3999,False,15,scaffold_4
100,7753001,7760000,6999,False,15,scaffold_4
101,7761001,7765000,3999,False,15,scaffold_4
102,7995001,7998000,2999,False,15,scaffold_4
103,8207001,8211000,3999,False,15,scaffold_4
104,8405001,8407000,1999,False,15,scaffold_4
105,8446001,8450000,3999,False,15,scaffold_4
106,8875001,8877000,1999,False,15,scaffold_4
107,8900001,8904000,3999,False,15,scaffold_4
108,9016001,9022000,5999,False,15,scaffold_4
109,9045001,9047000,1999,False,15,scaffold_4
110,9098001,9102000,3999,False,15,scaffold_4
111,9120001,9122000,1999,False,15,scaffold_4
112,9128001,9133000,4999,False,15,scaffold_4
113,9150001,9153000,2999,False,15,scaffold_4
114,9176001,9178000,1999,False,15,scaffold_4
115,9220001,9222000,1999,False,15,scaffold_4
116,9274001,9278000,3999,False,15,scaffold_4
117,9282001,9289000,6999,False,15,scaffold_4
118,9296001,9302000,5999,False,15,scaffold_4
119,9435001,9437000,1999,False,15,scaffold_4
120,9441001,9445000,3999,False,15,scaffold_4
121,9524001,9529000,4999,False,15,scaffold_4
122,9537001,9540000,2999,False,15,scaffold_4
123,9548001,9554000,5999,False,15,scaffold_4
124,9657001,9662000,4999,False,15,scaffold_4
125,9665001,9674000,8999,False,15,scaffold_4
126,9709001,9715000,5999,False,15,scaffold_4
127,9723001,9726000,2999,False,15,scaffold_4
128,9727001,9731000,3999,False,15,scaffold_4
129,9800001,9803000,2999,False,15,scaffold_4
130,9806001,9810000,3999,False,15,scaffold_4
0,317001,324000,6999,False,15,scaffold_5
1,336001,339000,2999,False,15,scaffold_5
2,342001,349000,6999,False,15,scaffold_5
3,476001,478000,1999,False,15,scaffold_5
4,501001,503000,1999,False,15,scaffold_5
5,575001,577000,1999,False,15,scaffold_5
6,589001,592000,2999,False,15,scaffold_5
7,836001,843000,6999,False,15,scaffold_5
8,874001,878000,3999,False,15,scaffold_5
9,938001,943000,4999,False,15,scaffold_5
10,1119001,1121000,1999,False,15,scaffold_5
11,1301001,1307000,5999,False,15,scaffold_5
12,1381001,1394000,12999,False,15,scaffold_5
13,1742001,1744000,1999,False,15,scaffold_5
14,2897001,2901000,3999,False,15,scaffold_5
15,2955001,2956000,999,False,15,scaffold_5
16,3062001,3065000,2999,False,15,scaffold_5
17,3208001,3211000,2999,False,15,scaffold_5
18,3325001,3327000,1999,False,15,scaffold_5
19,3394001,3396000,1999,False,15,scaffold_5
20,3583001,3585000,1999,False,15,scaffold_5
21,3587001,3590000,2999,False,15,scaffold_5
22,3881001,3884000,2999,False,15,scaffold_5
23,3963001,3969000,5999,False,15,scaffold_5
24,3996001,3998000,1999,False,15,scaffold_5
25,4043001,4045000,1999,False,15,scaffold_5
26,4056001,4057000,999,False,15,scaffold_5
27,4135001,4137000,1999,False,15,scaffold_5
28,4183001,4186000,2999,False,15,scaffold_5
29,4250001,4252000,1999,False,15,scaffold_5
30,4406001,4410000,3999,False,15,scaffold_5
31,4586001,4588000,1999,False,15,scaffold_5
32,4797001,4799000,1999,False,15,scaffold_5
33,4846001,4851000,4999,False,15,scaffold_5
34,4886001,4890000,3999,False,15,scaffold_5
35,5104001,5106000,1999,False,15,scaffold_5
36,5972001,5975000,2999,False,15,scaffold_5
37,6454001,6458000,3999,False,15,scaffold_5
38,6517001,6529000,11999,False,15,scaffold_5
39,6663001,6669000,5999,False,15,scaffold_5
40,6910001,6917000,6999,False,15,scaffold_5
41,6987001,6989000,1999,False,15,scaffold_5
42,7012001,7016000,3999,False,15,scaffold_5
43,7025001,7028000,2999,False,15,scaffold_5
44,7402001,7405000,2999,False,15,scaffold_5
45,7601001,7603000,1999,False,15,scaffold_5
46,7605001,7608000,2999,False,15,scaffold_5
47,7622001,7632000,9999,False,15,scaffold_5
48,7740001,7742000,1999,False,15,scaffold_5
49,7822001,7824000,1999,False,15,scaffold_5
50,7836001,7838000,1999,False,15,scaffold_5
51,8258001,8262000,3999,False,15,scaffold_5
52,8610001,8614000,3999,False,15,scaffold_5
53,8662001,8665000,2999,False,15,scaffold_5
54,8679001,8684000,4999,False,15,scaffold_5
55,8796001,8811000,14999,False,15,scaffold_5
56,8837001,8843000,5999,False,15,scaffold_5
57,8848001,8853000,4999,False,15,scaffold_5
58,8914001,8916000,1999,False,15,scaffold_5
59,8938001,8941000,2999,False,15,scaffold_5
60,8958001,8961000,2999,False,15,scaffold_5
61,8966001,8970000,3999,False,15,scaffold_5
62,8993001,8996000,2999,False,15,scaffold_5
63,9080001,9083000,2999,False,15,scaffold_5
64,9086001,9088000,1999,False,15,scaffold_5
65,9092001,9094000,1999,False,15,scaffold_5
66,9095001,9098000,2999,False,15,scaffold_5
67,9192001,9197000,4999,False,15,scaffold_5
68,9201001,9205000,3999,False,15,scaffold_5
69,9219001,9221000,1999,False,15,scaffold_5
70,9226001,9228000,1999,False,15,scaffold_5
71,9277001,9279000,1999,False,15,scaffold_5
72,9287001,9289000,1999,False,15,scaffold_5
73,9302001,9308000,5999,False,15,scaffold_5
74,9333001,9338000,4999,False,15,scaffold_5
0,1,4000,3999,True,15,scaffold_6
1,80001,84000,3999,False,15,scaffold_6
2,89001,96000,6999,False,15,scaffold_6
3,99001,112000,12999,False,15,scaffold_6
4,312001,314000,1999,False,15,scaffold_6
5,336001,339000,2999,False,15,scaffold_6
6,352001,358000,5999,False,15,scaffold_6
7,555001,559000,3999,False,15,scaffold_6
8,708001,712000,3999,False,15,scaffold_6
9,786001,794000,7999,False,15,scaffold_6
10,837001,842000,4999,False,15,scaffold_6
11,863001,870000,6999,False,15,scaffold_6
12,933001,940000,6999,False,15,scaffold_6
13,987001,1000000,12999,False,15,scaffold_6
14,1002001,1006000,3999,False,15,scaffold_6
15,1012001,1039000,26999,False,15,scaffold_6
16,1051001,1053000,1999,False,15,scaffold_6
17,1120001,1132000,11999,False,15,scaffold_6
18,1146001,1161000,14999,False,15,scaffold_6
19,1211001,1217000,5999,False,15,scaffold_6
20,1244001,1252000,7999,False,15,scaffold_6
21,1291001,1295000,3999,False,15,scaffold_6
22,1301001,1303000,1999,False,15,scaffold_6
23,1339001,1342000,2999,False,15,scaffold_6
24,1422001,1424000,1999,False,15,scaffold_6
25,1485001,1487000,1999,False,15,scaffold_6
26,1491001,1493000,1999,False,15,scaffold_6
27,1601001,1604000,2999,False,15,scaffold_6
28,1697001,1701000,3999,False,15,scaffold_6
29,1703001,1711000,7999,False,15,scaffold_6
30,1843001,1851000,7999,False,15,scaffold_6
31,1876001,1885000,8999,False,15,scaffold_6
32,1895001,1901000,5999,False,15,scaffold_6
33,2048001,2049000,999,False,15,scaffold_6
34,2058001,2062000,3999,False,15,scaffold_6
35,2074001,2077000,2999,False,15,scaffold_6
36,2240001,2248000,7999,False,15,scaffold_6
37,2308001,2313000,4999,False,15,scaffold_6
38,2375001,2380000,4999,False,15,scaffold_6
39,2439001,2441000,1999,False,15,scaffold_6
40,2485001,2492000,6999,False,15,scaffold_6
41,2494001,2506000,11999,False,15,scaffold_6
42,2528001,2531000,2999,False,15,scaffold_6
43,2636001,2639000,2999,False,15,scaffold_6
44,2670001,2675000,4999,False,15,scaffold_6
45,2791001,2796000,4999,False,15,scaffold_6
46,2797001,2801000,3999,False,15,scaffold_6
47,3417001,3419000,1999,False,15,scaffold_6
48,3477001,3479000,1999,False,15,scaffold_6
49,3605001,3608000,2999,False,15,scaffold_6
50,3615001,3624000,8999,False,15,scaffold_6
51,3791001,3794000,2999,False,15,scaffold_6
52,4190001,4194000,3999,False,15,scaffold_6
53,4735001,4741000,5999,False,15,scaffold_6
54,4838001,4876000,37999,False,15,scaffold_6
55,5022001,5025000,2999,False,15,scaffold_6
56,5730001,5733000,2999,False,15,scaffold_6
57,5791001,5794000,2999,False,15,scaffold_6
58,6024001,6027000,2999,False,15,scaffold_6
59,6028001,6031000,2999,False,15,scaffold_6
60,6178001,6186000,7999,False,15,scaffold_6
61,6252001,6257000,4999,False,15,scaffold_6
62,6302001,6305000,2999,False,15,scaffold_6
63,6569001,6571000,1999,False,15,scaffold_6
64,7007001,7010000,2999,False,15,scaffold_6
65,7095001,7098000,2999,False,15,scaffold_6
66,7271001,7274000,2999,False,15,scaffold_6
67,7346001,7350000,3999,False,15,scaffold_6
68,7601001,7605000,3999,False,15,scaffold_6
69,7705001,7709000,3999,False,15,scaffold_6
70,7832001,7839000,6999,False,15,scaffold_6
71,7923001,7925000,1999,False,15,scaffold_6
72,8028001,8037000,8999,False,15,scaffold_6
73,8105001,8108000,2999,False,15,scaffold_6
74,8116001,8120000,3999,False,15,scaffold_6
75,8139001,8146000,6999,False,15,scaffold_6
76,8238001,8241000,2999,False,15,scaffold_6
77,8249001,8254000,4999,False,15,scaffold_6
0,20001,34000,13999,False,15,scaffold_7
1,337001,340000,2999,False,15,scaffold_7
2,345001,348000,2999,False,15,scaffold_7
3,350001,354000,3999,False,15,scaffold_7
4,356001,362000,5999,False,15,scaffold_7
5,387001,408000,20999,False,15,scaffold_7
6,442001,447000,4999,False,15,scaffold_7
7,451001,459000,7999,False,15,scaffold_7
8,572001,577000,4999,False,15,scaffold_7
9,583001,586000,2999,False,15,scaffold_7
10,628001,632000,3999,False,15,scaffold_7
11,635001,636000,999,False,15,scaffold_7
12,652001,661000,8999,False,15,scaffold_7
13,688001,696000,7999,False,15,scaffold_7
14,721001,735000,13999,False,15,scaffold_7
15,741001,753000,11999,False,15,scaffold_7
16,785001,792000,6999,False,15,scaffold_7
17,793001,798000,4999,False,15,scaffold_7
18,859001,864000,4999,False,15,scaffold_7
19,880001,885000,4999,False,15,scaffold_7
20,900001,913000,12999,False,15,scaffold_7
21,969001,979000,9999,False,15,scaffold_7
22,982001,985000,2999,False,15,scaffold_7
23,1032001,1039000,6999,False,15,scaffold_7
24,1076001,1090000,13999,False,15,scaffold_7
25,1126001,1129000,2999,False,15,scaffold_7
26,1134001,1140000,5999,False,15,scaffold_7
27,1173001,1187000,13999,False,15,scaffold_7
28,1192001,1207000,14999,False,15,scaffold_7
29,1236001,1239000,2999,False,15,scaffold_7
30,1253001,1259000,5999,False,15,scaffold_7
31,1443001,1448000,4999,False,15,scaffold_7
32,1461001,1467000,5999,False,15,scaffold_7
33,1486001,1496000,9999,False,15,scaffold_7
34,1514001,1517000,2999,False,15,scaffold_7
35,1743001,1753000,9999,False,15,scaffold_7
36,1771001,1780000,8999,False,15,scaffold_7
37,1862001,1865000,2999,False,15,scaffold_7
38,1888001,1897000,8999,False,15,scaffold_7
39,2607001,2612000,4999,False,15,scaffold_7
40,2847001,2850000,2999,False,15,scaffold_7
41,3079001,3081000,1999,False,15,scaffold_7
42,3114001,3116000,1999,False,15,scaffold_7
43,3306001,3311000,4999,False,15,scaffold_7
44,3318001,3320000,1999,False,15,scaffold_7
45,3362001,3365000,2999,False,15,scaffold_7
46,3616001,3618000,1999,False,15,scaffold_7
47,3680001,3682000,1999,False,15,scaffold_7
48,3776001,3778000,1999,False,15,scaffold_7
49,3919001,3923000,3999,False,15,scaffold_7
50,3937001,3939000,1999,False,15,scaffold_7
51,4014001,4016000,1999,False,15,scaffold_7
52,4028001,4039000,10999,False,15,scaffold_7
53,4059001,4062000,2999,False,15,scaffold_7
54,4305001,4308000,2999,False,15,scaffold_7
55,4338001,4340000,1999,False,15,scaffold_7
56,5006001,5009000,2999,False,15,scaffold_7
57,5013001,5015000,1999,False,15,scaffold_7
58,5501001,5504000,2999,False,15,scaffold_7
59,5815001,5820000,4999,False,15,scaffold_7
60,5961001,5964000,2999,False,15,scaffold_7
61,5967001,5969000,1999,False,15,scaffold_7
62,6086001,6091000,4999,False,15,scaffold_7
63,6244001,6246000,1999,False,15,scaffold_7
64,6328001,6332000,3999,False,15,scaffold_7
65,6386001,6388000,1999,False,15,scaffold_7
66,6774001,6778000,3999,False,15,scaffold_7
67,7048001,7052000,3999,False,15,scaffold_7
68,7097001,7100000,2999,False,15,scaffold_7
69,7127001,7129000,1999,False,15,scaffold_7
70,7163001,7165000,1999,False,15,scaffold_7
71,7168001,7171000,2999,False,15,scaffold_7
72,7432001,7435000,2999,False,15,scaffold_7
73,7443001,7448000,4999,False,15,scaffold_7
74,7468001,7470000,1999,False,15,scaffold_7
75,7478001,7480000,1999,False,15,scaffold_7
76,7486001,7490000,3999,False,15,scaffold_7
0,3001,5000,1999,False,15,scaffold_8
1,32001,45000,12999,False,15,scaffold_8
2,74001,78000,3999,False,15,scaffold_8
3,82001,85000,2999,False,15,scaffold_8
4,218001,223000,4999,False,15,scaffold_8
5,346001,348000,1999,False,15,scaffold_8
6,541001,545000,3999,False,15,scaffold_8
7,977001,980000,2999,False,15,scaffold_8
8,1130001,1133000,2999,False,15,scaffold_8
9,1148001,1155000,6999,False,15,scaffold_8
10,1218001,1220000,1999,False,15,scaffold_8
11,1270001,1273000,2999,False,15,scaffold_8
12,1384001,1389000,4999,False,15,scaffold_8
13,1400001,1404000,3999,False,15,scaffold_8
14,1567001,1570000,2999,False,15,scaffold_8
15,1673001,1676000,2999,False,15,scaffold_8
16,1748001,1750000,1999,False,15,scaffold_8
17,1766001,1770000,3999,False,15,scaffold_8
18,1959001,1961000,1999,False,15,scaffold_8
19,2052001,2056000,3999,False,15,scaffold_8
20,2278001,2283000,4999,False,15,scaffold_8
21,2368001,2370000,1999,False,15,scaffold_8
22,2463001,2469000,5999,False,15,scaffold_8
23,2520001,2526000,5999,False,15,scaffold_8
24,2577001,2580000,2999,False,15,scaffold_8
25,2639001,2641000,1999,False,15,scaffold_8
26,2657001,2663000,5999,False,15,scaffold_8
27,2846001,2871000,24999,False,15,scaffold_8
28,3008001,3011000,2999,False,15,scaffold_8
29,3013001,3030000,16999,False,15,scaffold_8
30,3098001,3104000,5999,False,15,scaffold_8
31,3108001,3117000,8999,False,15,scaffold_8
32,3215001,3222000,6999,False,15,scaffold_8
33,3288001,3291000,2999,False,15,scaffold_8
34,3294001,3304000,9999,False,15,scaffold_8
35,3309001,3316000,6999,False,15,scaffold_8
36,3379001,3381000,1999,False,15,scaffold_8
37,3527001,3530000,2999,False,15,scaffold_8
38,3615001,3629000,13999,False,15,scaffold_8
39,3672001,3676000,3999,False,15,scaffold_8
40,3684001,3691000,6999,False,15,scaffold_8
41,3713001,3716000,2999,False,15,scaffold_8
42,3746001,3749000,2999,False,15,scaffold_8
43,3751001,3754000,2999,False,15,scaffold_8
44,3802001,3804000,1999,False,15,scaffold_8
45,3862001,3871000,8999,False,15,scaffold_8
46,3930001,3932000,1999,False,15,scaffold_8
47,4131001,4138000,6999,False,15,scaffold_8
48,4243001,4248000,4999,False,15,scaffold_8
49,4350001,4356000,5999,False,15,scaffold_8
50,4361001,4367000,5999,False,15,scaffold_8
51,4477001,4481000,3999,False,15,scaffold_8
52,4557001,4562000,4999,False,15,scaffold_8
53,4775001,4777000,1999,False,15,scaffold_8
54,5170001,5175000,4999,False,15,scaffold_8
55,5184001,5189000,4999,False,15,scaffold_8
56,5203001,5216000,12999,False,15,scaffold_8
57,5322001,5324000,1999,False,15,scaffold_8
58,5382001,5387000,4999,False,15,scaffold_8
59,5580001,5586000,5999,False,15,scaffold_8
60,5698001,5707000,8999,False,15,scaffold_8
61,5750001,5775000,24999,False,15,scaffold_8
62,6333001,6334544,1543,True,15,scaffold_8
0,67001,71000,3999,False,15,scaffold_9
1,121001,129000,7999,False,15,scaffold_9
2,271001,276000,4999,False,15,scaffold_9
3,297001,315000,17999,False,15,scaffold_9
4,319001,331000,11999,False,15,scaffold_9
5,369001,404000,34999,False,15,scaffold_9
6,409001,411000,1999,False,15,scaffold_9
7,415001,434000,18999,False,15,scaffold_9
8,491001,499000,7999,False,15,scaffold_9
9,520001,525000,4999,False,15,scaffold_9
10,532001,536000,3999,False,15,scaffold_9
11,550001,564000,13999,False,15,scaffold_9
12,652001,659000,6999,False,15,scaffold_9
13,660001,664000,3999,False,15,scaffold_9
14,679001,693000,13999,False,15,scaffold_9
15,900001,903000,2999,False,15,scaffold_9
16,905001,911000,5999,False,15,scaffold_9
17,915001,923000,7999,False,15,scaffold_9
18,934001,941000,6999,False,15,scaffold_9
19,942001,948000,5999,False,15,scaffold_9
20,1001001,1007000,5999,False,15,scaffold_9
21,1091001,1102000,10999,False,15,scaffold_9
22,1122001,1124000,1999,False,15,scaffold_9
23,1142001,1165000,22999,False,15,scaffold_9
24,1316001,1330000,13999,False,15,scaffold_9
25,1356001,1377000,20999,False,15,scaffold_9
26,1417001,1423000,5999,False,15,scaffold_9
27,1457001,1464000,6999,False,15,scaffold_9
28,1550001,1592000,41999,False,15,scaffold_9
29,1599001,1615000,15999,False,15,scaffold_9
30,1616001,1621000,4999,False,15,scaffold_9
31,1672001,1674000,1999,False,15,scaffold_9
32,1814001,1819000,4999,False,15,scaffold_9
33,1841001,1846000,4999,False,15,scaffold_9
34,1848001,1852000,3999,False,15,scaffold_9
35,1893001,1900000,6999,False,15,scaffold_9
36,1987001,1998000,10999,False,15,scaffold_9
37,2027001,2036000,8999,False,15,scaffold_9
38,2039001,2042000,2999,False,15,scaffold_9
39,2077001,2083000,5999,False,15,scaffold_9
40,2087001,2133000,45999,False,15,scaffold_9
41,2164001,2167000,2999,False,15,scaffold_9
42,2169001,2171000,1999,False,15,scaffold_9
43,2176001,2186000,9999,False,15,scaffold_9
44,2228001,2239000,10999,False,15,scaffold_9
45,2506001,2514000,7999,False,15,scaffold_9
46,2715001,2722000,6999,False,15,scaffold_9
47,2754001,2758000,3999,False,15,scaffold_9
48,2801001,2803000,1999,False,15,scaffold_9
49,2805001,2813000,7999,False,15,scaffold_9
50,2884001,2886000,1999,False,15,scaffold_9
51,2950001,2958000,7999,False,15,scaffold_9
52,3136001,3139000,2999,False,15,scaffold_9
53,3176001,3178000,1999,False,15,scaffold_9
54,3181001,3190000,8999,False,15,scaffold_9
55,3196001,3199000,2999,False,15,scaffold_9
56,3229001,3231000,1999,False,15,scaffold_9
57,3240001,3249000,8999,False,15,scaffold_9
58,3294001,3298000,3999,False,15,scaffold_9
59,3383001,3386000,2999,False,15,scaffold_9
60,3407001,3411000,3999,False,15,scaffold_9
61,3481001,3484000,2999,False,15,scaffold_9
62,3552001,3555000,2999,False,15,scaffold_9
63,3560001,3563000,2999,False,15,scaffold_9
64,3605001,3609000,3999,False,15,scaffold_9
65,4017001,4021000,3999,False,15,scaffold_9
66,4087001,4094000,6999,False,15,scaffold_9
67,4146001,4152000,5999,False,15,scaffold_9
68,4185001,4188000,2999,False,15,scaffold_9
69,4212001,4215000,2999,False,15,scaffold_9
70,4217001,4238000,20999,False,15,scaffold_9
71,4239001,4242000,2999,False,15,scaffold_9
72,4250001,4253000,2999,False,15,scaffold_9
73,4258001,4262000,3999,False,15,scaffold_9
74,4274001,4276000,1999,False,15,scaffold_9
75,4457001,4459000,1999,False,15,scaffold_9
76,4527001,4530000,2999,False,15,scaffold_9
77,4538001,4540000,1999,False,15,scaffold_9
78,4549001,4552000,2999,False,15,scaffold_9
79,4580001,4587000,6999,False,15,scaffold_9
80,4618001,4625000,6999,False,15,scaffold_9
81,4634001,4636000,1999,False,15,scaffold_9
82,4639001,4643000,3999,False,15,scaffold_9
83,4672001,4709000,36999,False,15,scaffold_9
84,4728001,4751000,22999,False,15,scaffold_9
85,4774001,4781000,6999,False,15,scaffold_9
86,4793001,4811000,17999,False,15,scaffold_9
87,4812001,4831000,18999,False,15,scaffold_9
88,4832001,4836000,3999,False,15,scaffold_9
89,4841001,4850000,8999,False,15,scaffold_9
90,4864001,4874000,9999,False,15,scaffold_9
91,4901001,4911000,9999,False,15,scaffold_9
92,4922001,4964000,41999,False,15,scaffold_9
93,4990001,4993000,2999,False,15,scaffold_9
94,5025001,5027000,1999,False,15,scaffold_9
95,5101001,5107000,5999,False,15,scaffold_9
96,5133001,5145000,11999,False,15,scaffold_9
97,5157001,5172000,14999,False,15,scaffold_9
98,5239001,5242000,2999,False,15,scaffold_9
99,5271001,5283000,11999,False,15,scaffold_9
100,5295001,5298000,2999,False,15,scaffold_9
101,5309001,5312000,2999,False,15,scaffold_9
102,5328001,5330000,1999,False,15,scaffold_9
103,5335001,5338000,2999,False,15,scaffold_9
104,5341001,5352000,10999,False,15,scaffold_9
105,5356001,5358000,1999,False,15,scaffold_9
106,5364001,5368000,3999,False,15,scaffold_9
107,5447001,5451000,3999,False,15,scaffold_9
108,5452001,5455000,2999,False,15,scaffold_9
109,5472001,5477000,4999,False,15,scaffold_9
110,5481001,5483000,1999,False,15,scaffold_9
111,5513001,5516000,2999,False,15,scaffold_9
112,5538001,5540000,1999,False,15,scaffold_9
113,5584001,5586000,1999,False,15,scaffold_9
114,5594001,5597000,2999,False,15,scaffold_9
115,5660001,5671000,10999,False,15,scaffold_9
116,5674001,5683000,8999,False,15,scaffold_9
117,5720001,5724000,3999,False,15,scaffold_9
118,5798001,5805000,6999,False,15,scaffold_9
119,5827001,5834000,6999,False,15,scaffold_9
120,5871001,5873000,1999,False,15,scaffold_9
121,5881001,5885000,3999,False,15,scaffold_9
122,5893001,5896000,2999,False,15,scaffold_9
123,5986001,5994000,7999,False,15,scaffold_9
124,5998001,6002000,3999,False,15,scaffold_9
125,6011001,6018000,6999,False,15,scaffold_9
126,6020001,6022000,1999,False,15,scaffold_9
127,6031001,6037000,5999,False,15,scaffold_9
128,6060001,6062000,1999,False,15,scaffold_9
129,6068001,6071000,2999,False,15,scaffold_9
130,6110001,6116000,5999,False,15,scaffold_9
131,6118001,6121000,2999,False,15,scaffold_9
132,6125001,6133000,7999,False,15,scaffold_9
133,6155001,6173000,17999,False,15,scaffold_9
134,6331001,6331288,287,True,15,scaffold_9
0,34001,39000,4999,False,15,scaffold_10
1,41001,89000,47999,False,15,scaffold_10
2,109001,114000,4999,False,15,scaffold_10
3,119001,128000,8999,False,15,scaffold_10
4,260001,268000,7999,False,15,scaffold_10
5,269001,284000,14999,False,15,scaffold_10
6,308001,320000,11999,False,15,scaffold_10
7,355001,367000,11999,False,15,scaffold_10
8,387001,395000,7999,False,15,scaffold_10
9,481001,482000,999,False,15,scaffold_10
10,577001,584000,6999,False,15,scaffold_10
11,687001,690000,2999,False,15,scaffold_10
12,1016001,1019000,2999,False,15,scaffold_10
13,1037001,1042000,4999,False,15,scaffold_10
14,1234001,1236000,1999,False,15,scaffold_10
15,1316001,1319000,2999,False,15,scaffold_10
16,1370001,1374000,3999,False,15,scaffold_10
17,1413001,1420000,6999,False,15,scaffold_10
18,1501001,1523000,21999,False,15,scaffold_10
19,1541001,1553000,11999,False,15,scaffold_10
20,1707001,1711000,3999,False,15,scaffold_10
21,1804001,1817000,12999,False,15,scaffold_10
22,1888001,1890000,1999,False,15,scaffold_10
23,1925001,1928000,2999,False,15,scaffold_10
24,2053001,2061000,7999,False,15,scaffold_10
25,2090001,2097000,6999,False,15,scaffold_10
26,2120001,2122000,1999,False,15,scaffold_10
27,2185001,2191000,5999,False,15,scaffold_10
28,2241001,2252000,10999,False,15,scaffold_10
29,2270001,2300000,29999,False,15,scaffold_10
30,2366001,2368000,1999,False,15,scaffold_10
31,2409001,2425000,15999,False,15,scaffold_10
32,2473001,2476000,2999,False,15,scaffold_10
33,2545001,2567000,21999,False,15,scaffold_10
34,2602001,2620000,17999,False,15,scaffold_10
35,2685001,2707000,21999,False,15,scaffold_10
36,2715001,2729000,13999,False,15,scaffold_10
37,2731001,2750000,18999,False,15,scaffold_10
38,2808001,2812000,3999,False,15,scaffold_10
39,2853001,2859000,5999,False,15,scaffold_10
40,2941001,2953000,11999,False,15,scaffold_10
41,3154001,3157000,2999,False,15,scaffold_10
42,3373001,3383000,9999,False,15,scaffold_10
43,3398001,3401000,2999,False,15,scaffold_10
44,3575001,3584000,8999,False,15,scaffold_10
45,3776001,3789000,12999,False,15,scaffold_10
46,4201001,4206000,4999,False,15,scaffold_10
47,4444001,4450000,5999,False,15,scaffold_10
48,4467001,4469000,1999,False,15,scaffold_10
49,4500001,4502000,1999,False,15,scaffold_10
50,4503001,4513000,9999,False,15,scaffold_10
51,4531001,4534000,2999,False,15,scaffold_10
52,4540001,4548000,7999,False,15,scaffold_10
53,4672001,4678000,5999,False,15,scaffold_10
54,4700001,4705000,4999,False,15,scaffold_10
55,4717001,4720000,2999,False,15,scaffold_10
56,4734001,4763000,28999,False,15,scaffold_10
57,4769001,4776000,6999,False,15,scaffold_10
58,4798001,4824000,25999,False,15,scaffold_10
59,4827001,4839000,11999,False,15,scaffold_10
60,4848001,4854000,5999,False,15,scaffold_10
61,4865001,4866973,1972,True,15,scaffold_10
0,13001,34000,20999,False,15,scaffold_11
1,47001,49000,1999,False,15,scaffold_11
2,65001,68000,2999,False,15,scaffold_11
3,79001,85000,5999,False,15,scaffold_11
4,88001,93000,4999,False,15,scaffold_11
5,146001,167000,20999,False,15,scaffold_11
6,242001,255000,12999,False,15,scaffold_11
7,291001,304000,12999,False,15,scaffold_11
8,350001,353000,2999,False,15,scaffold_11
9,404001,408000,3999,False,15,scaffold_11
10,411001,416000,4999,False,15,scaffold_11
11,419001,425000,5999,False,15,scaffold_11
12,433001,443000,9999,False,15,scaffold_11
13,651001,654000,2999,False,15,scaffold_11
14,747001,750000,2999,False,15,scaffold_11
15,860001,866000,5999,False,15,scaffold_11
16,916001,919000,2999,False,15,scaffold_11
17,1028001,1034000,5999,False,15,scaffold_11
18,1108001,1113000,4999,False,15,scaffold_11
19,1210001,1212000,1999,False,15,scaffold_11
20,1326001,1338000,11999,False,15,scaffold_11
21,1359001,1368000,8999,False,15,scaffold_11
22,1423001,1425000,1999,False,15,scaffold_11
23,1635001,1640000,4999,False,15,scaffold_11
24,1732001,1737000,4999,False,15,scaffold_11
25,2031001,2034000,2999,False,15,scaffold_11
26,2035001,2055000,19999,False,15,scaffold_11
27,2503001,2505000,1999,False,15,scaffold_11
28,2611001,2613000,1999,False,15,scaffold_11
29,2735001,2739000,3999,False,15,scaffold_11
30,3160001,3165000,4999,False,15,scaffold_11
31,3223001,3240000,16999,False,15,scaffold_11
32,3267001,3278000,10999,False,15,scaffold_11
33,3280001,3290000,9999,False,15,scaffold_11
34,3486001,3492000,5999,False,15,scaffold_11
35,3548001,3556000,7999,False,15,scaffold_11
36,3559001,3577000,17999,False,15,scaffold_11
37,3593001,3598000,4999,False,15,scaffold_11
38,3629001,3634000,4999,False,15,scaffold_11
39,3647001,3650000,2999,False,15,scaffold_11
40,3881001,3884000,2999,False,15,scaffold_11
41,3970001,3972000,1999,False,15,scaffold_11
42,3983001,3988000,4999,False,15,scaffold_11
43,4149001,4151000,1999,False,15,scaffold_11
44,4192001,4210000,17999,False,15,scaffold_11
45,4258001,4269000,10999,False,15,scaffold_11
46,4328001,4342000,13999,False,15,scaffold_11
47,4373001,4386000,12999,False,15,scaffold_11
48,4395001,4402000,6999,False,15,scaffold_11
49,4404001,4418000,13999,False,15,scaffold_11
50,4561001,4564000,2999,False,15,scaffold_11
51,4569001,4580000,10999,False,15,scaffold_11
52,4617001,4621000,3999,False,15,scaffold_11
53,4623001,4626000,2999,False,15,scaffold_11
54,4760001,4766820,6819,True,15,scaffold_11
0,22001,27000,4999,False,15,scaffold_12
1,29001,34000,4999,False,15,scaffold_12
2,56001,58000,1999,False,15,scaffold_12
3,66001,73000,6999,False,15,scaffold_12
4,114001,122000,7999,False,15,scaffold_12
5,170001,202000,31999,False,15,scaffold_12
6,206001,214000,7999,False,15,scaffold_12
7,231001,237000,5999,False,15,scaffold_12
8,827001,831000,3999,False,15,scaffold_12
9,900001,906000,5999,False,15,scaffold_12
10,1003001,1005000,1999,False,15,scaffold_12
11,1030001,1033000,2999,False,15,scaffold_12
12,1053001,1057000,3999,False,15,scaffold_12
13,1070001,1074000,3999,False,15,scaffold_12
14,1076001,1078000,1999,False,15,scaffold_12
15,1177001,1181000,3999,False,15,scaffold_12
16,1251001,1255000,3999,False,15,scaffold_12
17,1310001,1314000,3999,False,15,scaffold_12
18,1318001,1324000,5999,False,15,scaffold_12
19,1329001,1337000,7999,False,15,scaffold_12
20,1410001,1412000,1999,False,15,scaffold_12
21,1463001,1466000,2999,False,15,scaffold_12
22,1467001,1471000,3999,False,15,scaffold_12
23,1934001,1962000,27999,False,15,scaffold_12
24,2043001,2110000,66999,False,15,scaffold_12
25,2203001,2213000,9999,False,15,scaffold_12
26,2304001,2315000,10999,False,15,scaffold_12
27,2500001,2502000,1999,False,15,scaffold_12
28,2571001,2573000,1999,False,15,scaffold_12
29,2575001,2580000,4999,False,15,scaffold_12
30,2586001,2604000,17999,False,15,scaffold_12
31,2652001,2656000,3999,False,15,scaffold_12
32,2673001,2678000,4999,False,15,scaffold_12
33,2685001,2687000,1999,False,15,scaffold_12
34,2737001,2744000,6999,False,15,scaffold_12
35,2747001,2747968,967,True,15,scaffold_12
0,1,38000,37999,True,16,scaffold_1
1,64001,88000,23999,False,16,scaffold_1
2,90001,115000,24999,False,16,scaffold_1
3,116001,126000,9999,False,16,scaffold_1
4,131001,134000,2999,False,16,scaffold_1
5,138001,141000,2999,False,16,scaffold_1
6,144001,172000,27999,False,16,scaffold_1
7,173001,231000,57999,False,16,scaffold_1
8,233001,247000,13999,False,16,scaffold_1
9,249001,305000,55999,False,16,scaffold_1
10,488001,497000,8999,False,16,scaffold_1
11,702001,706000,3999,False,16,scaffold_1
12,791001,811000,19999,False,16,scaffold_1
13,1281001,1292000,10999,False,16,scaffold_1
14,3193001,3203000,9999,False,16,scaffold_1
15,3419001,3421000,1999,False,16,scaffold_1
16,3489001,3492000,2999,False,16,scaffold_1
17,4342001,4355000,12999,False,16,scaffold_1
18,4927001,4951000,23999,False,16,scaffold_1
19,4953001,4995000,41999,False,16,scaffold_1
20,6108001,6117000,8999,False,16,scaffold_1
21,6162001,6172000,9999,False,16,scaffold_1
22,6256001,6266000,9999,False,16,scaffold_1
23,6485001,6491000,5999,False,16,scaffold_1
24,6492001,6500000,7999,False,16,scaffold_1
25,7041001,7048000,6999,False,16,scaffold_1
26,7049001,7061000,11999,False,16,scaffold_1
27,7070001,7085000,14999,False,16,scaffold_1
28,7098001,7120000,21999,False,16,scaffold_1
29,7121001,7147000,25999,False,16,scaffold_1
30,7151001,7176000,24999,False,16,scaffold_1
31,7216001,7242000,25999,False,16,scaffold_1
32,7244001,7247000,2999,False,16,scaffold_1
33,7248001,7258000,9999,False,16,scaffold_1
34,7282001,7350000,67999,False,16,scaffold_1
35,7354001,7366000,11999,False,16,scaffold_1
36,7370001,7382000,11999,False,16,scaffold_1
37,7383001,7475000,91999,False,16,scaffold_1
38,7477001,7481000,3999,False,16,scaffold_1
39,7493001,7528000,34999,False,16,scaffold_1
40,7531001,7539000,7999,False,16,scaffold_1
41,7550001,7561000,10999,False,16,scaffold_1
42,7590001,7631000,40999,False,16,scaffold_1
43,7642001,7678000,35999,False,16,scaffold_1
44,7679001,7695000,15999,False,16,scaffold_1
45,7719001,7742000,22999,False,16,scaffold_1
46,7743001,7775000,31999,False,16,scaffold_1
47,7782001,7794000,11999,False,16,scaffold_1
48,7797001,7806000,8999,False,16,scaffold_1
49,7808001,7827000,18999,False,16,scaffold_1
50,7829001,7831000,1999,False,16,scaffold_1
51,7832001,7881000,48999,False,16,scaffold_1
52,7915001,7921000,5999,False,16,scaffold_1
53,7924001,7970000,45999,False,16,scaffold_1
54,7995001,8058000,62999,False,16,scaffold_1
55,8061001,8090000,28999,False,16,scaffold_1
56,8100001,8138000,37999,False,16,scaffold_1
57,8139001,8202000,62999,False,16,scaffold_1
58,8221001,8259000,37999,False,16,scaffold_1
59,8260001,8331000,70999,False,16,scaffold_1
60,8332001,8344000,11999,False,16,scaffold_1
61,8382001,8394000,11999,False,16,scaffold_1
62,8432001,8439000,6999,False,16,scaffold_1
63,8503001,8571000,67999,False,16,scaffold_1
64,8603001,8622000,18999,False,16,scaffold_1
65,8627001,8637000,9999,False,16,scaffold_1
66,8646001,8656000,9999,False,16,scaffold_1
67,8658001,8672000,13999,False,16,scaffold_1
68,8683001,8694000,10999,False,16,scaffold_1
69,8768001,8771000,2999,False,16,scaffold_1
70,8792001,8794000,1999,False,16,scaffold_1
71,8796001,8824000,27999,False,16,scaffold_1
72,8827001,8837000,9999,False,16,scaffold_1
73,8841001,8855000,13999,False,16,scaffold_1
74,8902001,8955000,52999,False,16,scaffold_1
75,8957001,9041000,83999,False,16,scaffold_1
76,9042001,9053000,10999,False,16,scaffold_1
77,9064001,9253000,188999,False,16,scaffold_1
78,9255001,9313000,57999,False,16,scaffold_1
79,9327001,9331000,3999,False,16,scaffold_1
80,9333001,9335000,1999,False,16,scaffold_1
81,9341001,9344000,2999,False,16,scaffold_1
82,9345001,9351000,5999,False,16,scaffold_1
83,9378001,9382000,3999,False,16,scaffold_1
84,9386001,9430000,43999,False,16,scaffold_1
85,9473001,9484000,10999,False,16,scaffold_1
86,9508001,9520000,11999,False,16,scaffold_1
87,9542001,9553000,10999,False,16,scaffold_1
88,9570001,9579000,8999,False,16,scaffold_1
89,9581001,9584000,2999,False,16,scaffold_1
90,9586001,9595000,8999,False,16,scaffold_1
91,9602001,9604000,1999,False,16,scaffold_1
92,9608001,9622000,13999,False,16,scaffold_1
93,9624001,9628000,3999,False,16,scaffold_1
94,9631001,9633000,1999,False,16,scaffold_1
95,9634001,9713000,78999,False,16,scaffold_1
96,9809001,9837000,27999,False,16,scaffold_1
97,9838001,9861000,22999,False,16,scaffold_1
98,9871001,9888000,16999,False,16,scaffold_1
99,9889001,9984000,94999,False,16,scaffold_1
100,10036001,10044000,7999,False,16,scaffold_1
101,10050001,10071000,20999,False,16,scaffold_1
102,10091001,10215000,123999,False,16,scaffold_1
103,10239001,10269000,29999,False,16,scaffold_1
104,10272001,10275000,2999,False,16,scaffold_1
105,10277001,10289000,11999,False,16,scaffold_1
106,10295001,10356000,60999,False,16,scaffold_1
107,10460001,10479000,18999,False,16,scaffold_1
108,10542001,10549000,6999,False,16,scaffold_1
109,10801001,10804000,2999,False,16,scaffold_1
110,10808001,10811000,2999,False,16,scaffold_1
111,10817001,10821000,3999,False,16,scaffold_1
112,12193001,12200000,6999,False,16,scaffold_1
113,12810001,12821000,10999,False,16,scaffold_1
114,12825001,12832000,6999,False,16,scaffold_1
115,13245001,13250000,4999,False,16,scaffold_1
116,13490001,13494000,3999,False,16,scaffold_1
117,13523001,13530000,6999,False,16,scaffold_1
118,13814001,13829000,14999,False,16,scaffold_1
119,13832001,13845000,12999,False,16,scaffold_1
120,14134001,14137000,2999,False,16,scaffold_1
121,14303001,14308000,4999,False,16,scaffold_1
122,14471001,14479000,7999,False,16,scaffold_1
123,14595001,14599000,3999,False,16,scaffold_1
124,14605001,14611000,5999,False,16,scaffold_1
0,168001,176000,7999,False,16,scaffold_2
1,300001,308000,7999,False,16,scaffold_2
2,309001,316000,6999,False,16,scaffold_2
3,342001,374000,31999,False,16,scaffold_2
4,379001,381000,1999,False,16,scaffold_2
5,1423001,1428000,4999,False,16,scaffold_2
6,2001001,2004000,2999,False,16,scaffold_2
7,2037001,2040000,2999,False,16,scaffold_2
8,2472001,2481000,8999,False,16,scaffold_2
9,2485001,2496000,10999,False,16,scaffold_2
10,3139001,3142000,2999,False,16,scaffold_2
11,3176001,3187000,10999,False,16,scaffold_2
12,3276001,3281000,4999,False,16,scaffold_2
13,3454001,3462000,7999,False,16,scaffold_2
14,3778001,3783000,4999,False,16,scaffold_2
15,4382001,4386000,3999,False,16,scaffold_2
16,4397001,4403000,5999,False,16,scaffold_2
17,5022001,5031000,8999,False,16,scaffold_2
18,5045001,5051000,5999,False,16,scaffold_2
19,5080001,5082000,1999,False,16,scaffold_2
20,5684001,5689000,4999,False,16,scaffold_2
21,6029001,6035000,5999,False,16,scaffold_2
22,6305001,6309000,3999,False,16,scaffold_2
23,6316001,6330000,13999,False,16,scaffold_2
24,6331001,6334000,2999,False,16,scaffold_2
25,7050001,7056000,5999,False,16,scaffold_2
26,7491001,7503000,11999,False,16,scaffold_2
27,7588001,7591000,2999,False,16,scaffold_2
28,7623001,7643000,19999,False,16,scaffold_2
29,7752001,7762000,9999,False,16,scaffold_2
30,7877001,7880000,2999,False,16,scaffold_2
31,7946001,7956000,9999,False,16,scaffold_2
32,8331001,8333000,1999,False,16,scaffold_2
33,9613001,9621000,7999,False,16,scaffold_2
34,11367001,11377000,9999,False,16,scaffold_2
35,11472001,11477000,4999,False,16,scaffold_2
36,11564001,11570000,5999,False,16,scaffold_2
37,11602001,11617000,14999,False,16,scaffold_2
38,11663001,11728000,64999,False,16,scaffold_2
0,43001,46000,2999,False,16,scaffold_3
1,51001,54000,2999,False,16,scaffold_3
2,897001,900000,2999,False,16,scaffold_3
3,1400001,1404000,3999,False,16,scaffold_3
4,1421001,1423000,1999,False,16,scaffold_3
5,1584001,1588000,3999,False,16,scaffold_3
6,1741001,1747000,5999,False,16,scaffold_3
7,1835001,1840000,4999,False,16,scaffold_3
8,2048001,2067000,18999,False,16,scaffold_3
9,2101001,2108000,6999,False,16,scaffold_3
10,2487001,2503000,15999,False,16,scaffold_3
11,2621001,2630000,8999,False,16,scaffold_3
12,3131001,3139000,7999,False,16,scaffold_3
13,3744001,3747000,2999,False,16,scaffold_3
14,3769001,3774000,4999,False,16,scaffold_3
15,4311001,4338000,26999,False,16,scaffold_3
16,4422001,4439000,16999,False,16,scaffold_3
17,4531001,4533000,1999,False,16,scaffold_3
18,4625001,4628000,2999,False,16,scaffold_3
19,6798001,6804000,5999,False,16,scaffold_3
20,6887001,6914000,26999,False,16,scaffold_3
21,7380001,7398000,17999,False,16,scaffold_3
22,8185001,8200000,14999,False,16,scaffold_3
23,8473001,8479000,5999,False,16,scaffold_3
24,8516001,8521000,4999,False,16,scaffold_3
25,8815001,8826000,10999,False,16,scaffold_3
26,10238001,10243000,4999,False,16,scaffold_3
27,10614001,10638000,23999,False,16,scaffold_3
28,10653001,10710000,56999,False,16,scaffold_3
29,10774001,10795000,20999,False,16,scaffold_3
30,10818001,10832000,13999,False,16,scaffold_3
31,10833001,10849000,15999,False,16,scaffold_3
32,10854001,10857000,2999,False,16,scaffold_3
33,10875001,10885000,9999,False,16,scaffold_3
34,10940001,10970000,29999,False,16,scaffold_3
35,11012001,11024000,11999,False,16,scaffold_3
36,11027001,11030000,2999,False,16,scaffold_3
37,11037001,11041000,3999,False,16,scaffold_3
38,11058001,11061000,2999,False,16,scaffold_3
39,11062001,11076000,13999,False,16,scaffold_3
40,11113001,11118000,4999,False,16,scaffold_3
41,11120001,11131000,10999,False,16,scaffold_3
42,11133001,11136000,2999,False,16,scaffold_3
43,11144001,11158000,13999,False,16,scaffold_3
44,11180001,11182071,2070,True,16,scaffold_3
0,17001,24000,6999,False,16,scaffold_4
1,48001,86000,37999,False,16,scaffold_4
2,147001,151000,3999,False,16,scaffold_4
3,185001,197000,11999,False,16,scaffold_4
4,201001,215000,13999,False,16,scaffold_4
5,217001,226000,8999,False,16,scaffold_4
6,345001,353000,7999,False,16,scaffold_4
7,355001,374000,18999,False,16,scaffold_4
8,429001,484000,54999,False,16,scaffold_4
9,485001,497000,11999,False,16,scaffold_4
10,548001,558000,9999,False,16,scaffold_4
11,565001,569000,3999,False,16,scaffold_4
12,612001,618000,5999,False,16,scaffold_4
13,620001,641000,20999,False,16,scaffold_4
14,653001,657000,3999,False,16,scaffold_4
15,1113001,1136000,22999,False,16,scaffold_4
16,1138001,1178000,39999,False,16,scaffold_4
17,1223001,1226000,2999,False,16,scaffold_4
18,1270001,1279000,8999,False,16,scaffold_4
19,1464001,1467000,2999,False,16,scaffold_4
20,1472001,1484000,11999,False,16,scaffold_4
21,1485001,1526000,40999,False,16,scaffold_4
22,1527001,1537000,9999,False,16,scaffold_4
23,1749001,1771000,21999,False,16,scaffold_4
24,1820001,1848000,27999,False,16,scaffold_4
25,1849001,1945000,95999,False,16,scaffold_4
26,1982001,2004000,21999,False,16,scaffold_4
27,2007001,2049000,41999,False,16,scaffold_4
28,2050001,2095000,44999,False,16,scaffold_4
29,2190001,2204000,13999,False,16,scaffold_4
30,2284001,2297000,12999,False,16,scaffold_4
31,2298001,2310000,11999,False,16,scaffold_4
32,2312001,2321000,8999,False,16,scaffold_4
33,2323001,2340000,16999,False,16,scaffold_4
34,2391001,2400000,8999,False,16,scaffold_4
35,2403001,2412000,8999,False,16,scaffold_4
36,2414001,2444000,29999,False,16,scaffold_4
37,2496001,2509000,12999,False,16,scaffold_4
38,2515001,2520000,4999,False,16,scaffold_4
39,2621001,2634000,12999,False,16,scaffold_4
40,2676001,2706000,29999,False,16,scaffold_4
41,3457001,3476000,18999,False,16,scaffold_4
42,3527001,3538000,10999,False,16,scaffold_4
43,3689001,3767000,77999,False,16,scaffold_4
44,4964001,4966000,1999,False,16,scaffold_4
45,5216001,5225000,8999,False,16,scaffold_4
46,5724001,5743000,18999,False,16,scaffold_4
47,5808001,5831000,22999,False,16,scaffold_4
48,7012001,7016000,3999,False,16,scaffold_4
49,8093001,8101000,7999,False,16,scaffold_4
50,8853001,8872000,18999,False,16,scaffold_4
51,8885001,8914000,28999,False,16,scaffold_4
52,8931001,8946000,14999,False,16,scaffold_4
53,8948001,8967000,18999,False,16,scaffold_4
54,8968001,8974000,5999,False,16,scaffold_4
55,8976001,8987000,10999,False,16,scaffold_4
56,8989001,8998000,8999,False,16,scaffold_4
57,9022001,9031000,8999,False,16,scaffold_4
58,9044001,9052000,7999,False,16,scaffold_4
59,9062001,9088000,25999,False,16,scaffold_4
60,9219001,9226000,6999,False,16,scaffold_4
61,9244001,9327000,82999,False,16,scaffold_4
62,9407001,9414000,6999,False,16,scaffold_4
63,9416001,9421000,4999,False,16,scaffold_4
64,9423001,9434000,10999,False,16,scaffold_4
65,9439001,9454000,14999,False,16,scaffold_4
66,9479001,9486000,6999,False,16,scaffold_4
67,9489001,9494000,4999,False,16,scaffold_4
68,9506001,9533000,26999,False,16,scaffold_4
69,9548001,9606000,57999,False,16,scaffold_4
70,9615001,9617000,1999,False,16,scaffold_4
71,9620001,9626000,5999,False,16,scaffold_4
72,9638001,9662000,23999,False,16,scaffold_4
73,9663001,9672000,8999,False,16,scaffold_4
74,9710001,9715000,4999,False,16,scaffold_4
75,9716001,9751000,34999,False,16,scaffold_4
76,9752001,9788000,35999,False,16,scaffold_4
77,9789001,9805000,15999,False,16,scaffold_4
78,9806001,9814000,7999,False,16,scaffold_4
0,1,4000,3999,True,16,scaffold_5
1,334001,350000,15999,False,16,scaffold_5
2,402001,410000,7999,False,16,scaffold_5
3,626001,636000,9999,False,16,scaffold_5
4,663001,666000,2999,False,16,scaffold_5
5,1553001,1556000,2999,False,16,scaffold_5
6,3168001,3179000,10999,False,16,scaffold_5
7,3180001,3183000,2999,False,16,scaffold_5
8,3456001,3458000,1999,False,16,scaffold_5
9,3939001,3946000,6999,False,16,scaffold_5
10,3963001,3972000,8999,False,16,scaffold_5
11,4128001,4140000,11999,False,16,scaffold_5
12,4603001,4614000,10999,False,16,scaffold_5
13,4617001,4628000,10999,False,16,scaffold_5
14,4839001,4853000,13999,False,16,scaffold_5
15,4854001,4857000,2999,False,16,scaffold_5
16,6481001,6490000,8999,False,16,scaffold_5
17,6515001,6529000,13999,False,16,scaffold_5
18,6690001,6692000,1999,False,16,scaffold_5
19,7621001,7633000,11999,False,16,scaffold_5
20,7688001,7719000,30999,False,16,scaffold_5
21,7722001,7727000,4999,False,16,scaffold_5
22,7835001,7839000,3999,False,16,scaffold_5
23,8724001,8750000,25999,False,16,scaffold_5
24,8781001,8812000,30999,False,16,scaffold_5
25,8813001,8819000,5999,False,16,scaffold_5
26,8821001,8846000,24999,False,16,scaffold_5
27,8847001,8912000,64999,False,16,scaffold_5
28,8914001,8917000,2999,False,16,scaffold_5
29,8919001,8934000,14999,False,16,scaffold_5
30,9008001,9015000,6999,False,16,scaffold_5
31,9020001,9073000,52999,False,16,scaffold_5
32,9092001,9098000,5999,False,16,scaffold_5
33,9110001,9118000,7999,False,16,scaffold_5
34,9119001,9131000,11999,False,16,scaffold_5
35,9165001,9170000,4999,False,16,scaffold_5
36,9171001,9177000,5999,False,16,scaffold_5
37,9183001,9198000,14999,False,16,scaffold_5
38,9265001,9279000,13999,False,16,scaffold_5
39,9283001,9286000,2999,False,16,scaffold_5
40,9287001,9331000,43999,False,16,scaffold_5
41,9333001,9339000,5999,False,16,scaffold_5
42,9341001,9348000,6999,False,16,scaffold_5
43,9350001,9364176,14175,True,16,scaffold_5
0,78001,84000,5999,False,16,scaffold_6
1,89001,97000,7999,False,16,scaffold_6
2,98001,112000,13999,False,16,scaffold_6
3,246001,254000,7999,False,16,scaffold_6
4,257001,262000,4999,False,16,scaffold_6
5,330001,333000,2999,False,16,scaffold_6
6,965001,974000,8999,False,16,scaffold_6
7,1284001,1298000,13999,False,16,scaffold_6
8,1339001,1342000,2999,False,16,scaffold_6
9,1843001,1859000,15999,False,16,scaffold_6
10,2155001,2168000,12999,False,16,scaffold_6
11,2382001,2396000,13999,False,16,scaffold_6
12,2410001,2444000,33999,False,16,scaffold_6
13,2458001,2463000,4999,False,16,scaffold_6
14,2761001,2779000,17999,False,16,scaffold_6
15,2781001,2790000,8999,False,16,scaffold_6
16,2791001,2796000,4999,False,16,scaffold_6
17,2799001,2807000,7999,False,16,scaffold_6
18,2979001,2981000,1999,False,16,scaffold_6
19,3283001,3292000,8999,False,16,scaffold_6
20,3468001,3471000,2999,False,16,scaffold_6
21,3481001,3488000,6999,False,16,scaffold_6
22,3661001,3679000,17999,False,16,scaffold_6
23,4136001,4149000,12999,False,16,scaffold_6
24,4836001,4861000,24999,False,16,scaffold_6
25,5405001,5407000,1999,False,16,scaffold_6
26,5774001,5788000,13999,False,16,scaffold_6
27,7056001,7066000,9999,False,16,scaffold_6
28,7601001,7605000,3999,False,16,scaffold_6
29,7632001,7634000,1999,False,16,scaffold_6
30,7710001,7717000,6999,False,16,scaffold_6
31,7753001,7771000,17999,False,16,scaffold_6
32,7864001,7881000,16999,False,16,scaffold_6
33,8105001,8120000,14999,False,16,scaffold_6
34,8235001,8268281,33280,True,16,scaffold_6
0,20001,31000,10999,False,16,scaffold_7
1,335001,340000,4999,False,16,scaffold_7
2,378001,412000,33999,False,16,scaffold_7
3,413001,419000,5999,False,16,scaffold_7
4,422001,431000,8999,False,16,scaffold_7
5,473001,483000,9999,False,16,scaffold_7
6,484001,508000,23999,False,16,scaffold_7
7,572001,576000,3999,False,16,scaffold_7
8,623001,625000,1999,False,16,scaffold_7
9,711001,735000,23999,False,16,scaffold_7
10,741001,753000,11999,False,16,scaffold_7
11,764001,782000,17999,False,16,scaffold_7
12,785001,799000,13999,False,16,scaffold_7
13,859001,864000,4999,False,16,scaffold_7
14,868001,871000,2999,False,16,scaffold_7
15,887001,897000,9999,False,16,scaffold_7
16,967001,980000,12999,False,16,scaffold_7
17,982001,1026000,43999,False,16,scaffold_7
18,1028001,1039000,10999,False,16,scaffold_7
19,1072001,1091000,18999,False,16,scaffold_7
20,1191001,1214000,22999,False,16,scaffold_7
21,1224001,1309000,84999,False,16,scaffold_7
22,1311001,1317000,5999,False,16,scaffold_7
23,1321001,1364000,42999,False,16,scaffold_7
24,1369001,1449000,79999,False,16,scaffold_7
25,1475001,1510000,34999,False,16,scaffold_7
26,1649001,1658000,8999,False,16,scaffold_7
27,1659001,1665000,5999,False,16,scaffold_7
28,3623001,3638000,14999,False,16,scaffold_7
29,3639001,3645000,5999,False,16,scaffold_7
30,3646001,3662000,15999,False,16,scaffold_7
31,3669001,3672000,2999,False,16,scaffold_7
32,4864001,4867000,2999,False,16,scaffold_7
33,5012001,5015000,2999,False,16,scaffold_7
34,6075001,6094000,18999,False,16,scaffold_7
35,7030001,7036000,5999,False,16,scaffold_7
36,7087001,7102000,14999,False,16,scaffold_7
37,7104001,7107000,2999,False,16,scaffold_7
38,7149001,7153000,3999,False,16,scaffold_7
39,7199001,7203000,3999,False,16,scaffold_7
40,7208001,7210000,1999,False,16,scaffold_7
41,7216001,7267000,50999,False,16,scaffold_7
42,7274001,7285000,10999,False,16,scaffold_7
43,7287001,7289000,1999,False,16,scaffold_7
44,7383001,7400000,16999,False,16,scaffold_7
45,7403001,7409000,5999,False,16,scaffold_7
46,7410001,7419000,8999,False,16,scaffold_7
47,7458001,7469000,10999,False,16,scaffold_7
48,7473001,7496000,22999,False,16,scaffold_7
49,7497001,7502216,5215,True,16,scaffold_7
0,93001,101000,7999,False,16,scaffold_8
1,299001,302000,2999,False,16,scaffold_8
2,672001,675000,2999,False,16,scaffold_8
3,1040001,1042000,1999,False,16,scaffold_8
4,1057001,1063000,5999,False,16,scaffold_8
5,2516001,2527000,10999,False,16,scaffold_8
6,2550001,2552000,1999,False,16,scaffold_8
7,2638001,2640000,1999,False,16,scaffold_8
8,2666001,2669000,2999,False,16,scaffold_8
9,2673001,2683000,9999,False,16,scaffold_8
10,3067001,3112000,44999,False,16,scaffold_8
11,3180001,3186000,5999,False,16,scaffold_8
12,3196001,3225000,28999,False,16,scaffold_8
13,3229001,3247000,17999,False,16,scaffold_8
14,3275001,3324000,48999,False,16,scaffold_8
15,3360001,3372000,11999,False,16,scaffold_8
16,3802001,3809000,6999,False,16,scaffold_8
17,3812001,3837000,24999,False,16,scaffold_8
18,4329001,4338000,8999,False,16,scaffold_8
19,5890001,5894000,3999,False,16,scaffold_8
20,6334001,6334544,543,True,16,scaffold_8
0,55001,57000,1999,False,16,scaffold_9
1,298001,311000,12999,False,16,scaffold_9
2,371001,393000,21999,False,16,scaffold_9
3,409001,411000,1999,False,16,scaffold_9
4,413001,434000,20999,False,16,scaffold_9
5,547001,563000,15999,False,16,scaffold_9
6,634001,636000,1999,False,16,scaffold_9
7,655001,659000,3999,False,16,scaffold_9
8,676001,697000,20999,False,16,scaffold_9
9,794001,801000,6999,False,16,scaffold_9
10,826001,841000,14999,False,16,scaffold_9
11,873001,890000,16999,False,16,scaffold_9
12,898001,926000,27999,False,16,scaffold_9
13,927001,941000,13999,False,16,scaffold_9
14,942001,986000,43999,False,16,scaffold_9
15,987001,995000,7999,False,16,scaffold_9
16,1001001,1007000,5999,False,16,scaffold_9
17,1066001,1083000,16999,False,16,scaffold_9
18,1087001,1106000,18999,False,16,scaffold_9
19,1109001,1140000,30999,False,16,scaffold_9
20,1141001,1150000,8999,False,16,scaffold_9
21,1151001,1166000,14999,False,16,scaffold_9
22,1275001,1277000,1999,False,16,scaffold_9
23,1321001,1345000,23999,False,16,scaffold_9
24,1347001,1377000,29999,False,16,scaffold_9
25,2040001,2063000,22999,False,16,scaffold_9
26,2159001,2172000,12999,False,16,scaffold_9
27,2922001,2982000,59999,False,16,scaffold_9
28,3001001,3089000,87999,False,16,scaffold_9
29,3092001,3115000,22999,False,16,scaffold_9
30,3119001,3141000,21999,False,16,scaffold_9
31,3156001,3170000,13999,False,16,scaffold_9
32,3194001,3310000,115999,False,16,scaffold_9
33,3312001,3334000,21999,False,16,scaffold_9
34,3383001,3387000,3999,False,16,scaffold_9
35,3404001,3413000,8999,False,16,scaffold_9
36,3418001,3423000,4999,False,16,scaffold_9
37,3424001,3455000,30999,False,16,scaffold_9
38,3508001,3541000,32999,False,16,scaffold_9
39,3564001,3574000,9999,False,16,scaffold_9
40,3575001,3676000,100999,False,16,scaffold_9
41,3679001,3693000,13999,False,16,scaffold_9
42,3694001,3732000,37999,False,16,scaffold_9
43,3733001,3744000,10999,False,16,scaffold_9
44,3747001,4035000,287999,False,16,scaffold_9
45,4036001,4042000,5999,False,16,scaffold_9
46,4047001,4168000,120999,False,16,scaffold_9
47,4177001,4211000,33999,False,16,scaffold_9
48,4212001,4241000,28999,False,16,scaffold_9
49,4242001,4247000,4999,False,16,scaffold_9
50,4248001,4253000,4999,False,16,scaffold_9
51,4257001,4266000,8999,False,16,scaffold_9
52,4267001,4325000,57999,False,16,scaffold_9
53,4326001,4364000,37999,False,16,scaffold_9
54,4402001,4495000,92999,False,16,scaffold_9
55,4497001,4520000,22999,False,16,scaffold_9
56,4522001,4576000,53999,False,16,scaffold_9
57,4579001,4599000,19999,False,16,scaffold_9
58,4600001,4631000,30999,False,16,scaffold_9
59,4634001,4772000,137999,False,16,scaffold_9
60,4773001,4792000,18999,False,16,scaffold_9
61,4794001,4831000,36999,False,16,scaffold_9
62,4832001,4836000,3999,False,16,scaffold_9
63,4840001,4854000,13999,False,16,scaffold_9
64,4863001,4875000,11999,False,16,scaffold_9
65,4878001,4944000,65999,False,16,scaffold_9
66,4954001,4966000,11999,False,16,scaffold_9
67,4968001,5012000,43999,False,16,scaffold_9
68,5049001,5070000,20999,False,16,scaffold_9
69,5074001,5089000,14999,False,16,scaffold_9
70,5092001,5099000,6999,False,16,scaffold_9
71,5101001,5107000,5999,False,16,scaffold_9
72,5112001,5129000,16999,False,16,scaffold_9
73,5133001,5174000,40999,False,16,scaffold_9
74,5197001,5222000,24999,False,16,scaffold_9
75,5239001,5256000,16999,False,16,scaffold_9
76,5271001,5283000,11999,False,16,scaffold_9
77,5308001,5326000,17999,False,16,scaffold_9
78,5347001,5352000,4999,False,16,scaffold_9
79,5366001,5387000,20999,False,16,scaffold_9
80,5388001,5392000,3999,False,16,scaffold_9
81,5403001,5410000,6999,False,16,scaffold_9
82,5412001,5430000,17999,False,16,scaffold_9
83,5431001,5449000,17999,False,16,scaffold_9
84,5467001,5489000,21999,False,16,scaffold_9
85,5497001,5510000,12999,False,16,scaffold_9
86,5515001,5522000,6999,False,16,scaffold_9
87,5525001,5533000,7999,False,16,scaffold_9
88,5550001,5557000,6999,False,16,scaffold_9
89,5558001,5564000,5999,False,16,scaffold_9
90,5569001,5574000,4999,False,16,scaffold_9
91,5654001,5672000,17999,False,16,scaffold_9
92,5673001,5695000,21999,False,16,scaffold_9
93,5716001,5737000,20999,False,16,scaffold_9
94,5744001,5822000,77999,False,16,scaffold_9
95,5823001,5896000,72999,False,16,scaffold_9
96,5913001,6002000,88999,False,16,scaffold_9
97,6031001,6037000,5999,False,16,scaffold_9
98,6051001,6062000,10999,False,16,scaffold_9
99,6064001,6068000,3999,False,16,scaffold_9
100,6079001,6106000,26999,False,16,scaffold_9
101,6122001,6210000,87999,False,16,scaffold_9
102,6229001,6258000,28999,False,16,scaffold_9
103,6267001,6282000,14999,False,16,scaffold_9
104,6314001,6331288,17287,True,16,scaffold_9
0,1,32000,31999,True,16,scaffold_10
1,35001,211000,175999,False,16,scaffold_10
2,290001,319000,28999,False,16,scaffold_10
3,336001,354000,17999,False,16,scaffold_10
4,698001,743000,44999,False,16,scaffold_10
5,1056001,1062000,5999,False,16,scaffold_10
6,1435001,1458000,22999,False,16,scaffold_10
7,2091001,2097000,5999,False,16,scaffold_10
8,2268001,2311000,42999,False,16,scaffold_10
9,2350001,2357000,6999,False,16,scaffold_10
10,2601001,2621000,19999,False,16,scaffold_10
11,2735001,2748000,12999,False,16,scaffold_10
12,3819001,3822000,2999,False,16,scaffold_10
13,4068001,4087000,18999,False,16,scaffold_10
14,4467001,4470000,2999,False,16,scaffold_10
15,4498001,4502000,3999,False,16,scaffold_10
16,4503001,4513000,9999,False,16,scaffold_10
17,4528001,4534000,5999,False,16,scaffold_10
18,4535001,4548000,12999,False,16,scaffold_10
19,4582001,4597000,14999,False,16,scaffold_10
20,4685001,4687000,1999,False,16,scaffold_10
21,4734001,4751000,16999,False,16,scaffold_10
22,4752001,4766000,13999,False,16,scaffold_10
23,4798001,4824000,25999,False,16,scaffold_10
24,4828001,4843000,14999,False,16,scaffold_10
25,4848001,4852000,3999,False,16,scaffold_10
26,4865001,4866973,1972,True,16,scaffold_10
0,10001,34000,23999,False,16,scaffold_11
1,51001,76000,24999,False,16,scaffold_11
2,79001,98000,18999,False,16,scaffold_11
3,150001,167000,16999,False,16,scaffold_11
4,171001,191000,19999,False,16,scaffold_11
5,639001,640000,999,False,16,scaffold_11
6,648001,656000,7999,False,16,scaffold_11
7,1474001,1477000,2999,False,16,scaffold_11
8,2384001,2388000,3999,False,16,scaffold_11
9,2843001,2873000,29999,False,16,scaffold_11
10,3225001,3246000,20999,False,16,scaffold_11
11,3558001,3581000,22999,False,16,scaffold_11
12,3888001,3894000,5999,False,16,scaffold_11
13,4191001,4282000,90999,False,16,scaffold_11
14,4283001,4386000,102999,False,16,scaffold_11
15,4395001,4421000,25999,False,16,scaffold_11
16,4547001,4556000,8999,False,16,scaffold_11
17,4561001,4613000,51999,False,16,scaffold_11
18,4615001,4633000,17999,False,16,scaffold_11
19,4636001,4641000,4999,False,16,scaffold_11
20,4643001,4648000,4999,False,16,scaffold_11
21,4659001,4688000,28999,False,16,scaffold_11
22,4690001,4710000,19999,False,16,scaffold_11
23,4716001,4729000,12999,False,16,scaffold_11
24,4730001,4766820,36819,True,16,scaffold_11
0,35001,44000,8999,False,16,scaffold_12
1,50001,62000,11999,False,16,scaffold_12
2,64001,67000,2999,False,16,scaffold_12
3,68001,74000,5999,False,16,scaffold_12
4,89001,100000,10999,False,16,scaffold_12
5,113001,183000,69999,False,16,scaffold_12
6,184001,188000,3999,False,16,scaffold_12
7,190001,204000,13999,False,16,scaffold_12
8,205001,215000,9999,False,16,scaffold_12
9,260001,283000,22999,False,16,scaffold_12
10,402001,430000,27999,False,16,scaffold_12
11,909001,925000,15999,False,16,scaffold_12
12,1329001,1337000,7999,False,16,scaffold_12
13,1340001,1365000,24999,False,16,scaffold_12
14,1873001,1877000,3999,False,16,scaffold_12
15,2047001,2087000,39999,False,16,scaffold_12
16,2088001,2103000,14999,False,16,scaffold_12
17,2136001,2167000,30999,False,16,scaffold_12
18,2560001,2566000,5999,False,16,scaffold_12
19,2571001,2618000,46999,False,16,scaffold_12
0,1,12000,11999,True,17,scaffold_1
1,15001,22000,6999,False,17,scaffold_1
2,26001,31000,4999,False,17,scaffold_1
3,42001,45000,2999,False,17,scaffold_1
4,57001,62000,4999,False,17,scaffold_1
5,78001,86000,7999,False,17,scaffold_1
6,93001,101000,7999,False,17,scaffold_1
7,105001,111000,5999,False,17,scaffold_1
8,203001,205000,1999,False,17,scaffold_1
9,222001,227000,4999,False,17,scaffold_1
10,268001,276000,7999,False,17,scaffold_1
11,379001,382000,2999,False,17,scaffold_1
12,390001,392000,1999,False,17,scaffold_1
13,710001,712000,1999,False,17,scaffold_1
14,721001,729000,7999,False,17,scaffold_1
15,761001,785000,23999,False,17,scaffold_1
16,953001,957000,3999,False,17,scaffold_1
17,1168001,1173000,4999,False,17,scaffold_1
18,1175001,1182000,6999,False,17,scaffold_1
19,1283001,1292000,8999,False,17,scaffold_1
20,1457001,1463000,5999,False,17,scaffold_1
21,1628001,1636000,7999,False,17,scaffold_1
22,1657001,1659000,1999,False,17,scaffold_1
23,1823001,1825000,1999,False,17,scaffold_1
24,1962001,1964000,1999,False,17,scaffold_1
25,1965001,1968000,2999,False,17,scaffold_1
26,1998001,2009000,10999,False,17,scaffold_1
27,2269001,2275000,5999,False,17,scaffold_1
28,2736001,2742000,5999,False,17,scaffold_1
29,2996001,3000000,3999,False,17,scaffold_1
30,3040001,3042000,1999,False,17,scaffold_1
31,3419001,3421000,1999,False,17,scaffold_1
32,3489001,3492000,2999,False,17,scaffold_1
33,3776001,3783000,6999,False,17,scaffold_1
34,3915001,3920000,4999,False,17,scaffold_1
35,3927001,3933000,5999,False,17,scaffold_1
36,4079001,4087000,7999,False,17,scaffold_1
37,4161001,4163000,1999,False,17,scaffold_1
38,4336001,4352000,15999,False,17,scaffold_1
39,4675001,4678000,2999,False,17,scaffold_1
40,4788001,4790000,1999,False,17,scaffold_1
41,5497001,5511000,13999,False,17,scaffold_1
42,6228001,6237000,8999,False,17,scaffold_1
43,6285001,6289000,3999,False,17,scaffold_1
44,6332001,6335000,2999,False,17,scaffold_1
45,6389001,6392000,2999,False,17,scaffold_1
46,6452001,6456000,3999,False,17,scaffold_1
47,6559001,6562000,2999,False,17,scaffold_1
48,6607001,6616000,8999,False,17,scaffold_1
49,6719001,6732000,12999,False,17,scaffold_1
50,6754001,6759000,4999,False,17,scaffold_1
51,7053001,7068000,14999,False,17,scaffold_1
52,7117001,7123000,5999,False,17,scaffold_1
53,7151001,7165000,13999,False,17,scaffold_1
54,7232001,7246000,13999,False,17,scaffold_1
55,7343001,7354000,10999,False,17,scaffold_1
56,7355001,7358000,2999,False,17,scaffold_1
57,7370001,7377000,6999,False,17,scaffold_1
58,7398001,7449000,50999,False,17,scaffold_1
59,7452001,7473000,20999,False,17,scaffold_1
60,7494001,7526000,31999,False,17,scaffold_1
61,7555001,7559000,3999,False,17,scaffold_1
62,7566001,7572000,5999,False,17,scaffold_1
63,7578001,7581000,2999,False,17,scaffold_1
64,7584001,7589000,4999,False,17,scaffold_1
65,7759001,7773000,13999,False,17,scaffold_1
66,7778001,7781000,2999,False,17,scaffold_1
67,7785001,7809000,23999,False,17,scaffold_1
68,7823001,7827000,3999,False,17,scaffold_1
69,7829001,7839000,9999,False,17,scaffold_1
70,7844001,7847000,2999,False,17,scaffold_1
71,7849001,7879000,29999,False,17,scaffold_1
72,7991001,8033000,41999,False,17,scaffold_1
73,8105001,8110000,4999,False,17,scaffold_1
74,8111001,8127000,15999,False,17,scaffold_1
75,8130001,8148000,17999,False,17,scaffold_1
76,8153001,8160000,6999,False,17,scaffold_1
77,8212001,8217000,4999,False,17,scaffold_1
78,8221001,8241000,19999,False,17,scaffold_1
79,8243001,8249000,5999,False,17,scaffold_1
80,8333001,8340000,6999,False,17,scaffold_1
81,8384001,8394000,9999,False,17,scaffold_1
82,8444001,8450000,5999,False,17,scaffold_1
83,8458001,8460000,1999,False,17,scaffold_1
84,8464001,8470000,5999,False,17,scaffold_1
85,8472001,8476000,3999,False,17,scaffold_1
86,8477001,8481000,3999,False,17,scaffold_1
87,8504001,8514000,9999,False,17,scaffold_1
88,8546001,8559000,12999,False,17,scaffold_1
89,8603001,8611000,7999,False,17,scaffold_1
90,8621001,8624000,2999,False,17,scaffold_1
91,8628001,8634000,5999,False,17,scaffold_1
92,8636001,8638000,1999,False,17,scaffold_1
93,8659001,8664000,4999,False,17,scaffold_1
94,8677001,8680000,2999,False,17,scaffold_1
95,8738001,8740000,1999,False,17,scaffold_1
96,8747001,8753000,5999,False,17,scaffold_1
97,8759001,8761000,1999,False,17,scaffold_1
98,8782001,8785000,2999,False,17,scaffold_1
99,8862001,8872000,9999,False,17,scaffold_1
100,8894001,8896000,1999,False,17,scaffold_1
101,8905001,8924000,18999,False,17,scaffold_1
102,8956001,8978000,21999,False,17,scaffold_1
103,8983001,8989000,5999,False,17,scaffold_1
104,9016001,9026000,9999,False,17,scaffold_1
105,9039001,9044000,4999,False,17,scaffold_1
106,9171001,9191000,19999,False,17,scaffold_1
107,9198001,9203000,4999,False,17,scaffold_1
108,9206001,9214000,7999,False,17,scaffold_1
109,9219001,9235000,15999,False,17,scaffold_1
110,9274001,9280000,5999,False,17,scaffold_1
111,9313001,9317000,3999,False,17,scaffold_1
112,9329001,9331000,1999,False,17,scaffold_1
113,9347001,9352000,4999,False,17,scaffold_1
114,9355001,9362000,6999,False,17,scaffold_1
115,9385001,9387000,1999,False,17,scaffold_1
116,9405001,9431000,25999,False,17,scaffold_1
117,9452001,9459000,6999,False,17,scaffold_1
118,9461001,9463000,1999,False,17,scaffold_1
119,9472001,9476000,3999,False,17,scaffold_1
120,9484001,9487000,2999,False,17,scaffold_1
121,9515001,9520000,4999,False,17,scaffold_1
122,9564001,9567000,2999,False,17,scaffold_1
123,9601001,9603000,1999,False,17,scaffold_1
124,9611001,9616000,4999,False,17,scaffold_1
125,9633001,9638000,4999,False,17,scaffold_1
126,9723001,9726000,2999,False,17,scaffold_1
127,9840001,9842000,1999,False,17,scaffold_1
128,9928001,9936000,7999,False,17,scaffold_1
129,10024001,10027000,2999,False,17,scaffold_1
130,10077001,10090000,12999,False,17,scaffold_1
131,10181001,10191000,9999,False,17,scaffold_1
132,10272001,10275000,2999,False,17,scaffold_1
133,10276001,10281000,4999,False,17,scaffold_1
134,10336001,10342000,5999,False,17,scaffold_1
135,10445001,10451000,5999,False,17,scaffold_1
136,10517001,10519000,1999,False,17,scaffold_1
137,10543001,10546000,2999,False,17,scaffold_1
138,10566001,10570000,3999,False,17,scaffold_1
139,10669001,10674000,4999,False,17,scaffold_1
140,10730001,10732000,1999,False,17,scaffold_1
141,10922001,10930000,7999,False,17,scaffold_1
142,10951001,10954000,2999,False,17,scaffold_1
143,11201001,11209000,7999,False,17,scaffold_1
144,11394001,11398000,3999,False,17,scaffold_1
145,11469001,11471000,1999,False,17,scaffold_1
146,11486001,11489000,2999,False,17,scaffold_1
147,11562001,11571000,8999,False,17,scaffold_1
148,11735001,11738000,2999,False,17,scaffold_1
149,11743001,11749000,5999,False,17,scaffold_1
150,11792001,11794000,1999,False,17,scaffold_1
151,11846001,11855000,8999,False,17,scaffold_1
152,11925001,11936000,10999,False,17,scaffold_1
153,12060001,12067000,6999,False,17,scaffold_1
154,12191001,12197000,5999,False,17,scaffold_1
155,12369001,12370000,999,False,17,scaffold_1
156,12752001,12755000,2999,False,17,scaffold_1
157,12825001,12828000,2999,False,17,scaffold_1
158,12871001,12874000,2999,False,17,scaffold_1
159,12886001,12888000,1999,False,17,scaffold_1
160,12913001,12918000,4999,False,17,scaffold_1
161,12926001,12930000,3999,False,17,scaffold_1
162,12983001,12989000,5999,False,17,scaffold_1
163,13119001,13121000,1999,False,17,scaffold_1
164,13309001,13313000,3999,False,17,scaffold_1
165,13327001,13332000,4999,False,17,scaffold_1
166,13386001,13396000,9999,False,17,scaffold_1
167,13402001,13412000,9999,False,17,scaffold_1
168,13556001,13560000,3999,False,17,scaffold_1
169,13676001,13696000,19999,False,17,scaffold_1
170,13698001,13709000,10999,False,17,scaffold_1
171,13737001,13740000,2999,False,17,scaffold_1
172,13793001,13829000,35999,False,17,scaffold_1
173,13832001,13845000,12999,False,17,scaffold_1
174,13912001,13927000,14999,False,17,scaffold_1
175,13947001,13955000,7999,False,17,scaffold_1
176,13959001,13974000,14999,False,17,scaffold_1
177,14289001,14294000,4999,False,17,scaffold_1
178,14296001,14299000,2999,False,17,scaffold_1
179,14303001,14308000,4999,False,17,scaffold_1
180,14318001,14320000,1999,False,17,scaffold_1
181,14351001,14353000,1999,False,17,scaffold_1
182,14408001,14411000,2999,False,17,scaffold_1
183,14471001,14476000,4999,False,17,scaffold_1
184,14541001,14563000,21999,False,17,scaffold_1
185,14578001,14582000,3999,False,17,scaffold_1
186,14584001,14592000,7999,False,17,scaffold_1
187,14596001,14599000,2999,False,17,scaffold_1
188,14654001,14664000,9999,False,17,scaffold_1
0,7001,9000,1999,False,17,scaffold_2
1,28001,36000,7999,False,17,scaffold_2
2,37001,39000,1999,False,17,scaffold_2
3,51001,56000,4999,False,17,scaffold_2
4,83001,86000,2999,False,17,scaffold_2
5,107001,112000,4999,False,17,scaffold_2
6,145001,148000,2999,False,17,scaffold_2
7,168001,177000,8999,False,17,scaffold_2
8,301001,316000,14999,False,17,scaffold_2
9,535001,537000,1999,False,17,scaffold_2
10,565001,571000,5999,False,17,scaffold_2
11,617001,621000,3999,False,17,scaffold_2
12,947001,951000,3999,False,17,scaffold_2
13,1061001,1066000,4999,False,17,scaffold_2
14,1335001,1339000,3999,False,17,scaffold_2
15,1381001,1386000,4999,False,17,scaffold_2
16,1387001,1395000,7999,False,17,scaffold_2
17,1407001,1427000,19999,False,17,scaffold_2
18,1518001,1529000,10999,False,17,scaffold_2
19,1693001,1704000,10999,False,17,scaffold_2
20,1708001,1713000,4999,False,17,scaffold_2
21,1872001,1888000,15999,False,17,scaffold_2
22,1954001,1959000,4999,False,17,scaffold_2
23,2178001,2182000,3999,False,17,scaffold_2
24,2283001,2285000,1999,False,17,scaffold_2
25,2302001,2308000,5999,False,17,scaffold_2
26,2317001,2319000,1999,False,17,scaffold_2
27,2336001,2342000,5999,False,17,scaffold_2
28,2354001,2357000,2999,False,17,scaffold_2
29,2418001,2423000,4999,False,17,scaffold_2
30,2468001,2470000,1999,False,17,scaffold_2
31,2477001,2482000,4999,False,17,scaffold_2
32,2527001,2530000,2999,False,17,scaffold_2
33,2645001,2650000,4999,False,17,scaffold_2
34,2698001,2701000,2999,False,17,scaffold_2
35,3086001,3090000,3999,False,17,scaffold_2
36,3103001,3105000,1999,False,17,scaffold_2
37,3139001,3142000,2999,False,17,scaffold_2
38,3145001,3147000,1999,False,17,scaffold_2
39,3179001,3187000,7999,False,17,scaffold_2
40,3242001,3245000,2999,False,17,scaffold_2
41,3497001,3517000,19999,False,17,scaffold_2
42,3518001,3532000,13999,False,17,scaffold_2
43,3594001,3602000,7999,False,17,scaffold_2
44,3769001,3771000,1999,False,17,scaffold_2
45,3780001,3784000,3999,False,17,scaffold_2
46,3787001,3790000,2999,False,17,scaffold_2
47,4137001,4140000,2999,False,17,scaffold_2
48,4144001,4149000,4999,False,17,scaffold_2
49,4398001,4403000,4999,False,17,scaffold_2
50,4425001,4429000,3999,False,17,scaffold_2
51,4537001,4553000,15999,False,17,scaffold_2
52,4794001,4797000,2999,False,17,scaffold_2
53,4908001,4910000,1999,False,17,scaffold_2
54,5025001,5031000,5999,False,17,scaffold_2
55,5100001,5104000,3999,False,17,scaffold_2
56,5128001,5131000,2999,False,17,scaffold_2
57,5843001,5846000,2999,False,17,scaffold_2
58,5855001,5858000,2999,False,17,scaffold_2
59,5881001,5888000,6999,False,17,scaffold_2
60,6020001,6023000,2999,False,17,scaffold_2
61,6228001,6236000,7999,False,17,scaffold_2
62,6400001,6402000,1999,False,17,scaffold_2
63,6404001,6406000,1999,False,17,scaffold_2
64,6417001,6420000,2999,False,17,scaffold_2
65,7838001,7841000,2999,False,17,scaffold_2
66,7947001,7955000,7999,False,17,scaffold_2
67,8040001,8043000,2999,False,17,scaffold_2
68,8331001,8333000,1999,False,17,scaffold_2
69,8495001,8499000,3999,False,17,scaffold_2
70,8938001,8940000,1999,False,17,scaffold_2
71,9327001,9333000,5999,False,17,scaffold_2
72,9617001,9623000,5999,False,17,scaffold_2
73,9756001,9758000,1999,False,17,scaffold_2
74,10627001,10629000,1999,False,17,scaffold_2
75,10702001,10704000,1999,False,17,scaffold_2
76,10705001,10708000,2999,False,17,scaffold_2
77,10776001,10778000,1999,False,17,scaffold_2
78,10812001,10818000,5999,False,17,scaffold_2
79,11197001,11200000,2999,False,17,scaffold_2
80,11367001,11377000,9999,False,17,scaffold_2
81,11379001,11381000,1999,False,17,scaffold_2
82,11395001,11410000,14999,False,17,scaffold_2
83,11519001,11522000,2999,False,17,scaffold_2
84,11565001,11570000,4999,False,17,scaffold_2
85,11572001,11574000,1999,False,17,scaffold_2
86,11627001,11631000,3999,False,17,scaffold_2
87,11647001,11649000,1999,False,17,scaffold_2
88,11684001,11691000,6999,False,17,scaffold_2
89,11696001,11710000,13999,False,17,scaffold_2
0,256001,260000,3999,False,17,scaffold_3
1,315001,317000,1999,False,17,scaffold_3
2,357001,359000,1999,False,17,scaffold_3
3,521001,526000,4999,False,17,scaffold_3
4,695001,697000,1999,False,17,scaffold_3
5,794001,801000,6999,False,17,scaffold_3
6,816001,819000,2999,False,17,scaffold_3
7,823001,826000,2999,False,17,scaffold_3
8,843001,845000,1999,False,17,scaffold_3
9,846001,850000,3999,False,17,scaffold_3
10,989001,993000,3999,False,17,scaffold_3
11,1241001,1244000,2999,False,17,scaffold_3
12,1282001,1286000,3999,False,17,scaffold_3
13,1307001,1311000,3999,False,17,scaffold_3
14,1346001,1348000,1999,False,17,scaffold_3
15,1434001,1437000,2999,False,17,scaffold_3
16,1573001,1581000,7999,False,17,scaffold_3
17,1583001,1587000,3999,False,17,scaffold_3
18,1771001,1777000,5999,False,17,scaffold_3
19,1835001,1840000,4999,False,17,scaffold_3
20,1853001,1862000,8999,False,17,scaffold_3
21,2048001,2060000,11999,False,17,scaffold_3
22,2079001,2097000,17999,False,17,scaffold_3
23,2273001,2275000,1999,False,17,scaffold_3
24,2438001,2442000,3999,False,17,scaffold_3
25,2488001,2497000,8999,False,17,scaffold_3
26,2595001,2601000,5999,False,17,scaffold_3
27,2621001,2629000,7999,False,17,scaffold_3
28,2671001,2705000,33999,False,17,scaffold_3
29,3107001,3128000,20999,False,17,scaffold_3
30,3131001,3144000,12999,False,17,scaffold_3
31,3446001,3452000,5999,False,17,scaffold_3
32,3487001,3491000,3999,False,17,scaffold_3
33,3712001,3717000,4999,False,17,scaffold_3
34,3938001,3945000,6999,False,17,scaffold_3
35,4146001,4159000,12999,False,17,scaffold_3
36,4200001,4205000,4999,False,17,scaffold_3
37,4285001,4292000,6999,False,17,scaffold_3
38,4328001,4341000,12999,False,17,scaffold_3
39,4354001,4358000,3999,False,17,scaffold_3
40,4700001,4703000,2999,False,17,scaffold_3
41,4940001,4942000,1999,False,17,scaffold_3
42,5427001,5430000,2999,False,17,scaffold_3
43,5678001,5680000,1999,False,17,scaffold_3
44,5837001,5843000,5999,False,17,scaffold_3
45,6016001,6020000,3999,False,17,scaffold_3
46,6022001,6025000,2999,False,17,scaffold_3
47,6091001,6094000,2999,False,17,scaffold_3
48,6100001,6107000,6999,False,17,scaffold_3
49,6597001,6599000,1999,False,17,scaffold_3
50,6770001,6772000,1999,False,17,scaffold_3
51,6907001,6910000,2999,False,17,scaffold_3
52,6924001,6927000,2999,False,17,scaffold_3
53,6932001,6934000,1999,False,17,scaffold_3
54,6939001,6943000,3999,False,17,scaffold_3
55,6968001,6973000,4999,False,17,scaffold_3
56,7223001,7233000,9999,False,17,scaffold_3
57,7829001,7831000,1999,False,17,scaffold_3
58,7833001,7835000,1999,False,17,scaffold_3
59,8428001,8433000,4999,False,17,scaffold_3
60,8483001,8487000,3999,False,17,scaffold_3
61,8674001,8677000,2999,False,17,scaffold_3
62,9070001,9081000,10999,False,17,scaffold_3
63,9211001,9217000,5999,False,17,scaffold_3
64,9936001,9939000,2999,False,17,scaffold_3
65,9990001,9993000,2999,False,17,scaffold_3
66,10448001,10450000,1999,False,17,scaffold_3
67,10476001,10480000,3999,False,17,scaffold_3
68,10536001,10537000,999,False,17,scaffold_3
69,10639001,10643000,3999,False,17,scaffold_3
70,10673001,10677000,3999,False,17,scaffold_3
71,10681001,10683000,1999,False,17,scaffold_3
72,10719001,10724000,4999,False,17,scaffold_3
73,10740001,10744000,3999,False,17,scaffold_3
74,10799001,10808000,8999,False,17,scaffold_3
75,10879001,10884000,4999,False,17,scaffold_3
76,10908001,10910000,1999,False,17,scaffold_3
77,10941001,10951000,9999,False,17,scaffold_3
78,10958001,10962000,3999,False,17,scaffold_3
79,10963001,10969000,5999,False,17,scaffold_3
80,10986001,10990000,3999,False,17,scaffold_3
81,11073001,11075000,1999,False,17,scaffold_3
82,11083001,11087000,3999,False,17,scaffold_3
83,11090001,11092000,1999,False,17,scaffold_3
84,11132001,11134000,1999,False,17,scaffold_3
85,11180001,11182071,2070,True,17,scaffold_3
0,11001,13000,1999,False,17,scaffold_4
1,49001,88000,38999,False,17,scaffold_4
2,147001,151000,3999,False,17,scaffold_4
3,155001,169000,13999,False,17,scaffold_4
4,171001,173000,1999,False,17,scaffold_4
5,175001,182000,6999,False,17,scaffold_4
6,200001,215000,14999,False,17,scaffold_4
7,217001,226000,8999,False,17,scaffold_4
8,230001,232000,1999,False,17,scaffold_4
9,248001,253000,4999,False,17,scaffold_4
10,355001,365000,9999,False,17,scaffold_4
11,366001,374000,7999,False,17,scaffold_4
12,485001,505000,19999,False,17,scaffold_4
13,507001,520000,12999,False,17,scaffold_4
14,582001,606000,23999,False,17,scaffold_4
15,653001,659000,5999,False,17,scaffold_4
16,695001,697000,1999,False,17,scaffold_4
17,1138001,1147000,8999,False,17,scaffold_4
18,1154001,1189000,34999,False,17,scaffold_4
19,1222001,1226000,3999,False,17,scaffold_4
20,1294001,1304000,9999,False,17,scaffold_4
21,1473001,1479000,5999,False,17,scaffold_4
22,1512001,1531000,18999,False,17,scaffold_4
23,1533001,1541000,7999,False,17,scaffold_4
24,1591001,1605000,13999,False,17,scaffold_4
25,1644001,1647000,2999,False,17,scaffold_4
26,1654001,1673000,18999,False,17,scaffold_4
27,1686001,1715000,28999,False,17,scaffold_4
28,1775001,1781000,5999,False,17,scaffold_4
29,1823001,1855000,31999,False,17,scaffold_4
30,1858001,1903000,44999,False,17,scaffold_4
31,1904001,1937000,32999,False,17,scaffold_4
32,1947001,1966000,18999,False,17,scaffold_4
33,1983001,2004000,20999,False,17,scaffold_4
34,2021001,2064000,42999,False,17,scaffold_4
35,2069001,2109000,39999,False,17,scaffold_4
36,2161001,2169000,7999,False,17,scaffold_4
37,2171001,2186000,14999,False,17,scaffold_4
38,2273001,2279000,5999,False,17,scaffold_4
39,2285001,2291000,5999,False,17,scaffold_4
40,2293001,2340000,46999,False,17,scaffold_4
41,2343001,2352000,8999,False,17,scaffold_4
42,2353001,2359000,5999,False,17,scaffold_4
43,2360001,2387000,26999,False,17,scaffold_4
44,2392001,2401000,8999,False,17,scaffold_4
45,2405001,2411000,5999,False,17,scaffold_4
46,2478001,2490000,11999,False,17,scaffold_4
47,2496001,2505000,8999,False,17,scaffold_4
48,2552001,2573000,20999,False,17,scaffold_4
49,2676001,2686000,9999,False,17,scaffold_4
50,2687001,2693000,5999,False,17,scaffold_4
51,3205001,3218000,12999,False,17,scaffold_4
52,3281001,3302000,20999,False,17,scaffold_4
53,3555001,3560000,4999,False,17,scaffold_4
54,3720001,3765000,44999,False,17,scaffold_4
55,4115001,4118000,2999,False,17,scaffold_4
56,4953001,4958000,4999,False,17,scaffold_4
57,5133001,5135000,1999,False,17,scaffold_4
58,5380001,5383000,2999,False,17,scaffold_4
59,5394001,5396000,1999,False,17,scaffold_4
60,5398001,5402000,3999,False,17,scaffold_4
61,5433001,5440000,6999,False,17,scaffold_4
62,5445001,5451000,5999,False,17,scaffold_4
63,5580001,5582000,1999,False,17,scaffold_4
64,5601001,5607000,5999,False,17,scaffold_4
65,5612001,5620000,7999,False,17,scaffold_4
66,5700001,5703000,2999,False,17,scaffold_4
67,5747001,5750000,2999,False,17,scaffold_4
68,6353001,6357000,3999,False,17,scaffold_4
69,6420001,6424000,3999,False,17,scaffold_4
70,6828001,6833000,4999,False,17,scaffold_4
71,7319001,7325000,5999,False,17,scaffold_4
72,7565001,7571000,5999,False,17,scaffold_4
73,7658001,7661000,2999,False,17,scaffold_4
74,7746001,7750000,3999,False,17,scaffold_4
75,8033001,8038000,4999,False,17,scaffold_4
76,8081001,8083000,1999,False,17,scaffold_4
77,8207001,8210000,2999,False,17,scaffold_4
78,8682001,8684000,1999,False,17,scaffold_4
79,8710001,8712000,1999,False,17,scaffold_4
80,8790001,8797000,6999,False,17,scaffold_4
81,8845001,8855000,9999,False,17,scaffold_4
82,8857001,8865000,7999,False,17,scaffold_4
83,8875001,8881000,5999,False,17,scaffold_4
84,9045001,9048000,2999,False,17,scaffold_4
85,9062001,9077000,14999,False,17,scaffold_4
86,9120001,9122000,1999,False,17,scaffold_4
87,9129001,9133000,3999,False,17,scaffold_4
88,9143001,9148000,4999,False,17,scaffold_4
89,9150001,9154000,3999,False,17,scaffold_4
90,9165001,9169000,3999,False,17,scaffold_4
91,9198001,9200000,1999,False,17,scaffold_4
92,9201001,9203000,1999,False,17,scaffold_4
93,9220001,9223000,2999,False,17,scaffold_4
94,9237001,9239000,1999,False,17,scaffold_4
95,9245001,9248000,2999,False,17,scaffold_4
96,9282001,9286000,3999,False,17,scaffold_4
97,9328001,9330000,1999,False,17,scaffold_4
98,9335001,9340000,4999,False,17,scaffold_4
99,9341001,9343000,1999,False,17,scaffold_4
100,9365001,9367000,1999,False,17,scaffold_4
101,9391001,9404000,12999,False,17,scaffold_4
102,9423001,9430000,6999,False,17,scaffold_4
103,9434001,9437000,2999,False,17,scaffold_4
104,9447001,9454000,6999,False,17,scaffold_4
105,9455001,9457000,1999,False,17,scaffold_4
106,9482001,9486000,3999,False,17,scaffold_4
107,9509001,9513000,3999,False,17,scaffold_4
108,9616001,9618000,1999,False,17,scaffold_4
109,9628001,9631000,2999,False,17,scaffold_4
110,9723001,9726000,2999,False,17,scaffold_4
111,9756001,9759000,2999,False,17,scaffold_4
112,9760001,9763000,2999,False,17,scaffold_4
113,9767001,9769000,1999,False,17,scaffold_4
114,9770001,9783000,12999,False,17,scaffold_4
115,9786001,9788000,1999,False,17,scaffold_4
116,9806001,9808000,1999,False,17,scaffold_4
117,9843001,9845951,2950,True,17,scaffold_4
0,127001,128000,999,False,17,scaffold_5
1,381001,395000,13999,False,17,scaffold_5
2,500001,503000,2999,False,17,scaffold_5
3,505001,509000,3999,False,17,scaffold_5
4,517001,524000,6999,False,17,scaffold_5
5,670001,676000,5999,False,17,scaffold_5
6,836001,842000,5999,False,17,scaffold_5
7,847001,855000,7999,False,17,scaffold_5
8,888001,891000,2999,False,17,scaffold_5
9,919001,925000,5999,False,17,scaffold_5
10,931001,944000,12999,False,17,scaffold_5
11,1027001,1030000,2999,False,17,scaffold_5
12,1097001,1105000,7999,False,17,scaffold_5
13,1118001,1121000,2999,False,17,scaffold_5
14,1234001,1237000,2999,False,17,scaffold_5
15,1302001,1305000,2999,False,17,scaffold_5
16,2091001,2099000,7999,False,17,scaffold_5
17,2762001,2774000,11999,False,17,scaffold_5
18,2828001,2837000,8999,False,17,scaffold_5
19,2848001,2851000,2999,False,17,scaffold_5
20,2855001,2858000,2999,False,17,scaffold_5
21,2891001,2893000,1999,False,17,scaffold_5
22,3201001,3205000,3999,False,17,scaffold_5
23,3239001,3242000,2999,False,17,scaffold_5
24,3420001,3426000,5999,False,17,scaffold_5
25,3441001,3452000,10999,False,17,scaffold_5
26,3463001,3468000,4999,False,17,scaffold_5
27,3472001,3475000,2999,False,17,scaffold_5
28,3476001,3481000,4999,False,17,scaffold_5
29,3482001,3486000,3999,False,17,scaffold_5
30,3488001,3493000,4999,False,17,scaffold_5
31,3553001,3555000,1999,False,17,scaffold_5
32,3579001,3581000,1999,False,17,scaffold_5
33,3594001,3597000,2999,False,17,scaffold_5
34,3606001,3610000,3999,False,17,scaffold_5
35,3741001,3743000,1999,False,17,scaffold_5
36,3752001,3755000,2999,False,17,scaffold_5
37,3880001,3883000,2999,False,17,scaffold_5
38,3897001,3907000,9999,False,17,scaffold_5
39,3989001,3992000,2999,False,17,scaffold_5
40,4043001,4052000,8999,False,17,scaffold_5
41,4066001,4069000,2999,False,17,scaffold_5
42,4141001,4144000,2999,False,17,scaffold_5
43,4182001,4186000,3999,False,17,scaffold_5
44,4535001,4555000,19999,False,17,scaffold_5
45,4726001,4730000,3999,False,17,scaffold_5
46,4778001,4782000,3999,False,17,scaffold_5
47,5321001,5324000,2999,False,17,scaffold_5
48,5761001,5768000,6999,False,17,scaffold_5
49,5840001,5843000,2999,False,17,scaffold_5
50,6483001,6490000,6999,False,17,scaffold_5
51,6597001,6600000,2999,False,17,scaffold_5
52,6770001,6778000,7999,False,17,scaffold_5
53,6987001,6989000,1999,False,17,scaffold_5
54,7012001,7016000,3999,False,17,scaffold_5
55,7066001,7072000,5999,False,17,scaffold_5
56,7118001,7121000,2999,False,17,scaffold_5
57,7376001,7386000,9999,False,17,scaffold_5
58,7722001,7729000,6999,False,17,scaffold_5
59,7836001,7840000,3999,False,17,scaffold_5
60,8015001,8017000,1999,False,17,scaffold_5
61,8094001,8096000,1999,False,17,scaffold_5
62,8258001,8264000,5999,False,17,scaffold_5
63,8530001,8535000,4999,False,17,scaffold_5
64,8603001,8605000,1999,False,17,scaffold_5
65,8747001,8766000,18999,False,17,scaffold_5
66,8768001,8770000,1999,False,17,scaffold_5
67,8779001,8785000,5999,False,17,scaffold_5
68,8787001,8800000,12999,False,17,scaffold_5
69,8801001,8811000,9999,False,17,scaffold_5
70,8813001,8834000,20999,False,17,scaffold_5
71,8837001,8845000,7999,False,17,scaffold_5
72,8847001,8854000,6999,False,17,scaffold_5
73,8924001,8932000,7999,False,17,scaffold_5
74,8946001,8956000,9999,False,17,scaffold_5
75,8959001,8962000,2999,False,17,scaffold_5
76,9053001,9056000,2999,False,17,scaffold_5
77,9058001,9060000,1999,False,17,scaffold_5
78,9095001,9100000,4999,False,17,scaffold_5
79,9192001,9195000,2999,False,17,scaffold_5
80,9219001,9221000,1999,False,17,scaffold_5
81,9223001,9230000,6999,False,17,scaffold_5
82,9233001,9238000,4999,False,17,scaffold_5
83,9258001,9260000,1999,False,17,scaffold_5
84,9301001,9307000,5999,False,17,scaffold_5
85,9309001,9313000,3999,False,17,scaffold_5
86,9320001,9326000,5999,False,17,scaffold_5
87,9332001,9336000,3999,False,17,scaffold_5
0,80001,84000,3999,False,17,scaffold_6
1,86001,97000,10999,False,17,scaffold_6
2,99001,114000,14999,False,17,scaffold_6
3,204001,211000,6999,False,17,scaffold_6
4,285001,287000,1999,False,17,scaffold_6
5,378001,383000,4999,False,17,scaffold_6
6,467001,493000,25999,False,17,scaffold_6
7,555001,559000,3999,False,17,scaffold_6
8,618001,623000,4999,False,17,scaffold_6
9,641001,657000,15999,False,17,scaffold_6
10,659001,664000,4999,False,17,scaffold_6
11,820001,823000,2999,False,17,scaffold_6
12,827001,830000,2999,False,17,scaffold_6
13,881001,883000,1999,False,17,scaffold_6
14,1044001,1048000,3999,False,17,scaffold_6
15,1150001,1162000,11999,False,17,scaffold_6
16,1164001,1174000,9999,False,17,scaffold_6
17,1211001,1218000,6999,False,17,scaffold_6
18,1353001,1357000,3999,False,17,scaffold_6
19,1422001,1424000,1999,False,17,scaffold_6
20,1568001,1573000,4999,False,17,scaffold_6
21,1683001,1687000,3999,False,17,scaffold_6
22,1697001,1701000,3999,False,17,scaffold_6
23,1704001,1713000,8999,False,17,scaffold_6
24,1843001,1856000,12999,False,17,scaffold_6
25,1894001,1899000,4999,False,17,scaffold_6
26,2047001,2050000,2999,False,17,scaffold_6
27,2308001,2313000,4999,False,17,scaffold_6
28,2339001,2358000,18999,False,17,scaffold_6
29,2375001,2380000,4999,False,17,scaffold_6
30,2390001,2392000,1999,False,17,scaffold_6
31,2414001,2433000,18999,False,17,scaffold_6
32,2512001,2518000,5999,False,17,scaffold_6
33,2636001,2645000,8999,False,17,scaffold_6
34,2669001,2679000,9999,False,17,scaffold_6
35,2809001,2812000,2999,False,17,scaffold_6
36,2822001,2824000,1999,False,17,scaffold_6
37,2846001,2848000,1999,False,17,scaffold_6
38,3285001,3287000,1999,False,17,scaffold_6
39,3297001,3301000,3999,False,17,scaffold_6
40,3460001,3465000,4999,False,17,scaffold_6
41,3477001,3481000,3999,False,17,scaffold_6
42,3505001,3507000,1999,False,17,scaffold_6
43,3512001,3520000,7999,False,17,scaffold_6
44,3605001,3607000,1999,False,17,scaffold_6
45,3618001,3624000,5999,False,17,scaffold_6
46,3661001,3667000,5999,False,17,scaffold_6
47,3760001,3763000,2999,False,17,scaffold_6
48,3810001,3814000,3999,False,17,scaffold_6
49,3910001,3913000,2999,False,17,scaffold_6
50,4088001,4092000,3999,False,17,scaffold_6
51,4413001,4420000,6999,False,17,scaffold_6
52,4698001,4707000,8999,False,17,scaffold_6
53,4712001,4722000,9999,False,17,scaffold_6
54,4845001,4870000,24999,False,17,scaffold_6
55,4903001,4916000,12999,False,17,scaffold_6
56,4943001,4951000,7999,False,17,scaffold_6
57,5314001,5317000,2999,False,17,scaffold_6
58,5612001,5614000,1999,False,17,scaffold_6
59,5672001,5677000,4999,False,17,scaffold_6
60,6023001,6025000,1999,False,17,scaffold_6
61,6028001,6031000,2999,False,17,scaffold_6
62,6086001,6092000,5999,False,17,scaffold_6
63,6252001,6259000,6999,False,17,scaffold_6
64,6285001,6287000,1999,False,17,scaffold_6
65,6328001,6333000,4999,False,17,scaffold_6
66,6344001,6348000,3999,False,17,scaffold_6
67,6412001,6414000,1999,False,17,scaffold_6
68,6734001,6737000,2999,False,17,scaffold_6
69,6993001,6996000,2999,False,17,scaffold_6
70,7007001,7010000,2999,False,17,scaffold_6
71,7108001,7110000,1999,False,17,scaffold_6
72,7587001,7595000,7999,False,17,scaffold_6
73,7781001,7784000,2999,False,17,scaffold_6
74,7832001,7839000,6999,False,17,scaffold_6
75,7865001,7868000,2999,False,17,scaffold_6
76,7872001,7876000,3999,False,17,scaffold_6
77,7892001,7894000,1999,False,17,scaffold_6
78,7944001,7947000,2999,False,17,scaffold_6
79,7967001,7969000,1999,False,17,scaffold_6
80,7972001,7976000,3999,False,17,scaffold_6
81,8041001,8044000,2999,False,17,scaffold_6
82,8114001,8118000,3999,False,17,scaffold_6
83,8202001,8206000,3999,False,17,scaffold_6
84,8219001,8221000,1999,False,17,scaffold_6
85,8224001,8230000,5999,False,17,scaffold_6
86,8249001,8255000,5999,False,17,scaffold_6
0,20001,31000,10999,False,17,scaffold_7
1,173001,175000,1999,False,17,scaffold_7
2,336001,340000,3999,False,17,scaffold_7
3,355001,363000,7999,False,17,scaffold_7
4,375001,377000,1999,False,17,scaffold_7
5,383001,411000,27999,False,17,scaffold_7
6,460001,462000,1999,False,17,scaffold_7
7,467001,477000,9999,False,17,scaffold_7
8,490001,507000,16999,False,17,scaffold_7
9,572001,576000,3999,False,17,scaffold_7
10,623001,625000,1999,False,17,scaffold_7
11,628001,639000,10999,False,17,scaffold_7
12,721001,736000,14999,False,17,scaffold_7
13,743001,753000,9999,False,17,scaffold_7
14,785001,798000,12999,False,17,scaffold_7
15,818001,822000,3999,False,17,scaffold_7
16,859001,864000,4999,False,17,scaffold_7
17,900001,906000,5999,False,17,scaffold_7
18,951001,963000,11999,False,17,scaffold_7
19,964001,966000,1999,False,17,scaffold_7
20,968001,980000,11999,False,17,scaffold_7
21,999001,1026000,26999,False,17,scaffold_7
22,1029001,1036000,6999,False,17,scaffold_7
23,1072001,1089000,16999,False,17,scaffold_7
24,1173001,1187000,13999,False,17,scaffold_7
25,1192001,1209000,16999,False,17,scaffold_7
26,1226001,1248000,21999,False,17,scaffold_7
27,1249001,1259000,9999,False,17,scaffold_7
28,1262001,1282000,19999,False,17,scaffold_7
29,1368001,1398000,29999,False,17,scaffold_7
30,1440001,1442000,1999,False,17,scaffold_7
31,1443001,1449000,5999,False,17,scaffold_7
32,1677001,1679000,1999,False,17,scaffold_7
33,1686001,1696000,9999,False,17,scaffold_7
34,1713001,1721000,7999,False,17,scaffold_7
35,1761001,1768000,6999,False,17,scaffold_7
36,1769001,1778000,8999,False,17,scaffold_7
37,1873001,1885000,11999,False,17,scaffold_7
38,1991001,2006000,14999,False,17,scaffold_7
39,2455001,2464000,8999,False,17,scaffold_7
40,2679001,2693000,13999,False,17,scaffold_7
41,2698001,2712000,13999,False,17,scaffold_7
42,2846001,2850000,3999,False,17,scaffold_7
43,2851001,2853000,1999,False,17,scaffold_7
44,3076001,3081000,4999,False,17,scaffold_7
45,3201001,3206000,4999,False,17,scaffold_7
46,3306001,3311000,4999,False,17,scaffold_7
47,3325001,3329000,3999,False,17,scaffold_7
48,3335001,3338000,2999,False,17,scaffold_7
49,3349001,3351000,1999,False,17,scaffold_7
50,3357001,3359000,1999,False,17,scaffold_7
51,3362001,3365000,2999,False,17,scaffold_7
52,3611001,3614000,2999,False,17,scaffold_7
53,3669001,3672000,2999,False,17,scaffold_7
54,3960001,3963000,2999,False,17,scaffold_7
55,4059001,4062000,2999,False,17,scaffold_7
56,4366001,4368000,1999,False,17,scaffold_7
57,4513001,4518000,4999,False,17,scaffold_7
58,4529001,4533000,3999,False,17,scaffold_7
59,4550001,4553000,2999,False,17,scaffold_7
60,4982001,4986000,3999,False,17,scaffold_7
61,5036001,5039000,2999,False,17,scaffold_7
62,5048001,5051000,2999,False,17,scaffold_7
63,5060001,5062000,1999,False,17,scaffold_7
64,5179001,5181000,1999,False,17,scaffold_7
65,5473001,5475000,1999,False,17,scaffold_7
66,5501001,5504000,2999,False,17,scaffold_7
67,5752001,5760000,7999,False,17,scaffold_7
68,5793001,5799000,5999,False,17,scaffold_7
69,5805001,5808000,2999,False,17,scaffold_7
70,5934001,5939000,4999,False,17,scaffold_7
71,6121001,6128000,6999,False,17,scaffold_7
72,6231001,6233000,1999,False,17,scaffold_7
73,6238001,6241000,2999,False,17,scaffold_7
74,6271001,6277000,5999,False,17,scaffold_7
75,6954001,6964000,9999,False,17,scaffold_7
76,6998001,7008000,9999,False,17,scaffold_7
77,7126001,7129000,2999,False,17,scaffold_7
78,7145001,7148000,2999,False,17,scaffold_7
79,7174001,7176000,1999,False,17,scaffold_7
80,7234001,7236000,1999,False,17,scaffold_7
81,7238001,7240000,1999,False,17,scaffold_7
82,7272001,7274000,1999,False,17,scaffold_7
83,7352001,7358000,5999,False,17,scaffold_7
84,7415001,7419000,3999,False,17,scaffold_7
85,7432001,7437000,4999,False,17,scaffold_7
86,7445001,7450000,4999,False,17,scaffold_7
87,7458001,7464000,5999,False,17,scaffold_7
88,7465001,7467000,1999,False,17,scaffold_7
89,7468001,7471000,2999,False,17,scaffold_7
90,7498001,7502216,4215,True,17,scaffold_7
0,3001,5000,1999,False,17,scaffold_8
1,82001,85000,2999,False,17,scaffold_8
2,93001,101000,7999,False,17,scaffold_8
3,435001,437000,1999,False,17,scaffold_8
4,565001,568000,2999,False,17,scaffold_8
5,695001,698000,2999,False,17,scaffold_8
6,722001,725000,2999,False,17,scaffold_8
7,1150001,1157000,6999,False,17,scaffold_8
8,1258001,1261000,2999,False,17,scaffold_8
9,1414001,1421000,6999,False,17,scaffold_8
10,1975001,1977000,1999,False,17,scaffold_8
11,2261001,2264000,2999,False,17,scaffold_8
12,2519001,2527000,7999,False,17,scaffold_8
13,2565001,2567000,1999,False,17,scaffold_8
14,2574001,2582000,7999,False,17,scaffold_8
15,2676001,2680000,3999,False,17,scaffold_8
16,2846001,2850000,3999,False,17,scaffold_8
17,2852001,2872000,19999,False,17,scaffold_8
18,3032001,3056000,23999,False,17,scaffold_8
19,3061001,3064000,2999,False,17,scaffold_8
20,3066001,3088000,21999,False,17,scaffold_8
21,3126001,3130000,3999,False,17,scaffold_8
22,3137001,3144000,6999,False,17,scaffold_8
23,3182001,3186000,3999,False,17,scaffold_8
24,3269001,3273000,3999,False,17,scaffold_8
25,3389001,3391000,1999,False,17,scaffold_8
26,3454001,3465000,10999,False,17,scaffold_8
27,3684001,3690000,5999,False,17,scaffold_8
28,3746001,3750000,3999,False,17,scaffold_8
29,3751001,3754000,2999,False,17,scaffold_8
30,3761001,3767000,5999,False,17,scaffold_8
31,3802001,3804000,1999,False,17,scaffold_8
32,3847001,3858000,10999,False,17,scaffold_8
33,3930001,3932000,1999,False,17,scaffold_8
34,3998001,4003000,4999,False,17,scaffold_8
35,4252001,4256000,3999,False,17,scaffold_8
36,4662001,4668000,5999,False,17,scaffold_8
37,5086001,5089000,2999,False,17,scaffold_8
38,5686001,5694000,7999,False,17,scaffold_8
39,5701001,5708000,6999,False,17,scaffold_8
40,5750001,5795000,44999,False,17,scaffold_8
41,6082001,6091000,8999,False,17,scaffold_8
42,6334001,6334544,543,True,17,scaffold_8
0,1001,17000,15999,False,17,scaffold_9
1,59001,62000,2999,False,17,scaffold_9
2,65001,71000,5999,False,17,scaffold_9
3,94001,106000,11999,False,17,scaffold_9
4,115001,117000,1999,False,17,scaffold_9
5,121001,130000,8999,False,17,scaffold_9
6,133001,135000,1999,False,17,scaffold_9
7,297001,314000,16999,False,17,scaffold_9
8,319001,334000,14999,False,17,scaffold_9
9,369001,392000,22999,False,17,scaffold_9
10,395001,404000,8999,False,17,scaffold_9
11,409001,411000,1999,False,17,scaffold_9
12,415001,434000,18999,False,17,scaffold_9
13,477001,479000,1999,False,17,scaffold_9
14,533001,535000,1999,False,17,scaffold_9
15,551001,564000,12999,False,17,scaffold_9
16,647001,665000,17999,False,17,scaffold_9
17,679001,695000,15999,False,17,scaffold_9
18,732001,735000,2999,False,17,scaffold_9
19,736001,739000,2999,False,17,scaffold_9
20,792001,799000,6999,False,17,scaffold_9
21,812001,820000,7999,False,17,scaffold_9
22,822001,824000,1999,False,17,scaffold_9
23,827001,842000,14999,False,17,scaffold_9
24,915001,923000,7999,False,17,scaffold_9
25,930001,941000,10999,False,17,scaffold_9
26,943001,947000,3999,False,17,scaffold_9
27,987001,995000,7999,False,17,scaffold_9
28,1037001,1066000,28999,False,17,scaffold_9
29,1067001,1083000,15999,False,17,scaffold_9
30,1087001,1106000,18999,False,17,scaffold_9
31,1109001,1117000,7999,False,17,scaffold_9
32,1202001,1212000,9999,False,17,scaffold_9
33,1292001,1295000,2999,False,17,scaffold_9
34,1317001,1353000,35999,False,17,scaffold_9
35,1356001,1372000,15999,False,17,scaffold_9
36,1427001,1437000,9999,False,17,scaffold_9
37,1543001,1586000,42999,False,17,scaffold_9
38,1706001,1711000,4999,False,17,scaffold_9
39,1823001,1836000,12999,False,17,scaffold_9
40,1837001,1843000,5999,False,17,scaffold_9
41,1844001,1846000,1999,False,17,scaffold_9
42,1848001,1856000,7999,False,17,scaffold_9
43,1893001,1899000,5999,False,17,scaffold_9
44,1987001,2008000,20999,False,17,scaffold_9
45,2026001,2036000,9999,False,17,scaffold_9
46,2039001,2059000,19999,False,17,scaffold_9
47,2077001,2083000,5999,False,17,scaffold_9
48,2085001,2133000,47999,False,17,scaffold_9
49,2136001,2171000,34999,False,17,scaffold_9
50,2206001,2237000,30999,False,17,scaffold_9
51,2435001,2445000,9999,False,17,scaffold_9
52,2520001,2540000,19999,False,17,scaffold_9
53,2750001,2752000,1999,False,17,scaffold_9
54,2792001,2798000,5999,False,17,scaffold_9
55,2801001,2813000,11999,False,17,scaffold_9
56,2846001,2860000,13999,False,17,scaffold_9
57,2946001,2957000,10999,False,17,scaffold_9
58,2965001,2972000,6999,False,17,scaffold_9
59,2989001,2992000,2999,False,17,scaffold_9
60,2993001,2997000,3999,False,17,scaffold_9
61,3030001,3047000,16999,False,17,scaffold_9
62,3066001,3089000,22999,False,17,scaffold_9
63,3090001,3101000,10999,False,17,scaffold_9
64,3102001,3115000,12999,False,17,scaffold_9
65,3161001,3173000,11999,False,17,scaffold_9
66,3176001,3179000,2999,False,17,scaffold_9
67,3206001,3212000,5999,False,17,scaffold_9
68,3229001,3231000,1999,False,17,scaffold_9
69,3238001,3250000,11999,False,17,scaffold_9
70,3280001,3283000,2999,False,17,scaffold_9
71,3289001,3302000,12999,False,17,scaffold_9
72,3344001,3349000,4999,False,17,scaffold_9
73,3365001,3367000,1999,False,17,scaffold_9
74,3383001,3386000,2999,False,17,scaffold_9
75,3388001,3393000,4999,False,17,scaffold_9
76,3397001,3401000,3999,False,17,scaffold_9
77,3480001,3484000,3999,False,17,scaffold_9
78,3488001,3493000,4999,False,17,scaffold_9
79,3522001,3536000,13999,False,17,scaffold_9
80,3572001,3574000,1999,False,17,scaffold_9
81,3642001,3657000,14999,False,17,scaffold_9
82,3729001,3732000,2999,False,17,scaffold_9
83,3752001,3789000,36999,False,17,scaffold_9
84,3810001,3825000,14999,False,17,scaffold_9
85,3826001,3830000,3999,False,17,scaffold_9
86,3834001,3861000,26999,False,17,scaffold_9
87,3889001,3906000,16999,False,17,scaffold_9
88,3949001,3972000,22999,False,17,scaffold_9
89,3973001,3977000,3999,False,17,scaffold_9
90,4033001,4036000,2999,False,17,scaffold_9
91,4047001,4051000,3999,False,17,scaffold_9
92,4078001,4082000,3999,False,17,scaffold_9
93,4212001,4222000,9999,False,17,scaffold_9
94,4224001,4242000,17999,False,17,scaffold_9
95,4248001,4253000,4999,False,17,scaffold_9
96,4254001,4273000,18999,False,17,scaffold_9
97,4286001,4295000,8999,False,17,scaffold_9
98,4512001,4521000,8999,False,17,scaffold_9
99,4608001,4612000,3999,False,17,scaffold_9
100,4620001,4625000,4999,False,17,scaffold_9
101,4627001,4629000,1999,False,17,scaffold_9
102,4634001,4669000,34999,False,17,scaffold_9
103,4670001,4716000,45999,False,17,scaffold_9
104,4718001,4770000,51999,False,17,scaffold_9
105,4772001,4781000,8999,False,17,scaffold_9
106,4782001,4836000,53999,False,17,scaffold_9
107,4841001,4851000,9999,False,17,scaffold_9
108,4864001,4874000,9999,False,17,scaffold_9
109,4877001,4894000,16999,False,17,scaffold_9
110,4900001,4909000,8999,False,17,scaffold_9
111,4913001,4919000,5999,False,17,scaffold_9
112,4922001,4965000,42999,False,17,scaffold_9
113,4968001,4981000,12999,False,17,scaffold_9
114,4991001,4993000,1999,False,17,scaffold_9
115,4994001,5012000,17999,False,17,scaffold_9
116,5025001,5027000,1999,False,17,scaffold_9
117,5078001,5085000,6999,False,17,scaffold_9
118,5087001,5089000,1999,False,17,scaffold_9
119,5092001,5094000,1999,False,17,scaffold_9
120,5100001,5107000,6999,False,17,scaffold_9
121,5112001,5129000,16999,False,17,scaffold_9
122,5133001,5167000,33999,False,17,scaffold_9
123,5239001,5243000,3999,False,17,scaffold_9
124,5269001,5284000,14999,False,17,scaffold_9
125,5309001,5314000,4999,False,17,scaffold_9
126,5341001,5352000,10999,False,17,scaffold_9
127,5366001,5370000,3999,False,17,scaffold_9
128,5397001,5399000,1999,False,17,scaffold_9
129,5402001,5405000,2999,False,17,scaffold_9
130,5425001,5430000,4999,False,17,scaffold_9
131,5431001,5442000,10999,False,17,scaffold_9
132,5447001,5451000,3999,False,17,scaffold_9
133,5452001,5454000,1999,False,17,scaffold_9
134,5472001,5477000,4999,False,17,scaffold_9
135,5485001,5487000,1999,False,17,scaffold_9
136,5513001,5516000,2999,False,17,scaffold_9
137,5602001,5604000,1999,False,17,scaffold_9
138,5631001,5648000,16999,False,17,scaffold_9
139,5649001,5666000,16999,False,17,scaffold_9
140,5667001,5672000,4999,False,17,scaffold_9
141,5674001,5700000,25999,False,17,scaffold_9
142,5747001,5771000,23999,False,17,scaffold_9
143,5913001,5922000,8999,False,17,scaffold_9
144,5987001,6002000,14999,False,17,scaffold_9
145,6010001,6014000,3999,False,17,scaffold_9
146,6015001,6023000,7999,False,17,scaffold_9
147,6028001,6030000,1999,False,17,scaffold_9
148,6065001,6067000,1999,False,17,scaffold_9
149,6069001,6072000,2999,False,17,scaffold_9
150,6087001,6111000,23999,False,17,scaffold_9
151,6125001,6135000,9999,False,17,scaffold_9
152,6144001,6152000,7999,False,17,scaffold_9
153,6153001,6177000,23999,False,17,scaffold_9
154,6187001,6209000,21999,False,17,scaffold_9
155,6231001,6234000,2999,False,17,scaffold_9
156,6298001,6301000,2999,False,17,scaffold_9
0,15001,34000,18999,False,17,scaffold_10
1,42001,84000,41999,False,17,scaffold_10
2,109001,114000,4999,False,17,scaffold_10
3,118001,153000,34999,False,17,scaffold_10
4,276001,287000,10999,False,17,scaffold_10
5,334001,350000,15999,False,17,scaffold_10
6,387001,395000,7999,False,17,scaffold_10
7,474001,482000,7999,False,17,scaffold_10
8,483001,488000,4999,False,17,scaffold_10
9,506001,515000,8999,False,17,scaffold_10
10,554001,565000,10999,False,17,scaffold_10
11,601001,608000,6999,False,17,scaffold_10
12,687001,690000,2999,False,17,scaffold_10
13,828001,832000,3999,False,17,scaffold_10
14,1087001,1095000,7999,False,17,scaffold_10
15,1443001,1457000,13999,False,17,scaffold_10
16,1461001,1470000,8999,False,17,scaffold_10
17,1769001,1776000,6999,False,17,scaffold_10
18,1804001,1816000,11999,False,17,scaffold_10
19,1840001,1844000,3999,False,17,scaffold_10
20,1926001,1929000,2999,False,17,scaffold_10
21,2087001,2099000,11999,False,17,scaffold_10
22,2148001,2153000,4999,False,17,scaffold_10
23,2155001,2173000,17999,False,17,scaffold_10
24,2218001,2227000,8999,False,17,scaffold_10
25,2276001,2300000,23999,False,17,scaffold_10
26,2336001,2348000,11999,False,17,scaffold_10
27,2351001,2354000,2999,False,17,scaffold_10
28,2409001,2425000,15999,False,17,scaffold_10
29,2521001,2533000,11999,False,17,scaffold_10
30,2557001,2576000,18999,False,17,scaffold_10
31,2601001,2619000,17999,False,17,scaffold_10
32,2679001,2707000,27999,False,17,scaffold_10
33,2735001,2745000,9999,False,17,scaffold_10
34,2941001,2953000,11999,False,17,scaffold_10
35,3035001,3045000,9999,False,17,scaffold_10
36,3164001,3179000,14999,False,17,scaffold_10
37,3234001,3236000,1999,False,17,scaffold_10
38,3307001,3312000,4999,False,17,scaffold_10
39,3342001,3344000,1999,False,17,scaffold_10
40,3397001,3405000,7999,False,17,scaffold_10
41,3561001,3567000,5999,False,17,scaffold_10
42,3575001,3582000,6999,False,17,scaffold_10
43,4231001,4237000,5999,False,17,scaffold_10
44,4350001,4353000,2999,False,17,scaffold_10
45,4444001,4450000,5999,False,17,scaffold_10
46,4451001,4457000,5999,False,17,scaffold_10
47,4503001,4513000,9999,False,17,scaffold_10
48,4530001,4534000,3999,False,17,scaffold_10
49,4535001,4537000,1999,False,17,scaffold_10
50,4540001,4548000,7999,False,17,scaffold_10
51,4672001,4678000,5999,False,17,scaffold_10
52,4717001,4720000,2999,False,17,scaffold_10
53,4734001,4763000,28999,False,17,scaffold_10
54,4769001,4776000,6999,False,17,scaffold_10
55,4798001,4824000,25999,False,17,scaffold_10
56,4828001,4839000,10999,False,17,scaffold_10
57,4865001,4866973,1972,True,17,scaffold_10
0,13001,34000,20999,False,17,scaffold_11
1,69001,74000,4999,False,17,scaffold_11
2,79001,93000,13999,False,17,scaffold_11
3,171001,197000,25999,False,17,scaffold_11
4,199001,222000,22999,False,17,scaffold_11
5,224001,228000,3999,False,17,scaffold_11
6,240001,255000,14999,False,17,scaffold_11
7,350001,353000,2999,False,17,scaffold_11
8,384001,389000,4999,False,17,scaffold_11
9,411001,416000,4999,False,17,scaffold_11
10,419001,425000,5999,False,17,scaffold_11
11,433001,445000,11999,False,17,scaffold_11
12,651001,656000,4999,False,17,scaffold_11
13,860001,867000,6999,False,17,scaffold_11
14,1025001,1034000,8999,False,17,scaffold_11
15,1116001,1120000,3999,False,17,scaffold_11
16,1310001,1314000,3999,False,17,scaffold_11
17,1361001,1368000,6999,False,17,scaffold_11
18,1383001,1398000,14999,False,17,scaffold_11
19,1423001,1425000,1999,False,17,scaffold_11
20,1474001,1478000,3999,False,17,scaffold_11
21,1503001,1507000,3999,False,17,scaffold_11
22,1960001,1984000,23999,False,17,scaffold_11
23,1985001,1989000,3999,False,17,scaffold_11
24,1992001,1998000,5999,False,17,scaffold_11
25,2039001,2057000,17999,False,17,scaffold_11
26,2212001,2233000,20999,False,17,scaffold_11
27,2847001,2858000,10999,False,17,scaffold_11
28,3001001,3006000,4999,False,17,scaffold_11
29,3009001,3011000,1999,False,17,scaffold_11
30,3193001,3202000,8999,False,17,scaffold_11
31,3280001,3293000,12999,False,17,scaffold_11
32,3433001,3447000,13999,False,17,scaffold_11
33,3486001,3491000,4999,False,17,scaffold_11
34,3521001,3537000,15999,False,17,scaffold_11
35,3557001,3574000,16999,False,17,scaffold_11
36,3591001,3598000,6999,False,17,scaffold_11
37,3829001,3831000,1999,False,17,scaffold_11
38,3889001,3891000,1999,False,17,scaffold_11
39,3893001,3897000,3999,False,17,scaffold_11
40,4040001,4056000,15999,False,17,scaffold_11
41,4107001,4130000,22999,False,17,scaffold_11
42,4131001,4142000,10999,False,17,scaffold_11
43,4200001,4236000,35999,False,17,scaffold_11
44,4254001,4274000,19999,False,17,scaffold_11
45,4310001,4325000,14999,False,17,scaffold_11
46,4327001,4386000,58999,False,17,scaffold_11
47,4392001,4394000,1999,False,17,scaffold_11
48,4395001,4416000,20999,False,17,scaffold_11
49,4440001,4446000,5999,False,17,scaffold_11
50,4472001,4479000,6999,False,17,scaffold_11
51,4496001,4514000,17999,False,17,scaffold_11
52,4547001,4556000,8999,False,17,scaffold_11
53,4560001,4565000,4999,False,17,scaffold_11
54,4566001,4568000,1999,False,17,scaffold_11
55,4571001,4584000,12999,False,17,scaffold_11
56,4656001,4658000,1999,False,17,scaffold_11
57,4663001,4670000,6999,False,17,scaffold_11
58,4681001,4687000,5999,False,17,scaffold_11
59,4691001,4693000,1999,False,17,scaffold_11
60,4695001,4699000,3999,False,17,scaffold_11
61,4713001,4716000,2999,False,17,scaffold_11
62,4722001,4725000,2999,False,17,scaffold_11
63,4729001,4734000,4999,False,17,scaffold_11
0,21001,28000,6999,False,17,scaffold_12
1,29001,34000,4999,False,17,scaffold_12
2,37001,45000,7999,False,17,scaffold_12
3,82001,91000,8999,False,17,scaffold_12
4,114001,123000,8999,False,17,scaffold_12
5,125001,144000,18999,False,17,scaffold_12
6,171001,188000,16999,False,17,scaffold_12
7,292001,311000,18999,False,17,scaffold_12
8,486001,490000,3999,False,17,scaffold_12
9,541001,542000,999,False,17,scaffold_12
10,687001,692000,4999,False,17,scaffold_12
11,827001,831000,3999,False,17,scaffold_12
12,835001,849000,13999,False,17,scaffold_12
13,944001,971000,26999,False,17,scaffold_12
14,979001,1001000,21999,False,17,scaffold_12
15,1003001,1006000,2999,False,17,scaffold_12
16,1132001,1134000,1999,False,17,scaffold_12
17,1241001,1244000,2999,False,17,scaffold_12
18,1251001,1255000,3999,False,17,scaffold_12
19,1286001,1292000,5999,False,17,scaffold_12
20,1310001,1315000,4999,False,17,scaffold_12
21,1338001,1340000,1999,False,17,scaffold_12
22,1342001,1366000,23999,False,17,scaffold_12
23,1376001,1406000,29999,False,17,scaffold_12
24,1476001,1491000,14999,False,17,scaffold_12
25,1573001,1575000,1999,False,17,scaffold_12
26,1882001,1895000,12999,False,17,scaffold_12
27,1971001,2001000,29999,False,17,scaffold_12
28,2006001,2015000,8999,False,17,scaffold_12
29,2017001,2022000,4999,False,17,scaffold_12
30,2023001,2038000,14999,False,17,scaffold_12
31,2055001,2087000,31999,False,17,scaffold_12
32,2088001,2103000,14999,False,17,scaffold_12
33,2404001,2407000,2999,False,17,scaffold_12
34,2440001,2445000,4999,False,17,scaffold_12
35,2586001,2605000,18999,False,17,scaffold_12
36,2616001,2617000,999,False,17,scaffold_12
37,2680001,2682000,1999,False,17,scaffold_12
38,2685001,2687000,1999,False,17,scaffold_12
39,2702001,2705000,2999,False,17,scaffold_12
0,1,355000,354999,True,18,scaffold_1
1,482001,498000,15999,False,18,scaffold_1
2,571001,643000,71999,False,18,scaffold_1
3,686001,743000,56999,False,18,scaffold_1
4,1280001,1291000,10999,False,18,scaffold_1
5,1618001,1660000,41999,False,18,scaffold_1
6,1812001,1901000,88999,False,18,scaffold_1
7,1954001,1964000,9999,False,18,scaffold_1
8,1965001,1984000,18999,False,18,scaffold_1
9,1988001,2015000,26999,False,18,scaffold_1
10,2346001,2386000,39999,False,18,scaffold_1
11,2449001,2517000,67999,False,18,scaffold_1
12,2564001,2582000,17999,False,18,scaffold_1
13,2726001,2746000,19999,False,18,scaffold_1
14,2961001,3023000,61999,False,18,scaffold_1
15,3174001,3212000,37999,False,18,scaffold_1
16,3444001,3498000,53999,False,18,scaffold_1
17,3714001,3941000,226999,False,18,scaffold_1
18,3946001,4030000,83999,False,18,scaffold_1
19,4064001,4112000,47999,False,18,scaffold_1
20,4312001,4377000,64999,False,18,scaffold_1
21,4709001,4789000,79999,False,18,scaffold_1
22,4796001,4820000,23999,False,18,scaffold_1
23,4919001,5026000,106999,False,18,scaffold_1
24,5087001,5119000,31999,False,18,scaffold_1
25,5482001,5512000,29999,False,18,scaffold_1
26,5535001,5579000,43999,False,18,scaffold_1
27,6108001,6153000,44999,False,18,scaffold_1
28,6201001,6575000,373999,False,18,scaffold_1
29,6939001,6950000,10999,False,18,scaffold_1
30,7038001,7247000,208999,False,18,scaffold_1
31,7248001,7589000,340999,False,18,scaffold_1
32,7590001,8259000,668999,False,18,scaffold_1
33,8260001,8656000,395999,False,18,scaffold_1
34,8658001,9584000,925999,False,18,scaffold_1
35,9586001,10362000,775999,False,18,scaffold_1
36,10460001,10639000,178999,False,18,scaffold_1
37,10808001,10811000,2999,False,18,scaffold_1
38,10832001,10857000,24999,False,18,scaffold_1
39,11014001,11031000,16999,False,18,scaffold_1
40,11273001,11503000,229999,False,18,scaffold_1
41,11555001,11951000,395999,False,18,scaffold_1
42,12184001,12205000,20999,False,18,scaffold_1
43,12425001,12450000,24999,False,18,scaffold_1
44,12494001,12580000,85999,False,18,scaffold_1
45,12625001,12738000,112999,False,18,scaffold_1
46,12743001,12758000,14999,False,18,scaffold_1
47,12772001,12888000,115999,False,18,scaffold_1
48,12967001,13002000,34999,False,18,scaffold_1
49,13100001,13216000,115999,False,18,scaffold_1
50,13347001,13431000,83999,False,18,scaffold_1
51,13558001,13583000,24999,False,18,scaffold_1
52,13791001,13845000,53999,False,18,scaffold_1
53,14285001,14310000,24999,False,18,scaffold_1
54,14521001,14528000,6999,False,18,scaffold_1
55,14647001,14664000,16999,False,18,scaffold_1
0,22001,48000,25999,False,18,scaffold_2
1,93001,159000,65999,False,18,scaffold_2
2,165001,177000,11999,False,18,scaffold_2
3,277001,288000,10999,False,18,scaffold_2
4,297001,318000,20999,False,18,scaffold_2
5,332001,374000,41999,False,18,scaffold_2
6,1347001,1415000,67999,False,18,scaffold_2
7,2085001,2111000,25999,False,18,scaffold_2
8,2336001,2358000,21999,False,18,scaffold_2
9,2398001,2423000,24999,False,18,scaffold_2
10,2441001,2600000,158999,False,18,scaffold_2
11,2628001,2637000,8999,False,18,scaffold_2
12,2660001,2689000,28999,False,18,scaffold_2
13,2694001,2744000,49999,False,18,scaffold_2
14,2767001,2787000,19999,False,18,scaffold_2
15,2835001,2856000,20999,False,18,scaffold_2
16,2868001,2902000,33999,False,18,scaffold_2
17,2993001,3013000,19999,False,18,scaffold_2
18,3331001,3344000,12999,False,18,scaffold_2
19,3362001,3389000,26999,False,18,scaffold_2
20,3450001,3467000,16999,False,18,scaffold_2
21,3659001,3709000,49999,False,18,scaffold_2
22,3754001,3792000,37999,False,18,scaffold_2
23,4334001,4409000,74999,False,18,scaffold_2
24,4426001,4459000,32999,False,18,scaffold_2
25,4515001,4791000,275999,False,18,scaffold_2
26,4793001,4809000,15999,False,18,scaffold_2
27,4918001,4956000,37999,False,18,scaffold_2
28,5021001,5060000,38999,False,18,scaffold_2
29,5080001,5104000,23999,False,18,scaffold_2
30,5198001,5223000,24999,False,18,scaffold_2
31,5349001,5563000,213999,False,18,scaffold_2
32,5620001,5759000,138999,False,18,scaffold_2
33,5840001,5891000,50999,False,18,scaffold_2
34,5909001,5959000,49999,False,18,scaffold_2
35,6028001,6055000,26999,False,18,scaffold_2
36,6125001,6135000,9999,False,18,scaffold_2
37,6261001,6330000,68999,False,18,scaffold_2
38,6331001,6349000,17999,False,18,scaffold_2
39,6397001,6452000,54999,False,18,scaffold_2
40,6578001,6629000,50999,False,18,scaffold_2
41,7002001,7042000,39999,False,18,scaffold_2
42,7049001,7097000,47999,False,18,scaffold_2
43,7385001,7473000,87999,False,18,scaffold_2
44,7491001,7517000,25999,False,18,scaffold_2
45,7549001,7561000,11999,False,18,scaffold_2
46,7563001,7697000,133999,False,18,scaffold_2
47,7754001,7890000,135999,False,18,scaffold_2
48,7933001,8161000,227999,False,18,scaffold_2
49,8260001,8327000,66999,False,18,scaffold_2
50,8331001,8333000,1999,False,18,scaffold_2
51,8334001,8344000,9999,False,18,scaffold_2
52,8346001,8455000,108999,False,18,scaffold_2
53,8466001,8493000,26999,False,18,scaffold_2
54,8495001,8562000,66999,False,18,scaffold_2
55,9001001,9049000,47999,False,18,scaffold_2
56,9140001,9168000,27999,False,18,scaffold_2
57,9320001,9382000,61999,False,18,scaffold_2
58,9601001,9639000,37999,False,18,scaffold_2
59,10710001,10729000,18999,False,18,scaffold_2
60,11395001,11426000,30999,False,18,scaffold_2
61,11520001,11786000,265999,False,18,scaffold_2
0,1,2000,1999,True,18,scaffold_3
1,218001,232000,13999,False,18,scaffold_3
2,799001,901000,101999,False,18,scaffold_3
3,1958001,1975000,16999,False,18,scaffold_3
4,2011001,2108000,96999,False,18,scaffold_3
5,2291001,2335000,43999,False,18,scaffold_3
6,2433001,2531000,97999,False,18,scaffold_3
7,2653001,2683000,29999,False,18,scaffold_3
8,2716001,2759000,42999,False,18,scaffold_3
9,3067001,3145000,77999,False,18,scaffold_3
10,3561001,3583000,21999,False,18,scaffold_3
11,3605001,3693000,87999,False,18,scaffold_3
12,3768001,3860000,91999,False,18,scaffold_3
13,3909001,3921000,11999,False,18,scaffold_3
14,4000001,4035000,34999,False,18,scaffold_3
15,4108001,4403000,294999,False,18,scaffold_3
16,4410001,4515000,104999,False,18,scaffold_3
17,4652001,4682000,29999,False,18,scaffold_3
18,5168001,5209000,40999,False,18,scaffold_3
19,5232001,5272000,39999,False,18,scaffold_3
20,5435001,5445000,9999,False,18,scaffold_3
21,5493001,5508000,14999,False,18,scaffold_3
22,5564001,5676000,111999,False,18,scaffold_3
23,5805001,5947000,141999,False,18,scaffold_3
24,5957001,6033000,75999,False,18,scaffold_3
25,6230001,6244000,13999,False,18,scaffold_3
26,6757001,6787000,29999,False,18,scaffold_3
27,6907001,6962000,54999,False,18,scaffold_3
28,6963001,7097000,133999,False,18,scaffold_3
29,7111001,7157000,45999,False,18,scaffold_3
30,7279001,7302000,22999,False,18,scaffold_3
31,7333001,7413000,79999,False,18,scaffold_3
32,7483001,7563000,79999,False,18,scaffold_3
33,7678001,7857000,178999,False,18,scaffold_3
34,8044001,8116000,71999,False,18,scaffold_3
35,8175001,8255000,79999,False,18,scaffold_3
36,8462001,8527000,64999,False,18,scaffold_3
37,8575001,8594000,18999,False,18,scaffold_3
38,9012001,9078000,65999,False,18,scaffold_3
39,9130001,9163000,32999,False,18,scaffold_3
40,9199001,9238000,38999,False,18,scaffold_3
41,9656001,9676000,19999,False,18,scaffold_3
42,9967001,9994000,26999,False,18,scaffold_3
43,10065001,10087000,21999,False,18,scaffold_3
44,10461001,10484000,22999,False,18,scaffold_3
45,10551001,10572000,20999,False,18,scaffold_3
46,10574001,11182071,608070,True,18,scaffold_3
0,17001,32000,14999,False,18,scaffold_4
1,48001,88000,39999,False,18,scaffold_4
2,108001,115000,6999,False,18,scaffold_4
3,137001,146000,8999,False,18,scaffold_4
4,147001,151000,3999,False,18,scaffold_4
5,155001,160000,4999,False,18,scaffold_4
6,161001,215000,53999,False,18,scaffold_4
7,217001,226000,8999,False,18,scaffold_4
8,227001,241000,13999,False,18,scaffold_4
9,242001,266000,23999,False,18,scaffold_4
10,294001,303000,8999,False,18,scaffold_4
11,320001,353000,32999,False,18,scaffold_4
12,355001,374000,18999,False,18,scaffold_4
13,393001,425000,31999,False,18,scaffold_4
14,429001,504000,74999,False,18,scaffold_4
15,548001,592000,43999,False,18,scaffold_4
16,600001,606000,5999,False,18,scaffold_4
17,608001,691000,82999,False,18,scaffold_4
18,701001,712000,10999,False,18,scaffold_4
19,735001,741000,5999,False,18,scaffold_4
20,1087001,1097000,9999,False,18,scaffold_4
21,1098001,1108000,9999,False,18,scaffold_4
22,1120001,1198000,77999,False,18,scaffold_4
23,1199001,1226000,26999,False,18,scaffold_4
24,1235001,1253000,17999,False,18,scaffold_4
25,1254001,1262000,7999,False,18,scaffold_4
26,1265001,1279000,13999,False,18,scaffold_4
27,1283001,1336000,52999,False,18,scaffold_4
28,1355001,1604000,248999,False,18,scaffold_4
29,1613001,2069000,455999,False,18,scaffold_4
30,2071001,2206000,134999,False,18,scaffold_4
31,2219001,2279000,59999,False,18,scaffold_4
32,2283001,2460000,176999,False,18,scaffold_4
33,2477001,2635000,157999,False,18,scaffold_4
34,2684001,2812000,127999,False,18,scaffold_4
35,2939001,2967000,27999,False,18,scaffold_4
36,3051001,3102000,50999,False,18,scaffold_4
37,3104001,3127000,22999,False,18,scaffold_4
38,3207001,3261000,53999,False,18,scaffold_4
39,3336001,3769000,432999,False,18,scaffold_4
40,4055001,4076000,20999,False,18,scaffold_4
41,4242001,4306000,63999,False,18,scaffold_4
42,4900001,5090000,189999,False,18,scaffold_4
43,5169001,5224000,54999,False,18,scaffold_4
44,5295001,5355000,59999,False,18,scaffold_4
45,5475001,5506000,30999,False,18,scaffold_4
46,5514001,5784000,269999,False,18,scaffold_4
47,5786001,5827000,40999,False,18,scaffold_4
48,5928001,5965000,36999,False,18,scaffold_4
49,6148001,6193000,44999,False,18,scaffold_4
50,6763001,6817000,53999,False,18,scaffold_4
51,6901001,6924000,22999,False,18,scaffold_4
52,6926001,6995000,68999,False,18,scaffold_4
53,7036001,7124000,87999,False,18,scaffold_4
54,7148001,7373000,224999,False,18,scaffold_4
55,7631001,7665000,33999,False,18,scaffold_4
56,7864001,7890000,25999,False,18,scaffold_4
57,7985001,7998000,12999,False,18,scaffold_4
58,8845001,9699000,853999,False,18,scaffold_4
59,9700001,9845951,145950,True,18,scaffold_4
0,1,4000,3999,True,18,scaffold_5
1,152001,173000,20999,False,18,scaffold_5
2,318001,386000,67999,False,18,scaffold_5
3,463001,523000,59999,False,18,scaffold_5
4,928001,947000,18999,False,18,scaffold_5
5,2089001,2104000,14999,False,18,scaffold_5
6,2264001,2283000,18999,False,18,scaffold_5
7,2475001,2493000,17999,False,18,scaffold_5
8,2510001,2515000,4999,False,18,scaffold_5
9,2562001,2869000,306999,False,18,scaffold_5
10,3133001,3184000,50999,False,18,scaffold_5
11,3216001,3513000,296999,False,18,scaffold_5
12,3630001,3643000,12999,False,18,scaffold_5
13,3645001,3649000,3999,False,18,scaffold_5
14,3962001,4101000,138999,False,18,scaffold_5
15,4119001,4220000,100999,False,18,scaffold_5
16,4232001,4321000,88999,False,18,scaffold_5
17,4446001,4554000,107999,False,18,scaffold_5
18,4590001,4861000,270999,False,18,scaffold_5
19,4892001,4923000,30999,False,18,scaffold_5
20,5059001,5097000,37999,False,18,scaffold_5
21,5217001,5312000,94999,False,18,scaffold_5
22,5314001,5346000,31999,False,18,scaffold_5
23,5721001,5738000,16999,False,18,scaffold_5
24,6406001,6654000,247999,False,18,scaffold_5
25,6886001,6906000,19999,False,18,scaffold_5
26,7406001,7440000,33999,False,18,scaffold_5
27,7454001,7483000,28999,False,18,scaffold_5
28,7546001,7619000,72999,False,18,scaffold_5
29,7621001,7748000,126999,False,18,scaffold_5
30,8555001,8615000,59999,False,18,scaffold_5
31,8659001,8689000,29999,False,18,scaffold_5
32,8713001,9363000,649999,False,18,scaffold_5
33,9364001,9364176,175,True,18,scaffold_5
0,65001,75000,9999,False,18,scaffold_6
1,78001,85000,6999,False,18,scaffold_6
2,86001,114000,27999,False,18,scaffold_6
3,172001,207000,34999,False,18,scaffold_6
4,239001,254000,14999,False,18,scaffold_6
5,268001,283000,14999,False,18,scaffold_6
6,782001,800000,17999,False,18,scaffold_6
7,1147001,1198000,50999,False,18,scaffold_6
8,1233001,1263000,29999,False,18,scaffold_6
9,1286001,1310000,23999,False,18,scaffold_6
10,1436001,1547000,110999,False,18,scaffold_6
11,1561001,1595000,33999,False,18,scaffold_6
12,1658001,1689000,30999,False,18,scaffold_6
13,1843001,1906000,62999,False,18,scaffold_6
14,2023001,2103000,79999,False,18,scaffold_6
15,2129001,2213000,83999,False,18,scaffold_6
16,2237001,2281000,43999,False,18,scaffold_6
17,2334001,2595000,260999,False,18,scaffold_6
18,2596001,2872000,275999,False,18,scaffold_6
19,2927001,3031000,103999,False,18,scaffold_6
20,3088001,3192000,103999,False,18,scaffold_6
21,3222001,3350000,127999,False,18,scaffold_6
22,3351001,3806000,454999,False,18,scaffold_6
23,3810001,3847000,36999,False,18,scaffold_6
24,3898001,3933000,34999,False,18,scaffold_6
25,3972001,4001000,28999,False,18,scaffold_6
26,4006001,4193000,186999,False,18,scaffold_6
27,4811001,4875000,63999,False,18,scaffold_6
28,4955001,4993000,37999,False,18,scaffold_6
29,6009001,6066000,56999,False,18,scaffold_6
30,6123001,6188000,64999,False,18,scaffold_6
31,6783001,6800000,16999,False,18,scaffold_6
32,7262001,7338000,75999,False,18,scaffold_6
33,7382001,7476000,93999,False,18,scaffold_6
34,7531001,8268281,737280,True,18,scaffold_6
0,13001,31000,17999,False,18,scaffold_7
1,323001,340000,16999,False,18,scaffold_7
2,342001,508000,165999,False,18,scaffold_7
3,553001,563000,9999,False,18,scaffold_7
4,571001,577000,5999,False,18,scaffold_7
5,706001,736000,29999,False,18,scaffold_7
6,741001,753000,11999,False,18,scaffold_7
7,764001,806000,41999,False,18,scaffold_7
8,859001,864000,4999,False,18,scaffold_7
9,868001,938000,69999,False,18,scaffold_7
10,967001,980000,12999,False,18,scaffold_7
11,982001,1044000,61999,False,18,scaffold_7
12,1048001,1104000,55999,False,18,scaffold_7
13,1191001,1513000,321999,False,18,scaffold_7
14,1588001,1690000,101999,False,18,scaffold_7
15,1740001,1782000,41999,False,18,scaffold_7
16,1850001,1897000,46999,False,18,scaffold_7
17,1973001,2011000,37999,False,18,scaffold_7
18,2540001,2570000,29999,False,18,scaffold_7
19,3122001,3143000,20999,False,18,scaffold_7
20,3325001,3370000,44999,False,18,scaffold_7
21,3519001,3773000,253999,False,18,scaffold_7
22,4026001,4047000,20999,False,18,scaffold_7
23,4415001,4512000,96999,False,18,scaffold_7
24,4658001,4852000,193999,False,18,scaffold_7
25,4979001,5140000,160999,False,18,scaffold_7
26,5471001,5536000,64999,False,18,scaffold_7
27,6073001,6094000,20999,False,18,scaffold_7
28,6165001,6245000,79999,False,18,scaffold_7
29,6750001,6796000,45999,False,18,scaffold_7
30,6953001,7502216,549215,True,18,scaffold_7
0,1,6000,5999,True,18,scaffold_8
1,67001,85000,17999,False,18,scaffold_8
2,93001,101000,7999,False,18,scaffold_8
3,722001,724000,1999,False,18,scaffold_8
4,1858001,1929000,70999,False,18,scaffold_8
5,2100001,2155000,54999,False,18,scaffold_8
6,2415001,2528000,112999,False,18,scaffold_8
7,2536001,2588000,51999,False,18,scaffold_8
8,2650001,2675000,24999,False,18,scaffold_8
9,2676001,2683000,6999,False,18,scaffold_8
10,2710001,2844000,133999,False,18,scaffold_8
11,2847001,2892000,44999,False,18,scaffold_8
12,3004001,3557000,552999,False,18,scaffold_8
13,3580001,3612000,31999,False,18,scaffold_8
14,3615001,3944000,328999,False,18,scaffold_8
15,4031001,4143000,111999,False,18,scaffold_8
16,4172001,4221000,48999,False,18,scaffold_8
17,4400001,4430000,29999,False,18,scaffold_8
18,4752001,4772000,19999,False,18,scaffold_8
19,5082001,5241000,158999,False,18,scaffold_8
20,5528001,5597000,68999,False,18,scaffold_8
21,5651001,5709000,57999,False,18,scaffold_8
22,5750001,5772000,21999,False,18,scaffold_8
23,5890001,5902000,11999,False,18,scaffold_8
24,6324001,6334544,10543,True,18,scaffold_8
0,109001,117000,7999,False,18,scaffold_9
1,121001,138000,16999,False,18,scaffold_9
2,236001,242000,5999,False,18,scaffold_9
3,367001,411000,43999,False,18,scaffold_9
4,413001,434000,20999,False,18,scaffold_9
5,504001,531000,26999,False,18,scaffold_9
6,652001,665000,12999,False,18,scaffold_9
7,671001,696000,24999,False,18,scaffold_9
8,719001,742000,22999,False,18,scaffold_9
9,815001,841000,25999,False,18,scaffold_9
10,850001,862000,11999,False,18,scaffold_9
11,873001,986000,112999,False,18,scaffold_9
12,988001,995000,6999,False,18,scaffold_9
13,1001001,1007000,5999,False,18,scaffold_9
14,1009001,1085000,75999,False,18,scaffold_9
15,1087001,1150000,62999,False,18,scaffold_9
16,1151001,1160000,8999,False,18,scaffold_9
17,1313001,1377000,63999,False,18,scaffold_9
18,1457001,1463000,5999,False,18,scaffold_9
19,1522001,1585000,62999,False,18,scaffold_9
20,1600001,1624000,23999,False,18,scaffold_9
21,1638001,1678000,39999,False,18,scaffold_9
22,1749001,1791000,41999,False,18,scaffold_9
23,1923001,1941000,17999,False,18,scaffold_9
24,1987001,2037000,49999,False,18,scaffold_9
25,2038001,2059000,20999,False,18,scaffold_9
26,2076001,2135000,58999,False,18,scaffold_9
27,2136001,2168000,31999,False,18,scaffold_9
28,2176001,2227000,50999,False,18,scaffold_9
29,2516001,2550000,33999,False,18,scaffold_9
30,2597001,2664000,66999,False,18,scaffold_9
31,2737001,2824000,86999,False,18,scaffold_9
32,2844001,3381000,536999,False,18,scaffold_9
33,3383001,5107000,1723999,False,18,scaffold_9
34,5112001,5238000,125999,False,18,scaffold_9
35,5239001,5298000,58999,False,18,scaffold_9
36,5300001,5491000,190999,False,18,scaffold_9
37,5493001,6331288,838287,True,18,scaffold_9
0,1,136000,135999,True,18,scaffold_10
1,137001,482000,344999,False,18,scaffold_10
2,483001,582000,98999,False,18,scaffold_10
3,597001,840000,242999,False,18,scaffold_10
4,858001,877000,18999,False,18,scaffold_10
5,888001,916000,27999,False,18,scaffold_10
6,923001,1069000,145999,False,18,scaffold_10
7,1087001,1146000,58999,False,18,scaffold_10
8,1386001,1466000,79999,False,18,scaffold_10
9,1863001,1917000,53999,False,18,scaffold_10
10,2042001,2103000,60999,False,18,scaffold_10
11,2140001,2176000,35999,False,18,scaffold_10
12,2199001,2227000,27999,False,18,scaffold_10
13,2268001,2312000,43999,False,18,scaffold_10
14,2346001,2471000,124999,False,18,scaffold_10
15,2521001,2652000,130999,False,18,scaffold_10
16,2674001,2700000,25999,False,18,scaffold_10
17,2715001,2748000,32999,False,18,scaffold_10
18,2801001,2812000,10999,False,18,scaffold_10
19,3577001,3582000,4999,False,18,scaffold_10
20,4054001,4093000,38999,False,18,scaffold_10
21,4154001,4174000,19999,False,18,scaffold_10
22,4316001,4324000,7999,False,18,scaffold_10
23,4337001,4358000,20999,False,18,scaffold_10
24,4445001,4462000,16999,False,18,scaffold_10
25,4467001,4477000,9999,False,18,scaffold_10
26,4503001,4513000,9999,False,18,scaffold_10
27,4515001,4523000,7999,False,18,scaffold_10
28,4526001,4548000,21999,False,18,scaffold_10
29,4574001,4596000,21999,False,18,scaffold_10
30,4679001,4688000,8999,False,18,scaffold_10
31,4734001,4776000,41999,False,18,scaffold_10
32,4798001,4824000,25999,False,18,scaffold_10
33,4828001,4843000,14999,False,18,scaffold_10
34,4848001,4861000,12999,False,18,scaffold_10
35,4865001,4866973,1972,True,18,scaffold_10
0,9001,93000,83999,False,18,scaffold_11
1,149001,167000,17999,False,18,scaffold_11
2,169001,191000,21999,False,18,scaffold_11
3,213001,236000,22999,False,18,scaffold_11
4,240001,248000,7999,False,18,scaffold_11
5,293001,315000,21999,False,18,scaffold_11
6,419001,431000,11999,False,18,scaffold_11
7,649001,656000,6999,False,18,scaffold_11
8,859001,867000,7999,False,18,scaffold_11
9,1025001,1034000,8999,False,18,scaffold_11
10,1474001,1478000,3999,False,18,scaffold_11
11,1853001,1884000,30999,False,18,scaffold_11
12,2132001,2172000,39999,False,18,scaffold_11
13,2201001,2224000,22999,False,18,scaffold_11
14,2701001,2909000,207999,False,18,scaffold_11
15,2978001,3021000,42999,False,18,scaffold_11
16,3079001,3175000,95999,False,18,scaffold_11
17,3188001,3383000,194999,False,18,scaffold_11
18,3433001,3483000,49999,False,18,scaffold_11
19,3521001,3651000,129999,False,18,scaffold_11
20,3672001,3926000,253999,False,18,scaffold_11
21,3939001,3971000,31999,False,18,scaffold_11
22,3985001,4159000,173999,False,18,scaffold_11
23,4179001,4710000,530999,False,18,scaffold_11
24,4713001,4766820,53819,True,18,scaffold_11
0,1,730000,729999,True,18,scaffold_12
1,741001,1497000,755999,False,18,scaffold_12
2,1720001,1755000,34999,False,18,scaffold_12
3,1973001,2001000,27999,False,18,scaffold_12
4,2024001,2041000,16999,False,18,scaffold_12
5,2042001,2087000,44999,False,18,scaffold_12
6,2130001,2172000,41999,False,18,scaffold_12
7,2350001,2380000,29999,False,18,scaffold_12
8,2571001,2617000,45999,False,18,scaffold_12
9,2674001,2682000,7999,False,18,scaffold_12
0,1,339000,338999,True,19,scaffold_1
1,482001,498000,15999,False,19,scaffold_1
2,572001,643000,70999,False,19,scaffold_1
3,686001,757000,70999,False,19,scaffold_1
4,794001,825000,30999,False,19,scaffold_1
5,857001,945000,87999,False,19,scaffold_1
6,1266001,1292000,25999,False,19,scaffold_1
7,1811001,1937000,125999,False,19,scaffold_1
8,1950001,1964000,13999,False,19,scaffold_1
9,1965001,1985000,19999,False,19,scaffold_1
10,1986001,2023000,36999,False,19,scaffold_1
11,2345001,2387000,41999,False,19,scaffold_1
12,2449001,2517000,67999,False,19,scaffold_1
13,2563001,2582000,18999,False,19,scaffold_1
14,2727001,2746000,18999,False,19,scaffold_1
15,2897001,2921000,23999,False,19,scaffold_1
16,3171001,3232000,60999,False,19,scaffold_1
17,3442001,3498000,55999,False,19,scaffold_1
18,3577001,3618000,40999,False,19,scaffold_1
19,3702001,3941000,238999,False,19,scaffold_1
20,3950001,4052000,101999,False,19,scaffold_1
21,4064001,4127000,62999,False,19,scaffold_1
22,4259001,4377000,117999,False,19,scaffold_1
23,4468001,4544000,75999,False,19,scaffold_1
24,4706001,4794000,87999,False,19,scaffold_1
25,4796001,4897000,100999,False,19,scaffold_1
26,4911001,5066000,154999,False,19,scaffold_1
27,5087001,5121000,33999,False,19,scaffold_1
28,5142001,5200000,57999,False,19,scaffold_1
29,5437001,5457000,19999,False,19,scaffold_1
30,5481001,5512000,30999,False,19,scaffold_1
31,5535001,5589000,53999,False,19,scaffold_1
32,5858001,5871000,12999,False,19,scaffold_1
33,6108001,6153000,44999,False,19,scaffold_1
34,6154001,6176000,21999,False,19,scaffold_1
35,6201001,6380000,178999,False,19,scaffold_1
36,6384001,6570000,185999,False,19,scaffold_1
37,6640001,6656000,15999,False,19,scaffold_1
38,6925001,6951000,25999,False,19,scaffold_1
39,7038001,7247000,208999,False,19,scaffold_1
40,7248001,7589000,340999,False,19,scaffold_1
41,7590001,8656000,1065999,False,19,scaffold_1
42,8658001,9584000,925999,False,19,scaffold_1
43,9586001,10363000,776999,False,19,scaffold_1
44,10448001,10640000,191999,False,19,scaffold_1
45,10736001,10755000,18999,False,19,scaffold_1
46,10808001,10811000,2999,False,19,scaffold_1
47,10835001,10857000,21999,False,19,scaffold_1
48,10920001,10989000,68999,False,19,scaffold_1
49,11013001,11072000,58999,False,19,scaffold_1
50,11269001,11510000,240999,False,19,scaffold_1
51,11550001,11951000,400999,False,19,scaffold_1
52,12184001,12205000,20999,False,19,scaffold_1
53,12329001,12367000,37999,False,19,scaffold_1
54,12425001,12450000,24999,False,19,scaffold_1
55,12496001,12951000,454999,False,19,scaffold_1
56,12968001,13074000,105999,False,19,scaffold_1
57,13101001,13216000,114999,False,19,scaffold_1
58,13344001,13447000,102999,False,19,scaffold_1
59,13558001,13590000,31999,False,19,scaffold_1
60,13591001,13611000,19999,False,19,scaffold_1
61,13670001,13709000,38999,False,19,scaffold_1
62,13789001,13844000,54999,False,19,scaffold_1
63,13847001,13927000,79999,False,19,scaffold_1
64,13928001,13955000,26999,False,19,scaffold_1
65,13959001,13977000,17999,False,19,scaffold_1
66,14046001,14063000,16999,False,19,scaffold_1
67,14285001,14313000,27999,False,19,scaffold_1
68,14501001,14529000,27999,False,19,scaffold_1
69,14530001,14592000,61999,False,19,scaffold_1
70,14648001,14664000,15999,False,19,scaffold_1
0,22001,48000,25999,False,19,scaffold_2
1,93001,159000,65999,False,19,scaffold_2
2,165001,177000,11999,False,19,scaffold_2
3,297001,318000,20999,False,19,scaffold_2
4,332001,374000,41999,False,19,scaffold_2
5,1127001,1135000,7999,False,19,scaffold_2
6,1234001,1254000,19999,False,19,scaffold_2
7,1353001,1416000,62999,False,19,scaffold_2
8,1537001,1556000,18999,False,19,scaffold_2
9,1836001,1862000,25999,False,19,scaffold_2
10,2078001,2133000,54999,False,19,scaffold_2
11,2302001,2334000,31999,False,19,scaffold_2
12,2336001,2424000,87999,False,19,scaffold_2
13,2437001,2600000,162999,False,19,scaffold_2
14,2660001,2689000,28999,False,19,scaffold_2
15,2694001,2742000,47999,False,19,scaffold_2
16,2767001,2787000,19999,False,19,scaffold_2
17,2835001,2855000,19999,False,19,scaffold_2
18,2868001,2905000,36999,False,19,scaffold_2
19,2975001,3021000,45999,False,19,scaffold_2
20,3022001,3050000,27999,False,19,scaffold_2
21,3174001,3186000,11999,False,19,scaffold_2
22,3330001,3344000,13999,False,19,scaffold_2
23,3367001,3385000,17999,False,19,scaffold_2
24,3450001,3575000,124999,False,19,scaffold_2
25,3658001,3712000,53999,False,19,scaffold_2
26,3753001,3784000,30999,False,19,scaffold_2
27,3838001,3930000,91999,False,19,scaffold_2
28,3991001,4001000,9999,False,19,scaffold_2
29,4007001,4037000,29999,False,19,scaffold_2
30,4243001,4409000,165999,False,19,scaffold_2
31,4426001,4460000,33999,False,19,scaffold_2
32,4474001,4790000,315999,False,19,scaffold_2
33,4793001,4803000,9999,False,19,scaffold_2
34,4917001,4963000,45999,False,19,scaffold_2
35,5020001,5104000,83999,False,19,scaffold_2
36,5178001,5221000,42999,False,19,scaffold_2
37,5248001,5276000,27999,False,19,scaffold_2
38,5285001,5323000,37999,False,19,scaffold_2
39,5327001,5564000,236999,False,19,scaffold_2
40,5606001,5759000,152999,False,19,scaffold_2
41,5814001,5989000,174999,False,19,scaffold_2
42,6005001,6059000,53999,False,19,scaffold_2
43,6087001,6178000,90999,False,19,scaffold_2
44,6261001,6350000,88999,False,19,scaffold_2
45,6390001,6464000,73999,False,19,scaffold_2
46,6575001,6631000,55999,False,19,scaffold_2
47,6822001,6861000,38999,False,19,scaffold_2
48,6940001,7047000,106999,False,19,scaffold_2
49,7049001,7097000,47999,False,19,scaffold_2
50,7351001,7473000,121999,False,19,scaffold_2
51,7491001,7516000,24999,False,19,scaffold_2
52,7550001,7561000,10999,False,19,scaffold_2
53,7563001,7916000,352999,False,19,scaffold_2
54,7933001,8230000,296999,False,19,scaffold_2
55,8259001,8327000,67999,False,19,scaffold_2
56,8346001,8455000,108999,False,19,scaffold_2
57,8461001,8493000,31999,False,19,scaffold_2
58,8495001,8565000,69999,False,19,scaffold_2
59,9029001,9055000,25999,False,19,scaffold_2
60,9140001,9168000,27999,False,19,scaffold_2
61,9283001,9382000,98999,False,19,scaffold_2
62,9600001,9636000,35999,False,19,scaffold_2
63,10638001,10669000,30999,False,19,scaffold_2
64,10676001,10695000,18999,False,19,scaffold_2
65,11023001,11068000,44999,False,19,scaffold_2
66,11353001,11384000,30999,False,19,scaffold_2
67,11519001,11786000,266999,False,19,scaffold_2
0,1,2000,1999,True,19,scaffold_3
1,373001,382000,8999,False,19,scaffold_3
2,618001,646000,27999,False,19,scaffold_3
3,797001,901000,103999,False,19,scaffold_3
4,1576001,1582000,5999,False,19,scaffold_3
5,1639001,1672000,32999,False,19,scaffold_3
6,1899001,1934000,34999,False,19,scaffold_3
7,1936001,1979000,42999,False,19,scaffold_3
8,2008001,2108000,99999,False,19,scaffold_3
9,2109001,2147000,37999,False,19,scaffold_3
10,2287001,2336000,48999,False,19,scaffold_3
11,2377001,2428000,50999,False,19,scaffold_3
12,2433001,2533000,99999,False,19,scaffold_3
13,2649001,2761000,111999,False,19,scaffold_3
14,2852001,2920000,67999,False,19,scaffold_3
15,2987001,3011000,23999,False,19,scaffold_3
16,3065001,3164000,98999,False,19,scaffold_3
17,3167001,3281000,113999,False,19,scaffold_3
18,3560001,3700000,139999,False,19,scaffold_3
19,3714001,3731000,16999,False,19,scaffold_3
20,3768001,3821000,52999,False,19,scaffold_3
21,3822001,3892000,69999,False,19,scaffold_3
22,3907001,3921000,13999,False,19,scaffold_3
23,3927001,3941000,13999,False,19,scaffold_3
24,4007001,4032000,24999,False,19,scaffold_3
25,4070001,4399000,328999,False,19,scaffold_3
26,4416001,4518000,101999,False,19,scaffold_3
27,4546001,4558000,11999,False,19,scaffold_3
28,4646001,4684000,37999,False,19,scaffold_3
29,4854001,4915000,60999,False,19,scaffold_3
30,4997001,5037000,39999,False,19,scaffold_3
31,5081001,5125000,43999,False,19,scaffold_3
32,5158001,5210000,51999,False,19,scaffold_3
33,5231001,5278000,46999,False,19,scaffold_3
34,5376001,5508000,131999,False,19,scaffold_3
35,5547001,5676000,128999,False,19,scaffold_3
36,5701001,5730000,28999,False,19,scaffold_3
37,5784001,6095000,310999,False,19,scaffold_3
38,6223001,6244000,20999,False,19,scaffold_3
39,6743001,6807000,63999,False,19,scaffold_3
40,6862001,7157000,294999,False,19,scaffold_3
41,7254001,7312000,57999,False,19,scaffold_3
42,7333001,7404000,70999,False,19,scaffold_3
43,7449001,7460000,10999,False,19,scaffold_3
44,7462001,7479000,16999,False,19,scaffold_3
45,7483001,7561000,77999,False,19,scaffold_3
46,7678001,7943000,264999,False,19,scaffold_3
47,8028001,8116000,87999,False,19,scaffold_3
48,8121001,8156000,34999,False,19,scaffold_3
49,8177001,8257000,79999,False,19,scaffold_3
50,8462001,8527000,64999,False,19,scaffold_3
51,8575001,8599000,23999,False,19,scaffold_3
52,8956001,9102000,145999,False,19,scaffold_3
53,9106001,9171000,64999,False,19,scaffold_3
54,9197001,9225000,27999,False,19,scaffold_3
55,9451001,9537000,85999,False,19,scaffold_3
56,9555001,9578000,22999,False,19,scaffold_3
57,9659001,9686000,26999,False,19,scaffold_3
58,9968001,9996000,27999,False,19,scaffold_3
59,10065001,10089000,23999,False,19,scaffold_3
60,10555001,10571000,15999,False,19,scaffold_3
61,10574001,11182071,608070,True,19,scaffold_3
0,11001,13000,1999,False,19,scaffold_4
1,17001,32000,14999,False,19,scaffold_4
2,48001,88000,39999,False,19,scaffold_4
3,91001,115000,23999,False,19,scaffold_4
4,147001,151000,3999,False,19,scaffold_4
5,155001,215000,59999,False,19,scaffold_4
6,217001,226000,8999,False,19,scaffold_4
7,227001,278000,50999,False,19,scaffold_4
8,283001,306000,22999,False,19,scaffold_4
9,355001,374000,18999,False,19,scaffold_4
10,375001,380000,4999,False,19,scaffold_4
11,384001,410000,25999,False,19,scaffold_4
12,412001,425000,12999,False,19,scaffold_4
13,429001,500000,70999,False,19,scaffold_4
14,546001,592000,45999,False,19,scaffold_4
15,593001,599000,5999,False,19,scaffold_4
16,600001,606000,5999,False,19,scaffold_4
17,608001,691000,82999,False,19,scaffold_4
18,701001,717000,15999,False,19,scaffold_4
19,1113001,1136000,22999,False,19,scaffold_4
20,1138001,1198000,59999,False,19,scaffold_4
21,1199001,1226000,26999,False,19,scaffold_4
22,1236001,1253000,16999,False,19,scaffold_4
23,1254001,1279000,24999,False,19,scaffold_4
24,1283001,1605000,321999,False,19,scaffold_4
25,1613001,2185000,571999,False,19,scaffold_4
26,2190001,2281000,90999,False,19,scaffold_4
27,2283001,2460000,176999,False,19,scaffold_4
28,2477001,2635000,157999,False,19,scaffold_4
29,2648001,2675000,26999,False,19,scaffold_4
30,2676001,2814000,137999,False,19,scaffold_4
31,2891001,3136000,244999,False,19,scaffold_4
32,3205001,3329000,123999,False,19,scaffold_4
33,3334001,3784000,449999,False,19,scaffold_4
34,3971001,3980000,8999,False,19,scaffold_4
35,4058001,4104000,45999,False,19,scaffold_4
36,4242001,4306000,63999,False,19,scaffold_4
37,4900001,5099000,198999,False,19,scaffold_4
38,5170001,5224000,53999,False,19,scaffold_4
39,5300001,5329000,28999,False,19,scaffold_4
40,5335001,5506000,170999,False,19,scaffold_4
41,5516001,5784000,267999,False,19,scaffold_4
42,5786001,5856000,69999,False,19,scaffold_4
43,5926001,5981000,54999,False,19,scaffold_4
44,6067001,6113000,45999,False,19,scaffold_4
45,6146001,6197000,50999,False,19,scaffold_4
46,6212001,6538000,325999,False,19,scaffold_4
47,6762001,6817000,54999,False,19,scaffold_4
48,6839001,6924000,84999,False,19,scaffold_4
49,6950001,6995000,44999,False,19,scaffold_4
50,7036001,7163000,126999,False,19,scaffold_4
51,7207001,7429000,221999,False,19,scaffold_4
52,7629001,7667000,37999,False,19,scaffold_4
53,7858001,7916000,57999,False,19,scaffold_4
54,8844001,9699000,854999,False,19,scaffold_4
55,9700001,9845951,145950,True,19,scaffold_4
0,1,5000,4999,True,19,scaffold_5
1,155001,164000,8999,False,19,scaffold_5
2,319001,386000,66999,False,19,scaffold_5
3,462001,526000,63999,False,19,scaffold_5
4,672001,695000,22999,False,19,scaffold_5
5,924001,947000,22999,False,19,scaffold_5
6,1357001,1387000,29999,False,19,scaffold_5
7,1626001,1661000,34999,False,19,scaffold_5
8,2087001,2104000,16999,False,19,scaffold_5
9,2475001,2494000,18999,False,19,scaffold_5
10,2508001,2515000,6999,False,19,scaffold_5
11,2562001,2894000,331999,False,19,scaffold_5
12,3137001,3520000,382999,False,19,scaffold_5
13,3616001,3659000,42999,False,19,scaffold_5
14,3834001,3946000,111999,False,19,scaffold_5
15,3962001,4101000,138999,False,19,scaffold_5
16,4120001,4389000,268999,False,19,scaffold_5
17,4446001,4861000,414999,False,19,scaffold_5
18,4883001,4919000,35999,False,19,scaffold_5
19,4972001,4992000,19999,False,19,scaffold_5
20,5055001,5105000,49999,False,19,scaffold_5
21,5199001,5346000,146999,False,19,scaffold_5
22,6393001,6726000,332999,False,19,scaffold_5
23,6818001,6854000,35999,False,19,scaffold_5
24,6878001,6907000,28999,False,19,scaffold_5
25,7174001,7245000,70999,False,19,scaffold_5
26,7454001,7483000,28999,False,19,scaffold_5
27,7545001,7619000,73999,False,19,scaffold_5
28,7621001,7748000,126999,False,19,scaffold_5
29,8436001,8467000,30999,False,19,scaffold_5
30,8550001,8616000,65999,False,19,scaffold_5
31,8632001,8689000,56999,False,19,scaffold_5
32,8711001,9364176,653175,True,19,scaffold_5
0,79001,113000,33999,False,19,scaffold_6
1,143001,208000,64999,False,19,scaffold_6
2,239001,254000,14999,False,19,scaffold_6
3,257001,297000,39999,False,19,scaffold_6
4,456001,497000,40999,False,19,scaffold_6
5,639001,665000,25999,False,19,scaffold_6
6,701001,756000,54999,False,19,scaffold_6
7,786001,799000,12999,False,19,scaffold_6
8,906001,1039000,132999,False,19,scaffold_6
9,1121001,1226000,104999,False,19,scaffold_6
10,1229001,1265000,35999,False,19,scaffold_6
11,1285001,1301000,15999,False,19,scaffold_6
12,1430001,1606000,175999,False,19,scaffold_6
13,1657001,1753000,95999,False,19,scaffold_6
14,1803001,1822000,18999,False,19,scaffold_6
15,1832001,1906000,73999,False,19,scaffold_6
16,1976001,2019000,42999,False,19,scaffold_6
17,2023001,2104000,80999,False,19,scaffold_6
18,2129001,2215000,85999,False,19,scaffold_6
19,2237001,2283000,45999,False,19,scaffold_6
20,2334001,2595000,260999,False,19,scaffold_6
21,2596001,2872000,275999,False,19,scaffold_6
22,2927001,3211000,283999,False,19,scaffold_6
23,3223001,3806000,582999,False,19,scaffold_6
24,3882001,3913000,30999,False,19,scaffold_6
25,3965001,3996000,30999,False,19,scaffold_6
26,4018001,4204000,185999,False,19,scaffold_6
27,4836001,4919000,82999,False,19,scaffold_6
28,4938001,4994000,55999,False,19,scaffold_6
29,5720001,5744000,23999,False,19,scaffold_6
30,5862001,5972000,109999,False,19,scaffold_6
31,6009001,6084000,74999,False,19,scaffold_6
32,6123001,6190000,66999,False,19,scaffold_6
33,6695001,6713000,17999,False,19,scaffold_6
34,6755001,6804000,48999,False,19,scaffold_6
35,6833001,6857000,23999,False,19,scaffold_6
36,6911001,6952000,40999,False,19,scaffold_6
37,7186001,7248000,61999,False,19,scaffold_6
38,7254001,7337000,82999,False,19,scaffold_6
39,7379001,7485000,105999,False,19,scaffold_6
40,7531001,8268281,737280,True,19,scaffold_6
0,14001,34000,19999,False,19,scaffold_7
1,320001,340000,19999,False,19,scaffold_7
2,342001,508000,165999,False,19,scaffold_7
3,571001,577000,5999,False,19,scaffold_7
4,706001,736000,29999,False,19,scaffold_7
5,764001,809000,44999,False,19,scaffold_7
6,810001,829000,18999,False,19,scaffold_7
7,858001,864000,5999,False,19,scaffold_7
8,868001,872000,3999,False,19,scaffold_7
9,875001,941000,65999,False,19,scaffold_7
10,982001,1044000,61999,False,19,scaffold_7
11,1048001,1081000,32999,False,19,scaffold_7
12,1191001,1514000,322999,False,19,scaffold_7
13,1588001,1696000,107999,False,19,scaffold_7
14,1730001,1782000,51999,False,19,scaffold_7
15,1848001,1897000,48999,False,19,scaffold_7
16,1976001,2018000,41999,False,19,scaffold_7
17,2516001,2594000,77999,False,19,scaffold_7
18,2639001,2709000,69999,False,19,scaffold_7
19,2931001,2953000,21999,False,19,scaffold_7
20,3294001,3369000,74999,False,19,scaffold_7
21,3515001,3767000,251999,False,19,scaffold_7
22,4413001,4512000,98999,False,19,scaffold_7
23,4550001,4580000,29999,False,19,scaffold_7
24,4631001,4877000,245999,False,19,scaffold_7
25,4978001,5207000,228999,False,19,scaffold_7
26,5479001,5537000,57999,False,19,scaffold_7
27,5917001,5931000,13999,False,19,scaffold_7
28,6052001,6094000,41999,False,19,scaffold_7
29,6096001,6251000,154999,False,19,scaffold_7
30,6579001,6675000,95999,False,19,scaffold_7
31,6694001,6722000,27999,False,19,scaffold_7
32,6750001,6798000,47999,False,19,scaffold_7
33,6820001,6839000,18999,False,19,scaffold_7
34,6954001,7270000,315999,False,19,scaffold_7
35,7271001,7502216,231215,True,19,scaffold_7
0,66001,85000,18999,False,19,scaffold_8
1,722001,724000,1999,False,19,scaffold_8
2,729001,733000,3999,False,19,scaffold_8
3,1859001,1931000,71999,False,19,scaffold_8
4,2066001,2154000,87999,False,19,scaffold_8
5,2360001,2379000,18999,False,19,scaffold_8
6,2415001,2470000,54999,False,19,scaffold_8
7,2491001,2533000,41999,False,19,scaffold_8
8,2535001,2584000,48999,False,19,scaffold_8
9,2648001,2683000,34999,False,19,scaffold_8
10,2685001,2844000,158999,False,19,scaffold_8
11,2847001,2924000,76999,False,19,scaffold_8
12,2942001,3558000,615999,False,19,scaffold_8
13,3576001,3614000,37999,False,19,scaffold_8
14,3615001,3945000,329999,False,19,scaffold_8
15,4026001,4143000,116999,False,19,scaffold_8
16,4172001,4272000,99999,False,19,scaffold_8
17,4396001,4431000,34999,False,19,scaffold_8
18,4609001,4644000,34999,False,19,scaffold_8
19,4751001,4776000,24999,False,19,scaffold_8
20,4904001,4915000,10999,False,19,scaffold_8
21,4985001,5018000,32999,False,19,scaffold_8
22,5068001,5243000,174999,False,19,scaffold_8
23,5530001,5544000,13999,False,19,scaffold_8
24,5576001,5596000,19999,False,19,scaffold_8
25,5650001,5715000,64999,False,19,scaffold_8
26,5750001,5806000,55999,False,19,scaffold_8
27,5807001,5904000,96999,False,19,scaffold_8
28,5923001,5944000,20999,False,19,scaffold_8
29,6025001,6308000,282999,False,19,scaffold_8
30,6317001,6334544,17543,True,19,scaffold_8
0,109001,118000,8999,False,19,scaffold_9
1,121001,140000,18999,False,19,scaffold_9
2,303001,315000,11999,False,19,scaffold_9
3,319001,331000,11999,False,19,scaffold_9
4,366001,411000,44999,False,19,scaffold_9
5,413001,434000,20999,False,19,scaffold_9
6,519001,531000,11999,False,19,scaffold_9
7,547001,563000,15999,False,19,scaffold_9
8,655001,665000,9999,False,19,scaffold_9
9,671001,697000,25999,False,19,scaffold_9
10,814001,842000,27999,False,19,scaffold_9
11,877001,986000,108999,False,19,scaffold_9
12,987001,995000,7999,False,19,scaffold_9
13,1001001,1085000,83999,False,19,scaffold_9
14,1087001,1178000,90999,False,19,scaffold_9
15,1201001,1225000,23999,False,19,scaffold_9
16,1311001,1383000,71999,False,19,scaffold_9
17,1428001,1440000,11999,False,19,scaffold_9
18,1457001,1465000,7999,False,19,scaffold_9
19,1486001,1584000,97999,False,19,scaffold_9
20,1600001,1624000,23999,False,19,scaffold_9
21,1653001,1682000,28999,False,19,scaffold_9
22,1731001,1811000,79999,False,19,scaffold_9
23,1815001,1856000,40999,False,19,scaffold_9
24,1886001,1940000,53999,False,19,scaffold_9
25,1970001,2171000,200999,False,19,scaffold_9
26,2172001,2354000,181999,False,19,scaffold_9
27,2390001,2468000,77999,False,19,scaffold_9
28,2516001,2579000,62999,False,19,scaffold_9
29,2594001,2673000,78999,False,19,scaffold_9
30,2737001,3381000,643999,False,19,scaffold_9
31,3383001,5099000,1715999,False,19,scaffold_9
32,5101001,5107000,5999,False,19,scaffold_9
33,5112001,5115000,2999,False,19,scaffold_9
34,5116001,5237000,120999,False,19,scaffold_9
35,5239001,5298000,58999,False,19,scaffold_9
36,5300001,5490000,189999,False,19,scaffold_9
37,5493001,6331288,838287,True,19,scaffold_9
0,1,414000,413999,True,19,scaffold_10
1,415001,482000,66999,False,19,scaffold_10
2,483001,581000,97999,False,19,scaffold_10
3,603001,797000,193999,False,19,scaffold_10
4,812001,877000,64999,False,19,scaffold_10
5,888001,921000,32999,False,19,scaffold_10
6,923001,1069000,145999,False,19,scaffold_10
7,1073001,1142000,68999,False,19,scaffold_10
8,1370001,1471000,100999,False,19,scaffold_10
9,1488001,1570000,81999,False,19,scaffold_10
10,1590001,1676000,85999,False,19,scaffold_10
11,1696001,1760000,63999,False,19,scaffold_10
12,1803001,1835000,31999,False,19,scaffold_10
13,1877001,1922000,44999,False,19,scaffold_10
14,2034001,2110000,75999,False,19,scaffold_10
15,2138001,2310000,171999,False,19,scaffold_10
16,2346001,2471000,124999,False,19,scaffold_10
17,2514001,2520000,5999,False,19,scaffold_10
18,2521001,2657000,135999,False,19,scaffold_10
19,2672001,2707000,34999,False,19,scaffold_10
20,2714001,2750000,35999,False,19,scaffold_10
21,2778001,2811000,32999,False,19,scaffold_10
22,2818001,2832000,13999,False,19,scaffold_10
23,2942001,2953000,10999,False,19,scaffold_10
24,3162001,3179000,16999,False,19,scaffold_10
25,3393001,3423000,29999,False,19,scaffold_10
26,3467001,3475000,7999,False,19,scaffold_10
27,3481001,3503000,21999,False,19,scaffold_10
28,3571001,3582000,10999,False,19,scaffold_10
29,4053001,4091000,37999,False,19,scaffold_10
30,4154001,4174000,19999,False,19,scaffold_10
31,4334001,4365000,30999,False,19,scaffold_10
32,4443001,4462000,18999,False,19,scaffold_10
33,4467001,4502000,34999,False,19,scaffold_10
34,4503001,4513000,9999,False,19,scaffold_10
35,4515001,4523000,7999,False,19,scaffold_10
36,4526001,4548000,21999,False,19,scaffold_10
37,4574001,4595000,20999,False,19,scaffold_10
38,4681001,4688000,6999,False,19,scaffold_10
39,4733001,4766000,32999,False,19,scaffold_10
40,4767001,4776000,8999,False,19,scaffold_10
41,4798001,4824000,25999,False,19,scaffold_10
42,4828001,4843000,14999,False,19,scaffold_10
43,4848001,4861000,12999,False,19,scaffold_10
44,4865001,4866973,1972,True,19,scaffold_10
0,10001,93000,82999,False,19,scaffold_11
1,141001,167000,25999,False,19,scaffold_11
2,169001,192000,22999,False,19,scaffold_11
3,214001,236000,21999,False,19,scaffold_11
4,240001,248000,7999,False,19,scaffold_11
5,419001,431000,11999,False,19,scaffold_11
6,651001,657000,5999,False,19,scaffold_11
7,1025001,1034000,8999,False,19,scaffold_11
8,1220001,1241000,20999,False,19,scaffold_11
9,1315001,1342000,26999,False,19,scaffold_11
10,1359001,1398000,38999,False,19,scaffold_11
11,1403001,1409000,5999,False,19,scaffold_11
12,1423001,1426000,2999,False,19,scaffold_11
13,1525001,1543000,17999,False,19,scaffold_11
14,1855001,1954000,98999,False,19,scaffold_11
15,1956001,2058000,101999,False,19,scaffold_11
16,2086001,2148000,61999,False,19,scaffold_11
17,2196001,2233000,36999,False,19,scaffold_11
18,2686001,2909000,222999,False,19,scaffold_11
19,2949001,3019000,69999,False,19,scaffold_11
20,3083001,3175000,91999,False,19,scaffold_11
21,3185001,3386000,200999,False,19,scaffold_11
22,3421001,3480000,58999,False,19,scaffold_11
23,3519001,3972000,452999,False,19,scaffold_11
24,3984001,4159000,174999,False,19,scaffold_11
25,4180001,4710000,529999,False,19,scaffold_11
26,4712001,4766820,54819,True,19,scaffold_11
0,1,1498000,1497999,True,19,scaffold_12
1,1562001,1590000,27999,False,19,scaffold_12
2,1720001,1733000,12999,False,19,scaffold_12
3,1772001,1812000,39999,False,19,scaffold_12
4,1879001,2000000,120999,False,19,scaffold_12
5,2024001,2103000,78999,False,19,scaffold_12
6,2129001,2180000,50999,False,19,scaffold_12
7,2340001,2380000,39999,False,19,scaffold_12
8,2571001,2609000,37999,False,19,scaffold_12
0,1,342000,341999,True,20,scaffold_1
1,482001,498000,15999,False,20,scaffold_1
2,574001,640000,65999,False,20,scaffold_1
3,686001,751000,64999,False,20,scaffold_1
4,1280001,1292000,11999,False,20,scaffold_1
5,1813001,1899000,85999,False,20,scaffold_1
6,1954001,1964000,9999,False,20,scaffold_1
7,1965001,1984000,18999,False,20,scaffold_1
8,1986001,2014000,27999,False,20,scaffold_1
9,2449001,2517000,67999,False,20,scaffold_1
10,2563001,2582000,18999,False,20,scaffold_1
11,2729001,2746000,16999,False,20,scaffold_1
12,3172001,3209000,36999,False,20,scaffold_1
13,3713001,3897000,183999,False,20,scaffold_1
14,3902001,3941000,38999,False,20,scaffold_1
15,3955001,4027000,71999,False,20,scaffold_1
16,4061001,4112000,50999,False,20,scaffold_1
17,4314001,4354000,39999,False,20,scaffold_1
18,4709001,4740000,30999,False,20,scaffold_1
19,4796001,4814000,17999,False,20,scaffold_1
20,4923001,5064000,140999,False,20,scaffold_1
21,5087001,5114000,26999,False,20,scaffold_1
22,5481001,5521000,39999,False,20,scaffold_1
23,5535001,5570000,34999,False,20,scaffold_1
24,6108001,6153000,44999,False,20,scaffold_1
25,6154001,6177000,22999,False,20,scaffold_1
26,6202001,6380000,177999,False,20,scaffold_1
27,6384001,6564000,179999,False,20,scaffold_1
28,6928001,6953000,24999,False,20,scaffold_1
29,7037001,7247000,209999,False,20,scaffold_1
30,7248001,7583000,334999,False,20,scaffold_1
31,7590001,8656000,1065999,False,20,scaffold_1
32,8658001,9584000,925999,False,20,scaffold_1
33,9586001,10357000,770999,False,20,scaffold_1
34,10461001,10639000,177999,False,20,scaffold_1
35,10832001,10857000,24999,False,20,scaffold_1
36,11014001,11031000,16999,False,20,scaffold_1
37,11275001,11507000,231999,False,20,scaffold_1
38,11556001,11951000,394999,False,20,scaffold_1
39,12184001,12204000,19999,False,20,scaffold_1
40,12425001,12449000,23999,False,20,scaffold_1
41,12533001,12584000,50999,False,20,scaffold_1
42,12648001,12723000,74999,False,20,scaffold_1
43,12775001,12888000,112999,False,20,scaffold_1
44,12974001,13000000,25999,False,20,scaffold_1
45,13099001,13211000,111999,False,20,scaffold_1
46,13347001,13431000,83999,False,20,scaffold_1
47,13560001,13590000,29999,False,20,scaffold_1
48,13591001,13617000,25999,False,20,scaffold_1
49,13812001,13844000,31999,False,20,scaffold_1
50,13959001,13974000,14999,False,20,scaffold_1
51,14285001,14310000,24999,False,20,scaffold_1
52,14471001,14479000,7999,False,20,scaffold_1
53,14648001,14664000,15999,False,20,scaffold_1
0,22001,48000,25999,False,20,scaffold_2
1,95001,159000,63999,False,20,scaffold_2
2,168001,177000,8999,False,20,scaffold_2
3,311001,318000,6999,False,20,scaffold_2
4,333001,374000,40999,False,20,scaffold_2
5,1539001,1553000,13999,False,20,scaffold_2
6,2085001,2104000,18999,False,20,scaffold_2
7,2303001,2334000,30999,False,20,scaffold_2
8,2336001,2358000,21999,False,20,scaffold_2
9,2397001,2424000,26999,False,20,scaffold_2
10,2441001,2600000,158999,False,20,scaffold_2
11,2645001,2689000,43999,False,20,scaffold_2
12,2694001,2742000,47999,False,20,scaffold_2
13,2777001,2787000,9999,False,20,scaffold_2
14,2819001,2855000,35999,False,20,scaffold_2
15,2878001,2905000,26999,False,20,scaffold_2
16,2974001,3021000,46999,False,20,scaffold_2
17,3332001,3343000,10999,False,20,scaffold_2
18,3454001,3464000,9999,False,20,scaffold_2
19,3671001,3711000,39999,False,20,scaffold_2
20,3754001,3789000,34999,False,20,scaffold_2
21,4243001,4277000,33999,False,20,scaffold_2
22,4296001,4319000,22999,False,20,scaffold_2
23,4342001,4409000,66999,False,20,scaffold_2
24,4426001,4457000,30999,False,20,scaffold_2
25,4515001,4790000,274999,False,20,scaffold_2
26,4911001,4960000,48999,False,20,scaffold_2
27,5020001,5104000,83999,False,20,scaffold_2
28,5285001,5314000,28999,False,20,scaffold_2
29,5350001,5481000,130999,False,20,scaffold_2
30,5491001,5514000,22999,False,20,scaffold_2
31,5622001,5759000,136999,False,20,scaffold_2
32,5838001,5892000,53999,False,20,scaffold_2
33,5913001,5989000,75999,False,20,scaffold_2
34,6005001,6057000,51999,False,20,scaffold_2
35,6125001,6135000,9999,False,20,scaffold_2
36,6261001,6330000,68999,False,20,scaffold_2
37,6331001,6349000,17999,False,20,scaffold_2
38,6411001,6454000,42999,False,20,scaffold_2
39,6590001,6628000,37999,False,20,scaffold_2
40,7005001,7038000,32999,False,20,scaffold_2
41,7063001,7097000,33999,False,20,scaffold_2
42,7429001,7472000,42999,False,20,scaffold_2
43,7491001,7517000,25999,False,20,scaffold_2
44,7550001,7561000,10999,False,20,scaffold_2
45,7563001,7697000,133999,False,20,scaffold_2
46,7764001,7891000,126999,False,20,scaffold_2
47,7933001,8161000,227999,False,20,scaffold_2
48,8260001,8320000,59999,False,20,scaffold_2
49,8331001,8333000,1999,False,20,scaffold_2
50,8346001,8455000,108999,False,20,scaffold_2
51,8495001,8559000,63999,False,20,scaffold_2
52,9142001,9174000,31999,False,20,scaffold_2
53,9319001,9382000,62999,False,20,scaffold_2
54,11395001,11421000,25999,False,20,scaffold_2
55,11519001,11786000,266999,False,20,scaffold_2
56,11798001,11802476,4475,True,20,scaffold_2
0,796001,900000,103999,False,20,scaffold_3
1,960001,963000,2999,False,20,scaffold_3
2,2008001,2107000,98999,False,20,scaffold_3
3,2288001,2336000,47999,False,20,scaffold_3
4,2487001,2532000,44999,False,20,scaffold_3
5,2653001,2759000,105999,False,20,scaffold_3
6,3110001,3149000,38999,False,20,scaffold_3
7,3227001,3274000,46999,False,20,scaffold_3
8,3606001,3644000,37999,False,20,scaffold_3
9,3713001,3736000,22999,False,20,scaffold_3
10,3765001,3821000,55999,False,20,scaffold_3
11,3822001,3890000,67999,False,20,scaffold_3
12,4007001,4034000,26999,False,20,scaffold_3
13,4108001,4403000,294999,False,20,scaffold_3
14,4417001,4519000,101999,False,20,scaffold_3
15,4546001,4558000,11999,False,20,scaffold_3
16,4652001,4680000,27999,False,20,scaffold_3
17,5158001,5212000,53999,False,20,scaffold_3
18,5624001,5668000,43999,False,20,scaffold_3
19,5854001,5872000,17999,False,20,scaffold_3
20,5879001,5947000,67999,False,20,scaffold_3
21,5970001,6033000,62999,False,20,scaffold_3
22,6757001,6787000,29999,False,20,scaffold_3
23,6888001,7092000,203999,False,20,scaffold_3
24,7286001,7298000,11999,False,20,scaffold_3
25,7336001,7362000,25999,False,20,scaffold_3
26,7368001,7398000,29999,False,20,scaffold_3
27,7451001,7459000,7999,False,20,scaffold_3
28,7524001,7556000,31999,False,20,scaffold_3
29,7692001,7856000,163999,False,20,scaffold_3
30,8034001,8116000,81999,False,20,scaffold_3
31,8121001,8156000,34999,False,20,scaffold_3
32,8176001,8253000,76999,False,20,scaffold_3
33,8462001,8527000,64999,False,20,scaffold_3
34,8575001,8594000,18999,False,20,scaffold_3
35,8963001,8979000,15999,False,20,scaffold_3
36,9004001,9080000,75999,False,20,scaffold_3
37,9968001,9995000,26999,False,20,scaffold_3
38,10065001,10086000,20999,False,20,scaffold_3
39,10461001,10485000,23999,False,20,scaffold_3
40,10587001,11165000,577999,False,20,scaffold_3
0,14001,32000,17999,False,20,scaffold_4
1,48001,88000,39999,False,20,scaffold_4
2,132001,146000,13999,False,20,scaffold_4
3,147001,151000,3999,False,20,scaffold_4
4,155001,215000,59999,False,20,scaffold_4
5,217001,226000,8999,False,20,scaffold_4
6,227001,266000,38999,False,20,scaffold_4
7,283001,311000,27999,False,20,scaffold_4
8,355001,374000,18999,False,20,scaffold_4
9,391001,425000,33999,False,20,scaffold_4
10,429001,498000,68999,False,20,scaffold_4
11,545001,592000,46999,False,20,scaffold_4
12,593001,599000,5999,False,20,scaffold_4
13,608001,691000,82999,False,20,scaffold_4
14,701001,714000,12999,False,20,scaffold_4
15,1121001,1136000,14999,False,20,scaffold_4
16,1137001,1226000,88999,False,20,scaffold_4
17,1235001,1253000,17999,False,20,scaffold_4
18,1254001,1262000,7999,False,20,scaffold_4
19,1265001,1279000,13999,False,20,scaffold_4
20,1283001,1337000,53999,False,20,scaffold_4
21,1341001,1604000,262999,False,20,scaffold_4
22,1613001,2114000,500999,False,20,scaffold_4
23,2142001,2185000,42999,False,20,scaffold_4
24,2188001,2206000,17999,False,20,scaffold_4
25,2211001,2218000,6999,False,20,scaffold_4
26,2219001,2280000,60999,False,20,scaffold_4
27,2284001,2310000,25999,False,20,scaffold_4
28,2312001,2340000,27999,False,20,scaffold_4
29,2342001,2461000,118999,False,20,scaffold_4
30,2476001,2635000,158999,False,20,scaffold_4
31,2676001,2801000,124999,False,20,scaffold_4
32,2896001,2956000,59999,False,20,scaffold_4
33,3032001,3129000,96999,False,20,scaffold_4
34,3335001,3761000,425999,False,20,scaffold_4
35,4057001,4072000,14999,False,20,scaffold_4
36,4262001,4304000,41999,False,20,scaffold_4
37,4905001,5089000,183999,False,20,scaffold_4
38,5172001,5224000,51999,False,20,scaffold_4
39,5300001,5400000,99999,False,20,scaffold_4
40,5471001,5506000,34999,False,20,scaffold_4
41,5514001,5784000,269999,False,20,scaffold_4
42,5786001,5818000,31999,False,20,scaffold_4
43,6146001,6197000,50999,False,20,scaffold_4
44,6764001,6817000,52999,False,20,scaffold_4
45,6890001,6924000,33999,False,20,scaffold_4
46,6926001,6941000,14999,False,20,scaffold_4
47,6943001,6944000,999,False,20,scaffold_4
48,6948001,6995000,46999,False,20,scaffold_4
49,7036001,7124000,87999,False,20,scaffold_4
50,7225001,7331000,105999,False,20,scaffold_4
51,7346001,7373000,26999,False,20,scaffold_4
52,7641001,7665000,23999,False,20,scaffold_4
53,8844001,9699000,854999,False,20,scaffold_4
54,9700001,9845951,145950,True,20,scaffold_4
0,1,4000,3999,True,20,scaffold_5
1,155001,175000,19999,False,20,scaffold_5
2,318001,390000,71999,False,20,scaffold_5
3,463001,523000,59999,False,20,scaffold_5
4,932001,947000,14999,False,20,scaffold_5
5,1668001,1684000,15999,False,20,scaffold_5
6,2475001,2493000,17999,False,20,scaffold_5
7,2563001,2753000,189999,False,20,scaffold_5
8,2765001,2877000,111999,False,20,scaffold_5
9,3133001,3189000,55999,False,20,scaffold_5
10,3211001,3513000,301999,False,20,scaffold_5
11,3616001,3658000,41999,False,20,scaffold_5
12,3962001,4101000,138999,False,20,scaffold_5
13,4119001,4221000,101999,False,20,scaffold_5
14,4227001,4274000,46999,False,20,scaffold_5
15,4445001,4506000,60999,False,20,scaffold_5
16,4590001,4861000,270999,False,20,scaffold_5
17,4883001,4919000,35999,False,20,scaffold_5
18,5059001,5096000,36999,False,20,scaffold_5
19,5258001,5274000,15999,False,20,scaffold_5
20,5288001,5310000,21999,False,20,scaffold_5
21,5318001,5346000,27999,False,20,scaffold_5
22,5720001,5738000,17999,False,20,scaffold_5
23,6403001,6420000,16999,False,20,scaffold_5
24,6454001,6653000,198999,False,20,scaffold_5
25,7454001,7483000,28999,False,20,scaffold_5
26,7547001,7619000,71999,False,20,scaffold_5
27,7621001,7659000,37999,False,20,scaffold_5
28,8551001,8615000,63999,False,20,scaffold_5
29,8659001,8689000,29999,False,20,scaffold_5
30,8703001,9363000,659999,False,20,scaffold_5
31,9364001,9364176,175,True,20,scaffold_5
0,78001,84000,5999,False,20,scaffold_6
1,86001,112000,25999,False,20,scaffold_6
2,165001,208000,42999,False,20,scaffold_6
3,239001,254000,14999,False,20,scaffold_6
4,256001,262000,5999,False,20,scaffold_6
5,267001,317000,49999,False,20,scaffold_6
6,1146001,1199000,52999,False,20,scaffold_6
7,1216001,1226000,9999,False,20,scaffold_6
8,1229001,1256000,26999,False,20,scaffold_6
9,1285001,1309000,23999,False,20,scaffold_6
10,1478001,1590000,111999,False,20,scaffold_6
11,1843001,1906000,62999,False,20,scaffold_6
12,2023001,2100000,76999,False,20,scaffold_6
13,2126001,2194000,67999,False,20,scaffold_6
14,2239001,2284000,44999,False,20,scaffold_6
15,2330001,2595000,264999,False,20,scaffold_6
16,2596001,2872000,275999,False,20,scaffold_6
17,2933001,3016000,82999,False,20,scaffold_6
18,3080001,3206000,125999,False,20,scaffold_6
19,3223001,3333000,109999,False,20,scaffold_6
20,3401001,3794000,392999,False,20,scaffold_6
21,3898001,3913000,14999,False,20,scaffold_6
22,3966001,4195000,228999,False,20,scaffold_6
23,4838001,4870000,31999,False,20,scaffold_6
24,4958001,4994000,35999,False,20,scaffold_6
25,5902001,5972000,69999,False,20,scaffold_6
26,6011001,6083000,71999,False,20,scaffold_6
27,6123001,6190000,66999,False,20,scaffold_6
28,6776001,6803000,26999,False,20,scaffold_6
29,7227001,7245000,17999,False,20,scaffold_6
30,7263001,7337000,73999,False,20,scaffold_6
31,7388001,7442000,53999,False,20,scaffold_6
32,7542001,8268281,726280,True,20,scaffold_6
0,13001,34000,20999,False,20,scaffold_7
1,323001,341000,17999,False,20,scaffold_7
2,342001,508000,165999,False,20,scaffold_7
3,571001,577000,5999,False,20,scaffold_7
4,706001,736000,29999,False,20,scaffold_7
5,764001,829000,64999,False,20,scaffold_7
6,859001,864000,4999,False,20,scaffold_7
7,865001,929000,63999,False,20,scaffold_7
8,964001,980000,15999,False,20,scaffold_7
9,982001,1044000,61999,False,20,scaffold_7
10,1048001,1100000,51999,False,20,scaffold_7
11,1191001,1460000,268999,False,20,scaffold_7
12,1461001,1512000,50999,False,20,scaffold_7
13,1588001,1698000,109999,False,20,scaffold_7
14,1740001,1757000,16999,False,20,scaffold_7
15,1758001,1782000,23999,False,20,scaffold_7
16,1850001,1902000,51999,False,20,scaffold_7
17,1972001,2010000,37999,False,20,scaffold_7
18,3296001,3313000,16999,False,20,scaffold_7
19,3325001,3370000,44999,False,20,scaffold_7
20,3521001,3766000,244999,False,20,scaffold_7
21,4324001,4361000,36999,False,20,scaffold_7
22,4415001,4517000,101999,False,20,scaffold_7
23,4527001,4580000,52999,False,20,scaffold_7
24,4631001,4743000,111999,False,20,scaffold_7
25,4978001,5149000,170999,False,20,scaffold_7
26,5470001,5536000,65999,False,20,scaffold_7
27,6168001,6234000,65999,False,20,scaffold_7
28,6954001,7078000,123999,False,20,scaffold_7
29,7079001,7270000,190999,False,20,scaffold_7
30,7271001,7502216,231215,True,20,scaffold_7
0,66001,87000,20999,False,20,scaffold_8
1,729001,732000,2999,False,20,scaffold_8
2,1858001,1928000,69999,False,20,scaffold_8
3,2444001,2528000,83999,False,20,scaffold_8
4,2536001,2552000,15999,False,20,scaffold_8
5,2650001,2683000,32999,False,20,scaffold_8
6,2684001,2844000,159999,False,20,scaffold_8
7,2847001,2874000,26999,False,20,scaffold_8
8,3035001,3554000,518999,False,20,scaffold_8
9,3579001,3612000,32999,False,20,scaffold_8
10,3615001,3938000,322999,False,20,scaffold_8
11,4038001,4110000,71999,False,20,scaffold_8
12,4203001,4221000,17999,False,20,scaffold_8
13,4394001,4432000,37999,False,20,scaffold_8
14,5095001,5136000,40999,False,20,scaffold_8
15,5164001,5240000,75999,False,20,scaffold_8
16,5580001,5597000,16999,False,20,scaffold_8
17,5651001,5692000,40999,False,20,scaffold_8
18,6321001,6334544,13543,True,20,scaffold_8
0,109001,117000,7999,False,20,scaffold_9
1,121001,137000,15999,False,20,scaffold_9
2,271001,276000,4999,False,20,scaffold_9
3,366001,411000,44999,False,20,scaffold_9
4,413001,434000,20999,False,20,scaffold_9
5,501001,531000,29999,False,20,scaffold_9
6,654001,659000,4999,False,20,scaffold_9
7,660001,665000,4999,False,20,scaffold_9
8,671001,696000,24999,False,20,scaffold_9
9,731001,742000,10999,False,20,scaffold_9
10,793001,803000,9999,False,20,scaffold_9
11,814001,842000,27999,False,20,scaffold_9
12,873001,986000,112999,False,20,scaffold_9
13,988001,995000,6999,False,20,scaffold_9
14,1001001,1007000,5999,False,20,scaffold_9
15,1010001,1085000,74999,False,20,scaffold_9
16,1087001,1150000,62999,False,20,scaffold_9
17,1151001,1176000,24999,False,20,scaffold_9
18,1312001,1386000,73999,False,20,scaffold_9
19,1456001,1465000,8999,False,20,scaffold_9
20,1657001,1667000,9999,False,20,scaffold_9
21,1749001,1791000,41999,False,20,scaffold_9
22,1831001,1857000,25999,False,20,scaffold_9
23,1987001,2058000,70999,False,20,scaffold_9
24,2076001,2133000,56999,False,20,scaffold_9
25,2137001,2171000,33999,False,20,scaffold_9
26,2594001,2663000,68999,False,20,scaffold_9
27,2737001,2824000,86999,False,20,scaffold_9
28,2844001,3381000,536999,False,20,scaffold_9
29,3383001,5099000,1715999,False,20,scaffold_9
30,5101001,5107000,5999,False,20,scaffold_9
31,5112001,5114000,1999,False,20,scaffold_9
32,5116001,5298000,181999,False,20,scaffold_9
33,5300001,5491000,190999,False,20,scaffold_9
34,5493001,6331288,838287,True,20,scaffold_9
0,1,414000,413999,True,20,scaffold_10
1,415001,482000,66999,False,20,scaffold_10
2,483001,582000,98999,False,20,scaffold_10
3,603001,795000,191999,False,20,scaffold_10
4,812001,840000,27999,False,20,scaffold_10
5,888001,921000,32999,False,20,scaffold_10
6,923001,964000,40999,False,20,scaffold_10
7,1060001,1069000,8999,False,20,scaffold_10
8,1073001,1113000,39999,False,20,scaffold_10
9,1426001,1468000,41999,False,20,scaffold_10
10,2091001,2102000,10999,False,20,scaffold_10
11,2140001,2180000,39999,False,20,scaffold_10
12,2266001,2319000,52999,False,20,scaffold_10
13,2339001,2444000,104999,False,20,scaffold_10
14,2556001,2586000,29999,False,20,scaffold_10
15,2599001,2650000,50999,False,20,scaffold_10
16,2683001,2694000,10999,False,20,scaffold_10
17,2714001,2749000,34999,False,20,scaffold_10
18,3114001,3131000,16999,False,20,scaffold_10
19,3579001,3582000,2999,False,20,scaffold_10
20,4054001,4091000,36999,False,20,scaffold_10
21,4154001,4174000,19999,False,20,scaffold_10
22,4336001,4359000,22999,False,20,scaffold_10
23,4443001,4462000,18999,False,20,scaffold_10
24,4467001,4502000,34999,False,20,scaffold_10
25,4503001,4513000,9999,False,20,scaffold_10
26,4515001,4523000,7999,False,20,scaffold_10
27,4526001,4548000,21999,False,20,scaffold_10
28,4565001,4596000,30999,False,20,scaffold_10
29,4681001,4688000,6999,False,20,scaffold_10
30,4734001,4776000,41999,False,20,scaffold_10
31,4798001,4824000,25999,False,20,scaffold_10
32,4827001,4843000,15999,False,20,scaffold_10
33,4848001,4861000,12999,False,20,scaffold_10
34,4865001,4866973,1972,True,20,scaffold_10
0,11001,92000,80999,False,20,scaffold_11
1,149001,167000,17999,False,20,scaffold_11
2,169001,191000,21999,False,20,scaffold_11
3,213001,235000,21999,False,20,scaffold_11
4,240001,248000,7999,False,20,scaffold_11
5,292001,317000,24999,False,20,scaffold_11
6,419001,431000,11999,False,20,scaffold_11
7,648001,656000,7999,False,20,scaffold_11
8,665001,669000,3999,False,20,scaffold_11
9,1025001,1034000,8999,False,20,scaffold_11
10,1423001,1426000,2999,False,20,scaffold_11
11,1474001,1478000,3999,False,20,scaffold_11
12,2008001,2034000,25999,False,20,scaffold_11
13,2131001,2172000,40999,False,20,scaffold_11
14,2701001,2877000,175999,False,20,scaffold_11
15,2951001,3015000,63999,False,20,scaffold_11
16,3086001,3292000,205999,False,20,scaffold_11
17,3328001,3383000,54999,False,20,scaffold_11
18,3422001,3478000,55999,False,20,scaffold_11
19,3521001,3612000,90999,False,20,scaffold_11
20,3616001,3650000,33999,False,20,scaffold_11
21,3702001,3971000,268999,False,20,scaffold_11
22,3997001,4159000,161999,False,20,scaffold_11
23,4179001,4710000,530999,False,20,scaffold_11
24,4713001,4766820,53819,True,20,scaffold_11
0,1,1468000,1467999,True,20,scaffold_12
1,1720001,1736000,15999,False,20,scaffold_12
2,2023001,2087000,63999,False,20,scaffold_12
3,2088001,2103000,14999,False,20,scaffold_12
4,2136001,2176000,39999,False,20,scaffold_12
5,2571001,2615000,43999,False,20,scaffold_12
6,2747001,2747968,967,True,20,scaffold_12
0,1,340000,339999,True,21,scaffold_1
1,482001,498000,15999,False,21,scaffold_1
2,572001,643000,70999,False,21,scaffold_1
3,686001,743000,56999,False,21,scaffold_1
4,1281001,1292000,10999,False,21,scaffold_1
5,1833001,1898000,64999,False,21,scaffold_1
6,1954001,1964000,9999,False,21,scaffold_1
7,1965001,1984000,18999,False,21,scaffold_1
8,2449001,2517000,67999,False,21,scaffold_1
9,2569001,2579000,9999,False,21,scaffold_1
10,2729001,2746000,16999,False,21,scaffold_1
11,3175001,3208000,32999,False,21,scaffold_1
12,3715001,3738000,22999,False,21,scaffold_1
13,3915001,3941000,25999,False,21,scaffold_1
14,4060001,4111000,50999,False,21,scaffold_1
15,4322001,4354000,31999,False,21,scaffold_1
16,4920001,5013000,92999,False,21,scaffold_1
17,5481001,5511000,29999,False,21,scaffold_1
18,5535001,5570000,34999,False,21,scaffold_1
19,6108001,6153000,44999,False,21,scaffold_1
20,6154001,6176000,21999,False,21,scaffold_1
21,6202001,6381000,178999,False,21,scaffold_1
22,6384001,6507000,122999,False,21,scaffold_1
23,6545001,6554000,8999,False,21,scaffold_1
24,7038001,7247000,208999,False,21,scaffold_1
25,7248001,7583000,334999,False,21,scaffold_1
26,7590001,8656000,1065999,False,21,scaffold_1
27,8658001,9584000,925999,False,21,scaffold_1
28,9586001,10356000,769999,False,21,scaffold_1
29,10461001,10638000,176999,False,21,scaffold_1
30,10808001,10811000,2999,False,21,scaffold_1
31,10837001,10858000,20999,False,21,scaffold_1
32,11344001,11510000,165999,False,21,scaffold_1
33,11560001,11951000,390999,False,21,scaffold_1
34,12184001,12206000,21999,False,21,scaffold_1
35,12650001,12722000,71999,False,21,scaffold_1
36,12776001,12888000,111999,False,21,scaffold_1
37,13113001,13215000,101999,False,21,scaffold_1
38,13347001,13431000,83999,False,21,scaffold_1
39,13816001,13844000,27999,False,21,scaffold_1
40,14291001,14310000,18999,False,21,scaffold_1
0,20001,48000,27999,False,21,scaffold_2
1,93001,159000,65999,False,21,scaffold_2
2,165001,177000,11999,False,21,scaffold_2
3,297001,318000,20999,False,21,scaffold_2
4,330001,374000,43999,False,21,scaffold_2
5,2336001,2358000,21999,False,21,scaffold_2
6,2441001,2554000,112999,False,21,scaffold_2
7,2660001,2689000,28999,False,21,scaffold_2
8,2694001,2742000,47999,False,21,scaffold_2
9,2868001,2900000,31999,False,21,scaffold_2
10,2974001,3021000,46999,False,21,scaffold_2
11,3454001,3464000,9999,False,21,scaffold_2
12,3760001,3783000,22999,False,21,scaffold_2
13,4382001,4409000,26999,False,21,scaffold_2
14,4427001,4458000,30999,False,21,scaffold_2
15,4521001,4656000,134999,False,21,scaffold_2
16,4918001,4937000,18999,False,21,scaffold_2
17,5022001,5031000,8999,False,21,scaffold_2
18,5033001,5061000,27999,False,21,scaffold_2
19,5371001,5394000,22999,False,21,scaffold_2
20,5491001,5515000,23999,False,21,scaffold_2
21,5668001,5705000,36999,False,21,scaffold_2
22,5719001,5752000,32999,False,21,scaffold_2
23,6261001,6330000,68999,False,21,scaffold_2
24,6331001,6351000,19999,False,21,scaffold_2
25,6396001,6449000,52999,False,21,scaffold_2
26,7439001,7472000,32999,False,21,scaffold_2
27,7563001,7697000,133999,False,21,scaffold_2
28,7786001,7890000,103999,False,21,scaffold_2
29,7934001,8136000,201999,False,21,scaffold_2
30,8261001,8313000,51999,False,21,scaffold_2
31,8331001,8333000,1999,False,21,scaffold_2
32,8346001,8454000,107999,False,21,scaffold_2
33,8509001,8559000,49999,False,21,scaffold_2
34,11544001,11786000,241999,False,21,scaffold_2
0,1,2000,1999,True,21,scaffold_3
1,51001,55000,3999,False,21,scaffold_3
2,799001,901000,101999,False,21,scaffold_3
3,960001,964000,3999,False,21,scaffold_3
4,2078001,2108000,29999,False,21,scaffold_3
5,2291001,2321000,29999,False,21,scaffold_3
6,2487001,2533000,45999,False,21,scaffold_3
7,2717001,2735000,17999,False,21,scaffold_3
8,3829001,3844000,14999,False,21,scaffold_3
9,4095001,4403000,307999,False,21,scaffold_3
10,4410001,4519000,108999,False,21,scaffold_3
11,4547001,4558000,10999,False,21,scaffold_3
12,5494001,5509000,14999,False,21,scaffold_3
13,5990001,6020000,29999,False,21,scaffold_3
14,6907001,6962000,54999,False,21,scaffold_3
15,6963001,7079000,115999,False,21,scaffold_3
16,7288001,7299000,10999,False,21,scaffold_3
17,7522001,7556000,33999,False,21,scaffold_3
18,7692001,7853000,160999,False,21,scaffold_3
19,8177001,8253000,75999,False,21,scaffold_3
20,8462001,8527000,64999,False,21,scaffold_3
21,8575001,8594000,18999,False,21,scaffold_3
22,9968001,9996000,27999,False,21,scaffold_3
23,10461001,10483000,21999,False,21,scaffold_3
24,10587001,11167000,579999,False,21,scaffold_3
0,48001,88000,39999,False,21,scaffold_4
1,120001,146000,25999,False,21,scaffold_4
2,147001,151000,3999,False,21,scaffold_4
3,155001,215000,59999,False,21,scaffold_4
4,217001,226000,8999,False,21,scaffold_4
5,227001,266000,38999,False,21,scaffold_4
6,290001,344000,53999,False,21,scaffold_4
7,355001,374000,18999,False,21,scaffold_4
8,375001,380000,4999,False,21,scaffold_4
9,390001,410000,19999,False,21,scaffold_4
10,411001,425000,13999,False,21,scaffold_4
11,429001,498000,68999,False,21,scaffold_4
12,545001,592000,46999,False,21,scaffold_4
13,608001,691000,82999,False,21,scaffold_4
14,701001,716000,14999,False,21,scaffold_4
15,1113001,1136000,22999,False,21,scaffold_4
16,1137001,1198000,60999,False,21,scaffold_4
17,1199001,1226000,26999,False,21,scaffold_4
18,1269001,1279000,9999,False,21,scaffold_4
19,1283001,1336000,52999,False,21,scaffold_4
20,1371001,1598000,226999,False,21,scaffold_4
21,1613001,2068000,454999,False,21,scaffold_4
22,2071001,2100000,28999,False,21,scaffold_4
23,2162001,2185000,22999,False,21,scaffold_4
24,2266001,2279000,12999,False,21,scaffold_4
25,2284001,2461000,176999,False,21,scaffold_4
26,2480001,2583000,102999,False,21,scaffold_4
27,2598001,2635000,36999,False,21,scaffold_4
28,3336001,3633000,296999,False,21,scaffold_4
29,3649001,3766000,116999,False,21,scaffold_4
30,4908001,4984000,75999,False,21,scaffold_4
31,5176001,5204000,27999,False,21,scaffold_4
32,5477001,5506000,28999,False,21,scaffold_4
33,5514001,5620000,105999,False,21,scaffold_4
34,5661001,5784000,122999,False,21,scaffold_4
35,6145001,6195000,49999,False,21,scaffold_4
36,6771001,6817000,45999,False,21,scaffold_4
37,6902001,6924000,21999,False,21,scaffold_4
38,6951001,6995000,43999,False,21,scaffold_4
39,7036001,7062000,25999,False,21,scaffold_4
40,7985001,7998000,12999,False,21,scaffold_4
41,8846001,9699000,852999,False,21,scaffold_4
42,9700001,9845951,145950,True,21,scaffold_4
0,1,4000,3999,True,21,scaffold_5
1,318001,382000,63999,False,21,scaffold_5
2,463001,523000,59999,False,21,scaffold_5
3,669001,696000,26999,False,21,scaffold_5
4,933001,947000,13999,False,21,scaffold_5
5,2516001,2526000,9999,False,21,scaffold_5
6,2565001,2583000,17999,False,21,scaffold_5
7,2618001,2745000,126999,False,21,scaffold_5
8,2813001,2871000,57999,False,21,scaffold_5
9,3136001,3185000,48999,False,21,scaffold_5
10,3311001,3512000,200999,False,21,scaffold_5
11,3962001,4101000,138999,False,21,scaffold_5
12,4121001,4219000,97999,False,21,scaffold_5
13,4246001,4263000,16999,False,21,scaffold_5
14,4446001,4505000,58999,False,21,scaffold_5
15,4602001,4680000,77999,False,21,scaffold_5
16,4691001,4861000,169999,False,21,scaffold_5
17,4892001,4919000,26999,False,21,scaffold_5
18,5250001,5274000,23999,False,21,scaffold_5
19,5303001,5310000,6999,False,21,scaffold_5
20,5314001,5346000,31999,False,21,scaffold_5
21,6409001,6418000,8999,False,21,scaffold_5
22,6508001,6655000,146999,False,21,scaffold_5
23,7454001,7483000,28999,False,21,scaffold_5
24,7579001,7619000,39999,False,21,scaffold_5
25,7621001,7654000,32999,False,21,scaffold_5
26,8571001,8616000,44999,False,21,scaffold_5
27,8730001,9275000,544999,False,21,scaffold_5
28,9276001,9363000,86999,False,21,scaffold_5
0,66001,74000,7999,False,21,scaffold_6
1,79001,114000,34999,False,21,scaffold_6
2,241001,254000,12999,False,21,scaffold_6
3,257001,263000,5999,False,21,scaffold_6
4,267001,283000,15999,False,21,scaffold_6
5,1239001,1255000,15999,False,21,scaffold_6
6,1478001,1546000,67999,False,21,scaffold_6
7,1564001,1592000,27999,False,21,scaffold_6
8,1862001,1899000,36999,False,21,scaffold_6
9,2023001,2099000,75999,False,21,scaffold_6
10,2130001,2181000,50999,False,21,scaffold_6
11,2243001,2265000,21999,False,21,scaffold_6
12,2336001,2595000,258999,False,21,scaffold_6
13,2596001,2691000,94999,False,21,scaffold_6
14,2712001,2872000,159999,False,21,scaffold_6
15,2934001,3014000,79999,False,21,scaffold_6
16,3115001,3176000,60999,False,21,scaffold_6
17,3223001,3301000,77999,False,21,scaffold_6
18,3406001,3428000,21999,False,21,scaffold_6
19,3461001,3785000,323999,False,21,scaffold_6
20,3899001,3913000,13999,False,21,scaffold_6
21,4018001,4192000,173999,False,21,scaffold_6
22,6008001,6063000,54999,False,21,scaffold_6
23,7283001,7337000,53999,False,21,scaffold_6
24,7393001,7414000,20999,False,21,scaffold_6
25,7545001,7795000,249999,False,21,scaffold_6
26,7811001,8268281,457280,True,21,scaffold_6
0,1,7000,6999,True,21,scaffold_7
1,13001,31000,17999,False,21,scaffold_7
2,323001,340000,16999,False,21,scaffold_7
3,342001,508000,165999,False,21,scaffold_7
4,554001,563000,8999,False,21,scaffold_7
5,571001,577000,5999,False,21,scaffold_7
6,706001,724000,17999,False,21,scaffold_7
7,725001,736000,10999,False,21,scaffold_7
8,764001,818000,53999,False,21,scaffold_7
9,859001,864000,4999,False,21,scaffold_7
10,868001,929000,60999,False,21,scaffold_7
11,964001,966000,1999,False,21,scaffold_7
12,968001,980000,11999,False,21,scaffold_7
13,982001,1044000,61999,False,21,scaffold_7
14,1048001,1101000,52999,False,21,scaffold_7
15,1191001,1512000,320999,False,21,scaffold_7
16,1588001,1695000,106999,False,21,scaffold_7
17,3326001,3369000,42999,False,21,scaffold_7
18,3537001,3547000,9999,False,21,scaffold_7
19,3593001,3649000,55999,False,21,scaffold_7
20,4416001,4518000,101999,False,21,scaffold_7
21,4658001,4682000,23999,False,21,scaffold_7
22,4978001,5149000,170999,False,21,scaffold_7
23,5484001,5515000,30999,False,21,scaffold_7
24,6954001,7270000,315999,False,21,scaffold_7
25,7271001,7502216,231215,True,21,scaffold_7
0,1,10000,9999,True,21,scaffold_8
1,67001,85000,17999,False,21,scaffold_8
2,93001,102000,8999,False,21,scaffold_8
3,2444001,2527000,82999,False,21,scaffold_8
4,2656001,2683000,26999,False,21,scaffold_8
5,2742001,2757000,14999,False,21,scaffold_8
6,2798001,2844000,45999,False,21,scaffold_8
7,3059001,3125000,65999,False,21,scaffold_8
8,3126001,3525000,398999,False,21,scaffold_8
9,3584001,3612000,27999,False,21,scaffold_8
10,3615001,3936000,320999,False,21,scaffold_8
11,4036001,4105000,68999,False,21,scaffold_8
12,5121001,5135000,13999,False,21,scaffold_8
13,5186001,5241000,54999,False,21,scaffold_8
14,6324001,6334544,10543,True,21,scaffold_8
0,109001,117000,7999,False,21,scaffold_9
1,367001,411000,43999,False,21,scaffold_9
2,413001,434000,20999,False,21,scaffold_9
3,502001,531000,28999,False,21,scaffold_9
4,671001,697000,25999,False,21,scaffold_9
5,732001,742000,9999,False,21,scaffold_9
6,815001,842000,26999,False,21,scaffold_9
7,850001,862000,11999,False,21,scaffold_9
8,873001,986000,112999,False,21,scaffold_9
9,987001,995000,7999,False,21,scaffold_9
10,1001001,1085000,83999,False,21,scaffold_9
11,1087001,1171000,83999,False,21,scaffold_9
12,1312001,1382000,69999,False,21,scaffold_9
13,1457001,1464000,6999,False,21,scaffold_9
14,1749001,1791000,41999,False,21,scaffold_9
15,1987001,2029000,41999,False,21,scaffold_9
16,2148001,2171000,22999,False,21,scaffold_9
17,2595001,2616000,20999,False,21,scaffold_9
18,2782001,2803000,20999,False,21,scaffold_9
19,2871001,3381000,509999,False,21,scaffold_9
20,3383001,5107000,1723999,False,21,scaffold_9
21,5112001,5114000,1999,False,21,scaffold_9
22,5116001,5238000,121999,False,21,scaffold_9
23,5239001,5298000,58999,False,21,scaffold_9
24,5299001,6331288,1032287,True,21,scaffold_9
0,1,203000,202999,True,21,scaffold_10
1,280001,414000,133999,False,21,scaffold_10
2,457001,482000,24999,False,21,scaffold_10
3,483001,582000,98999,False,21,scaffold_10
4,602001,755000,152999,False,21,scaffold_10
5,888001,917000,28999,False,21,scaffold_10
6,923001,962000,38999,False,21,scaffold_10
7,1088001,1112000,23999,False,21,scaffold_10
8,2141001,2170000,28999,False,21,scaffold_10
9,2273001,2299000,25999,False,21,scaffold_10
10,2346001,2425000,78999,False,21,scaffold_10
11,4053001,4091000,37999,False,21,scaffold_10
12,4154001,4174000,19999,False,21,scaffold_10
13,4443001,4462000,18999,False,21,scaffold_10
14,4467001,4476000,8999,False,21,scaffold_10
15,4503001,4513000,9999,False,21,scaffold_10
16,4515001,4523000,7999,False,21,scaffold_10
17,4526001,4548000,21999,False,21,scaffold_10
18,4574001,4596000,21999,False,21,scaffold_10
19,4679001,4688000,8999,False,21,scaffold_10
20,4734001,4766000,31999,False,21,scaffold_10
21,4769001,4776000,6999,False,21,scaffold_10
22,4798001,4824000,25999,False,21,scaffold_10
23,4828001,4843000,14999,False,21,scaffold_10
24,4848001,4861000,12999,False,21,scaffold_10
25,4865001,4866973,1972,True,21,scaffold_10
0,10001,93000,82999,False,21,scaffold_11
1,149001,167000,17999,False,21,scaffold_11
2,169001,189000,19999,False,21,scaffold_11
3,213001,236000,22999,False,21,scaffold_11
4,240001,247000,6999,False,21,scaffold_11
5,419001,431000,11999,False,21,scaffold_11
6,648001,656000,7999,False,21,scaffold_11
7,1025001,1034000,8999,False,21,scaffold_11
8,1423001,1427000,3999,False,21,scaffold_11
9,2701001,2876000,174999,False,21,scaffold_11
10,2983001,3018000,34999,False,21,scaffold_11
11,3092001,3123000,30999,False,21,scaffold_11
12,3185001,3241000,55999,False,21,scaffold_11
13,3329001,3383000,53999,False,21,scaffold_11
14,3549001,3577000,27999,False,21,scaffold_11
15,3702001,3933000,230999,False,21,scaffold_11
16,4008001,4159000,150999,False,21,scaffold_11
17,4189001,4710000,520999,False,21,scaffold_11
18,4713001,4766820,53819,True,21,scaffold_11
0,1,370000,369999,True,21,scaffold_12
1,474001,538000,63999,False,21,scaffold_12
2,580001,856000,275999,False,21,scaffold_12
3,864001,1467000,602999,False,21,scaffold_12
4,1720001,1733000,12999,False,21,scaffold_12
5,2043001,2087000,43999,False,21,scaffold_12
6,2088001,2103000,14999,False,21,scaffold_12
7,2137001,2165000,27999,False,21,scaffold_12
8,2365001,2374000,8999,False,21,scaffold_12
9,2571001,2617000,45999,False,21,scaffold_12
0,1,342000,341999,True,22,scaffold_1
1,482001,498000,15999,False,22,scaffold_1
2,571001,643000,71999,False,22,scaffold_1
3,686001,750000,63999,False,22,scaffold_1
4,1271001,1292000,20999,False,22,scaffold_1
5,1615001,1660000,44999,False,22,scaffold_1
6,1812001,1901000,88999,False,22,scaffold_1
7,1951001,1964000,12999,False,22,scaffold_1
8,1965001,1984000,18999,False,22,scaffold_1
9,1987001,2017000,29999,False,22,scaffold_1
10,2362001,2389000,26999,False,22,scaffold_1
11,2449001,2518000,68999,False,22,scaffold_1
12,2555001,2581000,25999,False,22,scaffold_1
13,2729001,2746000,16999,False,22,scaffold_1
14,3173001,3211000,37999,False,22,scaffold_1
15,3445001,3480000,34999,False,22,scaffold_1
16,3706001,3878000,171999,False,22,scaffold_1
17,3901001,3941000,39999,False,22,scaffold_1
18,3957001,4112000,154999,False,22,scaffold_1
19,4314001,4375000,60999,False,22,scaffold_1
20,4717001,4790000,72999,False,22,scaffold_1
21,4796001,4813000,16999,False,22,scaffold_1
22,4910001,5025000,114999,False,22,scaffold_1
23,5042001,5061000,18999,False,22,scaffold_1
24,5087001,5116000,28999,False,22,scaffold_1
25,5437001,5452000,14999,False,22,scaffold_1
26,5481001,5521000,39999,False,22,scaffold_1
27,5535001,5579000,43999,False,22,scaffold_1
28,5856001,5881000,24999,False,22,scaffold_1
29,6108001,6153000,44999,False,22,scaffold_1
30,6154001,6177000,22999,False,22,scaffold_1
31,6219001,6379000,159999,False,22,scaffold_1
32,6384001,6562000,177999,False,22,scaffold_1
33,6641001,6656000,14999,False,22,scaffold_1
34,7038001,7247000,208999,False,22,scaffold_1
35,7248001,7589000,340999,False,22,scaffold_1
36,7590001,8656000,1065999,False,22,scaffold_1
37,8658001,9584000,925999,False,22,scaffold_1
38,9586001,10363000,776999,False,22,scaffold_1
39,10461001,10638000,176999,False,22,scaffold_1
40,10739001,10755000,15999,False,22,scaffold_1
41,10808001,10811000,2999,False,22,scaffold_1
42,10832001,10857000,24999,False,22,scaffold_1
43,10920001,10940000,19999,False,22,scaffold_1
44,11270001,11509000,238999,False,22,scaffold_1
45,11551001,11957000,405999,False,22,scaffold_1
46,12184001,12205000,20999,False,22,scaffold_1
47,12382001,12396000,13999,False,22,scaffold_1
48,12425001,12449000,23999,False,22,scaffold_1
49,12498001,12547000,48999,False,22,scaffold_1
50,12625001,12888000,262999,False,22,scaffold_1
51,12976001,12989000,12999,False,22,scaffold_1
52,13014001,13042000,27999,False,22,scaffold_1
53,13112001,13212000,99999,False,22,scaffold_1
54,13344001,13447000,102999,False,22,scaffold_1
55,13796001,13845000,48999,False,22,scaffold_1
56,13847001,13876000,28999,False,22,scaffold_1
57,13928001,13941000,12999,False,22,scaffold_1
58,14285001,14313000,27999,False,22,scaffold_1
59,14595001,14611000,15999,False,22,scaffold_1
60,14648001,14660000,11999,False,22,scaffold_1
0,20001,48000,27999,False,22,scaffold_2
1,95001,159000,63999,False,22,scaffold_2
2,165001,177000,11999,False,22,scaffold_2
3,308001,318000,9999,False,22,scaffold_2
4,333001,374000,40999,False,22,scaffold_2
5,379001,381000,1999,False,22,scaffold_2
6,1528001,1556000,27999,False,22,scaffold_2
7,2085001,2113000,27999,False,22,scaffold_2
8,2336001,2424000,87999,False,22,scaffold_2
9,2437001,2609000,171999,False,22,scaffold_2
10,2623001,2639000,15999,False,22,scaffold_2
11,2645001,2689000,43999,False,22,scaffold_2
12,2694001,2744000,49999,False,22,scaffold_2
13,2777001,2787000,9999,False,22,scaffold_2
14,2803001,2856000,52999,False,22,scaffold_2
15,2868001,2905000,36999,False,22,scaffold_2
16,3330001,3347000,16999,False,22,scaffold_2
17,3369001,3382000,12999,False,22,scaffold_2
18,3450001,3472000,21999,False,22,scaffold_2
19,3678001,3688000,9999,False,22,scaffold_2
20,3754001,3790000,35999,False,22,scaffold_2
21,4242001,4277000,34999,False,22,scaffold_2
22,4336001,4409000,72999,False,22,scaffold_2
23,4426001,4460000,33999,False,22,scaffold_2
24,4517001,4654000,136999,False,22,scaffold_2
25,4784001,4790000,5999,False,22,scaffold_2
26,4793001,4808000,14999,False,22,scaffold_2
27,4917001,4962000,44999,False,22,scaffold_2
28,5021001,5104000,82999,False,22,scaffold_2
29,5287001,5315000,27999,False,22,scaffold_2
30,5349001,5564000,214999,False,22,scaffold_2
31,5607001,5759000,151999,False,22,scaffold_2
32,5838001,5891000,52999,False,22,scaffold_2
33,5909001,5993000,83999,False,22,scaffold_2
34,6261001,6330000,68999,False,22,scaffold_2
35,6331001,6351000,19999,False,22,scaffold_2
36,6384001,6465000,80999,False,22,scaffold_2
37,6585001,6629000,43999,False,22,scaffold_2
38,7001001,7039000,37999,False,22,scaffold_2
39,7063001,7096000,32999,False,22,scaffold_2
40,7166001,7219000,52999,False,22,scaffold_2
41,7350001,7472000,121999,False,22,scaffold_2
42,7491001,7513000,21999,False,22,scaffold_2
43,7563001,7708000,144999,False,22,scaffold_2
44,7767001,8162000,394999,False,22,scaffold_2
45,8262001,8314000,51999,False,22,scaffold_2
46,8331001,8333000,1999,False,22,scaffold_2
47,8334001,8344000,9999,False,22,scaffold_2
48,8346001,8454000,107999,False,22,scaffold_2
49,8509001,8563000,53999,False,22,scaffold_2
50,9139001,9175000,35999,False,22,scaffold_2
51,9348001,9382000,33999,False,22,scaffold_2
52,11367001,11380000,12999,False,22,scaffold_2
53,11395001,11422000,26999,False,22,scaffold_2
54,11520001,11786000,265999,False,22,scaffold_2
0,1,2000,1999,True,22,scaffold_3
1,618001,646000,27999,False,22,scaffold_3
2,798001,900000,101999,False,22,scaffold_3
3,1903001,1916000,12999,False,22,scaffold_3
4,2009001,2108000,98999,False,22,scaffold_3
5,2109001,2147000,37999,False,22,scaffold_3
6,2291001,2340000,48999,False,22,scaffold_3
7,2433001,2533000,99999,False,22,scaffold_3
8,2652001,2760000,107999,False,22,scaffold_3
9,3052001,3062000,9999,False,22,scaffold_3
10,3099001,3142000,42999,False,22,scaffold_3
11,3226001,3257000,30999,False,22,scaffold_3
12,3602001,3690000,87999,False,22,scaffold_3
13,3754001,3821000,66999,False,22,scaffold_3
14,3822001,3891000,68999,False,22,scaffold_3
15,3909001,3921000,11999,False,22,scaffold_3
16,4105001,4403000,297999,False,22,scaffold_3
17,4414001,4519000,104999,False,22,scaffold_3
18,4547001,4558000,10999,False,22,scaffold_3
19,4637001,4686000,48999,False,22,scaffold_3
20,4999001,5020000,20999,False,22,scaffold_3
21,5157001,5228000,70999,False,22,scaffold_3
22,5231001,5278000,46999,False,22,scaffold_3
23,5376001,5399000,22999,False,22,scaffold_3
24,5489001,5509000,19999,False,22,scaffold_3
25,5623001,5661000,37999,False,22,scaffold_3
26,5705001,5732000,26999,False,22,scaffold_3
27,5836001,5942000,105999,False,22,scaffold_3
28,5971001,6024000,52999,False,22,scaffold_3
29,6741001,6783000,41999,False,22,scaffold_3
30,6892001,7098000,205999,False,22,scaffold_3
31,7110001,7157000,46999,False,22,scaffold_3
32,7255001,7303000,47999,False,22,scaffold_3
33,7333001,7398000,64999,False,22,scaffold_3
34,7483001,7556000,72999,False,22,scaffold_3
35,7683001,7866000,182999,False,22,scaffold_3
36,8029001,8116000,86999,False,22,scaffold_3
37,8121001,8156000,34999,False,22,scaffold_3
38,8175001,8255000,79999,False,22,scaffold_3
39,8400001,8415000,14999,False,22,scaffold_3
40,8422001,8447000,24999,False,22,scaffold_3
41,8462001,8527000,64999,False,22,scaffold_3
42,8575001,8594000,18999,False,22,scaffold_3
43,9018001,9080000,61999,False,22,scaffold_3
44,9127001,9171000,43999,False,22,scaffold_3
45,9656001,9688000,31999,False,22,scaffold_3
46,9968001,9996000,27999,False,22,scaffold_3
47,10461001,10483000,21999,False,22,scaffold_3
48,10587001,11165000,577999,False,22,scaffold_3
0,11001,13000,1999,False,22,scaffold_4
1,14001,16000,1999,False,22,scaffold_4
2,17001,32000,14999,False,22,scaffold_4
3,48001,80000,31999,False,22,scaffold_4
4,133001,146000,12999,False,22,scaffold_4
5,147001,151000,3999,False,22,scaffold_4
6,155001,215000,59999,False,22,scaffold_4
7,217001,226000,8999,False,22,scaffold_4
8,227001,267000,39999,False,22,scaffold_4
9,318001,344000,25999,False,22,scaffold_4
10,355001,374000,18999,False,22,scaffold_4
11,375001,380000,4999,False,22,scaffold_4
12,390001,425000,34999,False,22,scaffold_4
13,429001,500000,70999,False,22,scaffold_4
14,542001,599000,56999,False,22,scaffold_4
15,600001,606000,5999,False,22,scaffold_4
16,608001,691000,82999,False,22,scaffold_4
17,1121001,1198000,76999,False,22,scaffold_4
18,1199001,1226000,26999,False,22,scaffold_4
19,1235001,1253000,17999,False,22,scaffold_4
20,1254001,1262000,7999,False,22,scaffold_4
21,1265001,1279000,13999,False,22,scaffold_4
22,1283001,1336000,52999,False,22,scaffold_4
23,1372001,1604000,231999,False,22,scaffold_4
24,1609001,1611000,1999,False,22,scaffold_4
25,1613001,2117000,503999,False,22,scaffold_4
26,2119001,2183000,63999,False,22,scaffold_4
27,2190001,2206000,15999,False,22,scaffold_4
28,2210001,2280000,69999,False,22,scaffold_4
29,2283001,2340000,56999,False,22,scaffold_4
30,2342001,2461000,118999,False,22,scaffold_4
31,2477001,2538000,60999,False,22,scaffold_4
32,2539001,2635000,95999,False,22,scaffold_4
33,2676001,2795000,118999,False,22,scaffold_4
34,2896001,2958000,61999,False,22,scaffold_4
35,3031001,3127000,95999,False,22,scaffold_4
36,3206001,3324000,117999,False,22,scaffold_4
37,3339001,3779000,439999,False,22,scaffold_4
38,4012001,4015000,2999,False,22,scaffold_4
39,4016001,4017000,999,False,22,scaffold_4
40,4019001,4023000,3999,False,22,scaffold_4
41,4058001,4104000,45999,False,22,scaffold_4
42,4900001,5095000,194999,False,22,scaffold_4
43,5170001,5224000,53999,False,22,scaffold_4
44,5339001,5404000,64999,False,22,scaffold_4
45,5475001,5506000,30999,False,22,scaffold_4
46,5514001,5784000,269999,False,22,scaffold_4
47,5786001,5856000,69999,False,22,scaffold_4
48,6047001,6106000,58999,False,22,scaffold_4
49,6146001,6197000,50999,False,22,scaffold_4
50,6214001,6296000,81999,False,22,scaffold_4
51,6329001,6375000,45999,False,22,scaffold_4
52,6764001,6817000,52999,False,22,scaffold_4
53,6898001,6924000,25999,False,22,scaffold_4
54,6926001,6931000,4999,False,22,scaffold_4
55,6950001,6995000,44999,False,22,scaffold_4
56,7036001,7079000,42999,False,22,scaffold_4
57,7207001,7322000,114999,False,22,scaffold_4
58,7352001,7428000,75999,False,22,scaffold_4
59,7629001,7666000,36999,False,22,scaffold_4
60,7862001,7911000,48999,False,22,scaffold_4
61,8520001,8531000,10999,False,22,scaffold_4
62,8846001,9699000,852999,False,22,scaffold_4
63,9700001,9845951,145950,True,22,scaffold_4
0,1,5000,4999,True,22,scaffold_5
1,318001,385000,66999,False,22,scaffold_5
2,459001,524000,64999,False,22,scaffold_5
3,669001,699000,29999,False,22,scaffold_5
4,839001,842000,2999,False,22,scaffold_5
5,933001,947000,13999,False,22,scaffold_5
6,2259001,2300000,40999,False,22,scaffold_5
7,2475001,2493000,17999,False,22,scaffold_5
8,2509001,2515000,5999,False,22,scaffold_5
9,2552001,2898000,345999,False,22,scaffold_5
10,3133001,3517000,383999,False,22,scaffold_5
11,3616001,3659000,42999,False,22,scaffold_5
12,3962001,4101000,138999,False,22,scaffold_5
13,4119001,4222000,102999,False,22,scaffold_5
14,4232001,4321000,88999,False,22,scaffold_5
15,4445001,4554000,108999,False,22,scaffold_5
16,4600001,4861000,260999,False,22,scaffold_5
17,4884001,4924000,39999,False,22,scaffold_5
18,5249001,5274000,24999,False,22,scaffold_5
19,5287001,5346000,58999,False,22,scaffold_5
20,5721001,5738000,16999,False,22,scaffold_5
21,6391001,6441000,49999,False,22,scaffold_5
22,6451001,6653000,201999,False,22,scaffold_5
23,7334001,7364000,29999,False,22,scaffold_5
24,7454001,7483000,28999,False,22,scaffold_5
25,7551001,7619000,67999,False,22,scaffold_5
26,7620001,7748000,127999,False,22,scaffold_5
27,7794001,7806000,11999,False,22,scaffold_5
28,8554001,8616000,61999,False,22,scaffold_5
29,8654001,8687000,32999,False,22,scaffold_5
30,8710001,9364176,654175,True,22,scaffold_5
0,79001,85000,5999,False,22,scaffold_6
1,86001,112000,25999,False,22,scaffold_6
2,168001,211000,42999,False,22,scaffold_6
3,240001,255000,14999,False,22,scaffold_6
4,256001,262000,5999,False,22,scaffold_6
5,264001,316000,51999,False,22,scaffold_6
6,467001,482000,14999,False,22,scaffold_6
7,741001,751000,9999,False,22,scaffold_6
8,787001,801000,13999,False,22,scaffold_6
9,901001,940000,38999,False,22,scaffold_6
10,1145001,1199000,53999,False,22,scaffold_6
11,1211001,1226000,14999,False,22,scaffold_6
12,1229001,1263000,33999,False,22,scaffold_6
13,1286001,1311000,24999,False,22,scaffold_6
14,1436001,1546000,109999,False,22,scaffold_6
15,1562001,1595000,32999,False,22,scaffold_6
16,1658001,1690000,31999,False,22,scaffold_6
17,1837001,1906000,68999,False,22,scaffold_6
18,2023001,2103000,79999,False,22,scaffold_6
19,2126001,2213000,86999,False,22,scaffold_6
20,2236001,2284000,47999,False,22,scaffold_6
21,2314001,2654000,339999,False,22,scaffold_6
22,2656001,2872000,215999,False,22,scaffold_6
23,2941001,3031000,89999,False,22,scaffold_6
24,3083001,3350000,266999,False,22,scaffold_6
25,3351001,3795000,443999,False,22,scaffold_6
26,3878001,3926000,47999,False,22,scaffold_6
27,4018001,4195000,176999,False,22,scaffold_6
28,4839001,4869000,29999,False,22,scaffold_6
29,4901001,4916000,14999,False,22,scaffold_6
30,4954001,4997000,42999,False,22,scaffold_6
31,5863001,5971000,107999,False,22,scaffold_6
32,6010001,6083000,72999,False,22,scaffold_6
33,6123001,6190000,66999,False,22,scaffold_6
34,6775001,6804000,28999,False,22,scaffold_6
35,6974001,7006000,31999,False,22,scaffold_6
36,7255001,7349000,93999,False,22,scaffold_6
37,7390001,7436000,45999,False,22,scaffold_6
38,7541001,8268281,727280,True,22,scaffold_6
0,13001,34000,20999,False,22,scaffold_7
1,323001,340000,16999,False,22,scaffold_7
2,342001,508000,165999,False,22,scaffold_7
3,554001,563000,8999,False,22,scaffold_7
4,571001,577000,5999,False,22,scaffold_7
5,706001,753000,46999,False,22,scaffold_7
6,764001,829000,64999,False,22,scaffold_7
7,859001,864000,4999,False,22,scaffold_7
8,874001,943000,68999,False,22,scaffold_7
9,964001,966000,1999,False,22,scaffold_7
10,968001,980000,11999,False,22,scaffold_7
11,982001,1044000,61999,False,22,scaffold_7
12,1195001,1512000,316999,False,22,scaffold_7
13,1588001,1694000,105999,False,22,scaffold_7
14,1740001,1782000,41999,False,22,scaffold_7
15,1975001,2015000,39999,False,22,scaffold_7
16,2639001,2670000,30999,False,22,scaffold_7
17,2931001,2959000,27999,False,22,scaffold_7
18,3325001,3370000,44999,False,22,scaffold_7
19,3515001,3792000,276999,False,22,scaffold_7
20,4414001,4517000,102999,False,22,scaffold_7
21,4548001,4580000,31999,False,22,scaffold_7
22,4658001,4876000,217999,False,22,scaffold_7
23,4978001,5168000,189999,False,22,scaffold_7
24,5483001,5536000,52999,False,22,scaffold_7
25,6069001,6094000,24999,False,22,scaffold_7
26,6580001,6674000,93999,False,22,scaffold_7
27,6750001,6787000,36999,False,22,scaffold_7
28,6954001,7270000,315999,False,22,scaffold_7
29,7271001,7502216,231215,True,22,scaffold_7
0,1,7000,6999,True,22,scaffold_8
1,66001,85000,18999,False,22,scaffold_8
2,93001,102000,8999,False,22,scaffold_8
3,729001,732000,2999,False,22,scaffold_8
4,1861001,1928000,66999,False,22,scaffold_8
5,2444001,2530000,85999,False,22,scaffold_8
6,2536001,2553000,16999,False,22,scaffold_8
7,2650001,2683000,32999,False,22,scaffold_8
8,2685001,2844000,158999,False,22,scaffold_8
9,2847001,2891000,43999,False,22,scaffold_8
10,3025001,3553000,527999,False,22,scaffold_8
11,3581001,3614000,32999,False,22,scaffold_8
12,3615001,3938000,322999,False,22,scaffold_8
13,4033001,4119000,85999,False,22,scaffold_8
14,4174001,4221000,46999,False,22,scaffold_8
15,4399001,4431000,31999,False,22,scaffold_8
16,4611001,4639000,27999,False,22,scaffold_8
17,5076001,5241000,164999,False,22,scaffold_8
18,5529001,5568000,38999,False,22,scaffold_8
19,5576001,5597000,20999,False,22,scaffold_8
20,5652001,5695000,42999,False,22,scaffold_8
21,5750001,5804000,53999,False,22,scaffold_8
22,5850001,5904000,53999,False,22,scaffold_8
23,6026001,6078000,51999,False,22,scaffold_8
24,6219001,6305000,85999,False,22,scaffold_8
25,6322001,6334544,12543,True,22,scaffold_8
0,109001,118000,8999,False,22,scaffold_9
1,121001,134000,12999,False,22,scaffold_9
2,303001,316000,12999,False,22,scaffold_9
3,319001,332000,12999,False,22,scaffold_9
4,366001,411000,44999,False,22,scaffold_9
5,413001,434000,20999,False,22,scaffold_9
6,501001,531000,29999,False,22,scaffold_9
7,652001,664000,11999,False,22,scaffold_9
8,671001,696000,24999,False,22,scaffold_9
9,731001,742000,10999,False,22,scaffold_9
10,817001,842000,24999,False,22,scaffold_9
11,873001,896000,22999,False,22,scaffold_9
12,897001,986000,88999,False,22,scaffold_9
13,987001,995000,7999,False,22,scaffold_9
14,997001,1000000,2999,False,22,scaffold_9
15,1001001,1007000,5999,False,22,scaffold_9
16,1010001,1180000,169999,False,22,scaffold_9
17,1310001,1377000,66999,False,22,scaffold_9
18,1487001,1500000,12999,False,22,scaffold_9
19,1502001,1592000,89999,False,22,scaffold_9
20,1600001,1623000,22999,False,22,scaffold_9
21,1637001,1692000,54999,False,22,scaffold_9
22,1748001,1791000,42999,False,22,scaffold_9
23,1894001,1943000,48999,False,22,scaffold_9
24,1970001,2063000,92999,False,22,scaffold_9
25,2075001,2171000,95999,False,22,scaffold_9
26,2174001,2255000,80999,False,22,scaffold_9
27,2390001,2429000,38999,False,22,scaffold_9
28,2516001,2540000,23999,False,22,scaffold_9
29,2597001,2664000,66999,False,22,scaffold_9
30,2738001,3381000,642999,False,22,scaffold_9
31,3383001,5107000,1723999,False,22,scaffold_9
32,5112001,5115000,2999,False,22,scaffold_9
33,5116001,5238000,121999,False,22,scaffold_9
34,5239001,5298000,58999,False,22,scaffold_9
35,5300001,5491000,190999,False,22,scaffold_9
36,5493001,6331288,838287,True,22,scaffold_9
0,1,482000,481999,True,22,scaffold_10
1,483001,581000,97999,False,22,scaffold_10
2,600001,796000,195999,False,22,scaffold_10
3,862001,877000,14999,False,22,scaffold_10
4,888001,986000,97999,False,22,scaffold_10
5,1038001,1069000,30999,False,22,scaffold_10
6,1073001,1145000,71999,False,22,scaffold_10
7,1370001,1472000,101999,False,22,scaffold_10
8,1602001,1621000,18999,False,22,scaffold_10
9,1635001,1664000,28999,False,22,scaffold_10
10,1694001,1729000,34999,False,22,scaffold_10
11,2012001,2113000,100999,False,22,scaffold_10
12,2136001,2176000,39999,False,22,scaffold_10
13,2201001,2327000,125999,False,22,scaffold_10
14,2346001,2471000,124999,False,22,scaffold_10
15,2509001,2520000,10999,False,22,scaffold_10
16,2528001,2590000,61999,False,22,scaffold_10
17,2600001,2653000,52999,False,22,scaffold_10
18,2674001,2708000,33999,False,22,scaffold_10
19,2714001,2749000,34999,False,22,scaffold_10
20,2758001,2811000,52999,False,22,scaffold_10
21,2942001,2956000,13999,False,22,scaffold_10
22,3393001,3407000,13999,False,22,scaffold_10
23,3408001,3423000,14999,False,22,scaffold_10
24,4052001,4093000,40999,False,22,scaffold_10
25,4154001,4174000,19999,False,22,scaffold_10
26,4467001,4502000,34999,False,22,scaffold_10
27,4515001,4523000,7999,False,22,scaffold_10
28,4526001,4548000,21999,False,22,scaffold_10
29,4574001,4597000,22999,False,22,scaffold_10
30,4679001,4688000,8999,False,22,scaffold_10
31,4734001,4751000,16999,False,22,scaffold_10
32,4752001,4766000,13999,False,22,scaffold_10
33,4791001,4797000,5999,False,22,scaffold_10
34,4798001,4824000,25999,False,22,scaffold_10
35,4828001,4843000,14999,False,22,scaffold_10
36,4848001,4861000,12999,False,22,scaffold_10
0,10001,99000,88999,False,22,scaffold_11
1,149001,167000,17999,False,22,scaffold_11
2,169001,212000,42999,False,22,scaffold_11
3,213001,236000,22999,False,22,scaffold_11
4,240001,248000,7999,False,22,scaffold_11
5,296001,314000,17999,False,22,scaffold_11
6,419001,431000,11999,False,22,scaffold_11
7,648001,656000,7999,False,22,scaffold_11
8,1025001,1034000,8999,False,22,scaffold_11
9,1423001,1426000,2999,False,22,scaffold_11
10,1432001,1449000,16999,False,22,scaffold_11
11,1474001,1478000,3999,False,22,scaffold_11
12,1855001,1870000,14999,False,22,scaffold_11
13,1871001,1898000,26999,False,22,scaffold_11
14,2008001,2058000,49999,False,22,scaffold_11
15,2142001,2172000,29999,False,22,scaffold_11
16,2201001,2220000,18999,False,22,scaffold_11
17,2701001,2919000,217999,False,22,scaffold_11
18,2950001,3019000,68999,False,22,scaffold_11
19,3081001,3176000,94999,False,22,scaffold_11
20,3184001,3383000,198999,False,22,scaffold_11
21,3418001,3479000,60999,False,22,scaffold_11
22,3521001,3777000,255999,False,22,scaffold_11
23,3779001,3971000,191999,False,22,scaffold_11
24,3992001,4159000,166999,False,22,scaffold_11
25,4189001,4710000,520999,False,22,scaffold_11
26,4713001,4766820,53819,True,22,scaffold_11
0,1,1500000,1499999,True,22,scaffold_12
1,1717001,1735000,17999,False,22,scaffold_12
2,1880001,1961000,80999,False,22,scaffold_12
3,1971001,1996000,24999,False,22,scaffold_12
4,2043001,2103000,59999,False,22,scaffold_12
5,2130001,2166000,35999,False,22,scaffold_12
6,2340001,2380000,39999,False,22,scaffold_12
7,2492001,2502000,9999,False,22,scaffold_12
8,2571001,2617000,45999,False,22,scaffold_12
9,2659001,2681000,21999,False,22,scaffold_12
0,1,342000,341999,True,23,scaffold_1
1,482001,498000,15999,False,23,scaffold_1
2,571001,643000,71999,False,23,scaffold_1
3,686001,751000,64999,False,23,scaffold_1
4,1176001,1195000,18999,False,23,scaffold_1
5,1281001,1292000,10999,False,23,scaffold_1
6,1645001,1659000,13999,False,23,scaffold_1
7,1794001,1935000,140999,False,23,scaffold_1
8,1951001,1964000,12999,False,23,scaffold_1
9,1965001,1984000,18999,False,23,scaffold_1
10,1987001,2015000,27999,False,23,scaffold_1
11,2345001,2387000,41999,False,23,scaffold_1
12,2449001,2517000,67999,False,23,scaffold_1
13,2564001,2582000,17999,False,23,scaffold_1
14,2726001,2746000,19999,False,23,scaffold_1
15,2908001,2921000,12999,False,23,scaffold_1
16,2960001,3023000,62999,False,23,scaffold_1
17,3174001,3213000,38999,False,23,scaffold_1
18,3444001,3499000,54999,False,23,scaffold_1
19,3713001,3941000,227999,False,23,scaffold_1
20,3955001,4028000,72999,False,23,scaffold_1
21,4064001,4112000,47999,False,23,scaffold_1
22,4313001,4354000,40999,False,23,scaffold_1
23,4684001,4693000,8999,False,23,scaffold_1
24,4796001,4815000,18999,False,23,scaffold_1
25,4913001,5027000,113999,False,23,scaffold_1
26,5438001,5456000,17999,False,23,scaffold_1
27,5481001,5521000,39999,False,23,scaffold_1
28,5535001,5573000,37999,False,23,scaffold_1
29,5852001,5875000,22999,False,23,scaffold_1
30,6108001,6177000,68999,False,23,scaffold_1
31,6203001,6380000,176999,False,23,scaffold_1
32,6384001,6567000,182999,False,23,scaffold_1
33,6830001,6851000,20999,False,23,scaffold_1
34,7038001,7247000,208999,False,23,scaffold_1
35,7248001,7584000,335999,False,23,scaffold_1
36,7590001,8656000,1065999,False,23,scaffold_1
37,8658001,9584000,925999,False,23,scaffold_1
38,9586001,10362000,775999,False,23,scaffold_1
39,10461001,10639000,177999,False,23,scaffold_1
40,10808001,10811000,2999,False,23,scaffold_1
41,10835001,10857000,21999,False,23,scaffold_1
42,10916001,10940000,23999,False,23,scaffold_1
43,11014001,11052000,37999,False,23,scaffold_1
44,11275001,11333000,57999,False,23,scaffold_1
45,11341001,11951000,609999,False,23,scaffold_1
46,12184001,12205000,20999,False,23,scaffold_1
47,12425001,12450000,24999,False,23,scaffold_1
48,12509001,12585000,75999,False,23,scaffold_1
49,12624001,12950000,325999,False,23,scaffold_1
50,12967001,13002000,34999,False,23,scaffold_1
51,13024001,13041000,16999,False,23,scaffold_1
52,13112001,13213000,100999,False,23,scaffold_1
53,13347001,13453000,105999,False,23,scaffold_1
54,13558001,13589000,30999,False,23,scaffold_1
55,13811001,13844000,32999,False,23,scaffold_1
56,13859001,13878000,18999,False,23,scaffold_1
57,13959001,13973000,13999,False,23,scaffold_1
58,14285001,14307000,21999,False,23,scaffold_1
59,14648001,14664000,15999,False,23,scaffold_1
0,1,48000,47999,True,23,scaffold_2
1,95001,159000,63999,False,23,scaffold_2
2,168001,177000,8999,False,23,scaffold_2
3,296001,318000,21999,False,23,scaffold_2
4,330001,374000,43999,False,23,scaffold_2
5,379001,381000,1999,False,23,scaffold_2
6,1359001,1415000,55999,False,23,scaffold_2
7,1526001,1548000,21999,False,23,scaffold_2
8,2085001,2111000,25999,False,23,scaffold_2
9,2336001,2387000,50999,False,23,scaffold_2
10,2404001,2415000,10999,False,23,scaffold_2
11,2416001,2424000,7999,False,23,scaffold_2
12,2441001,2609000,167999,False,23,scaffold_2
13,2626001,2639000,12999,False,23,scaffold_2
14,2645001,2689000,43999,False,23,scaffold_2
15,2694001,2747000,52999,False,23,scaffold_2
16,2766001,2788000,21999,False,23,scaffold_2
17,2818001,2856000,37999,False,23,scaffold_2
18,2878001,2902000,23999,False,23,scaffold_2
19,2973001,3013000,39999,False,23,scaffold_2
20,3022001,3048000,25999,False,23,scaffold_2
21,3274001,3282000,7999,False,23,scaffold_2
22,3450001,3553000,102999,False,23,scaffold_2
23,3658001,3693000,34999,False,23,scaffold_2
24,3754001,3790000,35999,False,23,scaffold_2
25,4243001,4277000,33999,False,23,scaffold_2
26,4296001,4409000,112999,False,23,scaffold_2
27,4426001,4459000,32999,False,23,scaffold_2
28,4516001,4790000,273999,False,23,scaffold_2
29,4911001,4956000,44999,False,23,scaffold_2
30,5018001,5104000,85999,False,23,scaffold_2
31,5182001,5224000,41999,False,23,scaffold_2
32,5348001,5481000,132999,False,23,scaffold_2
33,5490001,5515000,24999,False,23,scaffold_2
34,5622001,5758000,135999,False,23,scaffold_2
35,5830001,5888000,57999,False,23,scaffold_2
36,5910001,5989000,78999,False,23,scaffold_2
37,6124001,6140000,15999,False,23,scaffold_2
38,6261001,6341000,79999,False,23,scaffold_2
39,6385001,6449000,63999,False,23,scaffold_2
40,6580001,6628000,47999,False,23,scaffold_2
41,7001001,7038000,36999,False,23,scaffold_2
42,7049001,7097000,47999,False,23,scaffold_2
43,7341001,7473000,131999,False,23,scaffold_2
44,7491001,7513000,21999,False,23,scaffold_2
45,7549001,7561000,11999,False,23,scaffold_2
46,7563001,7917000,353999,False,23,scaffold_2
47,7933001,8313000,379999,False,23,scaffold_2
48,8331001,8333000,1999,False,23,scaffold_2
49,8346001,8453000,106999,False,23,scaffold_2
50,8495001,8564000,68999,False,23,scaffold_2
51,9001001,9051000,49999,False,23,scaffold_2
52,9140001,9173000,32999,False,23,scaffold_2
53,9316001,9382000,65999,False,23,scaffold_2
54,11395001,11423000,27999,False,23,scaffold_2
55,11519001,11786000,266999,False,23,scaffold_2
0,43001,46000,2999,False,23,scaffold_3
1,51001,55000,3999,False,23,scaffold_3
2,217001,232000,14999,False,23,scaffold_3
3,618001,646000,27999,False,23,scaffold_3
4,797001,900000,102999,False,23,scaffold_3
5,2000001,2108000,107999,False,23,scaffold_3
6,2287001,2336000,48999,False,23,scaffold_3
7,2378001,2427000,48999,False,23,scaffold_3
8,2459001,2533000,73999,False,23,scaffold_3
9,2622001,2761000,138999,False,23,scaffold_3
10,3104001,3144000,39999,False,23,scaffold_3
11,3225001,3282000,56999,False,23,scaffold_3
12,3561001,3591000,29999,False,23,scaffold_3
13,3602001,3692000,89999,False,23,scaffold_3
14,3768001,3892000,123999,False,23,scaffold_3
15,3926001,3945000,18999,False,23,scaffold_3
16,3975001,4036000,60999,False,23,scaffold_3
17,4092001,4403000,310999,False,23,scaffold_3
18,4410001,4519000,108999,False,23,scaffold_3
19,4546001,4558000,11999,False,23,scaffold_3
20,4652001,4680000,27999,False,23,scaffold_3
21,4855001,4890000,34999,False,23,scaffold_3
22,4997001,5033000,35999,False,23,scaffold_3
23,5159001,5208000,48999,False,23,scaffold_3
24,5235001,5272000,36999,False,23,scaffold_3
25,5385001,5444000,58999,False,23,scaffold_3
26,5493001,5509000,15999,False,23,scaffold_3
27,5564001,5676000,111999,False,23,scaffold_3
28,5678001,5684000,5999,False,23,scaffold_3
29,5805001,6021000,215999,False,23,scaffold_3
30,6066001,6093000,26999,False,23,scaffold_3
31,6741001,6805000,63999,False,23,scaffold_3
32,6886001,6962000,75999,False,23,scaffold_3
33,6963001,7097000,133999,False,23,scaffold_3
34,7111001,7157000,45999,False,23,scaffold_3
35,7229001,7328000,98999,False,23,scaffold_3
36,7332001,7413000,80999,False,23,scaffold_3
37,7462001,7479000,16999,False,23,scaffold_3
38,7483001,7556000,72999,False,23,scaffold_3
39,7576001,7648000,71999,False,23,scaffold_3
40,7677001,7855000,177999,False,23,scaffold_3
41,8028001,8116000,87999,False,23,scaffold_3
42,8121001,8154000,32999,False,23,scaffold_3
43,8175001,8255000,79999,False,23,scaffold_3
44,8428001,8449000,20999,False,23,scaffold_3
45,8462001,8594000,131999,False,23,scaffold_3
46,8994001,9170000,175999,False,23,scaffold_3
47,9197001,9238000,40999,False,23,scaffold_3
48,9648001,9688000,39999,False,23,scaffold_3
49,9968001,9996000,27999,False,23,scaffold_3
50,10042001,10086000,43999,False,23,scaffold_3
51,10461001,10484000,22999,False,23,scaffold_3
52,10551001,10571000,19999,False,23,scaffold_3
53,10574001,11166000,591999,False,23,scaffold_3
0,14001,16000,1999,False,23,scaffold_4
1,17001,32000,14999,False,23,scaffold_4
2,48001,88000,39999,False,23,scaffold_4
3,133001,146000,12999,False,23,scaffold_4
4,147001,151000,3999,False,23,scaffold_4
5,155001,215000,59999,False,23,scaffold_4
6,217001,226000,8999,False,23,scaffold_4
7,227001,267000,39999,False,23,scaffold_4
8,318001,344000,25999,False,23,scaffold_4
9,346001,353000,6999,False,23,scaffold_4
10,355001,374000,18999,False,23,scaffold_4
11,375001,380000,4999,False,23,scaffold_4
12,392001,410000,17999,False,23,scaffold_4
13,412001,425000,12999,False,23,scaffold_4
14,429001,501000,71999,False,23,scaffold_4
15,542001,599000,56999,False,23,scaffold_4
16,600001,606000,5999,False,23,scaffold_4
17,608001,691000,82999,False,23,scaffold_4
18,1087001,1110000,22999,False,23,scaffold_4
19,1113001,1136000,22999,False,23,scaffold_4
20,1137001,1226000,88999,False,23,scaffold_4
21,1229001,1253000,23999,False,23,scaffold_4
22,1254001,1279000,24999,False,23,scaffold_4
23,1283001,1336000,52999,False,23,scaffold_4
24,1353001,1604000,250999,False,23,scaffold_4
25,1613001,2117000,503999,False,23,scaffold_4
26,2119001,2128000,8999,False,23,scaffold_4
27,2142001,2205000,62999,False,23,scaffold_4
28,2219001,2279000,59999,False,23,scaffold_4
29,2284001,2461000,176999,False,23,scaffold_4
30,2477001,2635000,157999,False,23,scaffold_4
31,2676001,2814000,137999,False,23,scaffold_4
32,2891001,2964000,72999,False,23,scaffold_4
33,3030001,3133000,102999,False,23,scaffold_4
34,3236001,3785000,548999,False,23,scaffold_4
35,4057001,4079000,21999,False,23,scaffold_4
36,4258001,4306000,47999,False,23,scaffold_4
37,4900001,5091000,190999,False,23,scaffold_4
38,5177001,5187000,9999,False,23,scaffold_4
39,5197001,5223000,25999,False,23,scaffold_4
40,5341001,5424000,82999,False,23,scaffold_4
41,5458001,5506000,47999,False,23,scaffold_4
42,5513001,5784000,270999,False,23,scaffold_4
43,5786001,5819000,32999,False,23,scaffold_4
44,6067001,6108000,40999,False,23,scaffold_4
45,6145001,6194000,48999,False,23,scaffold_4
46,6287001,6297000,9999,False,23,scaffold_4
47,6328001,6375000,46999,False,23,scaffold_4
48,6763001,6924000,160999,False,23,scaffold_4
49,6926001,6995000,68999,False,23,scaffold_4
50,7036001,7124000,87999,False,23,scaffold_4
51,7192001,7402000,209999,False,23,scaffold_4
52,7629001,7665000,35999,False,23,scaffold_4
53,7860001,7917000,56999,False,23,scaffold_4
54,8844001,9699000,854999,False,23,scaffold_4
55,9700001,9845951,145950,True,23,scaffold_4
0,318001,401000,82999,False,23,scaffold_5
1,402001,427000,24999,False,23,scaffold_5
2,445001,526000,80999,False,23,scaffold_5
3,669001,698000,28999,False,23,scaffold_5
4,933001,947000,13999,False,23,scaffold_5
5,1096001,1104000,7999,False,23,scaffold_5
6,2093001,2104000,10999,False,23,scaffold_5
7,2472001,2493000,20999,False,23,scaffold_5
8,2508001,2515000,6999,False,23,scaffold_5
9,2516001,2522000,5999,False,23,scaffold_5
10,2554001,2894000,339999,False,23,scaffold_5
11,3133001,3519000,385999,False,23,scaffold_5
12,3616001,3658000,41999,False,23,scaffold_5
13,3962001,4101000,138999,False,23,scaffold_5
14,4119001,4222000,102999,False,23,scaffold_5
15,4241001,4322000,80999,False,23,scaffold_5
16,4446001,4551000,104999,False,23,scaffold_5
17,4574001,4861000,286999,False,23,scaffold_5
18,4892001,4926000,33999,False,23,scaffold_5
19,4972001,4991000,18999,False,23,scaffold_5
20,5056001,5106000,49999,False,23,scaffold_5
21,5249001,5347000,97999,False,23,scaffold_5
22,6393001,6425000,31999,False,23,scaffold_5
23,6458001,6726000,267999,False,23,scaffold_5
24,6836001,6851000,14999,False,23,scaffold_5
25,6888001,6906000,17999,False,23,scaffold_5
26,7175001,7204000,28999,False,23,scaffold_5
27,7299001,7327000,27999,False,23,scaffold_5
28,7406001,7440000,33999,False,23,scaffold_5
29,7454001,7513000,58999,False,23,scaffold_5
30,7558001,7619000,60999,False,23,scaffold_5
31,7620001,7746000,125999,False,23,scaffold_5
32,8435001,8470000,34999,False,23,scaffold_5
33,8550001,8616000,65999,False,23,scaffold_5
34,8658001,8689000,30999,False,23,scaffold_5
35,8702001,9364176,662175,True,23,scaffold_5
0,79001,85000,5999,False,23,scaffold_6
1,86001,114000,27999,False,23,scaffold_6
2,168001,205000,36999,False,23,scaffold_6
3,239001,254000,14999,False,23,scaffold_6
4,257001,262000,4999,False,23,scaffold_6
5,264001,296000,31999,False,23,scaffold_6
6,783001,810000,26999,False,23,scaffold_6
7,987001,1038000,50999,False,23,scaffold_6
8,1147001,1204000,56999,False,23,scaffold_6
9,1235001,1265000,29999,False,23,scaffold_6
10,1292001,1301000,8999,False,23,scaffold_6
11,1428001,1549000,120999,False,23,scaffold_6
12,1559001,1595000,35999,False,23,scaffold_6
13,1657001,1712000,54999,False,23,scaffold_6
14,1843001,1906000,62999,False,23,scaffold_6
15,1907001,1933000,25999,False,23,scaffold_6
16,1998001,2019000,20999,False,23,scaffold_6
17,2023001,2104000,80999,False,23,scaffold_6
18,2127001,2214000,86999,False,23,scaffold_6
19,2240001,2283000,42999,False,23,scaffold_6
20,2334001,2872000,537999,False,23,scaffold_6
21,2933001,3210000,276999,False,23,scaffold_6
22,3223001,3350000,126999,False,23,scaffold_6
23,3351001,3795000,443999,False,23,scaffold_6
24,3810001,3851000,40999,False,23,scaffold_6
25,3881001,3931000,49999,False,23,scaffold_6
26,3966001,4003000,36999,False,23,scaffold_6
27,4016001,4204000,187999,False,23,scaffold_6
28,4837001,4872000,34999,False,23,scaffold_6
29,4942001,4997000,54999,False,23,scaffold_6
30,5862001,5972000,109999,False,23,scaffold_6
31,6009001,6084000,74999,False,23,scaffold_6
32,6124001,6190000,65999,False,23,scaffold_6
33,6765001,6804000,38999,False,23,scaffold_6
34,6913001,6941000,27999,False,23,scaffold_6
35,7256001,7337000,80999,False,23,scaffold_6
36,7389001,7436000,46999,False,23,scaffold_6
37,7531001,8268281,737280,True,23,scaffold_6
0,1,9000,8999,True,23,scaffold_7
1,10001,34000,23999,False,23,scaffold_7
2,323001,340000,16999,False,23,scaffold_7
3,342001,508000,165999,False,23,scaffold_7
4,571001,577000,5999,False,23,scaffold_7
5,706001,736000,29999,False,23,scaffold_7
6,741001,755000,13999,False,23,scaffold_7
7,764001,843000,78999,False,23,scaffold_7
8,858001,864000,5999,False,23,scaffold_7
9,868001,946000,77999,False,23,scaffold_7
10,964001,966000,1999,False,23,scaffold_7
11,967001,980000,12999,False,23,scaffold_7
12,982001,1044000,61999,False,23,scaffold_7
13,1048001,1104000,55999,False,23,scaffold_7
14,1169001,1187000,17999,False,23,scaffold_7
15,1191001,1460000,268999,False,23,scaffold_7
16,1461001,1512000,50999,False,23,scaffold_7
17,1588001,1690000,101999,False,23,scaffold_7
18,1759001,1782000,22999,False,23,scaffold_7
19,1849001,1901000,51999,False,23,scaffold_7
20,3297001,3388000,90999,False,23,scaffold_7
21,3518001,3809000,290999,False,23,scaffold_7
22,3912001,3931000,18999,False,23,scaffold_7
23,4021001,4066000,44999,False,23,scaffold_7
24,4415001,4518000,102999,False,23,scaffold_7
25,4655001,4820000,164999,False,23,scaffold_7
26,4978001,5169000,190999,False,23,scaffold_7
27,5471001,5538000,66999,False,23,scaffold_7
28,6052001,6094000,41999,False,23,scaffold_7
29,6096001,6108000,11999,False,23,scaffold_7
30,6223001,6248000,24999,False,23,scaffold_7
31,6649001,6674000,24999,False,23,scaffold_7
32,6694001,6720000,25999,False,23,scaffold_7
33,6750001,6797000,46999,False,23,scaffold_7
34,6818001,6837000,18999,False,23,scaffold_7
35,6954001,7270000,315999,False,23,scaffold_7
36,7271001,7502216,231215,True,23,scaffold_7
0,1,6000,5999,True,23,scaffold_8
1,67001,85000,17999,False,23,scaffold_8
2,790001,792000,1999,False,23,scaffold_8
3,1363001,1405000,41999,False,23,scaffold_8
4,2092001,2153000,60999,False,23,scaffold_8
5,2443001,2529000,85999,False,23,scaffold_8
6,2536001,2552000,15999,False,23,scaffold_8
7,2650001,2844000,193999,False,23,scaffold_8
8,2846001,2906000,59999,False,23,scaffold_8
9,2949001,3526000,576999,False,23,scaffold_8
10,3577001,3612000,34999,False,23,scaffold_8
11,3615001,3938000,322999,False,23,scaffold_8
12,4011001,4143000,131999,False,23,scaffold_8
13,4202001,4266000,63999,False,23,scaffold_8
14,4394001,4432000,37999,False,23,scaffold_8
15,4470001,4485000,14999,False,23,scaffold_8
16,4610001,4644000,33999,False,23,scaffold_8
17,4750001,4777000,26999,False,23,scaffold_8
18,4897001,4915000,17999,False,23,scaffold_8
19,5073001,5241000,167999,False,23,scaffold_8
20,5566001,5596000,29999,False,23,scaffold_8
21,5651001,5723000,71999,False,23,scaffold_8
22,5750001,5772000,21999,False,23,scaffold_8
23,5778001,5804000,25999,False,23,scaffold_8
24,5837001,5904000,66999,False,23,scaffold_8
25,6229001,6297000,67999,False,23,scaffold_8
26,6319001,6334544,15543,True,23,scaffold_8
0,1001,19000,17999,False,23,scaffold_9
1,109001,118000,8999,False,23,scaffold_9
2,121001,138000,16999,False,23,scaffold_9
3,189001,194000,4999,False,23,scaffold_9
4,366001,411000,44999,False,23,scaffold_9
5,413001,434000,20999,False,23,scaffold_9
6,501001,531000,29999,False,23,scaffold_9
7,551001,562000,10999,False,23,scaffold_9
8,653001,659000,5999,False,23,scaffold_9
9,660001,665000,4999,False,23,scaffold_9
10,670001,697000,26999,False,23,scaffold_9
11,731001,741000,9999,False,23,scaffold_9
12,815001,842000,26999,False,23,scaffold_9
13,873001,986000,112999,False,23,scaffold_9
14,988001,995000,6999,False,23,scaffold_9
15,1001001,1007000,5999,False,23,scaffold_9
16,1009001,1085000,75999,False,23,scaffold_9
17,1087001,1150000,62999,False,23,scaffold_9
18,1151001,1198000,46999,False,23,scaffold_9
19,1313001,1383000,69999,False,23,scaffold_9
20,1428001,1439000,10999,False,23,scaffold_9
21,1520001,1592000,71999,False,23,scaffold_9
22,1600001,1621000,20999,False,23,scaffold_9
23,1654001,1691000,36999,False,23,scaffold_9
24,1749001,1791000,41999,False,23,scaffold_9
25,1885001,1954000,68999,False,23,scaffold_9
26,1987001,2133000,145999,False,23,scaffold_9
27,2137001,2171000,33999,False,23,scaffold_9
28,2173001,2249000,75999,False,23,scaffold_9
29,2390001,2426000,35999,False,23,scaffold_9
30,2517001,2550000,32999,False,23,scaffold_9
31,2584001,2632000,47999,False,23,scaffold_9
32,2737001,3381000,643999,False,23,scaffold_9
33,3383001,5107000,1723999,False,23,scaffold_9
34,5112001,5238000,125999,False,23,scaffold_9
35,5239001,5298000,58999,False,23,scaffold_9
36,5299001,5490000,190999,False,23,scaffold_9
37,5493001,6331288,838287,True,23,scaffold_9
0,1,414000,413999,True,23,scaffold_10
1,415001,482000,66999,False,23,scaffold_10
2,483001,584000,100999,False,23,scaffold_10
3,596001,795000,198999,False,23,scaffold_10
4,812001,841000,28999,False,23,scaffold_10
5,888001,917000,28999,False,23,scaffold_10
6,923001,1068000,144999,False,23,scaffold_10
7,1086001,1146000,59999,False,23,scaffold_10
8,1313001,1336000,22999,False,23,scaffold_10
9,1370001,1473000,102999,False,23,scaffold_10
10,1587001,1662000,74999,False,23,scaffold_10
11,1697001,1729000,31999,False,23,scaffold_10
12,1859001,1923000,63999,False,23,scaffold_10
13,2089001,2107000,17999,False,23,scaffold_10
14,2140001,2177000,36999,False,23,scaffold_10
15,2200001,2230000,29999,False,23,scaffold_10
16,2268001,2331000,62999,False,23,scaffold_10
17,2334001,2345000,10999,False,23,scaffold_10
18,2346001,2471000,124999,False,23,scaffold_10
19,2511001,2520000,8999,False,23,scaffold_10
20,2521001,2653000,131999,False,23,scaffold_10
21,2671001,2751000,79999,False,23,scaffold_10
22,2754001,2811000,56999,False,23,scaffold_10
23,3115001,3133000,17999,False,23,scaffold_10
24,4053001,4092000,38999,False,23,scaffold_10
25,4154001,4174000,19999,False,23,scaffold_10
26,4336001,4359000,22999,False,23,scaffold_10
27,4443001,4462000,18999,False,23,scaffold_10
28,4467001,4477000,9999,False,23,scaffold_10
29,4478001,4502000,23999,False,23,scaffold_10
30,4503001,4513000,9999,False,23,scaffold_10
31,4515001,4523000,7999,False,23,scaffold_10
32,4526001,4548000,21999,False,23,scaffold_10
33,4565001,4600000,34999,False,23,scaffold_10
34,4680001,4688000,7999,False,23,scaffold_10
35,4733001,4776000,42999,False,23,scaffold_10
36,4798001,4824000,25999,False,23,scaffold_10
37,4828001,4843000,14999,False,23,scaffold_10
38,4848001,4861000,12999,False,23,scaffold_10
39,4862001,4866973,4972,True,23,scaffold_10
0,11001,99000,87999,False,23,scaffold_11
1,149001,167000,17999,False,23,scaffold_11
2,169001,193000,23999,False,23,scaffold_11
3,204001,212000,7999,False,23,scaffold_11
4,213001,236000,22999,False,23,scaffold_11
5,240001,246000,5999,False,23,scaffold_11
6,295001,316000,20999,False,23,scaffold_11
7,419001,431000,11999,False,23,scaffold_11
8,649001,656000,6999,False,23,scaffold_11
9,781001,785000,3999,False,23,scaffold_11
10,1025001,1034000,8999,False,23,scaffold_11
11,1404001,1409000,4999,False,23,scaffold_11
12,1474001,1477000,2999,False,23,scaffold_11
13,1854001,1884000,29999,False,23,scaffold_11
14,2002001,2058000,55999,False,23,scaffold_11
15,2099001,2162000,62999,False,23,scaffold_11
16,2163001,2172000,8999,False,23,scaffold_11
17,2201001,2224000,22999,False,23,scaffold_11
18,2701001,2877000,175999,False,23,scaffold_11
19,2957001,3025000,67999,False,23,scaffold_11
20,3066001,3173000,106999,False,23,scaffold_11
21,3187001,3297000,109999,False,23,scaffold_11
22,3299001,3383000,83999,False,23,scaffold_11
23,3420001,3481000,60999,False,23,scaffold_11
24,3518001,3972000,453999,False,23,scaffold_11
25,3996001,4159000,162999,False,23,scaffold_11
26,4180001,4710000,529999,False,23,scaffold_11
27,4713001,4766820,53819,True,23,scaffold_11
0,1,1471000,1470999,True,23,scaffold_12
1,1719001,1738000,18999,False,23,scaffold_12
2,1903001,1999000,95999,False,23,scaffold_12
3,2016001,2041000,24999,False,23,scaffold_12
4,2043001,2103000,59999,False,23,scaffold_12
5,2130001,2180000,49999,False,23,scaffold_12
6,2340001,2378000,37999,False,23,scaffold_12
7,2571001,2609000,37999,False,23,scaffold_12
8,2747001,2747968,967,True,23,scaffold_12
0,1,342000,341999,True,24,scaffold_1
1,482001,498000,15999,False,24,scaffold_1
2,574001,643000,68999,False,24,scaffold_1
3,686001,759000,72999,False,24,scaffold_1
4,1281001,1292000,10999,False,24,scaffold_1
5,1817001,1899000,81999,False,24,scaffold_1
6,1954001,1964000,9999,False,24,scaffold_1
7,1965001,1984000,18999,False,24,scaffold_1
8,1987001,2014000,26999,False,24,scaffold_1
9,2449001,2519000,69999,False,24,scaffold_1
10,2564001,2581000,16999,False,24,scaffold_1
11,2727001,2746000,18999,False,24,scaffold_1
12,3179001,3211000,31999,False,24,scaffold_1
13,3715001,3737000,21999,False,24,scaffold_1
14,3902001,3941000,38999,False,24,scaffold_1
15,3956001,4027000,70999,False,24,scaffold_1
16,4060001,4112000,51999,False,24,scaffold_1
17,4315001,4354000,38999,False,24,scaffold_1
18,4719001,4780000,60999,False,24,scaffold_1
19,4927001,5022000,94999,False,24,scaffold_1
20,5481001,5512000,30999,False,24,scaffold_1
21,5535001,5578000,42999,False,24,scaffold_1
22,6108001,6153000,44999,False,24,scaffold_1
23,6228001,6507000,278999,False,24,scaffold_1
24,6543001,6555000,11999,False,24,scaffold_1
25,7038001,7247000,208999,False,24,scaffold_1
26,7248001,7589000,340999,False,24,scaffold_1
27,7590001,8656000,1065999,False,24,scaffold_1
28,8658001,9584000,925999,False,24,scaffold_1
29,9586001,10356000,769999,False,24,scaffold_1
30,10460001,10634000,173999,False,24,scaffold_1
31,10808001,10811000,2999,False,24,scaffold_1
32,10839001,10857000,17999,False,24,scaffold_1
33,11278001,11509000,230999,False,24,scaffold_1
34,11562001,11578000,15999,False,24,scaffold_1
35,11590001,11955000,364999,False,24,scaffold_1
36,12184001,12204000,19999,False,24,scaffold_1
37,12631001,12722000,90999,False,24,scaffold_1
38,12775001,12888000,112999,False,24,scaffold_1
39,12974001,13001000,26999,False,24,scaffold_1
40,13113001,13216000,102999,False,24,scaffold_1
41,13347001,13431000,83999,False,24,scaffold_1
42,13815001,13844000,28999,False,24,scaffold_1
43,14093001,14095000,1999,False,24,scaffold_1
44,14285001,14310000,24999,False,24,scaffold_1
45,14471001,14479000,7999,False,24,scaffold_1
46,14648001,14664000,15999,False,24,scaffold_1
47,14690001,14692000,1999,False,24,scaffold_1
0,21001,48000,26999,False,24,scaffold_2
1,96001,159000,62999,False,24,scaffold_2
2,170001,177000,6999,False,24,scaffold_2
3,332001,374000,41999,False,24,scaffold_2
4,2086001,2100000,13999,False,24,scaffold_2
5,2336001,2384000,47999,False,24,scaffold_2
6,2404001,2424000,19999,False,24,scaffold_2
7,2441001,2599000,157999,False,24,scaffold_2
8,2660001,2689000,28999,False,24,scaffold_2
9,2694001,2742000,47999,False,24,scaffold_2
10,2818001,2855000,36999,False,24,scaffold_2
11,2868001,2903000,34999,False,24,scaffold_2
12,3174001,3186000,11999,False,24,scaffold_2
13,3329001,3343000,13999,False,24,scaffold_2
14,3451001,3465000,13999,False,24,scaffold_2
15,3757001,3784000,26999,False,24,scaffold_2
16,4377001,4409000,31999,False,24,scaffold_2
17,4426001,4457000,30999,False,24,scaffold_2
18,4520001,4656000,135999,False,24,scaffold_2
19,4781001,4790000,8999,False,24,scaffold_2
20,4917001,4954000,36999,False,24,scaffold_2
21,5020001,5031000,10999,False,24,scaffold_2
22,5033001,5061000,27999,False,24,scaffold_2
23,5080001,5103000,22999,False,24,scaffold_2
24,5370001,5393000,22999,False,24,scaffold_2
25,5415001,5473000,57999,False,24,scaffold_2
26,5491001,5511000,19999,False,24,scaffold_2
27,5670001,5704000,33999,False,24,scaffold_2
28,5719001,5759000,39999,False,24,scaffold_2
29,6261001,6330000,68999,False,24,scaffold_2
30,6331001,6350000,18999,False,24,scaffold_2
31,6429001,6449000,19999,False,24,scaffold_2
32,7002001,7038000,35999,False,24,scaffold_2
33,7439001,7472000,32999,False,24,scaffold_2
34,7493001,7501000,7999,False,24,scaffold_2
35,7563001,7698000,134999,False,24,scaffold_2
36,7786001,7913000,126999,False,24,scaffold_2
37,7934001,8159000,224999,False,24,scaffold_2
38,8260001,8296000,35999,False,24,scaffold_2
39,8331001,8333000,1999,False,24,scaffold_2
40,8346001,8454000,107999,False,24,scaffold_2
41,8495001,8562000,66999,False,24,scaffold_2
42,11367001,11378000,10999,False,24,scaffold_2
43,11520001,11786000,265999,False,24,scaffold_2
44,11797001,11802476,5475,True,24,scaffold_2
0,43001,47000,3999,False,24,scaffold_3
1,51001,55000,3999,False,24,scaffold_3
2,798001,900000,101999,False,24,scaffold_3
3,2037001,2108000,70999,False,24,scaffold_3
4,2291001,2328000,36999,False,24,scaffold_3
5,2329001,2334000,4999,False,24,scaffold_3
6,2487001,2533000,45999,False,24,scaffold_3
7,2716001,2736000,19999,False,24,scaffold_3
8,3772001,3821000,48999,False,24,scaffold_3
9,3822001,3872000,49999,False,24,scaffold_3
10,4097001,4229000,131999,False,24,scaffold_3
11,4230001,4403000,172999,False,24,scaffold_3
12,4410001,4519000,108999,False,24,scaffold_3
13,4546001,4558000,11999,False,24,scaffold_3
14,4652001,4680000,27999,False,24,scaffold_3
15,5167001,5194000,26999,False,24,scaffold_3
16,5491001,5509000,17999,False,24,scaffold_3
17,5970001,6024000,53999,False,24,scaffold_3
18,6909001,7088000,178999,False,24,scaffold_3
19,7287001,7299000,11999,False,24,scaffold_3
20,7369001,7399000,29999,False,24,scaffold_3
21,7522001,7556000,33999,False,24,scaffold_3
22,7692001,7803000,110999,False,24,scaffold_3
23,7817001,7856000,38999,False,24,scaffold_3
24,8046001,8116000,69999,False,24,scaffold_3
25,8175001,8255000,79999,False,24,scaffold_3
26,8462001,8527000,64999,False,24,scaffold_3
27,8575001,8593000,17999,False,24,scaffold_3
28,9968001,9996000,27999,False,24,scaffold_3
29,10461001,10483000,21999,False,24,scaffold_3
30,10587001,11167000,579999,False,24,scaffold_3
0,3001,7000,3999,False,24,scaffold_4
1,17001,32000,14999,False,24,scaffold_4
2,48001,88000,39999,False,24,scaffold_4
3,136001,146000,9999,False,24,scaffold_4
4,147001,151000,3999,False,24,scaffold_4
5,155001,215000,59999,False,24,scaffold_4
6,217001,226000,8999,False,24,scaffold_4
7,227001,266000,38999,False,24,scaffold_4
8,288001,311000,22999,False,24,scaffold_4
9,355001,374000,18999,False,24,scaffold_4
10,375001,380000,4999,False,24,scaffold_4
11,411001,425000,13999,False,24,scaffold_4
12,429001,498000,68999,False,24,scaffold_4
13,545001,606000,60999,False,24,scaffold_4
14,608001,667000,58999,False,24,scaffold_4
15,669001,691000,21999,False,24,scaffold_4
16,695001,697000,1999,False,24,scaffold_4
17,701001,717000,15999,False,24,scaffold_4
18,1121001,1136000,14999,False,24,scaffold_4
19,1137001,1179000,41999,False,24,scaffold_4
20,1199001,1208000,8999,False,24,scaffold_4
21,1209001,1226000,16999,False,24,scaffold_4
22,1268001,1279000,10999,False,24,scaffold_4
23,1283001,1323000,39999,False,24,scaffold_4
24,1372001,1598000,225999,False,24,scaffold_4
25,1613001,1957000,343999,False,24,scaffold_4
26,1958001,2117000,158999,False,24,scaffold_4
27,2119001,2129000,9999,False,24,scaffold_4
28,2162001,2185000,22999,False,24,scaffold_4
29,2210001,2218000,7999,False,24,scaffold_4
30,2219001,2268000,48999,False,24,scaffold_4
31,2269001,2279000,9999,False,24,scaffold_4
32,2283001,2340000,56999,False,24,scaffold_4
33,2342001,2352000,9999,False,24,scaffold_4
34,2353001,2461000,107999,False,24,scaffold_4
35,2476001,2635000,158999,False,24,scaffold_4
36,2676001,2713000,36999,False,24,scaffold_4
37,3087001,3127000,39999,False,24,scaffold_4
38,3335001,3764000,428999,False,24,scaffold_4
39,4057001,4077000,19999,False,24,scaffold_4
40,4908001,5021000,112999,False,24,scaffold_4
41,5173001,5224000,50999,False,24,scaffold_4
42,5340001,5355000,14999,False,24,scaffold_4
43,5476001,5506000,29999,False,24,scaffold_4
44,5514001,5620000,105999,False,24,scaffold_4
45,5659001,5784000,124999,False,24,scaffold_4
46,5786001,5817000,30999,False,24,scaffold_4
47,6146001,6166000,19999,False,24,scaffold_4
48,6764001,6817000,52999,False,24,scaffold_4
49,6902001,6924000,21999,False,24,scaffold_4
50,6964001,6995000,30999,False,24,scaffold_4
51,7036001,7062000,25999,False,24,scaffold_4
52,7226001,7272000,45999,False,24,scaffold_4
53,7637001,7664000,26999,False,24,scaffold_4
54,8846001,9699000,852999,False,24,scaffold_4
55,9700001,9845951,145950,True,24,scaffold_4
0,1,4000,3999,True,24,scaffold_5
1,318001,326000,7999,False,24,scaffold_5
2,327001,368000,40999,False,24,scaffold_5
3,463001,523000,59999,False,24,scaffold_5
4,672001,678000,5999,False,24,scaffold_5
5,933001,947000,13999,False,24,scaffold_5
6,2475001,2493000,17999,False,24,scaffold_5
7,2511001,2515000,3999,False,24,scaffold_5
8,2562001,2582000,19999,False,24,scaffold_5
9,2618001,2741000,122999,False,24,scaffold_5
10,2813001,2871000,57999,False,24,scaffold_5
11,3137001,3186000,48999,False,24,scaffold_5
12,3217001,3255000,37999,False,24,scaffold_5
13,3310001,3513000,202999,False,24,scaffold_5
14,3962001,4101000,138999,False,24,scaffold_5
15,4121001,4219000,97999,False,24,scaffold_5
16,4246001,4291000,44999,False,24,scaffold_5
17,4444001,4551000,106999,False,24,scaffold_5
18,4601001,4681000,79999,False,24,scaffold_5
19,4690001,4861000,170999,False,24,scaffold_5
20,4889001,4919000,29999,False,24,scaffold_5
21,5260001,5274000,13999,False,24,scaffold_5
22,5285001,5310000,24999,False,24,scaffold_5
23,5314001,5346000,31999,False,24,scaffold_5
24,6407001,6420000,12999,False,24,scaffold_5
25,6481001,6655000,173999,False,24,scaffold_5
26,7454001,7483000,28999,False,24,scaffold_5
27,7580001,7610000,29999,False,24,scaffold_5
28,7622001,7655000,32999,False,24,scaffold_5
29,8578001,8595000,16999,False,24,scaffold_5
30,8661001,8689000,27999,False,24,scaffold_5
31,8713001,9364176,651175,True,24,scaffold_5
0,79001,85000,5999,False,24,scaffold_6
1,86001,113000,26999,False,24,scaffold_6
2,239001,254000,14999,False,24,scaffold_6
3,257001,262000,4999,False,24,scaffold_6
4,264001,283000,18999,False,24,scaffold_6
5,1229001,1260000,30999,False,24,scaffold_6
6,1479001,1546000,66999,False,24,scaffold_6
7,1867001,1906000,38999,False,24,scaffold_6
8,2023001,2087000,63999,False,24,scaffold_6
9,2129001,2193000,63999,False,24,scaffold_6
10,2246001,2265000,18999,False,24,scaffold_6
11,2336001,2595000,258999,False,24,scaffold_6
12,2596001,2654000,57999,False,24,scaffold_6
13,2655001,2701000,45999,False,24,scaffold_6
14,2711001,2872000,160999,False,24,scaffold_6
15,2937001,3031000,93999,False,24,scaffold_6
16,3079001,3203000,123999,False,24,scaffold_6
17,3224001,3366000,141999,False,24,scaffold_6
18,3407001,3766000,358999,False,24,scaffold_6
19,3901001,3912000,10999,False,24,scaffold_6
20,4018001,4195000,176999,False,24,scaffold_6
21,4844001,4869000,24999,False,24,scaffold_6
22,6010001,6062000,51999,False,24,scaffold_6
23,7264001,7337000,72999,False,24,scaffold_6
24,7390001,7436000,45999,False,24,scaffold_6
25,7549001,7796000,246999,False,24,scaffold_6
26,7811001,8268281,457280,True,24,scaffold_6
0,13001,31000,17999,False,24,scaffold_7
1,122001,125000,2999,False,24,scaffold_7
2,323001,340000,16999,False,24,scaffold_7
3,342001,508000,165999,False,24,scaffold_7
4,571001,577000,5999,False,24,scaffold_7
5,706001,736000,29999,False,24,scaffold_7
6,743001,753000,9999,False,24,scaffold_7
7,764001,809000,44999,False,24,scaffold_7
8,859001,864000,4999,False,24,scaffold_7
9,868001,963000,94999,False,24,scaffold_7
10,964001,966000,1999,False,24,scaffold_7
11,968001,980000,11999,False,24,scaffold_7
12,982001,1044000,61999,False,24,scaffold_7
13,1071001,1104000,32999,False,24,scaffold_7
14,1191001,1512000,320999,False,24,scaffold_7
15,1588001,1696000,107999,False,24,scaffold_7
16,3326001,3369000,42999,False,24,scaffold_7
17,3526001,3766000,239999,False,24,scaffold_7
18,4415001,4517000,101999,False,24,scaffold_7
19,4658001,4737000,78999,False,24,scaffold_7
20,4979001,5149000,169999,False,24,scaffold_7
21,5483001,5536000,52999,False,24,scaffold_7
22,6651001,6671000,19999,False,24,scaffold_7
23,6954001,7270000,315999,False,24,scaffold_7
24,7271001,7502216,231215,True,24,scaffold_7
0,67001,85000,17999,False,24,scaffold_8
1,722001,724000,1999,False,24,scaffold_8
2,2434001,2528000,93999,False,24,scaffold_8
3,2650001,2682000,31999,False,24,scaffold_8
4,2740001,2845000,104999,False,24,scaffold_8
5,3060001,3525000,464999,False,24,scaffold_8
6,3584001,3612000,27999,False,24,scaffold_8
7,3623001,3916000,292999,False,24,scaffold_8
8,4038001,4105000,66999,False,24,scaffold_8
9,5084001,5136000,51999,False,24,scaffold_8
10,5171001,5241000,69999,False,24,scaffold_8
11,5580001,5596000,15999,False,24,scaffold_8
12,5662001,5692000,29999,False,24,scaffold_8
13,6323001,6334544,11543,True,24,scaffold_8
0,109001,117000,7999,False,24,scaffold_9
1,121001,137000,15999,False,24,scaffold_9
2,367001,411000,43999,False,24,scaffold_9
3,413001,434000,20999,False,24,scaffold_9
4,502001,531000,28999,False,24,scaffold_9
5,547001,563000,15999,False,24,scaffold_9
6,670001,697000,26999,False,24,scaffold_9
7,732001,741000,8999,False,24,scaffold_9
8,815001,842000,26999,False,24,scaffold_9
9,886001,986000,99999,False,24,scaffold_9
10,988001,995000,6999,False,24,scaffold_9
11,1001001,1031000,29999,False,24,scaffold_9
12,1037001,1085000,47999,False,24,scaffold_9
13,1087001,1150000,62999,False,24,scaffold_9
14,1151001,1165000,13999,False,24,scaffold_9
15,1312001,1377000,64999,False,24,scaffold_9
16,1487001,1499000,11999,False,24,scaffold_9
17,1749001,1811000,61999,False,24,scaffold_9
18,1991001,2037000,45999,False,24,scaffold_9
19,2038001,2058000,19999,False,24,scaffold_9
20,2137001,2171000,33999,False,24,scaffold_9
21,2599001,2628000,28999,False,24,scaffold_9
22,2738001,2803000,64999,False,24,scaffold_9
23,2844001,3381000,536999,False,24,scaffold_9
24,3383001,5107000,1723999,False,24,scaffold_9
25,5112001,5238000,125999,False,24,scaffold_9
26,5239001,5298000,58999,False,24,scaffold_9
27,5300001,5491000,190999,False,24,scaffold_9
28,5493001,6331288,838287,True,24,scaffold_9
0,1,136000,135999,True,24,scaffold_10
1,137001,406000,268999,False,24,scaffold_10
2,446001,482000,35999,False,24,scaffold_10
3,483001,581000,97999,False,24,scaffold_10
4,603001,758000,154999,False,24,scaffold_10
5,783001,794000,10999,False,24,scaffold_10
6,888001,921000,32999,False,24,scaffold_10
7,923001,963000,39999,False,24,scaffold_10
8,1073001,1112000,38999,False,24,scaffold_10
9,2140001,2176000,35999,False,24,scaffold_10
10,2281001,2300000,18999,False,24,scaffold_10
11,2346001,2392000,45999,False,24,scaffold_10
12,2436001,2471000,34999,False,24,scaffold_10
13,2605001,2620000,14999,False,24,scaffold_10
14,4054001,4091000,36999,False,24,scaffold_10
15,4154001,4174000,19999,False,24,scaffold_10
16,4443001,4461000,17999,False,24,scaffold_10
17,4506001,4513000,6999,False,24,scaffold_10
18,4527001,4548000,20999,False,24,scaffold_10
19,4576001,4596000,19999,False,24,scaffold_10
20,4679001,4688000,8999,False,24,scaffold_10
21,4734001,4766000,31999,False,24,scaffold_10
22,4769001,4776000,6999,False,24,scaffold_10
23,4798001,4824000,25999,False,24,scaffold_10
24,4828001,4843000,14999,False,24,scaffold_10
25,4848001,4861000,12999,False,24,scaffold_10
26,4865001,4866973,1972,True,24,scaffold_10
0,10001,34000,23999,False,24,scaffold_11
1,40001,93000,52999,False,24,scaffold_11
2,149001,167000,17999,False,24,scaffold_11
3,169001,191000,21999,False,24,scaffold_11
4,213001,236000,22999,False,24,scaffold_11
5,240001,248000,7999,False,24,scaffold_11
6,419001,431000,11999,False,24,scaffold_11
7,648001,656000,7999,False,24,scaffold_11
8,1025001,1034000,8999,False,24,scaffold_11
9,1423001,1426000,2999,False,24,scaffold_11
10,1474001,1477000,2999,False,24,scaffold_11
11,2701001,2874000,172999,False,24,scaffold_11
12,2957001,3019000,61999,False,24,scaffold_11
13,3088001,3146000,57999,False,24,scaffold_11
14,3185001,3292000,106999,False,24,scaffold_11
15,3331001,3383000,51999,False,24,scaffold_11
16,3549001,3652000,102999,False,24,scaffold_11
17,3702001,3933000,230999,False,24,scaffold_11
18,4009001,4159000,149999,False,24,scaffold_11
19,4182001,4710000,527999,False,24,scaffold_11
20,4712001,4766820,54819,True,24,scaffold_11
0,1,550000,549999,True,24,scaffold_12
1,579001,731000,151999,False,24,scaffold_12
2,739001,1469000,729999,False,24,scaffold_12
3,1720001,1733000,12999,False,24,scaffold_12
4,2043001,2087000,43999,False,24,scaffold_12
5,2137001,2166000,28999,False,24,scaffold_12
6,2571001,2609000,37999,False,24,scaffold_12
0,1,342000,341999,True,25,scaffold_1
1,482001,498000,15999,False,25,scaffold_1
2,574001,643000,68999,False,25,scaffold_1
3,686001,743000,56999,False,25,scaffold_1
4,1819001,1899000,79999,False,25,scaffold_1
5,1951001,1964000,12999,False,25,scaffold_1
6,1965001,1984000,18999,False,25,scaffold_1
7,1987001,1999000,11999,False,25,scaffold_1
8,2449001,2517000,67999,False,25,scaffold_1
9,2565001,2581000,15999,False,25,scaffold_1
10,2727001,2746000,18999,False,25,scaffold_1
11,3178001,3209000,30999,False,25,scaffold_1
12,3715001,3738000,22999,False,25,scaffold_1
13,3923001,3941000,17999,False,25,scaffold_1
14,3961001,4030000,68999,False,25,scaffold_1
15,4062001,4112000,49999,False,25,scaffold_1
16,4315001,4354000,38999,False,25,scaffold_1
17,4927001,5018000,90999,False,25,scaffold_1
18,5097001,5103000,5999,False,25,scaffold_1
19,5481001,5511000,29999,False,25,scaffold_1
20,5535001,5570000,34999,False,25,scaffold_1
21,6108001,6153000,44999,False,25,scaffold_1
22,6154001,6177000,22999,False,25,scaffold_1
23,6228001,6522000,293999,False,25,scaffold_1
24,6543001,6555000,11999,False,25,scaffold_1
25,7038001,7247000,208999,False,25,scaffold_1
26,7248001,7589000,340999,False,25,scaffold_1
27,7590001,8656000,1065999,False,25,scaffold_1
28,8658001,9584000,925999,False,25,scaffold_1
29,9586001,10355000,768999,False,25,scaffold_1
30,10461001,10636000,174999,False,25,scaffold_1
31,10808001,10811000,2999,False,25,scaffold_1
32,10837001,10857000,19999,False,25,scaffold_1
33,11275001,11307000,31999,False,25,scaffold_1
34,11308001,11504000,195999,False,25,scaffold_1
35,11560001,11956000,395999,False,25,scaffold_1
36,12184001,12204000,19999,False,25,scaffold_1
37,12425001,12448000,22999,False,25,scaffold_1
38,12652001,12722000,69999,False,25,scaffold_1
39,12777001,12888000,110999,False,25,scaffold_1
40,13113001,13211000,97999,False,25,scaffold_1
41,13346001,13439000,92999,False,25,scaffold_1
42,13814001,13839000,24999,False,25,scaffold_1
43,14296001,14307000,10999,False,25,scaffold_1
44,14471001,14479000,7999,False,25,scaffold_1
45,14649001,14664000,14999,False,25,scaffold_1
0,21001,48000,26999,False,25,scaffold_2
1,93001,159000,65999,False,25,scaffold_2
2,168001,176000,7999,False,25,scaffold_2
3,303001,318000,14999,False,25,scaffold_2
4,332001,374000,41999,False,25,scaffold_2
5,2085001,2102000,16999,False,25,scaffold_2
6,2336001,2390000,53999,False,25,scaffold_2
7,2395001,2424000,28999,False,25,scaffold_2
8,2441001,2599000,157999,False,25,scaffold_2
9,2658001,2689000,30999,False,25,scaffold_2
10,2694001,2743000,48999,False,25,scaffold_2
11,2868001,2901000,32999,False,25,scaffold_2
12,2997001,3009000,11999,False,25,scaffold_2
13,3174001,3186000,11999,False,25,scaffold_2
14,3449001,3466000,16999,False,25,scaffold_2
15,3754001,3784000,29999,False,25,scaffold_2
16,4385001,4409000,23999,False,25,scaffold_2
17,4426001,4457000,30999,False,25,scaffold_2
18,4520001,4654000,133999,False,25,scaffold_2
19,4783001,4790000,6999,False,25,scaffold_2
20,4918001,4954000,35999,False,25,scaffold_2
21,5021001,5061000,39999,False,25,scaffold_2
22,5080001,5104000,23999,False,25,scaffold_2
23,5436001,5478000,41999,False,25,scaffold_2
24,5490001,5511000,20999,False,25,scaffold_2
25,5659001,5704000,44999,False,25,scaffold_2
26,5719001,5756000,36999,False,25,scaffold_2
27,5863001,5884000,20999,False,25,scaffold_2
28,6261001,6330000,68999,False,25,scaffold_2
29,6331001,6342000,10999,False,25,scaffold_2
30,6427001,6449000,21999,False,25,scaffold_2
31,7005001,7038000,32999,False,25,scaffold_2
32,7439001,7473000,33999,False,25,scaffold_2
33,7563001,7697000,133999,False,25,scaffold_2
34,7781001,7891000,109999,False,25,scaffold_2
35,7933001,8136000,202999,False,25,scaffold_2
36,8260001,8294000,33999,False,25,scaffold_2
37,8331001,8333000,1999,False,25,scaffold_2
38,8346001,8453000,106999,False,25,scaffold_2
39,8495001,8562000,66999,False,25,scaffold_2
40,11520001,11786000,265999,False,25,scaffold_2
0,1,2000,1999,True,25,scaffold_3
1,51001,55000,3999,False,25,scaffold_3
2,530001,539000,8999,False,25,scaffold_3
3,618001,646000,27999,False,25,scaffold_3
4,799001,900000,100999,False,25,scaffold_3
5,2011001,2108000,96999,False,25,scaffold_3
6,2291001,2321000,29999,False,25,scaffold_3
7,2487001,2533000,45999,False,25,scaffold_3
8,3110001,3140000,29999,False,25,scaffold_3
9,3770001,3821000,50999,False,25,scaffold_3
10,3822001,3890000,67999,False,25,scaffold_3
11,4104001,4403000,298999,False,25,scaffold_3
12,4417001,4514000,96999,False,25,scaffold_3
13,4547001,4558000,10999,False,25,scaffold_3
14,4652001,4680000,27999,False,25,scaffold_3
15,5181001,5208000,26999,False,25,scaffold_3
16,5493001,5509000,15999,False,25,scaffold_3
17,5990001,6019000,28999,False,25,scaffold_3
18,6909001,6962000,52999,False,25,scaffold_3
19,6963001,7088000,124999,False,25,scaffold_3
20,7369001,7397000,27999,False,25,scaffold_3
21,7430001,7445000,14999,False,25,scaffold_3
22,7516001,7557000,40999,False,25,scaffold_3
23,7681001,7854000,172999,False,25,scaffold_3
24,7910001,7935000,24999,False,25,scaffold_3
25,8176001,8255000,78999,False,25,scaffold_3
26,8462001,8527000,64999,False,25,scaffold_3
27,8575001,8596000,20999,False,25,scaffold_3
28,9058001,9079000,20999,False,25,scaffold_3
29,9967001,9996000,28999,False,25,scaffold_3
30,10461001,10483000,21999,False,25,scaffold_3
31,10587001,11167000,579999,False,25,scaffold_3
0,17001,32000,14999,False,25,scaffold_4
1,49001,88000,38999,False,25,scaffold_4
2,137001,146000,8999,False,25,scaffold_4
3,147001,151000,3999,False,25,scaffold_4
4,155001,215000,59999,False,25,scaffold_4
5,217001,226000,8999,False,25,scaffold_4
6,227001,266000,38999,False,25,scaffold_4
7,320001,344000,23999,False,25,scaffold_4
8,355001,374000,18999,False,25,scaffold_4
9,375001,380000,4999,False,25,scaffold_4
10,393001,425000,31999,False,25,scaffold_4
11,429001,502000,72999,False,25,scaffold_4
12,545001,592000,46999,False,25,scaffold_4
13,593001,606000,12999,False,25,scaffold_4
14,608001,691000,82999,False,25,scaffold_4
15,701001,717000,15999,False,25,scaffold_4
16,1121001,1136000,14999,False,25,scaffold_4
17,1138001,1198000,59999,False,25,scaffold_4
18,1199001,1208000,8999,False,25,scaffold_4
19,1209001,1226000,16999,False,25,scaffold_4
20,1268001,1279000,10999,False,25,scaffold_4
21,1283001,1336000,52999,False,25,scaffold_4
22,1369001,1600000,230999,False,25,scaffold_4
23,1613001,2118000,504999,False,25,scaffold_4
24,2119001,2134000,14999,False,25,scaffold_4
25,2142001,2183000,40999,False,25,scaffold_4
26,2190001,2279000,88999,False,25,scaffold_4
27,2283001,2340000,56999,False,25,scaffold_4
28,2342001,2352000,9999,False,25,scaffold_4
29,2353001,2364000,10999,False,25,scaffold_4
30,2393001,2461000,67999,False,25,scaffold_4
31,2477001,2635000,157999,False,25,scaffold_4
32,2738001,2769000,30999,False,25,scaffold_4
33,3078001,3125000,46999,False,25,scaffold_4
34,3336001,3769000,432999,False,25,scaffold_4
35,4905001,5047000,141999,False,25,scaffold_4
36,5174001,5222000,47999,False,25,scaffold_4
37,5476001,5506000,29999,False,25,scaffold_4
38,5514001,5620000,105999,False,25,scaffold_4
39,5659001,5784000,124999,False,25,scaffold_4
40,6148001,6197000,48999,False,25,scaffold_4
41,6771001,6788000,16999,False,25,scaffold_4
42,6789001,6817000,27999,False,25,scaffold_4
43,6902001,6924000,21999,False,25,scaffold_4
44,7036001,7079000,42999,False,25,scaffold_4
45,7641001,7663000,21999,False,25,scaffold_4
46,7985001,7998000,12999,False,25,scaffold_4
47,8845001,9699000,853999,False,25,scaffold_4
48,9700001,9845951,145950,True,25,scaffold_4
0,170001,174000,3999,False,25,scaffold_5
1,318001,326000,7999,False,25,scaffold_5
2,327001,385000,57999,False,25,scaffold_5
3,463001,523000,59999,False,25,scaffold_5
4,669001,685000,15999,False,25,scaffold_5
5,931001,947000,15999,False,25,scaffold_5
6,2475001,2493000,17999,False,25,scaffold_5
7,2511001,2515000,3999,False,25,scaffold_5
8,2563001,2738000,174999,False,25,scaffold_5
9,2813001,2874000,60999,False,25,scaffold_5
10,3133001,3186000,52999,False,25,scaffold_5
11,3217001,3254000,36999,False,25,scaffold_5
12,3301001,3518000,216999,False,25,scaffold_5
13,3618001,3653000,34999,False,25,scaffold_5
14,3962001,4101000,138999,False,25,scaffold_5
15,4121001,4219000,97999,False,25,scaffold_5
16,4239001,4271000,31999,False,25,scaffold_5
17,4446001,4507000,60999,False,25,scaffold_5
18,4600001,4682000,81999,False,25,scaffold_5
19,4691001,4861000,169999,False,25,scaffold_5
20,4892001,4919000,26999,False,25,scaffold_5
21,5287001,5312000,24999,False,25,scaffold_5
22,5314001,5346000,31999,False,25,scaffold_5
23,6506001,6653000,146999,False,25,scaffold_5
24,6890001,6904000,13999,False,25,scaffold_5
25,7454001,7483000,28999,False,25,scaffold_5
26,7579001,7619000,39999,False,25,scaffold_5
27,7620001,7656000,35999,False,25,scaffold_5
28,8571001,8616000,44999,False,25,scaffold_5
29,8659001,8689000,29999,False,25,scaffold_5
30,8712001,9364176,652175,True,25,scaffold_5
0,66001,75000,8999,False,25,scaffold_6
1,79001,116000,36999,False,25,scaffold_6
2,172001,207000,34999,False,25,scaffold_6
3,241001,255000,13999,False,25,scaffold_6
4,257001,262000,4999,False,25,scaffold_6
5,264001,283000,18999,False,25,scaffold_6
6,1147001,1197000,49999,False,25,scaffold_6
7,1235001,1260000,24999,False,25,scaffold_6
8,1478001,1546000,67999,False,25,scaffold_6
9,1843001,1906000,62999,False,25,scaffold_6
10,2023001,2103000,79999,False,25,scaffold_6
11,2129001,2194000,64999,False,25,scaffold_6
12,2334001,2595000,260999,False,25,scaffold_6
13,2596001,2694000,97999,False,25,scaffold_6
14,2712001,2872000,159999,False,25,scaffold_6
15,2937001,3016000,78999,False,25,scaffold_6
16,3113001,3151000,37999,False,25,scaffold_6
17,3224001,3345000,120999,False,25,scaffold_6
18,3407001,3766000,358999,False,25,scaffold_6
19,3897001,3913000,15999,False,25,scaffold_6
20,4016001,4072000,55999,False,25,scaffold_6
21,4073001,4195000,121999,False,25,scaffold_6
22,6011001,6062000,50999,False,25,scaffold_6
23,6140001,6185000,44999,False,25,scaffold_6
24,7263001,7338000,74999,False,25,scaffold_6
25,7390001,7436000,45999,False,25,scaffold_6
26,7541001,8268281,727280,True,25,scaffold_6
0,14001,34000,19999,False,25,scaffold_7
1,323001,340000,16999,False,25,scaffold_7
2,342001,508000,165999,False,25,scaffold_7
3,571001,576000,4999,False,25,scaffold_7
4,706001,736000,29999,False,25,scaffold_7
5,741001,753000,11999,False,25,scaffold_7
6,764001,829000,64999,False,25,scaffold_7
7,859001,864000,4999,False,25,scaffold_7
8,868001,872000,3999,False,25,scaffold_7
9,875001,938000,62999,False,25,scaffold_7
10,967001,980000,12999,False,25,scaffold_7
11,982001,1044000,61999,False,25,scaffold_7
12,1048001,1100000,51999,False,25,scaffold_7
13,1191001,1460000,268999,False,25,scaffold_7
14,1461001,1512000,50999,False,25,scaffold_7
15,1588001,1693000,104999,False,25,scaffold_7
16,1770001,1782000,11999,False,25,scaffold_7
17,3325001,3369000,43999,False,25,scaffold_7
18,3529001,3550000,20999,False,25,scaffold_7
19,3593001,3766000,172999,False,25,scaffold_7
20,4415001,4518000,102999,False,25,scaffold_7
21,4658001,4682000,23999,False,25,scaffold_7
22,4978001,5114000,135999,False,25,scaffold_7
23,5474001,5536000,61999,False,25,scaffold_7
24,6954001,7270000,315999,False,25,scaffold_7
25,7271001,7502216,231215,True,25,scaffold_7
0,67001,85000,17999,False,25,scaffold_8
1,93001,101000,7999,False,25,scaffold_8
2,2415001,2470000,54999,False,25,scaffold_8
3,2492001,2530000,37999,False,25,scaffold_8
4,2536001,2552000,15999,False,25,scaffold_8
5,2652001,2692000,39999,False,25,scaffold_8
6,2742001,2757000,14999,False,25,scaffold_8
7,2799001,2844000,44999,False,25,scaffold_8
8,3057001,3525000,467999,False,25,scaffold_8
9,3580001,3612000,31999,False,25,scaffold_8
10,3615001,3938000,322999,False,25,scaffold_8
11,4050001,4104000,53999,False,25,scaffold_8
12,4400001,4426000,25999,False,25,scaffold_8
13,5097001,5137000,39999,False,25,scaffold_8
14,5184001,5241000,56999,False,25,scaffold_8
15,5776001,5792000,15999,False,25,scaffold_8
16,6322001,6334544,12543,True,25,scaffold_8
0,109001,117000,7999,False,25,scaffold_9
1,121001,138000,16999,False,25,scaffold_9
2,367001,411000,43999,False,25,scaffold_9
3,413001,434000,20999,False,25,scaffold_9
4,501001,531000,29999,False,25,scaffold_9
5,547001,561000,13999,False,25,scaffold_9
6,660001,665000,4999,False,25,scaffold_9
7,670001,696000,25999,False,25,scaffold_9
8,732001,742000,9999,False,25,scaffold_9
9,815001,842000,26999,False,25,scaffold_9
10,883001,986000,102999,False,25,scaffold_9
11,988001,995000,6999,False,25,scaffold_9
12,1001001,1007000,5999,False,25,scaffold_9
13,1009001,1085000,75999,False,25,scaffold_9
14,1087001,1150000,62999,False,25,scaffold_9
15,1151001,1176000,24999,False,25,scaffold_9
16,1313001,1377000,63999,False,25,scaffold_9
17,1487001,1499000,11999,False,25,scaffold_9
18,1550001,1584000,33999,False,25,scaffold_9
19,1600001,1620000,19999,False,25,scaffold_9
20,1749001,1791000,41999,False,25,scaffold_9
21,1987001,2058000,70999,False,25,scaffold_9
22,2075001,2133000,57999,False,25,scaffold_9
23,2594001,2622000,27999,False,25,scaffold_9
24,2737001,2824000,86999,False,25,scaffold_9
25,2844001,3381000,536999,False,25,scaffold_9
26,3383001,5107000,1723999,False,25,scaffold_9
27,5112001,5114000,1999,False,25,scaffold_9
28,5116001,5238000,121999,False,25,scaffold_9
29,5239001,5298000,58999,False,25,scaffold_9
30,5300001,5490000,189999,False,25,scaffold_9
31,5491001,6331288,840287,True,25,scaffold_9
0,1,136000,135999,True,25,scaffold_10
1,137001,414000,276999,False,25,scaffold_10
2,453001,482000,28999,False,25,scaffold_10
3,483001,580000,96999,False,25,scaffold_10
4,602001,754000,151999,False,25,scaffold_10
5,888001,921000,32999,False,25,scaffold_10
6,923001,963000,39999,False,25,scaffold_10
7,1087001,1113000,25999,False,25,scaffold_10
8,2140001,2171000,30999,False,25,scaffold_10
9,2268001,2300000,31999,False,25,scaffold_10
10,2346001,2425000,78999,False,25,scaffold_10
11,2558001,2573000,14999,False,25,scaffold_10
12,2601001,2621000,19999,False,25,scaffold_10
13,2735001,2746000,10999,False,25,scaffold_10
14,4053001,4091000,37999,False,25,scaffold_10
15,4154001,4174000,19999,False,25,scaffold_10
16,4443001,4462000,18999,False,25,scaffold_10
17,4467001,4477000,9999,False,25,scaffold_10
18,4506001,4513000,6999,False,25,scaffold_10
19,4515001,4523000,7999,False,25,scaffold_10
20,4526001,4548000,21999,False,25,scaffold_10
21,4574001,4596000,21999,False,25,scaffold_10
22,4679001,4688000,8999,False,25,scaffold_10
23,4734001,4776000,41999,False,25,scaffold_10
24,4798001,4824000,25999,False,25,scaffold_10
25,4827001,4846000,18999,False,25,scaffold_10
26,4848001,4861000,12999,False,25,scaffold_10
27,4865001,4866973,1972,True,25,scaffold_10
0,11001,34000,22999,False,25,scaffold_11
1,38001,93000,54999,False,25,scaffold_11
2,149001,167000,17999,False,25,scaffold_11
3,169001,191000,21999,False,25,scaffold_11
4,213001,235000,21999,False,25,scaffold_11
5,240001,248000,7999,False,25,scaffold_11
6,419001,431000,11999,False,25,scaffold_11
7,649001,656000,6999,False,25,scaffold_11
8,1025001,1034000,8999,False,25,scaffold_11
9,1423001,1426000,2999,False,25,scaffold_11
10,1474001,1477000,2999,False,25,scaffold_11
11,2035001,2058000,22999,False,25,scaffold_11
12,2701001,2875000,173999,False,25,scaffold_11
13,2957001,3018000,60999,False,25,scaffold_11
14,3188001,3293000,104999,False,25,scaffold_11
15,3327001,3383000,55999,False,25,scaffold_11
16,3556001,3651000,94999,False,25,scaffold_11
17,3702001,3879000,176999,False,25,scaffold_11
18,3880001,3927000,46999,False,25,scaffold_11
19,4004001,4159000,154999,False,25,scaffold_11
20,4189001,4710000,520999,False,25,scaffold_11
21,4713001,4766820,53819,True,25,scaffold_11
0,1,1472000,1471999,True,25,scaffold_12
1,1720001,1733000,12999,False,25,scaffold_12
2,2043001,2103000,59999,False,25,scaffold_12
3,2138001,2152000,13999,False,25,scaffold_12
4,2350001,2380000,29999,False,25,scaffold_12
5,2571001,2618000,46999,False,25,scaffold_12
6,2686001,2698000,11999,False,25,scaffold_12
0,1,342000,341999,True,26,scaffold_1
1,482001,498000,15999,False,26,scaffold_1
2,574001,643000,68999,False,26,scaffold_1
3,686001,756000,69999,False,26,scaffold_1
4,1277001,1292000,14999,False,26,scaffold_1
5,1630001,1659000,28999,False,26,scaffold_1
6,1811001,1898000,86999,False,26,scaffold_1
7,1954001,1964000,9999,False,26,scaffold_1
8,1965001,1984000,18999,False,26,scaffold_1
9,1987001,2014000,26999,False,26,scaffold_1
10,2363001,2387000,23999,False,26,scaffold_1
11,2449001,2517000,67999,False,26,scaffold_1
12,2726001,2746000,19999,False,26,scaffold_1
13,3174001,3209000,34999,False,26,scaffold_1
14,3450001,3500000,49999,False,26,scaffold_1
15,3704001,3878000,173999,False,26,scaffold_1
16,3901001,3941000,39999,False,26,scaffold_1
17,3960001,4030000,69999,False,26,scaffold_1
18,4063001,4112000,48999,False,26,scaffold_1
19,4314001,4354000,39999,False,26,scaffold_1
20,4710001,4790000,79999,False,26,scaffold_1
21,4796001,4815000,18999,False,26,scaffold_1
22,4920001,5025000,104999,False,26,scaffold_1
23,5047001,5065000,17999,False,26,scaffold_1
24,5087001,5114000,26999,False,26,scaffold_1
25,5481001,5521000,39999,False,26,scaffold_1
26,5535001,5579000,43999,False,26,scaffold_1
27,6108001,6153000,44999,False,26,scaffold_1
28,6154001,6176000,21999,False,26,scaffold_1
29,6202001,6381000,178999,False,26,scaffold_1
30,6384001,6509000,124999,False,26,scaffold_1
31,6543001,6561000,17999,False,26,scaffold_1
32,7038001,7247000,208999,False,26,scaffold_1
33,7248001,7358000,109999,False,26,scaffold_1
34,7359001,7491000,131999,False,26,scaffold_1
35,7492001,7589000,96999,False,26,scaffold_1
36,7590001,8656000,1065999,False,26,scaffold_1
37,8658001,9584000,925999,False,26,scaffold_1
38,9586001,10361000,774999,False,26,scaffold_1
39,10460001,10640000,179999,False,26,scaffold_1
40,10808001,10811000,2999,False,26,scaffold_1
41,10839001,10857000,17999,False,26,scaffold_1
42,10918001,10940000,21999,False,26,scaffold_1
43,11274001,11334000,59999,False,26,scaffold_1
44,11339001,11504000,164999,False,26,scaffold_1
45,11555001,11951000,395999,False,26,scaffold_1
46,12184001,12204000,19999,False,26,scaffold_1
47,12421001,12449000,27999,False,26,scaffold_1
48,12652001,12723000,70999,False,26,scaffold_1
49,12776001,12888000,111999,False,26,scaffold_1
50,12969001,13044000,74999,False,26,scaffold_1
51,13113001,13212000,98999,False,26,scaffold_1
52,13346001,13431000,84999,False,26,scaffold_1
53,13559001,13589000,29999,False,26,scaffold_1
54,13811001,13845000,33999,False,26,scaffold_1
55,14289001,14310000,20999,False,26,scaffold_1
56,14471001,14479000,7999,False,26,scaffold_1
57,14648001,14664000,15999,False,26,scaffold_1
0,1,48000,47999,True,26,scaffold_2
1,93001,159000,65999,False,26,scaffold_2
2,165001,176000,10999,False,26,scaffold_2
3,314001,318000,3999,False,26,scaffold_2
4,333001,374000,40999,False,26,scaffold_2
5,2085001,2111000,25999,False,26,scaffold_2
6,2336001,2358000,21999,False,26,scaffold_2
7,2397001,2424000,26999,False,26,scaffold_2
8,2441001,2609000,167999,False,26,scaffold_2
9,2626001,2639000,12999,False,26,scaffold_2
10,2660001,2689000,28999,False,26,scaffold_2
11,2694001,2746000,51999,False,26,scaffold_2
12,2868001,2905000,36999,False,26,scaffold_2
13,2993001,3021000,27999,False,26,scaffold_2
14,3451001,3465000,13999,False,26,scaffold_2
15,3659001,3691000,31999,False,26,scaffold_2
16,3754001,3787000,32999,False,26,scaffold_2
17,4242001,4276000,33999,False,26,scaffold_2
18,4335001,4409000,73999,False,26,scaffold_2
19,4426001,4458000,31999,False,26,scaffold_2
20,4511001,4656000,144999,False,26,scaffold_2
21,4730001,4790000,59999,False,26,scaffold_2
22,4918001,4959000,40999,False,26,scaffold_2
23,5021001,5063000,41999,False,26,scaffold_2
24,5080001,5104000,23999,False,26,scaffold_2
25,5356001,5393000,36999,False,26,scaffold_2
26,5413001,5480000,66999,False,26,scaffold_2
27,5491001,5562000,70999,False,26,scaffold_2
28,5672001,5709000,36999,False,26,scaffold_2
29,5717001,5759000,41999,False,26,scaffold_2
30,5839001,5888000,48999,False,26,scaffold_2
31,5915001,5992000,76999,False,26,scaffold_2
32,6261001,6330000,68999,False,26,scaffold_2
33,6331001,6349000,17999,False,26,scaffold_2
34,6365001,6451000,85999,False,26,scaffold_2
35,6576001,6628000,51999,False,26,scaffold_2
36,7005001,7037000,31999,False,26,scaffold_2
37,7063001,7097000,33999,False,26,scaffold_2
38,7439001,7473000,33999,False,26,scaffold_2
39,7550001,7561000,10999,False,26,scaffold_2
40,7563001,7697000,133999,False,26,scaffold_2
41,7753001,7891000,137999,False,26,scaffold_2
42,7934001,8198000,263999,False,26,scaffold_2
43,8259001,8313000,53999,False,26,scaffold_2
44,8331001,8333000,1999,False,26,scaffold_2
45,8340001,8345000,4999,False,26,scaffold_2
46,8346001,8454000,107999,False,26,scaffold_2
47,8466001,8494000,27999,False,26,scaffold_2
48,8495001,8563000,67999,False,26,scaffold_2
49,9034001,9045000,10999,False,26,scaffold_2
50,9140001,9167000,26999,False,26,scaffold_2
51,9609001,9632000,22999,False,26,scaffold_2
52,10710001,10736000,25999,False,26,scaffold_2
53,11366001,11381000,14999,False,26,scaffold_2
54,11520001,11786000,265999,False,26,scaffold_2
0,528001,539000,10999,False,26,scaffold_3
1,618001,646000,27999,False,26,scaffold_3
2,798001,900000,101999,False,26,scaffold_3
3,2007001,2108000,100999,False,26,scaffold_3
4,2109001,2129000,19999,False,26,scaffold_3
5,2133001,2140000,6999,False,26,scaffold_3
6,2291001,2334000,42999,False,26,scaffold_3
7,2485001,2533000,47999,False,26,scaffold_3
8,2716001,2735000,18999,False,26,scaffold_3
9,3127001,3145000,17999,False,26,scaffold_3
10,3606001,3655000,48999,False,26,scaffold_3
11,3768001,3821000,52999,False,26,scaffold_3
12,3822001,3890000,67999,False,26,scaffold_3
13,4096001,4403000,306999,False,26,scaffold_3
14,4418001,4519000,100999,False,26,scaffold_3
15,4546001,4558000,11999,False,26,scaffold_3
16,4654001,4678000,23999,False,26,scaffold_3
17,5168001,5191000,22999,False,26,scaffold_3
18,5236001,5271000,34999,False,26,scaffold_3
19,5490001,5508000,17999,False,26,scaffold_3
20,5623001,5675000,51999,False,26,scaffold_3
21,5805001,5872000,66999,False,26,scaffold_3
22,5929001,5947000,17999,False,26,scaffold_3
23,5971001,6023000,51999,False,26,scaffold_3
24,6741001,6784000,42999,False,26,scaffold_3
25,6907001,7093000,185999,False,26,scaffold_3
26,7338001,7362000,23999,False,26,scaffold_3
27,7367001,7403000,35999,False,26,scaffold_3
28,7522001,7556000,33999,False,26,scaffold_3
29,7681001,7856000,174999,False,26,scaffold_3
30,8028001,8116000,87999,False,26,scaffold_3
31,8183001,8253000,69999,False,26,scaffold_3
32,8462001,8527000,64999,False,26,scaffold_3
33,8575001,8594000,18999,False,26,scaffold_3
34,9005001,9078000,72999,False,26,scaffold_3
35,9645001,9686000,40999,False,26,scaffold_3
36,9968001,9996000,27999,False,26,scaffold_3
37,10461001,10471000,9999,False,26,scaffold_3
38,10587001,11163000,575999,False,26,scaffold_3
0,17001,32000,14999,False,26,scaffold_4
1,48001,86000,37999,False,26,scaffold_4
2,124001,146000,21999,False,26,scaffold_4
3,147001,151000,3999,False,26,scaffold_4
4,155001,215000,59999,False,26,scaffold_4
5,217001,226000,8999,False,26,scaffold_4
6,227001,266000,38999,False,26,scaffold_4
7,318001,344000,25999,False,26,scaffold_4
8,355001,374000,18999,False,26,scaffold_4
9,375001,380000,4999,False,26,scaffold_4
10,411001,425000,13999,False,26,scaffold_4
11,429001,498000,68999,False,26,scaffold_4
12,548001,606000,57999,False,26,scaffold_4
13,608001,667000,58999,False,26,scaffold_4
14,669001,691000,21999,False,26,scaffold_4
15,701001,712000,10999,False,26,scaffold_4
16,1121001,1136000,14999,False,26,scaffold_4
17,1137001,1208000,70999,False,26,scaffold_4
18,1209001,1226000,16999,False,26,scaffold_4
19,1235001,1253000,17999,False,26,scaffold_4
20,1254001,1262000,7999,False,26,scaffold_4
21,1265001,1279000,13999,False,26,scaffold_4
22,1283001,1336000,52999,False,26,scaffold_4
23,1372001,1604000,231999,False,26,scaffold_4
24,1609001,1611000,1999,False,26,scaffold_4
25,1613001,1799000,185999,False,26,scaffold_4
26,1801001,2117000,315999,False,26,scaffold_4
27,2119001,2185000,65999,False,26,scaffold_4
28,2188001,2206000,17999,False,26,scaffold_4
29,2207001,2280000,72999,False,26,scaffold_4
30,2283001,2310000,26999,False,26,scaffold_4
31,2312001,2340000,27999,False,26,scaffold_4
32,2342001,2461000,118999,False,26,scaffold_4
33,2476001,2635000,158999,False,26,scaffold_4
34,2661001,2675000,13999,False,26,scaffold_4
35,2676001,2695000,18999,False,26,scaffold_4
36,2735001,2799000,63999,False,26,scaffold_4
37,2921001,2956000,34999,False,26,scaffold_4
38,3090001,3127000,36999,False,26,scaffold_4
39,3335001,3768000,432999,False,26,scaffold_4
40,4056001,4086000,29999,False,26,scaffold_4
41,4900001,5057000,156999,False,26,scaffold_4
42,5170001,5223000,52999,False,26,scaffold_4
43,5340001,5404000,63999,False,26,scaffold_4
44,5468001,5506000,37999,False,26,scaffold_4
45,5514001,5632000,117999,False,26,scaffold_4
46,5657001,5784000,126999,False,26,scaffold_4
47,5786001,5824000,37999,False,26,scaffold_4
48,6146001,6197000,50999,False,26,scaffold_4
49,6353001,6376000,22999,False,26,scaffold_4
50,6764001,6817000,52999,False,26,scaffold_4
51,6901001,6924000,22999,False,26,scaffold_4
52,6950001,6995000,44999,False,26,scaffold_4
53,7036001,7124000,87999,False,26,scaffold_4
54,7225001,7302000,76999,False,26,scaffold_4
55,7641001,7665000,23999,False,26,scaffold_4
56,8846001,9699000,852999,False,26,scaffold_4
57,9700001,9845951,145950,True,26,scaffold_4
0,1,4000,3999,True,26,scaffold_5
1,151001,174000,22999,False,26,scaffold_5
2,318001,382000,63999,False,26,scaffold_5
3,463001,523000,59999,False,26,scaffold_5
4,669001,680000,10999,False,26,scaffold_5
5,932001,947000,14999,False,26,scaffold_5
6,2475001,2494000,18999,False,26,scaffold_5
7,2510001,2515000,4999,False,26,scaffold_5
8,2568001,2586000,17999,False,26,scaffold_5
9,2614001,2894000,279999,False,26,scaffold_5
10,3133001,3253000,119999,False,26,scaffold_5
11,3300001,3513000,212999,False,26,scaffold_5
12,3616001,3658000,41999,False,26,scaffold_5
13,3962001,4101000,138999,False,26,scaffold_5
14,4120001,4222000,101999,False,26,scaffold_5
15,4226001,4321000,94999,False,26,scaffold_5
16,4445001,4553000,107999,False,26,scaffold_5
17,4600001,4861000,260999,False,26,scaffold_5
18,4892001,4919000,26999,False,26,scaffold_5
19,5249001,5312000,62999,False,26,scaffold_5
20,5314001,5346000,31999,False,26,scaffold_5
21,6394001,6420000,25999,False,26,scaffold_5
22,6479001,6661000,181999,False,26,scaffold_5
23,6886001,6906000,19999,False,26,scaffold_5
24,7176001,7195000,18999,False,26,scaffold_5
25,7454001,7483000,28999,False,26,scaffold_5
26,7559001,7611000,51999,False,26,scaffold_5
27,7621001,7657000,35999,False,26,scaffold_5
28,8577001,8613000,35999,False,26,scaffold_5
29,8659001,8689000,29999,False,26,scaffold_5
30,8713001,9364176,651175,True,26,scaffold_5
0,79001,85000,5999,False,26,scaffold_6
1,86001,114000,27999,False,26,scaffold_6
2,174001,204000,29999,False,26,scaffold_6
3,241001,254000,12999,False,26,scaffold_6
4,264001,287000,22999,False,26,scaffold_6
5,988001,1012000,23999,False,26,scaffold_6
6,1146001,1196000,49999,False,26,scaffold_6
7,1237001,1257000,19999,False,26,scaffold_6
8,1286001,1304000,17999,False,26,scaffold_6
9,1478001,1546000,67999,False,26,scaffold_6
10,1658001,1688000,29999,False,26,scaffold_6
11,1838001,1906000,67999,False,26,scaffold_6
12,2023001,2101000,77999,False,26,scaffold_6
13,2126001,2211000,84999,False,26,scaffold_6
14,2241001,2265000,23999,False,26,scaffold_6
15,2335001,2595000,259999,False,26,scaffold_6
16,2596001,2690000,93999,False,26,scaffold_6
17,2712001,2872000,159999,False,26,scaffold_6
18,2933001,3031000,97999,False,26,scaffold_6
19,3092001,3211000,118999,False,26,scaffold_6
20,3215001,3350000,134999,False,26,scaffold_6
21,3351001,3800000,448999,False,26,scaffold_6
22,3809001,3847000,37999,False,26,scaffold_6
23,3883001,3925000,41999,False,26,scaffold_6
24,4018001,4072000,53999,False,26,scaffold_6
25,4073001,4193000,119999,False,26,scaffold_6
26,4838001,4872000,33999,False,26,scaffold_6
27,5780001,5785000,4999,False,26,scaffold_6
28,5947001,5972000,24999,False,26,scaffold_6
29,6011001,6083000,71999,False,26,scaffold_6
30,6123001,6190000,66999,False,26,scaffold_6
31,6776001,6803000,26999,False,26,scaffold_6
32,7257001,7337000,79999,False,26,scaffold_6
33,7389001,7444000,54999,False,26,scaffold_6
34,7549001,8268281,719280,True,26,scaffold_6
0,13001,31000,17999,False,26,scaffold_7
1,323001,340000,16999,False,26,scaffold_7
2,342001,508000,165999,False,26,scaffold_7
3,554001,563000,8999,False,26,scaffold_7
4,571001,577000,5999,False,26,scaffold_7
5,706001,736000,29999,False,26,scaffold_7
6,741001,753000,11999,False,26,scaffold_7
7,764001,822000,57999,False,26,scaffold_7
8,859001,864000,4999,False,26,scaffold_7
9,876001,945000,68999,False,26,scaffold_7
10,968001,980000,11999,False,26,scaffold_7
11,982001,1044000,61999,False,26,scaffold_7
12,1191001,1460000,268999,False,26,scaffold_7
13,1461001,1512000,50999,False,26,scaffold_7
14,1588001,1696000,107999,False,26,scaffold_7
15,3297001,3369000,71999,False,26,scaffold_7
16,3520001,3767000,246999,False,26,scaffold_7
17,4414001,4514000,99999,False,26,scaffold_7
18,4633001,4790000,156999,False,26,scaffold_7
19,4892001,4911000,18999,False,26,scaffold_7
20,4979001,5149000,169999,False,26,scaffold_7
21,5482001,5536000,53999,False,26,scaffold_7
22,6954001,7270000,315999,False,26,scaffold_7
23,7271001,7502216,231215,True,26,scaffold_7
0,1,7000,6999,True,26,scaffold_8
1,66001,85000,18999,False,26,scaffold_8
2,93001,101000,7999,False,26,scaffold_8
3,729001,732000,2999,False,26,scaffold_8
4,2414001,2529000,114999,False,26,scaffold_8
5,2652001,2682000,29999,False,26,scaffold_8
6,2711001,2844000,132999,False,26,scaffold_8
7,2847001,2892000,44999,False,26,scaffold_8
8,3038001,3395000,356999,False,26,scaffold_8
9,3396001,3525000,128999,False,26,scaffold_8
10,3578001,3612000,33999,False,26,scaffold_8
11,3615001,3938000,322999,False,26,scaffold_8
12,4037001,4108000,70999,False,26,scaffold_8
13,4203001,4263000,59999,False,26,scaffold_8
14,4400001,4426000,25999,False,26,scaffold_8
15,4757001,4769000,11999,False,26,scaffold_8
16,5083001,5242000,158999,False,26,scaffold_8
17,5661001,5709000,47999,False,26,scaffold_8
18,5750001,5768000,17999,False,26,scaffold_8
19,5890001,5905000,14999,False,26,scaffold_8
20,6320001,6334544,14543,True,26,scaffold_8
0,1001,19000,17999,False,26,scaffold_9
1,109001,117000,7999,False,26,scaffold_9
2,121001,133000,11999,False,26,scaffold_9
3,305001,311000,5999,False,26,scaffold_9
4,319001,332000,12999,False,26,scaffold_9
5,366001,411000,44999,False,26,scaffold_9
6,413001,434000,20999,False,26,scaffold_9
7,502001,531000,28999,False,26,scaffold_9
8,671001,696000,24999,False,26,scaffold_9
9,732001,741000,8999,False,26,scaffold_9
10,817001,842000,24999,False,26,scaffold_9
11,873001,986000,112999,False,26,scaffold_9
12,988001,995000,6999,False,26,scaffold_9
13,1001001,1007000,5999,False,26,scaffold_9
14,1010001,1085000,74999,False,26,scaffold_9
15,1087001,1160000,72999,False,26,scaffold_9
16,1312001,1377000,64999,False,26,scaffold_9
17,1428001,1436000,7999,False,26,scaffold_9
18,1545001,1586000,40999,False,26,scaffold_9
19,1587001,1592000,4999,False,26,scaffold_9
20,1597001,1616000,18999,False,26,scaffold_9
21,1655001,1691000,35999,False,26,scaffold_9
22,1755001,1810000,54999,False,26,scaffold_9
23,1987001,2058000,70999,False,26,scaffold_9
24,2075001,2132000,56999,False,26,scaffold_9
25,2148001,2171000,22999,False,26,scaffold_9
26,2597001,2661000,63999,False,26,scaffold_9
27,2737001,2811000,73999,False,26,scaffold_9
28,2844001,3381000,536999,False,26,scaffold_9
29,3383001,5107000,1723999,False,26,scaffold_9
30,5112001,5114000,1999,False,26,scaffold_9
31,5116001,5238000,121999,False,26,scaffold_9
32,5239001,5298000,58999,False,26,scaffold_9
33,5300001,5491000,190999,False,26,scaffold_9
34,5493001,6331288,838287,True,26,scaffold_9
0,1,414000,413999,True,26,scaffold_10
1,415001,482000,66999,False,26,scaffold_10
2,483001,582000,98999,False,26,scaffold_10
3,603001,750000,146999,False,26,scaffold_10
4,888001,986000,97999,False,26,scaffold_10
5,1048001,1069000,20999,False,26,scaffold_10
6,1087001,1106000,18999,False,26,scaffold_10
7,1373001,1430000,56999,False,26,scaffold_10
8,1635001,1674000,38999,False,26,scaffold_10
9,2087001,2110000,22999,False,26,scaffold_10
10,2140001,2175000,34999,False,26,scaffold_10
11,2268001,2331000,62999,False,26,scaffold_10
12,2334001,2471000,136999,False,26,scaffold_10
13,2557001,2588000,30999,False,26,scaffold_10
14,2606001,2616000,9999,False,26,scaffold_10
15,2673001,2708000,34999,False,26,scaffold_10
16,2714001,2749000,34999,False,26,scaffold_10
17,4052001,4091000,38999,False,26,scaffold_10
18,4154001,4173000,18999,False,26,scaffold_10
19,4335001,4365000,29999,False,26,scaffold_10
20,4443001,4462000,18999,False,26,scaffold_10
21,4467001,4476000,8999,False,26,scaffold_10
22,4503001,4513000,9999,False,26,scaffold_10
23,4515001,4523000,7999,False,26,scaffold_10
24,4526001,4548000,21999,False,26,scaffold_10
25,4575001,4596000,20999,False,26,scaffold_10
26,4680001,4688000,7999,False,26,scaffold_10
27,4734001,4766000,31999,False,26,scaffold_10
28,4767001,4776000,8999,False,26,scaffold_10
29,4798001,4824000,25999,False,26,scaffold_10
30,4827001,4843000,15999,False,26,scaffold_10
31,4848001,4861000,12999,False,26,scaffold_10
32,4865001,4866973,1972,True,26,scaffold_10
0,10001,91000,80999,False,26,scaffold_11
1,149001,167000,17999,False,26,scaffold_11
2,169001,191000,21999,False,26,scaffold_11
3,213001,235000,21999,False,26,scaffold_11
4,240001,248000,7999,False,26,scaffold_11
5,419001,431000,11999,False,26,scaffold_11
6,648001,656000,7999,False,26,scaffold_11
7,1025001,1034000,8999,False,26,scaffold_11
8,1423001,1426000,2999,False,26,scaffold_11
9,1432001,1443000,10999,False,26,scaffold_11
10,1474001,1478000,3999,False,26,scaffold_11
11,2019001,2058000,38999,False,26,scaffold_11
12,2090001,2108000,17999,False,26,scaffold_11
13,2131001,2172000,40999,False,26,scaffold_11
14,2701001,2877000,175999,False,26,scaffold_11
15,2978001,3019000,40999,False,26,scaffold_11
16,3086001,3176000,89999,False,26,scaffold_11
17,3186001,3297000,110999,False,26,scaffold_11
18,3299001,3383000,83999,False,26,scaffold_11
19,3433001,3477000,43999,False,26,scaffold_11
20,3520001,3689000,168999,False,26,scaffold_11
21,3706001,3934000,227999,False,26,scaffold_11
22,3997001,4159000,161999,False,26,scaffold_11
23,4181001,4710000,528999,False,26,scaffold_11
24,4713001,4766820,53819,True,26,scaffold_11
0,1,1498000,1497999,True,26,scaffold_12
1,1720001,1733000,12999,False,26,scaffold_12
2,1788001,1805000,16999,False,26,scaffold_12
3,1979001,1994000,14999,False,26,scaffold_12
4,2050001,2087000,36999,False,26,scaffold_12
5,2088001,2103000,14999,False,26,scaffold_12
6,2137001,2166000,28999,False,26,scaffold_12
7,2341001,2375000,33999,False,26,scaffold_12
8,2560001,2566000,5999,False,26,scaffold_12
9,2571001,2618000,46999,False,26,scaffold_12
0,1,342000,341999,True,27,scaffold_1
1,482001,498000,15999,False,27,scaffold_1
2,570001,643000,72999,False,27,scaffold_1
3,686001,743000,56999,False,27,scaffold_1
4,1281001,1292000,10999,False,27,scaffold_1
5,1627001,1660000,32999,False,27,scaffold_1
6,1817001,1935000,117999,False,27,scaffold_1
7,1951001,1964000,12999,False,27,scaffold_1
8,1965001,1984000,18999,False,27,scaffold_1
9,1986001,2016000,29999,False,27,scaffold_1
10,2449001,2519000,69999,False,27,scaffold_1
11,2565001,2582000,16999,False,27,scaffold_1
12,2727001,2746000,18999,False,27,scaffold_1
13,3172001,3210000,37999,False,27,scaffold_1
14,3444001,3481000,36999,False,27,scaffold_1
15,3578001,3617000,38999,False,27,scaffold_1
16,3713001,3741000,27999,False,27,scaffold_1
17,3803001,3878000,74999,False,27,scaffold_1
18,3910001,3941000,30999,False,27,scaffold_1
19,3956001,4028000,71999,False,27,scaffold_1
20,4061001,4111000,49999,False,27,scaffold_1
21,4314001,4354000,39999,False,27,scaffold_1
22,4796001,4814000,17999,False,27,scaffold_1
23,4920001,5022000,101999,False,27,scaffold_1
24,5088001,5110000,21999,False,27,scaffold_1
25,5481001,5514000,32999,False,27,scaffold_1
26,5535001,5570000,34999,False,27,scaffold_1
27,6108001,6153000,44999,False,27,scaffold_1
28,6154001,6176000,21999,False,27,scaffold_1
29,6208001,6382000,173999,False,27,scaffold_1
30,6384001,6509000,124999,False,27,scaffold_1
31,6541001,6566000,24999,False,27,scaffold_1
32,7038001,7247000,208999,False,27,scaffold_1
33,7248001,7583000,334999,False,27,scaffold_1
34,7590001,8656000,1065999,False,27,scaffold_1
35,8658001,9584000,925999,False,27,scaffold_1
36,9586001,10363000,776999,False,27,scaffold_1
37,10460001,10631000,170999,False,27,scaffold_1
38,10832001,10857000,24999,False,27,scaffold_1
39,10916001,10940000,23999,False,27,scaffold_1
40,11275001,11506000,230999,False,27,scaffold_1
41,11555001,11951000,395999,False,27,scaffold_1
42,12184001,12204000,19999,False,27,scaffold_1
43,12425001,12449000,23999,False,27,scaffold_1
44,12553001,12583000,29999,False,27,scaffold_1
45,12650001,12722000,71999,False,27,scaffold_1
46,12776001,12888000,111999,False,27,scaffold_1
47,13024001,13042000,17999,False,27,scaffold_1
48,13113001,13136000,22999,False,27,scaffold_1
49,13163001,13211000,47999,False,27,scaffold_1
50,13347001,13431000,83999,False,27,scaffold_1
51,13796001,13845000,48999,False,27,scaffold_1
52,14299001,14303000,3999,False,27,scaffold_1
0,21001,48000,26999,False,27,scaffold_2
1,93001,159000,65999,False,27,scaffold_2
2,168001,177000,8999,False,27,scaffold_2
3,302001,318000,15999,False,27,scaffold_2
4,332001,374000,41999,False,27,scaffold_2
5,2085001,2101000,15999,False,27,scaffold_2
6,2336001,2358000,21999,False,27,scaffold_2
7,2397001,2424000,26999,False,27,scaffold_2
8,2441001,2553000,111999,False,27,scaffold_2
9,2660001,2689000,28999,False,27,scaffold_2
10,2694001,2744000,49999,False,27,scaffold_2
11,2767001,2787000,19999,False,27,scaffold_2
12,2840001,2855000,14999,False,27,scaffold_2
13,2868001,2905000,36999,False,27,scaffold_2
14,3001001,3008000,6999,False,27,scaffold_2
15,3174001,3186000,11999,False,27,scaffold_2
16,3363001,3387000,23999,False,27,scaffold_2
17,3450001,3466000,15999,False,27,scaffold_2
18,3754001,3788000,33999,False,27,scaffold_2
19,4243001,4276000,32999,False,27,scaffold_2
20,4383001,4409000,25999,False,27,scaffold_2
21,4427001,4458000,30999,False,27,scaffold_2
22,4515001,4658000,142999,False,27,scaffold_2
23,4793001,4809000,15999,False,27,scaffold_2
24,4918001,4956000,37999,False,27,scaffold_2
25,5019001,5031000,11999,False,27,scaffold_2
26,5033001,5067000,33999,False,27,scaffold_2
27,5080001,5104000,23999,False,27,scaffold_2
28,5209001,5222000,12999,False,27,scaffold_2
29,5285001,5316000,30999,False,27,scaffold_2
30,5370001,5488000,117999,False,27,scaffold_2
31,5490001,5512000,21999,False,27,scaffold_2
32,5627001,5758000,130999,False,27,scaffold_2
33,5830001,5892000,61999,False,27,scaffold_2
34,5911001,5993000,81999,False,27,scaffold_2
35,6261001,6343000,81999,False,27,scaffold_2
36,6397001,6451000,53999,False,27,scaffold_2
37,6593001,6629000,35999,False,27,scaffold_2
38,7006001,7038000,31999,False,27,scaffold_2
39,7062001,7097000,34999,False,27,scaffold_2
40,7439001,7472000,32999,False,27,scaffold_2
41,7550001,7561000,10999,False,27,scaffold_2
42,7563001,7697000,133999,False,27,scaffold_2
43,7785001,7916000,130999,False,27,scaffold_2
44,7933001,8161000,227999,False,27,scaffold_2
45,8261001,8297000,35999,False,27,scaffold_2
46,8331001,8333000,1999,False,27,scaffold_2
47,8334001,8344000,9999,False,27,scaffold_2
48,8346001,8454000,107999,False,27,scaffold_2
49,8495001,8564000,68999,False,27,scaffold_2
50,9157001,9168000,10999,False,27,scaffold_2
51,11520001,11786000,265999,False,27,scaffold_2
0,1,2000,1999,True,27,scaffold_3
1,102001,104000,1999,False,27,scaffold_3
2,799001,901000,101999,False,27,scaffold_3
3,2008001,2108000,99999,False,27,scaffold_3
4,2288001,2335000,46999,False,27,scaffold_3
5,2485001,2533000,47999,False,27,scaffold_3
6,2649001,2704000,54999,False,27,scaffold_3
7,2716001,2738000,21999,False,27,scaffold_3
8,3097001,3135000,37999,False,27,scaffold_3
9,3608001,3644000,35999,False,27,scaffold_3
10,3768001,3821000,52999,False,27,scaffold_3
11,3822001,3892000,69999,False,27,scaffold_3
12,4007001,4035000,27999,False,27,scaffold_3
13,4102001,4398000,295999,False,27,scaffold_3
14,4418001,4518000,99999,False,27,scaffold_3
15,4546001,4558000,11999,False,27,scaffold_3
16,4652001,4678000,25999,False,27,scaffold_3
17,4999001,5033000,33999,False,27,scaffold_3
18,5158001,5207000,48999,False,27,scaffold_3
19,5238001,5259000,20999,False,27,scaffold_3
20,5489001,5508000,18999,False,27,scaffold_3
21,5805001,5944000,138999,False,27,scaffold_3
22,5967001,6029000,61999,False,27,scaffold_3
23,6742001,6784000,41999,False,27,scaffold_3
24,6891001,7092000,200999,False,27,scaffold_3
25,7286001,7328000,41999,False,27,scaffold_3
26,7333001,7397000,63999,False,27,scaffold_3
27,7517001,7556000,38999,False,27,scaffold_3
28,7690001,7856000,165999,False,27,scaffold_3
29,8044001,8116000,71999,False,27,scaffold_3
30,8176001,8255000,78999,False,27,scaffold_3
31,8462001,8527000,64999,False,27,scaffold_3
32,8575001,8594000,18999,False,27,scaffold_3
33,9006001,9075000,68999,False,27,scaffold_3
34,9968001,9996000,27999,False,27,scaffold_3
35,10587001,11182071,595070,True,27,scaffold_3
0,11001,13000,1999,False,27,scaffold_4
1,17001,32000,14999,False,27,scaffold_4
2,48001,86000,37999,False,27,scaffold_4
3,147001,151000,3999,False,27,scaffold_4
4,155001,215000,59999,False,27,scaffold_4
5,217001,226000,8999,False,27,scaffold_4
6,227001,241000,13999,False,27,scaffold_4
7,242001,266000,23999,False,27,scaffold_4
8,355001,374000,18999,False,27,scaffold_4
9,375001,380000,4999,False,27,scaffold_4
10,391001,410000,18999,False,27,scaffold_4
11,412001,425000,12999,False,27,scaffold_4
12,429001,498000,68999,False,27,scaffold_4
13,545001,592000,46999,False,27,scaffold_4
14,593001,606000,12999,False,27,scaffold_4
15,608001,691000,82999,False,27,scaffold_4
16,701001,727000,25999,False,27,scaffold_4
17,1121001,1136000,14999,False,27,scaffold_4
18,1137001,1198000,60999,False,27,scaffold_4
19,1199001,1226000,26999,False,27,scaffold_4
20,1235001,1253000,17999,False,27,scaffold_4
21,1254001,1260000,5999,False,27,scaffold_4
22,1265001,1279000,13999,False,27,scaffold_4
23,1283001,1336000,52999,False,27,scaffold_4
24,1372001,1600000,227999,False,27,scaffold_4
25,1613001,2065000,451999,False,27,scaffold_4
26,2071001,2117000,45999,False,27,scaffold_4
27,2119001,2128000,8999,False,27,scaffold_4
28,2142001,2185000,42999,False,27,scaffold_4
29,2190001,2205000,14999,False,27,scaffold_4
30,2207001,2218000,10999,False,27,scaffold_4
31,2219001,2268000,48999,False,27,scaffold_4
32,2269001,2280000,10999,False,27,scaffold_4
33,2283001,2461000,177999,False,27,scaffold_4
34,2476001,2635000,158999,False,27,scaffold_4
35,2676001,2795000,118999,False,27,scaffold_4
36,2897001,2967000,69999,False,27,scaffold_4
37,3055001,3127000,71999,False,27,scaffold_4
38,3206001,3331000,124999,False,27,scaffold_4
39,3334001,3633000,298999,False,27,scaffold_4
40,3645001,3766000,120999,False,27,scaffold_4
41,4056001,4072000,15999,False,27,scaffold_4
42,4900001,5088000,187999,False,27,scaffold_4
43,5171001,5225000,53999,False,27,scaffold_4
44,5293001,5329000,35999,False,27,scaffold_4
45,5338001,5356000,17999,False,27,scaffold_4
46,5468001,5506000,37999,False,27,scaffold_4
47,5514001,5784000,269999,False,27,scaffold_4
48,5786001,5825000,38999,False,27,scaffold_4
49,6145001,6193000,47999,False,27,scaffold_4
50,6764001,6817000,52999,False,27,scaffold_4
51,6897001,6924000,26999,False,27,scaffold_4
52,6951001,6995000,43999,False,27,scaffold_4
53,7036001,7124000,87999,False,27,scaffold_4
54,7225001,7324000,98999,False,27,scaffold_4
55,7632001,7666000,33999,False,27,scaffold_4
56,8846001,9699000,852999,False,27,scaffold_4
57,9700001,9845951,145950,True,27,scaffold_4
0,1,4000,3999,True,27,scaffold_5
1,319001,382000,62999,False,27,scaffold_5
2,462001,523000,60999,False,27,scaffold_5
3,639001,649000,9999,False,27,scaffold_5
4,669001,697000,27999,False,27,scaffold_5
5,933001,947000,13999,False,27,scaffold_5
6,2511001,2515000,3999,False,27,scaffold_5
7,2516001,2519000,2999,False,27,scaffold_5
8,2556001,2757000,200999,False,27,scaffold_5
9,2763001,2874000,110999,False,27,scaffold_5
10,3133001,3253000,119999,False,27,scaffold_5
11,3300001,3514000,213999,False,27,scaffold_5
12,3621001,3656000,34999,False,27,scaffold_5
13,3962001,4101000,138999,False,27,scaffold_5
14,4119001,4221000,101999,False,27,scaffold_5
15,4226001,4272000,45999,False,27,scaffold_5
16,4446001,4552000,105999,False,27,scaffold_5
17,4595001,4861000,265999,False,27,scaffold_5
18,4893001,4922000,28999,False,27,scaffold_5
19,5059001,5090000,30999,False,27,scaffold_5
20,5249001,5274000,24999,False,27,scaffold_5
21,5288001,5312000,23999,False,27,scaffold_5
22,5314001,5344000,29999,False,27,scaffold_5
23,6394001,6420000,25999,False,27,scaffold_5
24,6453001,6653000,199999,False,27,scaffold_5
25,6877001,6921000,43999,False,27,scaffold_5
26,7311001,7322000,10999,False,27,scaffold_5
27,7406001,7436000,29999,False,27,scaffold_5
28,7454001,7487000,32999,False,27,scaffold_5
29,7547001,7619000,71999,False,27,scaffold_5
30,7620001,7659000,38999,False,27,scaffold_5
31,8556001,8616000,59999,False,27,scaffold_5
32,8640001,8689000,48999,False,27,scaffold_5
33,8713001,9364176,651175,True,27,scaffold_5
0,79001,84000,4999,False,27,scaffold_6
1,86001,114000,27999,False,27,scaffold_6
2,172001,208000,35999,False,27,scaffold_6
3,241001,254000,12999,False,27,scaffold_6
4,257001,262000,4999,False,27,scaffold_6
5,267001,296000,28999,False,27,scaffold_6
6,732001,755000,22999,False,27,scaffold_6
7,782001,801000,18999,False,27,scaffold_6
8,1147001,1199000,51999,False,27,scaffold_6
9,1215001,1226000,10999,False,27,scaffold_6
10,1229001,1262000,32999,False,27,scaffold_6
11,1478001,1595000,116999,False,27,scaffold_6
12,1658001,1689000,30999,False,27,scaffold_6
13,1862001,1906000,43999,False,27,scaffold_6
14,2023001,2102000,78999,False,27,scaffold_6
15,2130001,2213000,82999,False,27,scaffold_6
16,2236001,2283000,46999,False,27,scaffold_6
17,2336001,2595000,258999,False,27,scaffold_6
18,2596001,2872000,275999,False,27,scaffold_6
19,2936001,3032000,95999,False,27,scaffold_6
20,3097001,3191000,93999,False,27,scaffold_6
21,3223001,3350000,126999,False,27,scaffold_6
22,3351001,3432000,80999,False,27,scaffold_6
23,3452001,3767000,314999,False,27,scaffold_6
24,3897001,3925000,27999,False,27,scaffold_6
25,4018001,4193000,174999,False,27,scaffold_6
26,6011001,6083000,71999,False,27,scaffold_6
27,6152001,6190000,37999,False,27,scaffold_6
28,6782001,6803000,20999,False,27,scaffold_6
29,7263001,7337000,73999,False,27,scaffold_6
30,7389001,7476000,86999,False,27,scaffold_6
31,7543001,8268281,725280,True,27,scaffold_6
0,13001,34000,20999,False,27,scaffold_7
1,323001,340000,16999,False,27,scaffold_7
2,342001,508000,165999,False,27,scaffold_7
3,554001,563000,8999,False,27,scaffold_7
4,571001,577000,5999,False,27,scaffold_7
5,654001,674000,19999,False,27,scaffold_7
6,706001,736000,29999,False,27,scaffold_7
7,764001,827000,62999,False,27,scaffold_7
8,859001,864000,4999,False,27,scaffold_7
9,868001,872000,3999,False,27,scaffold_7
10,875001,938000,62999,False,27,scaffold_7
11,982001,1044000,61999,False,27,scaffold_7
12,1048001,1104000,55999,False,27,scaffold_7
13,1191001,1460000,268999,False,27,scaffold_7
14,1461001,1512000,50999,False,27,scaffold_7
15,1588001,1695000,106999,False,27,scaffold_7
16,1740001,1757000,16999,False,27,scaffold_7
17,1758001,1782000,23999,False,27,scaffold_7
18,1851001,1901000,49999,False,27,scaffold_7
19,1978001,2015000,36999,False,27,scaffold_7
20,3325001,3369000,43999,False,27,scaffold_7
21,3525001,3550000,24999,False,27,scaffold_7
22,3593001,3766000,172999,False,27,scaffold_7
23,4415001,4517000,101999,False,27,scaffold_7
24,4658001,4734000,75999,False,27,scaffold_7
25,4978001,5153000,174999,False,27,scaffold_7
26,5482001,5537000,54999,False,27,scaffold_7
27,6075001,6094000,18999,False,27,scaffold_7
28,6751001,6794000,42999,False,27,scaffold_7
29,6954001,7270000,315999,False,27,scaffold_7
30,7271001,7502216,231215,True,27,scaffold_7
0,1,6000,5999,True,27,scaffold_8
1,67001,85000,17999,False,27,scaffold_8
2,299001,304000,4999,False,27,scaffold_8
3,1858001,1932000,73999,False,27,scaffold_8
4,2444001,2530000,85999,False,27,scaffold_8
5,2536001,2553000,16999,False,27,scaffold_8
6,2651001,2844000,192999,False,27,scaffold_8
7,2847001,2891000,43999,False,27,scaffold_8
8,3032001,3554000,521999,False,27,scaffold_8
9,3584001,3612000,27999,False,27,scaffold_8
10,3615001,3938000,322999,False,27,scaffold_8
11,4031001,4108000,76999,False,27,scaffold_8
12,4164001,4187000,22999,False,27,scaffold_8
13,4202001,4221000,18999,False,27,scaffold_8
14,4395001,4431000,35999,False,27,scaffold_8
15,5086001,5137000,50999,False,27,scaffold_8
16,5163001,5242000,78999,False,27,scaffold_8
17,5579001,5597000,17999,False,27,scaffold_8
18,5652001,5714000,61999,False,27,scaffold_8
19,5750001,5775000,24999,False,27,scaffold_8
20,5776001,5792000,15999,False,27,scaffold_8
21,5885001,5907000,21999,False,27,scaffold_8
22,6320001,6334544,14543,True,27,scaffold_8
0,109001,117000,7999,False,27,scaffold_9
1,189001,193000,3999,False,27,scaffold_9
2,236001,242000,5999,False,27,scaffold_9
3,303001,315000,11999,False,27,scaffold_9
4,319001,334000,14999,False,27,scaffold_9
5,366001,411000,44999,False,27,scaffold_9
6,413001,434000,20999,False,27,scaffold_9
7,502001,531000,28999,False,27,scaffold_9
8,547001,563000,15999,False,27,scaffold_9
9,660001,665000,4999,False,27,scaffold_9
10,670001,696000,25999,False,27,scaffold_9
11,731001,742000,10999,False,27,scaffold_9
12,815001,842000,26999,False,27,scaffold_9
13,873001,986000,112999,False,27,scaffold_9
14,988001,995000,6999,False,27,scaffold_9
15,1002001,1007000,4999,False,27,scaffold_9
16,1009001,1085000,75999,False,27,scaffold_9
17,1087001,1175000,87999,False,27,scaffold_9
18,1312001,1378000,65999,False,27,scaffold_9
19,1428001,1440000,11999,False,27,scaffold_9
20,1487001,1499000,11999,False,27,scaffold_9
21,1552001,1584000,31999,False,27,scaffold_9
22,1637001,1679000,41999,False,27,scaffold_9
23,1748001,1791000,42999,False,27,scaffold_9
24,1839001,1857000,17999,False,27,scaffold_9
25,1987001,2037000,49999,False,27,scaffold_9
26,2076001,2133000,56999,False,27,scaffold_9
27,2147001,2171000,23999,False,27,scaffold_9
28,2174001,2198000,23999,False,27,scaffold_9
29,2220001,2233000,12999,False,27,scaffold_9
30,2594001,2633000,38999,False,27,scaffold_9
31,2737001,2824000,86999,False,27,scaffold_9
32,2844001,3381000,536999,False,27,scaffold_9
33,3383001,5099000,1715999,False,27,scaffold_9
34,5101001,5107000,5999,False,27,scaffold_9
35,5112001,5114000,1999,False,27,scaffold_9
36,5116001,5238000,121999,False,27,scaffold_9
37,5239001,5298000,58999,False,27,scaffold_9
38,5300001,5491000,190999,False,27,scaffold_9
39,5493001,6331288,838287,True,27,scaffold_9
0,1,136000,135999,True,27,scaffold_10
1,137001,405000,267999,False,27,scaffold_10
2,422001,482000,59999,False,27,scaffold_10
3,483001,576000,92999,False,27,scaffold_10
4,602001,796000,193999,False,27,scaffold_10
5,812001,841000,28999,False,27,scaffold_10
6,859001,876000,16999,False,27,scaffold_10
7,888001,921000,32999,False,27,scaffold_10
8,923001,963000,39999,False,27,scaffold_10
9,1058001,1069000,10999,False,27,scaffold_10
10,1087001,1147000,59999,False,27,scaffold_10
11,1446001,1462000,15999,False,27,scaffold_10
12,2079001,2103000,23999,False,27,scaffold_10
13,2140001,2170000,29999,False,27,scaffold_10
14,2268001,2327000,58999,False,27,scaffold_10
15,2336001,2457000,120999,False,27,scaffold_10
16,2514001,2520000,5999,False,27,scaffold_10
17,2547001,2586000,38999,False,27,scaffold_10
18,2600001,2626000,25999,False,27,scaffold_10
19,2673001,2697000,23999,False,27,scaffold_10
20,2714001,2733000,18999,False,27,scaffold_10
21,2735001,2748000,12999,False,27,scaffold_10
22,3156001,3171000,14999,False,27,scaffold_10
23,4056001,4091000,34999,False,27,scaffold_10
24,4154001,4181000,26999,False,27,scaffold_10
25,4335001,4359000,23999,False,27,scaffold_10
26,4445001,4462000,16999,False,27,scaffold_10
27,4467001,4477000,9999,False,27,scaffold_10
28,4503001,4513000,9999,False,27,scaffold_10
29,4515001,4523000,7999,False,27,scaffold_10
30,4526001,4548000,21999,False,27,scaffold_10
31,4554001,4562000,7999,False,27,scaffold_10
32,4565001,4596000,30999,False,27,scaffold_10
33,4679001,4688000,8999,False,27,scaffold_10
34,4734001,4766000,31999,False,27,scaffold_10
35,4798001,4824000,25999,False,27,scaffold_10
36,4828001,4843000,14999,False,27,scaffold_10
37,4848001,4861000,12999,False,27,scaffold_10
38,4865001,4866973,1972,True,27,scaffold_10
0,10001,91000,80999,False,27,scaffold_11
1,148001,167000,18999,False,27,scaffold_11
2,169001,191000,21999,False,27,scaffold_11
3,213001,235000,21999,False,27,scaffold_11
4,240001,248000,7999,False,27,scaffold_11
5,300001,309000,8999,False,27,scaffold_11
6,419001,431000,11999,False,27,scaffold_11
7,649001,656000,6999,False,27,scaffold_11
8,1025001,1034000,8999,False,27,scaffold_11
9,1423001,1426000,2999,False,27,scaffold_11
10,1474001,1477000,2999,False,27,scaffold_11
11,2035001,2058000,22999,False,27,scaffold_11
12,2129001,2150000,20999,False,27,scaffold_11
13,2701001,2877000,175999,False,27,scaffold_11
14,2957001,3011000,53999,False,27,scaffold_11
15,3086001,3175000,88999,False,27,scaffold_11
16,3185001,3383000,197999,False,27,scaffold_11
17,3426001,3480000,53999,False,27,scaffold_11
18,3520001,3972000,451999,False,27,scaffold_11
19,3985001,4159000,173999,False,27,scaffold_11
20,4189001,4710000,520999,False,27,scaffold_11
21,4712001,4766820,54819,True,27,scaffold_11
0,1,387000,386999,True,27,scaffold_12
1,403001,1497000,1093999,False,27,scaffold_12
2,1720001,1734000,13999,False,27,scaffold_12
3,1789001,1805000,15999,False,27,scaffold_12
4,1972001,1994000,21999,False,27,scaffold_12
5,2043001,2094000,50999,False,27,scaffold_12
6,2136001,2165000,28999,False,27,scaffold_12
7,2203001,2205000,1999,False,27,scaffold_12
8,2571001,2610000,38999,False,27,scaffold_12
9,2747001,2747968,967,True,27,scaffold_12
0,1,344000,343999,True,28,scaffold_1
1,482001,498000,15999,False,28,scaffold_1
2,571001,643000,71999,False,28,scaffold_1
3,686001,749000,62999,False,28,scaffold_1
4,883001,903000,19999,False,28,scaffold_1
5,1179001,1193000,13999,False,28,scaffold_1
6,1272001,1292000,19999,False,28,scaffold_1
7,1628001,1660000,31999,False,28,scaffold_1
8,1819001,1900000,80999,False,28,scaffold_1
9,1951001,1964000,12999,False,28,scaffold_1
10,1965001,1984000,18999,False,28,scaffold_1
11,1988001,2014000,25999,False,28,scaffold_1
12,2449001,2517000,67999,False,28,scaffold_1
13,2565001,2582000,16999,False,28,scaffold_1
14,2725001,2746000,20999,False,28,scaffold_1
15,3175001,3208000,32999,False,28,scaffold_1
16,3445001,3499000,53999,False,28,scaffold_1
17,3703001,3880000,176999,False,28,scaffold_1
18,3903001,3940000,36999,False,28,scaffold_1
19,3956001,4029000,72999,False,28,scaffold_1
20,4064001,4128000,63999,False,28,scaffold_1
21,4306001,4355000,48999,False,28,scaffold_1
22,4708001,4741000,32999,False,28,scaffold_1
23,4796001,4812000,15999,False,28,scaffold_1
24,4919001,5023000,103999,False,28,scaffold_1
25,5088001,5110000,21999,False,28,scaffold_1
26,5481001,5511000,29999,False,28,scaffold_1
27,5535001,5579000,43999,False,28,scaffold_1
28,6108001,6153000,44999,False,28,scaffold_1
29,6154001,6177000,22999,False,28,scaffold_1
30,6202001,6531000,328999,False,28,scaffold_1
31,6542001,6557000,14999,False,28,scaffold_1
32,7038001,7247000,208999,False,28,scaffold_1
33,7248001,7589000,340999,False,28,scaffold_1
34,7590001,8656000,1065999,False,28,scaffold_1
35,8658001,9584000,925999,False,28,scaffold_1
36,9586001,10355000,768999,False,28,scaffold_1
37,10454001,10637000,182999,False,28,scaffold_1
38,10736001,10757000,20999,False,28,scaffold_1
39,10839001,10857000,17999,False,28,scaffold_1
40,10918001,10941000,22999,False,28,scaffold_1
41,11275001,11509000,233999,False,28,scaffold_1
42,11560001,11951000,390999,False,28,scaffold_1
43,12184001,12207000,22999,False,28,scaffold_1
44,12382001,12396000,13999,False,28,scaffold_1
45,12427001,12444000,16999,False,28,scaffold_1
46,12522001,12586000,63999,False,28,scaffold_1
47,12651001,12722000,70999,False,28,scaffold_1
48,12747001,12888000,140999,False,28,scaffold_1
49,12967001,13004000,36999,False,28,scaffold_1
50,13113001,13211000,97999,False,28,scaffold_1
51,13336001,13443000,106999,False,28,scaffold_1
52,13558001,13589000,30999,False,28,scaffold_1
53,13663001,13710000,46999,False,28,scaffold_1
54,13793001,13845000,51999,False,28,scaffold_1
55,13919001,13927000,7999,False,28,scaffold_1
56,13959001,13973000,13999,False,28,scaffold_1
57,14285001,14313000,27999,False,28,scaffold_1
58,14541001,14561000,19999,False,28,scaffold_1
59,14578001,14591000,12999,False,28,scaffold_1
60,14595001,14613000,17999,False,28,scaffold_1
61,14648001,14664000,15999,False,28,scaffold_1
0,21001,48000,26999,False,28,scaffold_2
1,93001,159000,65999,False,28,scaffold_2
2,165001,177000,11999,False,28,scaffold_2
3,296001,318000,21999,False,28,scaffold_2
4,332001,374000,41999,False,28,scaffold_2
5,1351001,1414000,62999,False,28,scaffold_2
6,1537001,1555000,17999,False,28,scaffold_2
7,1840001,1857000,16999,False,28,scaffold_2
8,1882001,1900000,17999,False,28,scaffold_2
9,2316001,2334000,17999,False,28,scaffold_2
10,2336001,2390000,53999,False,28,scaffold_2
11,2397001,2609000,211999,False,28,scaffold_2
12,2627001,2639000,11999,False,28,scaffold_2
13,2645001,2689000,43999,False,28,scaffold_2
14,2694001,2745000,50999,False,28,scaffold_2
15,2766001,2788000,21999,False,28,scaffold_2
16,2878001,2901000,22999,False,28,scaffold_2
17,2993001,3021000,27999,False,28,scaffold_2
18,3022001,3045000,22999,False,28,scaffold_2
19,3330001,3344000,13999,False,28,scaffold_2
20,3452001,3549000,96999,False,28,scaffold_2
21,3658001,3690000,31999,False,28,scaffold_2
22,3754001,3784000,29999,False,28,scaffold_2
23,4243001,4281000,37999,False,28,scaffold_2
24,4297001,4316000,18999,False,28,scaffold_2
25,4341001,4409000,67999,False,28,scaffold_2
26,4426001,4457000,30999,False,28,scaffold_2
27,4517001,4664000,146999,False,28,scaffold_2
28,4783001,4790000,6999,False,28,scaffold_2
29,4793001,4800000,6999,False,28,scaffold_2
30,4917001,4984000,66999,False,28,scaffold_2
31,5034001,5104000,69999,False,28,scaffold_2
32,5287001,5314000,26999,False,28,scaffold_2
33,5370001,5515000,144999,False,28,scaffold_2
34,5667001,5758000,90999,False,28,scaffold_2
35,5840001,5888000,47999,False,28,scaffold_2
36,5933001,5993000,59999,False,28,scaffold_2
37,6005001,6037000,31999,False,28,scaffold_2
38,6125001,6140000,14999,False,28,scaffold_2
39,6261001,6330000,68999,False,28,scaffold_2
40,6331001,6342000,10999,False,28,scaffold_2
41,6366001,6449000,82999,False,28,scaffold_2
42,6590001,6628000,37999,False,28,scaffold_2
43,7005001,7038000,32999,False,28,scaffold_2
44,7049001,7097000,47999,False,28,scaffold_2
45,7428001,7473000,44999,False,28,scaffold_2
46,7549001,7561000,11999,False,28,scaffold_2
47,7563001,7699000,135999,False,28,scaffold_2
48,7783001,7916000,132999,False,28,scaffold_2
49,7933001,8164000,230999,False,28,scaffold_2
50,8261001,8313000,51999,False,28,scaffold_2
51,8331001,8333000,1999,False,28,scaffold_2
52,8335001,8344000,8999,False,28,scaffold_2
53,8346001,8454000,107999,False,28,scaffold_2
54,8465001,8493000,27999,False,28,scaffold_2
55,8495001,8562000,66999,False,28,scaffold_2
56,9140001,9199000,58999,False,28,scaffold_2
57,9601001,9635000,33999,False,28,scaffold_2
58,10712001,10732000,19999,False,28,scaffold_2
59,11520001,11786000,265999,False,28,scaffold_2
0,1,2000,1999,True,28,scaffold_3
1,218001,232000,13999,False,28,scaffold_3
2,618001,646000,27999,False,28,scaffold_3
3,798001,901000,102999,False,28,scaffold_3
4,2007001,2108000,100999,False,28,scaffold_3
5,2110001,2126000,15999,False,28,scaffold_3
6,2288001,2336000,47999,False,28,scaffold_3
7,2486001,2533000,46999,False,28,scaffold_3
8,2650001,2761000,110999,False,28,scaffold_3
9,3101001,3146000,44999,False,28,scaffold_3
10,3215001,3275000,59999,False,28,scaffold_3
11,3606001,3700000,93999,False,28,scaffold_3
12,3822001,3891000,68999,False,28,scaffold_3
13,4007001,4036000,28999,False,28,scaffold_3
14,4068001,4398000,329999,False,28,scaffold_3
15,4418001,4518000,99999,False,28,scaffold_3
16,4547001,4558000,10999,False,28,scaffold_3
17,4638001,4674000,35999,False,28,scaffold_3
18,5158001,5196000,37999,False,28,scaffold_3
19,5232001,5249000,16999,False,28,scaffold_3
20,5378001,5451000,72999,False,28,scaffold_3
21,5489001,5509000,19999,False,28,scaffold_3
22,5591001,5672000,80999,False,28,scaffold_3
23,5806001,5918000,111999,False,28,scaffold_3
24,5919001,5946000,26999,False,28,scaffold_3
25,5964001,6029000,64999,False,28,scaffold_3
26,6759001,6785000,25999,False,28,scaffold_3
27,6887001,7094000,206999,False,28,scaffold_3
28,7255001,7301000,45999,False,28,scaffold_3
29,7369001,7403000,33999,False,28,scaffold_3
30,7449001,7458000,8999,False,28,scaffold_3
31,7506001,7557000,50999,False,28,scaffold_3
32,7675001,7858000,182999,False,28,scaffold_3
33,8046001,8116000,69999,False,28,scaffold_3
34,8183001,8253000,69999,False,28,scaffold_3
35,8378001,8447000,68999,False,28,scaffold_3
36,8462001,8527000,64999,False,28,scaffold_3
37,8575001,8594000,18999,False,28,scaffold_3
38,8994001,9080000,85999,False,28,scaffold_3
39,9121001,9151000,29999,False,28,scaffold_3
40,9968001,9996000,27999,False,28,scaffold_3
41,10587001,11182071,595070,True,28,scaffold_3
0,11001,13000,1999,False,28,scaffold_4
1,17001,32000,14999,False,28,scaffold_4
2,48001,88000,39999,False,28,scaffold_4
3,101001,115000,13999,False,28,scaffold_4
4,120001,131000,10999,False,28,scaffold_4
5,132001,146000,13999,False,28,scaffold_4
6,147001,151000,3999,False,28,scaffold_4
7,155001,215000,59999,False,28,scaffold_4
8,217001,226000,8999,False,28,scaffold_4
9,227001,266000,38999,False,28,scaffold_4
10,293001,307000,13999,False,28,scaffold_4
11,355001,374000,18999,False,28,scaffold_4
12,375001,380000,4999,False,28,scaffold_4
13,383001,410000,26999,False,28,scaffold_4
14,411001,425000,13999,False,28,scaffold_4
15,429001,503000,73999,False,28,scaffold_4
16,545001,599000,53999,False,28,scaffold_4
17,608001,691000,82999,False,28,scaffold_4
18,695001,697000,1999,False,28,scaffold_4
19,701001,727000,25999,False,28,scaffold_4
20,1121001,1136000,14999,False,28,scaffold_4
21,1137001,1198000,60999,False,28,scaffold_4
22,1199001,1208000,8999,False,28,scaffold_4
23,1210001,1226000,15999,False,28,scaffold_4
24,1229001,1253000,23999,False,28,scaffold_4
25,1268001,1279000,10999,False,28,scaffold_4
26,1283001,1337000,53999,False,28,scaffold_4
27,1356001,1605000,248999,False,28,scaffold_4
28,1613001,2129000,515999,False,28,scaffold_4
29,2142001,2206000,63999,False,28,scaffold_4
30,2210001,2461000,250999,False,28,scaffold_4
31,2477001,2635000,157999,False,28,scaffold_4
32,2650001,2674000,23999,False,28,scaffold_4
33,2676001,2812000,135999,False,28,scaffold_4
34,2892001,2958000,65999,False,28,scaffold_4
35,3029001,3127000,97999,False,28,scaffold_4
36,3205001,3766000,560999,False,28,scaffold_4
37,4052001,4105000,52999,False,28,scaffold_4
38,4258001,4306000,47999,False,28,scaffold_4
39,4901001,5050000,148999,False,28,scaffold_4
40,5172001,5224000,51999,False,28,scaffold_4
41,5293001,5404000,110999,False,28,scaffold_4
42,5476001,5506000,29999,False,28,scaffold_4
43,5516001,5640000,123999,False,28,scaffold_4
44,5654001,5784000,129999,False,28,scaffold_4
45,5786001,5825000,38999,False,28,scaffold_4
46,6061001,6112000,50999,False,28,scaffold_4
47,6145001,6191000,45999,False,28,scaffold_4
48,6330001,6396000,65999,False,28,scaffold_4
49,6764001,6817000,52999,False,28,scaffold_4
50,6950001,6995000,44999,False,28,scaffold_4
51,7036001,7124000,87999,False,28,scaffold_4
52,7192001,7302000,109999,False,28,scaffold_4
53,7346001,7402000,55999,False,28,scaffold_4
54,7640001,7664000,23999,False,28,scaffold_4
55,7986001,7997000,10999,False,28,scaffold_4
56,8849001,9699000,849999,False,28,scaffold_4
57,9700001,9845951,145950,True,28,scaffold_4
0,1,4000,3999,True,28,scaffold_5
1,318001,326000,7999,False,28,scaffold_5
2,327001,382000,54999,False,28,scaffold_5
3,463001,526000,62999,False,28,scaffold_5
4,932001,947000,14999,False,28,scaffold_5
5,2092001,2104000,11999,False,28,scaffold_5
6,2475001,2493000,17999,False,28,scaffold_5
7,2511001,2515000,3999,False,28,scaffold_5
8,2552001,2876000,323999,False,28,scaffold_5
9,3132001,3515000,382999,False,28,scaffold_5
10,3621001,3663000,41999,False,28,scaffold_5
11,3962001,4101000,138999,False,28,scaffold_5
12,4121001,4321000,199999,False,28,scaffold_5
13,4445001,4554000,108999,False,28,scaffold_5
14,4600001,4861000,260999,False,28,scaffold_5
15,4892001,4923000,30999,False,28,scaffold_5
16,5061001,5083000,21999,False,28,scaffold_5
17,5217001,5274000,56999,False,28,scaffold_5
18,5318001,5346000,27999,False,28,scaffold_5
19,6394001,6667000,272999,False,28,scaffold_5
20,7296001,7328000,31999,False,28,scaffold_5
21,7454001,7488000,33999,False,28,scaffold_5
22,7547001,7619000,71999,False,28,scaffold_5
23,7621001,7655000,33999,False,28,scaffold_5
24,7676001,7745000,68999,False,28,scaffold_5
25,8550001,8615000,64999,False,28,scaffold_5
26,8659001,8688000,28999,False,28,scaffold_5
27,8702001,9364176,662175,True,28,scaffold_5
0,79001,84000,4999,False,28,scaffold_6
1,86001,116000,29999,False,28,scaffold_6
2,172001,208000,35999,False,28,scaffold_6
3,241001,263000,21999,False,28,scaffold_6
4,264001,296000,31999,False,28,scaffold_6
5,457001,486000,28999,False,28,scaffold_6
6,786001,802000,15999,False,28,scaffold_6
7,987001,1037000,49999,False,28,scaffold_6
8,1124001,1258000,133999,False,28,scaffold_6
9,1284001,1311000,26999,False,28,scaffold_6
10,1434001,1546000,111999,False,28,scaffold_6
11,1561001,1599000,37999,False,28,scaffold_6
12,1657001,1755000,97999,False,28,scaffold_6
13,1843001,1906000,62999,False,28,scaffold_6
14,2023001,2103000,79999,False,28,scaffold_6
15,2129001,2212000,82999,False,28,scaffold_6
16,2239001,2283000,43999,False,28,scaffold_6
17,2334001,2691000,356999,False,28,scaffold_6
18,2712001,2872000,159999,False,28,scaffold_6
19,2934001,3017000,82999,False,28,scaffold_6
20,3083001,3193000,109999,False,28,scaffold_6
21,3223001,3350000,126999,False,28,scaffold_6
22,3351001,3793000,441999,False,28,scaffold_6
23,3830001,3848000,17999,False,28,scaffold_6
24,3898001,3924000,25999,False,28,scaffold_6
25,4017001,4072000,54999,False,28,scaffold_6
26,4073001,4195000,121999,False,28,scaffold_6
27,4838001,4868000,29999,False,28,scaffold_6
28,4956001,4997000,40999,False,28,scaffold_6
29,5731001,5743000,11999,False,28,scaffold_6
30,6010001,6088000,77999,False,28,scaffold_6
31,6123001,6190000,66999,False,28,scaffold_6
32,6773001,6804000,30999,False,28,scaffold_6
33,7187001,7248000,60999,False,28,scaffold_6
34,7254001,7338000,83999,False,28,scaffold_6
35,7390001,7442000,51999,False,28,scaffold_6
36,7553001,8268281,715280,True,28,scaffold_6
0,1,8000,7999,True,28,scaffold_7
1,13001,31000,17999,False,28,scaffold_7
2,50001,60000,9999,False,28,scaffold_7
3,323001,340000,16999,False,28,scaffold_7
4,342001,508000,165999,False,28,scaffold_7
5,705001,753000,47999,False,28,scaffold_7
6,764001,829000,64999,False,28,scaffold_7
7,859001,864000,4999,False,28,scaffold_7
8,865001,929000,63999,False,28,scaffold_7
9,964001,966000,1999,False,28,scaffold_7
10,968001,980000,11999,False,28,scaffold_7
11,982001,1044000,61999,False,28,scaffold_7
12,1048001,1098000,49999,False,28,scaffold_7
13,1183001,1187000,3999,False,28,scaffold_7
14,1191001,1512000,320999,False,28,scaffold_7
15,1588001,1706000,117999,False,28,scaffold_7
16,1727001,1781000,53999,False,28,scaffold_7
17,1973001,2010000,36999,False,28,scaffold_7
18,2550001,2567000,16999,False,28,scaffold_7
19,3305001,3370000,64999,False,28,scaffold_7
20,3524001,3766000,241999,False,28,scaffold_7
21,4415001,4517000,101999,False,28,scaffold_7
22,4635001,4734000,98999,False,28,scaffold_7
23,4978001,5167000,188999,False,28,scaffold_7
24,5478001,5536000,57999,False,28,scaffold_7
25,6070001,6094000,23999,False,28,scaffold_7
26,6953001,7502216,549215,True,28,scaffold_7
0,1,6000,5999,True,28,scaffold_8
1,66001,85000,18999,False,28,scaffold_8
2,2414001,2528000,113999,False,28,scaffold_8
3,2538001,2548000,9999,False,28,scaffold_8
4,2652001,2683000,30999,False,28,scaffold_8
5,2685001,2844000,158999,False,28,scaffold_8
6,2847001,2894000,46999,False,28,scaffold_8
7,3031001,3557000,525999,False,28,scaffold_8
8,3577001,3612000,34999,False,28,scaffold_8
9,3615001,3937000,321999,False,28,scaffold_8
10,3999001,4148000,148999,False,28,scaffold_8
11,4206001,4221000,14999,False,28,scaffold_8
12,4396001,4429000,32999,False,28,scaffold_8
13,4729001,4771000,41999,False,28,scaffold_8
14,4901001,4915000,13999,False,28,scaffold_8
15,5088001,5137000,48999,False,28,scaffold_8
16,5167001,5241000,73999,False,28,scaffold_8
17,5579001,5595000,15999,False,28,scaffold_8
18,5651001,5695000,43999,False,28,scaffold_8
19,5750001,5773000,22999,False,28,scaffold_8
20,5776001,5804000,27999,False,28,scaffold_8
21,6071001,6087000,15999,False,28,scaffold_8
22,6266001,6302000,35999,False,28,scaffold_8
23,6319001,6334544,15543,True,28,scaffold_8
0,109001,117000,7999,False,28,scaffold_9
1,121001,138000,16999,False,28,scaffold_9
2,366001,411000,44999,False,28,scaffold_9
3,413001,434000,20999,False,28,scaffold_9
4,500001,531000,30999,False,28,scaffold_9
5,548001,561000,12999,False,28,scaffold_9
6,655001,665000,9999,False,28,scaffold_9
7,671001,697000,25999,False,28,scaffold_9
8,732001,741000,8999,False,28,scaffold_9
9,815001,845000,29999,False,28,scaffold_9
10,873001,986000,112999,False,28,scaffold_9
11,988001,995000,6999,False,28,scaffold_9
12,997001,1000000,2999,False,28,scaffold_9
13,1001001,1007000,5999,False,28,scaffold_9
14,1009001,1085000,75999,False,28,scaffold_9
15,1087001,1150000,62999,False,28,scaffold_9
16,1151001,1160000,8999,False,28,scaffold_9
17,1201001,1230000,28999,False,28,scaffold_9
18,1312001,1383000,70999,False,28,scaffold_9
19,1428001,1440000,11999,False,28,scaffold_9
20,1483001,1499000,15999,False,28,scaffold_9
21,1541001,1585000,43999,False,28,scaffold_9
22,1599001,1624000,24999,False,28,scaffold_9
23,1637001,1693000,55999,False,28,scaffold_9
24,1749001,1791000,41999,False,28,scaffold_9
25,1814001,1853000,38999,False,28,scaffold_9
26,1885001,1911000,25999,False,28,scaffold_9
27,1987001,2059000,71999,False,28,scaffold_9
28,2075001,2135000,59999,False,28,scaffold_9
29,2136001,2171000,34999,False,28,scaffold_9
30,2173001,2286000,112999,False,28,scaffold_9
31,2390001,2441000,50999,False,28,scaffold_9
32,2595001,2640000,44999,False,28,scaffold_9
33,2737001,3381000,643999,False,28,scaffold_9
34,3383001,4617000,1233999,False,28,scaffold_9
35,4618001,5107000,488999,False,28,scaffold_9
36,5112001,5238000,125999,False,28,scaffold_9
37,5239001,5298000,58999,False,28,scaffold_9
38,5300001,5491000,190999,False,28,scaffold_9
39,5493001,6331288,838287,True,28,scaffold_9
0,1,414000,413999,True,28,scaffold_10
1,415001,482000,66999,False,28,scaffold_10
2,483001,576000,92999,False,28,scaffold_10
3,596001,761000,164999,False,28,scaffold_10
4,783001,793000,9999,False,28,scaffold_10
5,888001,921000,32999,False,28,scaffold_10
6,923001,972000,48999,False,28,scaffold_10
7,1056001,1066000,9999,False,28,scaffold_10
8,1087001,1147000,59999,False,28,scaffold_10
9,1387001,1429000,41999,False,28,scaffold_10
10,1430001,1467000,36999,False,28,scaffold_10
11,1635001,1661000,25999,False,28,scaffold_10
12,1697001,1733000,35999,False,28,scaffold_10
13,1863001,1918000,54999,False,28,scaffold_10
14,2079001,2103000,23999,False,28,scaffold_10
15,2138001,2172000,33999,False,28,scaffold_10
16,2197001,2331000,133999,False,28,scaffold_10
17,2334001,2476000,141999,False,28,scaffold_10
18,2521001,2586000,64999,False,28,scaffold_10
19,2600001,2653000,52999,False,28,scaffold_10
20,2673001,2695000,21999,False,28,scaffold_10
21,2714001,2751000,36999,False,28,scaffold_10
22,2754001,2811000,56999,False,28,scaffold_10
23,3154001,3184000,29999,False,28,scaffold_10
24,3559001,3582000,22999,False,28,scaffold_10
25,4054001,4091000,36999,False,28,scaffold_10
26,4154001,4174000,19999,False,28,scaffold_10
27,4335001,4363000,27999,False,28,scaffold_10
28,4443001,4462000,18999,False,28,scaffold_10
29,4503001,4513000,9999,False,28,scaffold_10
30,4527001,4548000,20999,False,28,scaffold_10
31,4554001,4562000,7999,False,28,scaffold_10
32,4574001,4597000,22999,False,28,scaffold_10
33,4681001,4688000,6999,False,28,scaffold_10
34,4716001,4732000,15999,False,28,scaffold_10
35,4734001,4776000,41999,False,28,scaffold_10
36,4798001,4824000,25999,False,28,scaffold_10
37,4827001,4843000,15999,False,28,scaffold_10
38,4848001,4861000,12999,False,28,scaffold_10
39,4865001,4866973,1972,True,28,scaffold_10
0,10001,91000,80999,False,28,scaffold_11
1,148001,167000,18999,False,28,scaffold_11
2,169001,212000,42999,False,28,scaffold_11
3,213001,235000,21999,False,28,scaffold_11
4,240001,252000,11999,False,28,scaffold_11
5,297001,314000,16999,False,28,scaffold_11
6,419001,431000,11999,False,28,scaffold_11
7,649001,656000,6999,False,28,scaffold_11
8,1025001,1034000,8999,False,28,scaffold_11
9,1315001,1343000,27999,False,28,scaffold_11
10,1403001,1409000,5999,False,28,scaffold_11
11,1423001,1426000,2999,False,28,scaffold_11
12,1432001,1447000,14999,False,28,scaffold_11
13,1474001,1478000,3999,False,28,scaffold_11
14,1967001,1999000,31999,False,28,scaffold_11
15,2001001,2007000,5999,False,28,scaffold_11
16,2008001,2058000,49999,False,28,scaffold_11
17,2177001,2224000,46999,False,28,scaffold_11
18,2700001,2895000,194999,False,28,scaffold_11
19,2983001,3020000,36999,False,28,scaffold_11
20,3083001,3383000,299999,False,28,scaffold_11
21,3421001,3479000,57999,False,28,scaffold_11
22,3522001,3657000,134999,False,28,scaffold_11
23,3671001,3972000,300999,False,28,scaffold_11
24,3996001,4160000,163999,False,28,scaffold_11
25,4181001,4710000,528999,False,28,scaffold_11
26,4712001,4766820,54819,True,28,scaffold_11
0,1,1498000,1497999,True,28,scaffold_12
1,1716001,1733000,16999,False,28,scaffold_12
2,1797001,1808000,10999,False,28,scaffold_12
3,1906001,2000000,93999,False,28,scaffold_12
4,2043001,2087000,43999,False,28,scaffold_12
5,2088001,2104000,15999,False,28,scaffold_12
6,2136001,2192000,55999,False,28,scaffold_12
7,2340001,2380000,39999,False,28,scaffold_12
8,2571001,2609000,37999,False,28,scaffold_12
9,2747001,2747968,967,True,28,scaffold_12
0,1,6000,5999,True,29,scaffold_1
1,16001,19000,2999,False,29,scaffold_1
2,27001,33000,5999,False,29,scaffold_1
3,79001,86000,6999,False,29,scaffold_1
4,95001,101000,5999,False,29,scaffold_1
5,103001,112000,8999,False,29,scaffold_1
6,113001,115000,1999,False,29,scaffold_1
7,174001,183000,8999,False,29,scaffold_1
8,191001,193000,1999,False,29,scaffold_1
9,210001,216000,5999,False,29,scaffold_1
10,217001,221000,3999,False,29,scaffold_1
11,222001,227000,4999,False,29,scaffold_1
12,242001,244000,1999,False,29,scaffold_1
13,270001,276000,5999,False,29,scaffold_1
14,311001,314000,2999,False,29,scaffold_1
15,390001,392000,1999,False,29,scaffold_1
16,489001,493000,3999,False,29,scaffold_1
17,536001,542000,5999,False,29,scaffold_1
18,721001,725000,3999,False,29,scaffold_1
19,761001,767000,5999,False,29,scaffold_1
20,1649001,1651000,1999,False,29,scaffold_1
21,1707001,1711000,3999,False,29,scaffold_1
22,1738001,1740000,1999,False,29,scaffold_1
23,1745001,1756000,10999,False,29,scaffold_1
24,1762001,1764000,1999,False,29,scaffold_1
25,1814001,1817000,2999,False,29,scaffold_1
26,1823001,1825000,1999,False,29,scaffold_1
27,1961001,1964000,2999,False,29,scaffold_1
28,2345001,2352000,6999,False,29,scaffold_1
29,2378001,2385000,6999,False,29,scaffold_1
30,2522001,2525000,2999,False,29,scaffold_1
31,2547001,2549000,1999,False,29,scaffold_1
32,2689001,2693000,3999,False,29,scaffold_1
33,2735001,2741000,5999,False,29,scaffold_1
34,2923001,2925000,1999,False,29,scaffold_1
35,3040001,3043000,2999,False,29,scaffold_1
36,3053001,3056000,2999,False,29,scaffold_1
37,3057001,3064000,6999,False,29,scaffold_1
38,3194001,3197000,2999,False,29,scaffold_1
39,3278001,3282000,3999,False,29,scaffold_1
40,3471001,3478000,6999,False,29,scaffold_1
41,3489001,3492000,2999,False,29,scaffold_1
42,3598001,3600000,1999,False,29,scaffold_1
43,3685001,3693000,7999,False,29,scaffold_1
44,3776001,3782000,5999,False,29,scaffold_1
45,3810001,3816000,5999,False,29,scaffold_1
46,3894001,3897000,2999,False,29,scaffold_1
47,3915001,3920000,4999,False,29,scaffold_1
48,4096001,4105000,8999,False,29,scaffold_1
49,4108001,4111000,2999,False,29,scaffold_1
50,4329001,4332000,2999,False,29,scaffold_1
51,4336001,4340000,3999,False,29,scaffold_1
52,4344001,4349000,4999,False,29,scaffold_1
53,4623001,4628000,4999,False,29,scaffold_1
54,5059001,5064000,4999,False,29,scaffold_1
55,5088001,5092000,3999,False,29,scaffold_1
56,5190001,5196000,5999,False,29,scaffold_1
57,5197001,5199000,1999,False,29,scaffold_1
58,6109001,6113000,3999,False,29,scaffold_1
59,6139001,6142000,2999,False,29,scaffold_1
60,6241001,6243000,1999,False,29,scaffold_1
61,6276001,6278000,1999,False,29,scaffold_1
62,6331001,6335000,3999,False,29,scaffold_1
63,6384001,6388000,3999,False,29,scaffold_1
64,6404001,6405000,999,False,29,scaffold_1
65,6438001,6441000,2999,False,29,scaffold_1
66,6666001,6668000,1999,False,29,scaffold_1
67,6691001,6696000,4999,False,29,scaffold_1
68,6756001,6760000,3999,False,29,scaffold_1
69,6792001,6796000,3999,False,29,scaffold_1
70,6880001,6883000,2999,False,29,scaffold_1
71,7086001,7088000,1999,False,29,scaffold_1
72,7124001,7132000,7999,False,29,scaffold_1
73,7136001,7141000,4999,False,29,scaffold_1
74,7151001,7162000,10999,False,29,scaffold_1
75,7167001,7171000,3999,False,29,scaffold_1
76,7199001,7204000,4999,False,29,scaffold_1
77,7217001,7228000,10999,False,29,scaffold_1
78,7231001,7240000,8999,False,29,scaffold_1
79,7333001,7337000,3999,False,29,scaffold_1
80,7341001,7349000,7999,False,29,scaffold_1
81,7351001,7358000,6999,False,29,scaffold_1
82,7406001,7428000,21999,False,29,scaffold_1
83,7431001,7449000,17999,False,29,scaffold_1
84,7555001,7559000,3999,False,29,scaffold_1
85,7578001,7581000,2999,False,29,scaffold_1
86,7686001,7692000,5999,False,29,scaffold_1
87,7702001,7704000,1999,False,29,scaffold_1
88,7786001,7788000,1999,False,29,scaffold_1
89,7881001,7886000,4999,False,29,scaffold_1
90,7891001,7893000,1999,False,29,scaffold_1
91,7914001,7916000,1999,False,29,scaffold_1
92,7923001,7925000,1999,False,29,scaffold_1
93,7964001,7968000,3999,False,29,scaffold_1
94,7974001,7978000,3999,False,29,scaffold_1
95,7988001,8003000,14999,False,29,scaffold_1
96,8018001,8033000,14999,False,29,scaffold_1
97,8133001,8138000,4999,False,29,scaffold_1
98,8173001,8176000,2999,False,29,scaffold_1
99,8183001,8186000,2999,False,29,scaffold_1
100,8194001,8198000,3999,False,29,scaffold_1
101,8221001,8240000,18999,False,29,scaffold_1
102,8291001,8295000,3999,False,29,scaffold_1
103,8333001,8340000,6999,False,29,scaffold_1
104,8368001,8381000,12999,False,29,scaffold_1
105,8432001,8435000,2999,False,29,scaffold_1
106,8665001,8667000,1999,False,29,scaffold_1
107,8811001,8815000,3999,False,29,scaffold_1
108,8861001,8863000,1999,False,29,scaffold_1
109,8864001,8870000,5999,False,29,scaffold_1
110,8884001,8888000,3999,False,29,scaffold_1
111,8949001,8952000,2999,False,29,scaffold_1
112,8983001,8988000,4999,False,29,scaffold_1
113,9027001,9031000,3999,False,29,scaffold_1
114,9055001,9063000,7999,False,29,scaffold_1
115,9091001,9094000,2999,False,29,scaffold_1
116,9199001,9203000,3999,False,29,scaffold_1
117,9244001,9254000,9999,False,29,scaffold_1
118,9348001,9351000,2999,False,29,scaffold_1
119,9395001,9402000,6999,False,29,scaffold_1
120,9436001,9443000,6999,False,29,scaffold_1
121,9485001,9487000,1999,False,29,scaffold_1
122,9488001,9490000,1999,False,29,scaffold_1
123,9508001,9510000,1999,False,29,scaffold_1
124,9611001,9616000,4999,False,29,scaffold_1
125,9618001,9622000,3999,False,29,scaffold_1
126,9723001,9726000,2999,False,29,scaffold_1
127,10003001,10008000,4999,False,29,scaffold_1
128,10051001,10054000,2999,False,29,scaffold_1
129,10119001,10121000,1999,False,29,scaffold_1
130,10141001,10147000,5999,False,29,scaffold_1
131,10230001,10232000,1999,False,29,scaffold_1
132,10244001,10248000,3999,False,29,scaffold_1
133,10252001,10254000,1999,False,29,scaffold_1
134,10259001,10267000,7999,False,29,scaffold_1
135,10272001,10274000,1999,False,29,scaffold_1
136,10291001,10307000,15999,False,29,scaffold_1
137,10605001,10607000,1999,False,29,scaffold_1
138,10916001,10919000,2999,False,29,scaffold_1
139,10922001,10929000,6999,False,29,scaffold_1
140,11201001,11210000,8999,False,29,scaffold_1
141,11333001,11336000,2999,False,29,scaffold_1
142,11422001,11425000,2999,False,29,scaffold_1
143,11660001,11663000,2999,False,29,scaffold_1
144,11722001,11725000,2999,False,29,scaffold_1
145,11743001,11745000,1999,False,29,scaffold_1
146,11802001,11805000,2999,False,29,scaffold_1
147,11834001,11835000,999,False,29,scaffold_1
148,11891001,11897000,5999,False,29,scaffold_1
149,11931001,11935000,3999,False,29,scaffold_1
150,11958001,11962000,3999,False,29,scaffold_1
151,12191001,12199000,7999,False,29,scaffold_1
152,12441001,12445000,3999,False,29,scaffold_1
153,12624001,12630000,5999,False,29,scaffold_1
154,12709001,12712000,2999,False,29,scaffold_1
155,12732001,12736000,3999,False,29,scaffold_1
156,12752001,12755000,2999,False,29,scaffold_1
157,12983001,12988000,4999,False,29,scaffold_1
158,12996001,13001000,4999,False,29,scaffold_1
159,13061001,13068000,6999,False,29,scaffold_1
160,13127001,13130000,2999,False,29,scaffold_1
161,13142001,13144000,1999,False,29,scaffold_1
162,13205001,13210000,4999,False,29,scaffold_1
163,13355001,13357000,1999,False,29,scaffold_1
164,13364001,13366000,1999,False,29,scaffold_1
165,13804001,13829000,24999,False,29,scaffold_1
166,13830001,13845000,14999,False,29,scaffold_1
167,13959001,13975000,15999,False,29,scaffold_1
168,14385001,14392000,6999,False,29,scaffold_1
169,14396001,14402000,5999,False,29,scaffold_1
170,14471001,14479000,7999,False,29,scaffold_1
171,14541001,14559000,17999,False,29,scaffold_1
172,14672001,14674000,1999,False,29,scaffold_1
173,14740001,14756000,15999,False,29,scaffold_1
0,51001,55000,3999,False,29,scaffold_2
1,107001,112000,4999,False,29,scaffold_2
2,138001,142000,3999,False,29,scaffold_2
3,165001,177000,11999,False,29,scaffold_2
4,302001,316000,13999,False,29,scaffold_2
5,342001,348000,5999,False,29,scaffold_2
6,566001,571000,4999,False,29,scaffold_2
7,573001,576000,2999,False,29,scaffold_2
8,606001,608000,1999,False,29,scaffold_2
9,659001,663000,3999,False,29,scaffold_2
10,848001,852000,3999,False,29,scaffold_2
11,918001,922000,3999,False,29,scaffold_2
12,1122001,1127000,4999,False,29,scaffold_2
13,1198001,1202000,3999,False,29,scaffold_2
14,1266001,1274000,7999,False,29,scaffold_2
15,1356001,1378000,21999,False,29,scaffold_2
16,1379001,1385000,5999,False,29,scaffold_2
17,1462001,1475000,12999,False,29,scaffold_2
18,1537001,1556000,18999,False,29,scaffold_2
19,1693001,1705000,11999,False,29,scaffold_2
20,1708001,1712000,3999,False,29,scaffold_2
21,1890001,1896000,5999,False,29,scaffold_2
22,2178001,2180000,1999,False,29,scaffold_2
23,2317001,2319000,1999,False,29,scaffold_2
24,2413001,2417000,3999,False,29,scaffold_2
25,2478001,2482000,3999,False,29,scaffold_2
26,2484001,2487000,2999,False,29,scaffold_2
27,2603001,2608000,4999,False,29,scaffold_2
28,2697001,2699000,1999,False,29,scaffold_2
29,2868001,2871000,2999,False,29,scaffold_2
30,2879001,2884000,4999,False,29,scaffold_2
31,3195001,3198000,2999,False,29,scaffold_2
32,3330001,3332000,1999,False,29,scaffold_2
33,3756001,3758000,1999,False,29,scaffold_2
34,3793001,3797000,3999,False,29,scaffold_2
35,3951001,3957000,5999,False,29,scaffold_2
36,4092001,4096000,3999,False,29,scaffold_2
37,4242001,4245000,2999,False,29,scaffold_2
38,4511001,4523000,11999,False,29,scaffold_2
39,4530001,4533000,2999,False,29,scaffold_2
40,4666001,4670000,3999,False,29,scaffold_2
41,4755001,4759000,3999,False,29,scaffold_2
42,4783001,4787000,3999,False,29,scaffold_2
43,4794001,4796000,1999,False,29,scaffold_2
44,4880001,4882000,1999,False,29,scaffold_2
45,4893001,4896000,2999,False,29,scaffold_2
46,4982001,4986000,3999,False,29,scaffold_2
47,5102001,5104000,1999,False,29,scaffold_2
48,5155001,5158000,2999,False,29,scaffold_2
49,5265001,5269000,3999,False,29,scaffold_2
50,5721001,5723000,1999,False,29,scaffold_2
51,6261001,6263000,1999,False,29,scaffold_2
52,6267001,6272000,4999,False,29,scaffold_2
53,6317001,6325000,7999,False,29,scaffold_2
54,6326001,6330000,3999,False,29,scaffold_2
55,6403001,6406000,2999,False,29,scaffold_2
56,6576001,6579000,2999,False,29,scaffold_2
57,6667001,6669000,1999,False,29,scaffold_2
58,6731001,6732000,999,False,29,scaffold_2
59,6832001,6835000,2999,False,29,scaffold_2
60,6954001,6957000,2999,False,29,scaffold_2
61,7453001,7457000,3999,False,29,scaffold_2
62,7491001,7494000,2999,False,29,scaffold_2
63,7572001,7575000,2999,False,29,scaffold_2
64,7780001,7790000,9999,False,29,scaffold_2
65,7822001,7830000,7999,False,29,scaffold_2
66,7911001,7916000,4999,False,29,scaffold_2
67,7937001,7940000,2999,False,29,scaffold_2
68,7947001,7955000,7999,False,29,scaffold_2
69,7958001,7962000,3999,False,29,scaffold_2
70,7965001,7972000,6999,False,29,scaffold_2
71,8023001,8025000,1999,False,29,scaffold_2
72,8269001,8272000,2999,False,29,scaffold_2
73,8274001,8284000,9999,False,29,scaffold_2
74,8331001,8333000,1999,False,29,scaffold_2
75,8690001,8693000,2999,False,29,scaffold_2
76,9048001,9050000,1999,False,29,scaffold_2
77,9085001,9088000,2999,False,29,scaffold_2
78,9193001,9196000,2999,False,29,scaffold_2
79,9203001,9207000,3999,False,29,scaffold_2
80,9327001,9333000,5999,False,29,scaffold_2
81,9500001,9502000,1999,False,29,scaffold_2
82,9617001,9620000,2999,False,29,scaffold_2
83,10188001,10191000,2999,False,29,scaffold_2
84,10298001,10301000,2999,False,29,scaffold_2
85,10488001,10492000,3999,False,29,scaffold_2
86,10757001,10766000,8999,False,29,scaffold_2
87,10948001,10950000,1999,False,29,scaffold_2
88,10959001,10962000,2999,False,29,scaffold_2
89,11354001,11357000,2999,False,29,scaffold_2
90,11566001,11570000,3999,False,29,scaffold_2
91,11576001,11580000,3999,False,29,scaffold_2
92,11634001,11637000,2999,False,29,scaffold_2
93,11647001,11649000,1999,False,29,scaffold_2
94,11697001,11709000,11999,False,29,scaffold_2
95,11720001,11722000,1999,False,29,scaffold_2
96,11781001,11785000,3999,False,29,scaffold_2
97,11800001,11802476,2475,True,29,scaffold_2
0,101001,104000,2999,False,29,scaffold_3
1,158001,160000,1999,False,29,scaffold_3
2,218001,228000,9999,False,29,scaffold_3
3,256001,260000,3999,False,29,scaffold_3
4,644001,646000,1999,False,29,scaffold_3
5,795001,802000,6999,False,29,scaffold_3
6,816001,820000,3999,False,29,scaffold_3
7,843001,845000,1999,False,29,scaffold_3
8,874001,881000,6999,False,29,scaffold_3
9,891001,895000,3999,False,29,scaffold_3
10,898001,900000,1999,False,29,scaffold_3
11,989001,993000,3999,False,29,scaffold_3
12,1241001,1244000,2999,False,29,scaffold_3
13,1258001,1261000,2999,False,29,scaffold_3
14,1276001,1280000,3999,False,29,scaffold_3
15,1282001,1285000,2999,False,29,scaffold_3
16,1308001,1311000,2999,False,29,scaffold_3
17,1326001,1332000,5999,False,29,scaffold_3
18,1485001,1487000,1999,False,29,scaffold_3
19,1488001,1491000,2999,False,29,scaffold_3
20,1548001,1556000,7999,False,29,scaffold_3
21,1562001,1564000,1999,False,29,scaffold_3
22,1584001,1587000,2999,False,29,scaffold_3
23,1599001,1602000,2999,False,29,scaffold_3
24,1612001,1621000,8999,False,29,scaffold_3
25,1660001,1664000,3999,False,29,scaffold_3
26,1667001,1672000,4999,False,29,scaffold_3
27,1692001,1694000,1999,False,29,scaffold_3
28,1732001,1735000,2999,False,29,scaffold_3
29,1804001,1808000,3999,False,29,scaffold_3
30,1852001,1860000,7999,False,29,scaffold_3
31,1987001,1989000,1999,False,29,scaffold_3
32,2043001,2045000,1999,False,29,scaffold_3
33,2069001,2072000,2999,False,29,scaffold_3
34,2081001,2100000,18999,False,29,scaffold_3
35,2101001,2108000,6999,False,29,scaffold_3
36,2164001,2169000,4999,False,29,scaffold_3
37,2323001,2327000,3999,False,29,scaffold_3
38,2350001,2352000,1999,False,29,scaffold_3
39,2488001,2497000,8999,False,29,scaffold_3
40,2522001,2526000,3999,False,29,scaffold_3
41,2529001,2533000,3999,False,29,scaffold_3
42,2578001,2585000,6999,False,29,scaffold_3
43,2672001,2706000,33999,False,29,scaffold_3
44,2758001,2760000,1999,False,29,scaffold_3
45,2899001,2901000,1999,False,29,scaffold_3
46,3227001,3263000,35999,False,29,scaffold_3
47,3423001,3426000,2999,False,29,scaffold_3
48,3697001,3700000,2999,False,29,scaffold_3
49,3712001,3715000,2999,False,29,scaffold_3
50,3822001,3824000,1999,False,29,scaffold_3
51,3886001,3891000,4999,False,29,scaffold_3
52,4148001,4159000,10999,False,29,scaffold_3
53,4200001,4204000,3999,False,29,scaffold_3
54,4258001,4260000,1999,False,29,scaffold_3
55,4311001,4320000,8999,False,29,scaffold_3
56,4333001,4338000,4999,False,29,scaffold_3
57,4354001,4358000,3999,False,29,scaffold_3
58,4382001,4392000,9999,False,29,scaffold_3
59,5123001,5125000,1999,False,29,scaffold_3
60,5198001,5200000,1999,False,29,scaffold_3
61,5310001,5317000,6999,False,29,scaffold_3
62,5489001,5508000,18999,False,29,scaffold_3
63,5512001,5515000,2999,False,29,scaffold_3
64,5516001,5523000,6999,False,29,scaffold_3
65,5530001,5535000,4999,False,29,scaffold_3
66,5590001,5596000,5999,False,29,scaffold_3
67,5743001,5746000,2999,False,29,scaffold_3
68,5770001,5773000,2999,False,29,scaffold_3
69,5964001,5971000,6999,False,29,scaffold_3
70,6022001,6025000,2999,False,29,scaffold_3
71,6083001,6085000,1999,False,29,scaffold_3
72,6091001,6094000,2999,False,29,scaffold_3
73,6226001,6229000,2999,False,29,scaffold_3
74,6230001,6232000,1999,False,29,scaffold_3
75,6262001,6264000,1999,False,29,scaffold_3
76,6677001,6681000,3999,False,29,scaffold_3
77,6812001,6816000,3999,False,29,scaffold_3
78,6914001,6919000,4999,False,29,scaffold_3
79,6968001,6974000,5999,False,29,scaffold_3
80,7154001,7157000,2999,False,29,scaffold_3
81,7212001,7216000,3999,False,29,scaffold_3
82,7231001,7234000,2999,False,29,scaffold_3
83,7289001,7301000,11999,False,29,scaffold_3
84,7487001,7493000,5999,False,29,scaffold_3
85,7837001,7842000,4999,False,29,scaffold_3
86,8068001,8071000,2999,False,29,scaffold_3
87,8134001,8136000,1999,False,29,scaffold_3
88,8142001,8147000,4999,False,29,scaffold_3
89,8175001,8177000,1999,False,29,scaffold_3
90,8222001,8230000,7999,False,29,scaffold_3
91,8312001,8321000,8999,False,29,scaffold_3
92,8475001,8478000,2999,False,29,scaffold_3
93,8492001,8495000,2999,False,29,scaffold_3
94,8582001,8590000,7999,False,29,scaffold_3
95,8593001,8596000,2999,False,29,scaffold_3
96,8767001,8771000,3999,False,29,scaffold_3
97,8833001,8836000,2999,False,29,scaffold_3
98,8952001,8958000,5999,False,29,scaffold_3
99,9057001,9063000,5999,False,29,scaffold_3
100,9197001,9203000,5999,False,29,scaffold_3
101,9206001,9210000,3999,False,29,scaffold_3
102,9289001,9294000,4999,False,29,scaffold_3
103,9862001,9868000,5999,False,29,scaffold_3
104,9919001,9921000,1999,False,29,scaffold_3
105,9934001,9938000,3999,False,29,scaffold_3
106,9975001,9981000,5999,False,29,scaffold_3
107,10535001,10537000,1999,False,29,scaffold_3
108,10596001,10599000,2999,False,29,scaffold_3
109,10674001,10677000,2999,False,29,scaffold_3
110,10887001,10890000,2999,False,29,scaffold_3
111,10896001,10898000,1999,False,29,scaffold_3
112,10923001,10930000,6999,False,29,scaffold_3
113,10933001,10936000,2999,False,29,scaffold_3
114,11001001,11004000,2999,False,29,scaffold_3
115,11050001,11052000,1999,False,29,scaffold_3
116,11054001,11057000,2999,False,29,scaffold_3
117,11125001,11130000,4999,False,29,scaffold_3
118,11146001,11150000,3999,False,29,scaffold_3
119,11162001,11168000,5999,False,29,scaffold_3
120,11180001,11182071,2070,True,29,scaffold_3
0,1,4000,3999,True,29,scaffold_4
1,11001,13000,1999,False,29,scaffold_4
2,25001,28000,2999,False,29,scaffold_4
3,30001,32000,1999,False,29,scaffold_4
4,50001,69000,18999,False,29,scaffold_4
5,110001,115000,4999,False,29,scaffold_4
6,138001,151000,12999,False,29,scaffold_4
7,155001,160000,4999,False,29,scaffold_4
8,161001,169000,7999,False,29,scaffold_4
9,175001,181000,5999,False,29,scaffold_4
10,217001,226000,8999,False,29,scaffold_4
11,248001,252000,3999,False,29,scaffold_4
12,355001,364000,8999,False,29,scaffold_4
13,366001,374000,7999,False,29,scaffold_4
14,375001,380000,4999,False,29,scaffold_4
15,383001,398000,14999,False,29,scaffold_4
16,416001,425000,8999,False,29,scaffold_4
17,485001,504000,18999,False,29,scaffold_4
18,526001,531000,4999,False,29,scaffold_4
19,583001,592000,8999,False,29,scaffold_4
20,593001,599000,5999,False,29,scaffold_4
21,614001,617000,2999,False,29,scaffold_4
22,653001,658000,4999,False,29,scaffold_4
23,695001,697000,1999,False,29,scaffold_4
24,889001,892000,2999,False,29,scaffold_4
25,1149001,1152000,2999,False,29,scaffold_4
26,1154001,1186000,31999,False,29,scaffold_4
27,1187001,1190000,2999,False,29,scaffold_4
28,1223001,1226000,2999,False,29,scaffold_4
29,1265001,1274000,8999,False,29,scaffold_4
30,1283001,1291000,7999,False,29,scaffold_4
31,1293001,1304000,10999,False,29,scaffold_4
32,1340001,1357000,16999,False,29,scaffold_4
33,1377001,1391000,13999,False,29,scaffold_4
34,1533001,1540000,6999,False,29,scaffold_4
35,1586001,1588000,1999,False,29,scaffold_4
36,1590001,1601000,10999,False,29,scaffold_4
37,1652001,1673000,20999,False,29,scaffold_4
38,1681001,1694000,12999,False,29,scaffold_4
39,1741001,1776000,34999,False,29,scaffold_4
40,1785001,1789000,3999,False,29,scaffold_4
41,1810001,1850000,39999,False,29,scaffold_4
42,1856001,1887000,30999,False,29,scaffold_4
43,1888001,1902000,13999,False,29,scaffold_4
44,1904001,1932000,27999,False,29,scaffold_4
45,1952001,1966000,13999,False,29,scaffold_4
46,1985001,2004000,18999,False,29,scaffold_4
47,2005001,2060000,54999,False,29,scaffold_4
48,2061001,2097000,35999,False,29,scaffold_4
49,2148001,2159000,10999,False,29,scaffold_4
50,2161001,2170000,8999,False,29,scaffold_4
51,2171001,2185000,13999,False,29,scaffold_4
52,2207001,2242000,34999,False,29,scaffold_4
53,2282001,2284000,1999,False,29,scaffold_4
54,2285001,2291000,5999,False,29,scaffold_4
55,2292001,2298000,5999,False,29,scaffold_4
56,2300001,2322000,21999,False,29,scaffold_4
57,2323001,2340000,16999,False,29,scaffold_4
58,2343001,2350000,6999,False,29,scaffold_4
59,2360001,2379000,18999,False,29,scaffold_4
60,2392001,2400000,7999,False,29,scaffold_4
61,2405001,2412000,6999,False,29,scaffold_4
62,2414001,2421000,6999,False,29,scaffold_4
63,2445001,2459000,13999,False,29,scaffold_4
64,2480001,2487000,6999,False,29,scaffold_4
65,2496001,2504000,7999,False,29,scaffold_4
66,2514001,2520000,5999,False,29,scaffold_4
67,2527001,2559000,31999,False,29,scaffold_4
68,2569001,2572000,2999,False,29,scaffold_4
69,2687001,2726000,38999,False,29,scaffold_4
70,2767001,2773000,5999,False,29,scaffold_4
71,2868001,2870000,1999,False,29,scaffold_4
72,2877001,2883000,5999,False,29,scaffold_4
73,3293001,3300000,6999,False,29,scaffold_4
74,3303001,3309000,5999,False,29,scaffold_4
75,3387001,3390000,2999,False,29,scaffold_4
76,3406001,3411000,4999,False,29,scaffold_4
77,3525001,3531000,5999,False,29,scaffold_4
78,3534001,3537000,2999,False,29,scaffold_4
79,3631001,3634000,2999,False,29,scaffold_4
80,3682001,3685000,2999,False,29,scaffold_4
81,3732001,3739000,6999,False,29,scaffold_4
82,4276001,4284000,7999,False,29,scaffold_4
83,4287001,4294000,6999,False,29,scaffold_4
84,4361001,4363000,1999,False,29,scaffold_4
85,4687001,4690000,2999,False,29,scaffold_4
86,5503001,5506000,2999,False,29,scaffold_4
87,5612001,5620000,7999,False,29,scaffold_4
88,5786001,5788000,1999,False,29,scaffold_4
89,6104001,6108000,3999,False,29,scaffold_4
90,6192001,6194000,1999,False,29,scaffold_4
91,6293001,6298000,4999,False,29,scaffold_4
92,6820001,6823000,2999,False,29,scaffold_4
93,6836001,6843000,6999,False,29,scaffold_4
94,6893001,6894000,999,False,29,scaffold_4
95,6905001,6913000,7999,False,29,scaffold_4
96,6985001,6990000,4999,False,29,scaffold_4
97,7040001,7044000,3999,False,29,scaffold_4
98,7071001,7074000,2999,False,29,scaffold_4
99,7089001,7091000,1999,False,29,scaffold_4
100,7147001,7164000,16999,False,29,scaffold_4
101,7388001,7399000,10999,False,29,scaffold_4
102,7643001,7646000,2999,False,29,scaffold_4
103,7736001,7739000,2999,False,29,scaffold_4
104,8212001,8216000,3999,False,29,scaffold_4
105,8447001,8450000,2999,False,29,scaffold_4
106,8875001,8877000,1999,False,29,scaffold_4
107,9045001,9048000,2999,False,29,scaffold_4
108,9057001,9059000,1999,False,29,scaffold_4
109,9063001,9071000,7999,False,29,scaffold_4
110,9150001,9153000,2999,False,29,scaffold_4
111,9219001,9222000,2999,False,29,scaffold_4
112,9247001,9250000,2999,False,29,scaffold_4
113,9274001,9276000,1999,False,29,scaffold_4
114,9282001,9286000,3999,False,29,scaffold_4
115,9312001,9316000,3999,False,29,scaffold_4
116,9321001,9323000,1999,False,29,scaffold_4
117,9370001,9373000,2999,False,29,scaffold_4
118,9382001,9384000,1999,False,29,scaffold_4
119,9441001,9444000,2999,False,29,scaffold_4
120,9490001,9492000,1999,False,29,scaffold_4
121,9496001,9499000,2999,False,29,scaffold_4
122,9509001,9512000,2999,False,29,scaffold_4
123,9515001,9519000,3999,False,29,scaffold_4
124,9537001,9541000,3999,False,29,scaffold_4
125,9594001,9596000,1999,False,29,scaffold_4
126,9633001,9636000,2999,False,29,scaffold_4
127,9657001,9662000,4999,False,29,scaffold_4
128,9728001,9730000,1999,False,29,scaffold_4
129,9782001,9786000,3999,False,29,scaffold_4
0,170001,173000,2999,False,29,scaffold_5
1,318001,322000,3999,False,29,scaffold_5
2,360001,363000,2999,False,29,scaffold_5
3,381001,392000,10999,False,29,scaffold_5
4,513001,516000,2999,False,29,scaffold_5
5,670001,675000,4999,False,29,scaffold_5
6,681001,687000,5999,False,29,scaffold_5
7,836001,842000,5999,False,29,scaffold_5
8,873001,877000,3999,False,29,scaffold_5
9,927001,929000,1999,False,29,scaffold_5
10,1294001,1298000,3999,False,29,scaffold_5
11,1302001,1305000,2999,False,29,scaffold_5
12,1318001,1322000,3999,False,29,scaffold_5
13,1499001,1501000,1999,False,29,scaffold_5
14,1627001,1631000,3999,False,29,scaffold_5
15,1841001,1849000,7999,False,29,scaffold_5
16,2384001,2387000,2999,False,29,scaffold_5
17,2544001,2547000,2999,False,29,scaffold_5
18,2570001,2575000,4999,False,29,scaffold_5
19,2598001,2600000,1999,False,29,scaffold_5
20,2653001,2656000,2999,False,29,scaffold_5
21,2828001,2837000,8999,False,29,scaffold_5
22,2849001,2853000,3999,False,29,scaffold_5
23,2895001,2903000,7999,False,29,scaffold_5
24,3062001,3065000,2999,False,29,scaffold_5
25,3208001,3211000,2999,False,29,scaffold_5
26,3243001,3247000,3999,False,29,scaffold_5
27,3484001,3487000,2999,False,29,scaffold_5
28,3488001,3493000,4999,False,29,scaffold_5
29,3679001,3681000,1999,False,29,scaffold_5
30,3797001,3799000,1999,False,29,scaffold_5
31,3808001,3811000,2999,False,29,scaffold_5
32,3964001,3970000,5999,False,29,scaffold_5
33,4017001,4020000,2999,False,29,scaffold_5
34,4021001,4023000,1999,False,29,scaffold_5
35,4083001,4085000,1999,False,29,scaffold_5
36,4135001,4137000,1999,False,29,scaffold_5
37,4145001,4149000,3999,False,29,scaffold_5
38,4192001,4195000,2999,False,29,scaffold_5
39,4197001,4199000,1999,False,29,scaffold_5
40,4406001,4410000,3999,False,29,scaffold_5
41,4456001,4471000,14999,False,29,scaffold_5
42,4733001,4749000,15999,False,29,scaffold_5
43,4797001,4800000,2999,False,29,scaffold_5
44,4820001,4828000,7999,False,29,scaffold_5
45,6492001,6496000,3999,False,29,scaffold_5
46,6717001,6720000,2999,False,29,scaffold_5
47,6825001,6832000,6999,False,29,scaffold_5
48,6843001,6853000,9999,False,29,scaffold_5
49,6940001,6943000,2999,False,29,scaffold_5
50,7118001,7121000,2999,False,29,scaffold_5
51,7634001,7643000,8999,False,29,scaffold_5
52,7676001,7690000,13999,False,29,scaffold_5
53,7780001,7784000,3999,False,29,scaffold_5
54,7979001,7983000,3999,False,29,scaffold_5
55,8322001,8324000,1999,False,29,scaffold_5
56,8610001,8616000,5999,False,29,scaffold_5
57,8667001,8684000,16999,False,29,scaffold_5
58,8686001,8689000,2999,False,29,scaffold_5
59,8801001,8811000,9999,False,29,scaffold_5
60,8814001,8817000,2999,False,29,scaffold_5
61,8820001,8845000,24999,False,29,scaffold_5
62,8920001,8922000,1999,False,29,scaffold_5
63,8924001,8932000,7999,False,29,scaffold_5
64,9034001,9036000,1999,False,29,scaffold_5
65,9058001,9060000,1999,False,29,scaffold_5
66,9095001,9098000,2999,False,29,scaffold_5
67,9131001,9137000,5999,False,29,scaffold_5
68,9150001,9154000,3999,False,29,scaffold_5
69,9171001,9176000,4999,False,29,scaffold_5
70,9219001,9221000,1999,False,29,scaffold_5
71,9258001,9260000,1999,False,29,scaffold_5
72,9272001,9275000,2999,False,29,scaffold_5
73,9277001,9279000,1999,False,29,scaffold_5
74,9292001,9299000,6999,False,29,scaffold_5
75,9302001,9307000,4999,False,29,scaffold_5
76,9321001,9323000,1999,False,29,scaffold_5
77,9332001,9340000,7999,False,29,scaffold_5
0,80001,84000,3999,False,29,scaffold_6
1,87001,96000,8999,False,29,scaffold_6
2,99001,113000,13999,False,29,scaffold_6
3,183001,186000,2999,False,29,scaffold_6
4,235001,237000,1999,False,29,scaffold_6
5,352001,358000,5999,False,29,scaffold_6
6,416001,426000,9999,False,29,scaffold_6
7,428001,432000,3999,False,29,scaffold_6
8,524001,530000,5999,False,29,scaffold_6
9,555001,559000,3999,False,29,scaffold_6
10,605001,608000,2999,False,29,scaffold_6
11,708001,714000,5999,False,29,scaffold_6
12,838001,848000,9999,False,29,scaffold_6
13,1028001,1039000,10999,False,29,scaffold_6
14,1150001,1161000,10999,False,29,scaffold_6
15,1164001,1174000,9999,False,29,scaffold_6
16,1179001,1198000,18999,False,29,scaffold_6
17,1242001,1249000,6999,False,29,scaffold_6
18,1339001,1342000,2999,False,29,scaffold_6
19,1355001,1357000,1999,False,29,scaffold_6
20,1422001,1424000,1999,False,29,scaffold_6
21,1491001,1494000,2999,False,29,scaffold_6
22,1516001,1519000,2999,False,29,scaffold_6
23,1619001,1630000,10999,False,29,scaffold_6
24,1649001,1652000,2999,False,29,scaffold_6
25,1697001,1701000,3999,False,29,scaffold_6
26,1843001,1851000,7999,False,29,scaffold_6
27,2046001,2050000,3999,False,29,scaffold_6
28,2058001,2062000,3999,False,29,scaffold_6
29,2074001,2079000,4999,False,29,scaffold_6
30,2092001,2099000,6999,False,29,scaffold_6
31,2339001,2352000,12999,False,29,scaffold_6
32,2375001,2380000,4999,False,29,scaffold_6
33,2390001,2392000,1999,False,29,scaffold_6
34,2414001,2433000,18999,False,29,scaffold_6
35,2455001,2474000,18999,False,29,scaffold_6
36,2476001,2483000,6999,False,29,scaffold_6
37,2485001,2492000,6999,False,29,scaffold_6
38,2584001,2592000,7999,False,29,scaffold_6
39,2672001,2675000,2999,False,29,scaffold_6
40,2739001,2741000,1999,False,29,scaffold_6
41,2783001,2787000,3999,False,29,scaffold_6
42,2954001,2962000,7999,False,29,scaffold_6
43,3132001,3134000,1999,False,29,scaffold_6
44,3295001,3301000,5999,False,29,scaffold_6
45,3417001,3418000,999,False,29,scaffold_6
46,3477001,3479000,1999,False,29,scaffold_6
47,3605001,3607000,1999,False,29,scaffold_6
48,3616001,3624000,7999,False,29,scaffold_6
49,3628001,3631000,2999,False,29,scaffold_6
50,3790001,3793000,2999,False,29,scaffold_6
51,3810001,3813000,2999,False,29,scaffold_6
52,3919001,3923000,3999,False,29,scaffold_6
53,4190001,4194000,3999,False,29,scaffold_6
54,4237001,4239000,1999,False,29,scaffold_6
55,4712001,4727000,14999,False,29,scaffold_6
56,4794001,4796000,1999,False,29,scaffold_6
57,4839001,4860000,20999,False,29,scaffold_6
58,4981001,4991000,9999,False,29,scaffold_6
59,5021001,5025000,3999,False,29,scaffold_6
60,5177001,5182000,4999,False,29,scaffold_6
61,5310001,5312000,1999,False,29,scaffold_6
62,5422001,5424000,1999,False,29,scaffold_6
63,5492001,5496000,3999,False,29,scaffold_6
64,5619001,5623000,3999,False,29,scaffold_6
65,5724001,5728000,3999,False,29,scaffold_6
66,5730001,5733000,2999,False,29,scaffold_6
67,5739001,5743000,3999,False,29,scaffold_6
68,5791001,5794000,2999,False,29,scaffold_6
69,5811001,5813000,1999,False,29,scaffold_6
70,5823001,5825000,1999,False,29,scaffold_6
71,5918001,5923000,4999,False,29,scaffold_6
72,6113001,6115000,1999,False,29,scaffold_6
73,6253001,6257000,3999,False,29,scaffold_6
74,6344001,6347000,2999,False,29,scaffold_6
75,6353001,6358000,4999,False,29,scaffold_6
76,7034001,7037000,2999,False,29,scaffold_6
77,7074001,7078000,3999,False,29,scaffold_6
78,7246001,7248000,1999,False,29,scaffold_6
79,7341001,7343000,1999,False,29,scaffold_6
80,7463001,7466000,2999,False,29,scaffold_6
81,7513001,7520000,6999,False,29,scaffold_6
82,7569001,7572000,2999,False,29,scaffold_6
83,7620001,7622000,1999,False,29,scaffold_6
84,7662001,7664000,1999,False,29,scaffold_6
85,7693001,7698000,4999,False,29,scaffold_6
86,7705001,7709000,3999,False,29,scaffold_6
87,7712001,7714000,1999,False,29,scaffold_6
88,7824001,7826000,1999,False,29,scaffold_6
89,7864001,7867000,2999,False,29,scaffold_6
90,7879001,7881000,1999,False,29,scaffold_6
91,7923001,7925000,1999,False,29,scaffold_6
92,7926001,7930000,3999,False,29,scaffold_6
93,7961001,7964000,2999,False,29,scaffold_6
94,7967001,7969000,1999,False,29,scaffold_6
95,8074001,8079000,4999,False,29,scaffold_6
96,8095001,8098000,2999,False,29,scaffold_6
97,8105001,8108000,2999,False,29,scaffold_6
98,8109001,8112000,2999,False,29,scaffold_6
99,8223001,8228000,4999,False,29,scaffold_6
100,8261001,8268281,7280,True,29,scaffold_6
0,13001,15000,1999,False,29,scaffold_7
1,21001,34000,12999,False,29,scaffold_7
2,65001,68000,2999,False,29,scaffold_7
3,337001,340000,2999,False,29,scaffold_7
4,345001,348000,2999,False,29,scaffold_7
5,383001,408000,24999,False,29,scaffold_7
6,410001,412000,1999,False,29,scaffold_7
7,427001,430000,2999,False,29,scaffold_7
8,433001,436000,2999,False,29,scaffold_7
9,442001,449000,6999,False,29,scaffold_7
10,486001,510000,23999,False,29,scaffold_7
11,572001,576000,3999,False,29,scaffold_7
12,628001,633000,4999,False,29,scaffold_7
13,652001,661000,8999,False,29,scaffold_7
14,711001,713000,1999,False,29,scaffold_7
15,715001,718000,2999,False,29,scaffold_7
16,721001,735000,13999,False,29,scaffold_7
17,741001,753000,11999,False,29,scaffold_7
18,777001,781000,3999,False,29,scaffold_7
19,802001,816000,13999,False,29,scaffold_7
20,818001,822000,3999,False,29,scaffold_7
21,830001,843000,12999,False,29,scaffold_7
22,858001,864000,5999,False,29,scaffold_7
23,880001,884000,3999,False,29,scaffold_7
24,949001,958000,8999,False,29,scaffold_7
25,999001,1026000,26999,False,29,scaffold_7
26,1032001,1036000,3999,False,29,scaffold_7
27,1075001,1090000,14999,False,29,scaffold_7
28,1173001,1179000,5999,False,29,scaffold_7
29,1183001,1187000,3999,False,29,scaffold_7
30,1192001,1209000,16999,False,29,scaffold_7
31,1218001,1221000,2999,False,29,scaffold_7
32,1253001,1259000,5999,False,29,scaffold_7
33,1277001,1282000,4999,False,29,scaffold_7
34,1374001,1394000,19999,False,29,scaffold_7
35,1440001,1442000,1999,False,29,scaffold_7
36,1443001,1449000,5999,False,29,scaffold_7
37,1462001,1468000,5999,False,29,scaffold_7
38,1482001,1486000,3999,False,29,scaffold_7
39,1487001,1496000,8999,False,29,scaffold_7
40,1760001,1768000,7999,False,29,scaffold_7
41,1770001,1782000,11999,False,29,scaffold_7
42,1824001,1828000,3999,False,29,scaffold_7
43,1863001,1867000,3999,False,29,scaffold_7
44,2043001,2046000,2999,False,29,scaffold_7
45,2147001,2150000,2999,False,29,scaffold_7
46,2500001,2502000,1999,False,29,scaffold_7
47,2591001,2593000,1999,False,29,scaffold_7
48,2614001,2621000,6999,False,29,scaffold_7
49,2679001,2691000,11999,False,29,scaffold_7
50,2753001,2756000,2999,False,29,scaffold_7
51,2793001,2795000,1999,False,29,scaffold_7
52,2830001,2838000,7999,False,29,scaffold_7
53,2839001,2842000,2999,False,29,scaffold_7
54,3007001,3014000,6999,False,29,scaffold_7
55,3017001,3019000,1999,False,29,scaffold_7
56,3079001,3081000,1999,False,29,scaffold_7
57,3260001,3271000,10999,False,29,scaffold_7
58,3366001,3368000,1999,False,29,scaffold_7
59,3560001,3562000,1999,False,29,scaffold_7
60,3596001,3600000,3999,False,29,scaffold_7
61,3637001,3641000,3999,False,29,scaffold_7
62,3913001,3916000,2999,False,29,scaffold_7
63,3960001,3963000,2999,False,29,scaffold_7
64,3972001,3974000,1999,False,29,scaffold_7
65,4028001,4040000,11999,False,29,scaffold_7
66,4298001,4302000,3999,False,29,scaffold_7
67,4415001,4418000,2999,False,29,scaffold_7
68,5006001,5009000,2999,False,29,scaffold_7
69,5137001,5139000,1999,False,29,scaffold_7
70,5423001,5426000,2999,False,29,scaffold_7
71,5473001,5475000,1999,False,29,scaffold_7
72,5499001,5504000,4999,False,29,scaffold_7
73,5512001,5515000,2999,False,29,scaffold_7
74,5520001,5522000,1999,False,29,scaffold_7
75,5793001,5799000,5999,False,29,scaffold_7
76,5805001,5808000,2999,False,29,scaffold_7
77,6066001,6074000,7999,False,29,scaffold_7
78,6471001,6477000,5999,False,29,scaffold_7
79,7000001,7003000,2999,False,29,scaffold_7
80,7132001,7135000,2999,False,29,scaffold_7
81,7193001,7196000,2999,False,29,scaffold_7
82,7246001,7249000,2999,False,29,scaffold_7
83,7322001,7327000,4999,False,29,scaffold_7
84,7371001,7373000,1999,False,29,scaffold_7
85,7404001,7408000,3999,False,29,scaffold_7
86,7418001,7420000,1999,False,29,scaffold_7
87,7431001,7435000,3999,False,29,scaffold_7
88,7445001,7450000,4999,False,29,scaffold_7
89,7497001,7502216,5215,True,29,scaffold_7
0,82001,87000,4999,False,29,scaffold_8
1,112001,116000,3999,False,29,scaffold_8
2,955001,960000,4999,False,29,scaffold_8
3,1113001,1115000,1999,False,29,scaffold_8
4,1229001,1231000,1999,False,29,scaffold_8
5,1270001,1273000,2999,False,29,scaffold_8
6,2302001,2310000,7999,False,29,scaffold_8
7,2659001,2664000,4999,False,29,scaffold_8
8,2719001,2722000,2999,False,29,scaffold_8
9,2852001,2871000,18999,False,29,scaffold_8
10,2878001,2898000,19999,False,29,scaffold_8
11,2902001,2906000,3999,False,29,scaffold_8
12,2909001,2912000,2999,False,29,scaffold_8
13,3032001,3043000,10999,False,29,scaffold_8
14,3294001,3304000,9999,False,29,scaffold_8
15,3635001,3641000,5999,False,29,scaffold_8
16,3642001,3647000,4999,False,29,scaffold_8
17,3683001,3691000,7999,False,29,scaffold_8
18,3727001,3729000,1999,False,29,scaffold_8
19,3736001,3740000,3999,False,29,scaffold_8
20,3817001,3820000,2999,False,29,scaffold_8
21,3847001,3857000,9999,False,29,scaffold_8
22,3920001,3922000,1999,False,29,scaffold_8
23,3924001,3927000,2999,False,29,scaffold_8
24,3930001,3932000,1999,False,29,scaffold_8
25,4131001,4137000,5999,False,29,scaffold_8
26,4203001,4213000,9999,False,29,scaffold_8
27,4544001,4548000,3999,False,29,scaffold_8
28,4747001,4771000,23999,False,29,scaffold_8
29,5185001,5188000,2999,False,29,scaffold_8
30,5229001,5231000,1999,False,29,scaffold_8
31,5690001,5692000,1999,False,29,scaffold_8
32,5700001,5707000,6999,False,29,scaffold_8
33,5711001,5714000,2999,False,29,scaffold_8
34,5750001,5772000,21999,False,29,scaffold_8
35,5883001,5894000,10999,False,29,scaffold_8
36,5923001,5933000,9999,False,29,scaffold_8
37,5972001,5982000,9999,False,29,scaffold_8
0,59001,62000,2999,False,29,scaffold_9
1,66001,71000,4999,False,29,scaffold_9
2,133001,137000,3999,False,29,scaffold_9
3,298001,311000,12999,False,29,scaffold_9
4,409001,411000,1999,False,29,scaffold_9
5,413001,419000,5999,False,29,scaffold_9
6,420001,434000,13999,False,29,scaffold_9
7,481001,490000,8999,False,29,scaffold_9
8,491001,503000,11999,False,29,scaffold_9
9,528001,531000,2999,False,29,scaffold_9
10,551001,564000,12999,False,29,scaffold_9
11,649001,665000,15999,False,29,scaffold_9
12,679001,693000,13999,False,29,scaffold_9
13,706001,710000,3999,False,29,scaffold_9
14,758001,763000,4999,False,29,scaffold_9
15,827001,842000,14999,False,29,scaffold_9
16,934001,941000,6999,False,29,scaffold_9
17,943001,950000,6999,False,29,scaffold_9
18,953001,960000,6999,False,29,scaffold_9
19,963001,986000,22999,False,29,scaffold_9
20,1009001,1014000,4999,False,29,scaffold_9
21,1022001,1027000,4999,False,29,scaffold_9
22,1028001,1040000,11999,False,29,scaffold_9
23,1042001,1044000,1999,False,29,scaffold_9
24,1045001,1065000,19999,False,29,scaffold_9
25,1087001,1106000,18999,False,29,scaffold_9
26,1122001,1124000,1999,False,29,scaffold_9
27,1126001,1138000,11999,False,29,scaffold_9
28,1171001,1175000,3999,False,29,scaffold_9
29,1283001,1285000,1999,False,29,scaffold_9
30,1316001,1353000,36999,False,29,scaffold_9
31,1356001,1377000,20999,False,29,scaffold_9
32,1427001,1434000,6999,False,29,scaffold_9
33,1456001,1467000,10999,False,29,scaffold_9
34,1545001,1592000,46999,False,29,scaffold_9
35,1599001,1613000,13999,False,29,scaffold_9
36,1637001,1639000,1999,False,29,scaffold_9
37,1814001,1820000,5999,False,29,scaffold_9
38,1871001,1874000,2999,False,29,scaffold_9
39,1878001,1880000,1999,False,29,scaffold_9
40,1885001,1887000,1999,False,29,scaffold_9
41,1892001,1899000,6999,False,29,scaffold_9
42,1923001,1931000,7999,False,29,scaffold_9
43,1933001,1940000,6999,False,29,scaffold_9
44,2027001,2036000,8999,False,29,scaffold_9
45,2077001,2083000,5999,False,29,scaffold_9
46,2087001,2133000,45999,False,29,scaffold_9
47,2159001,2168000,8999,False,29,scaffold_9
48,2606001,2615000,8999,False,29,scaffold_9
49,2714001,2722000,7999,False,29,scaffold_9
50,2806001,2813000,6999,False,29,scaffold_9
51,2990001,2992000,1999,False,29,scaffold_9
52,3119001,3131000,11999,False,29,scaffold_9
53,3135001,3137000,1999,False,29,scaffold_9
54,3143001,3145000,1999,False,29,scaffold_9
55,3176001,3178000,1999,False,29,scaffold_9
56,3196001,3198000,1999,False,29,scaffold_9
57,3290001,3292000,1999,False,29,scaffold_9
58,3294001,3298000,3999,False,29,scaffold_9
59,3300001,3302000,1999,False,29,scaffold_9
60,3383001,3387000,3999,False,29,scaffold_9
61,3407001,3409000,1999,False,29,scaffold_9
62,3430001,3433000,2999,False,29,scaffold_9
63,3545001,3547000,1999,False,29,scaffold_9
64,3572001,3574000,1999,False,29,scaffold_9
65,3578001,3581000,2999,False,29,scaffold_9
66,3709001,3712000,2999,False,29,scaffold_9
67,3752001,3765000,12999,False,29,scaffold_9
68,3897001,3906000,8999,False,29,scaffold_9
69,3927001,3941000,13999,False,29,scaffold_9
70,4019001,4021000,1999,False,29,scaffold_9
71,4026001,4031000,4999,False,29,scaffold_9
72,4033001,4035000,1999,False,29,scaffold_9
73,4068001,4074000,5999,False,29,scaffold_9
74,4077001,4079000,1999,False,29,scaffold_9
75,4087001,4093000,5999,False,29,scaffold_9
76,4135001,4152000,16999,False,29,scaffold_9
77,4189001,4192000,2999,False,29,scaffold_9
78,4193001,4198000,4999,False,29,scaffold_9
79,4209001,4215000,5999,False,29,scaffold_9
80,4217001,4222000,4999,False,29,scaffold_9
81,4223001,4238000,14999,False,29,scaffold_9
82,4243001,4246000,2999,False,29,scaffold_9
83,4258001,4262000,3999,False,29,scaffold_9
84,4366001,4368000,1999,False,29,scaffold_9
85,4418001,4432000,13999,False,29,scaffold_9
86,4580001,4587000,6999,False,29,scaffold_9
87,4726001,4764000,37999,False,29,scaffold_9
88,4765001,4770000,4999,False,29,scaffold_9
89,4773001,4780000,6999,False,29,scaffold_9
90,4782001,4811000,28999,False,29,scaffold_9
91,4812001,4836000,23999,False,29,scaffold_9
92,4841001,4850000,8999,False,29,scaffold_9
93,4862001,4874000,11999,False,29,scaffold_9
94,4878001,4887000,8999,False,29,scaffold_9
95,4888001,4912000,23999,False,29,scaffold_9
96,4922001,4945000,22999,False,29,scaffold_9
97,4947001,4964000,16999,False,29,scaffold_9
98,4969001,4974000,4999,False,29,scaffold_9
99,4975001,4988000,12999,False,29,scaffold_9
100,5004001,5009000,4999,False,29,scaffold_9
101,5017001,5024000,6999,False,29,scaffold_9
102,5036001,5038000,1999,False,29,scaffold_9
103,5051001,5053000,1999,False,29,scaffold_9
104,5061001,5063000,1999,False,29,scaffold_9
105,5092001,5094000,1999,False,29,scaffold_9
106,5095001,5099000,3999,False,29,scaffold_9
107,5101001,5107000,5999,False,29,scaffold_9
108,5112001,5115000,2999,False,29,scaffold_9
109,5118001,5125000,6999,False,29,scaffold_9
110,5126001,5130000,3999,False,29,scaffold_9
111,5133001,5145000,11999,False,29,scaffold_9
112,5193001,5196000,2999,False,29,scaffold_9
113,5239001,5244000,4999,False,29,scaffold_9
114,5248001,5254000,5999,False,29,scaffold_9
115,5257001,5264000,6999,False,29,scaffold_9
116,5269001,5276000,6999,False,29,scaffold_9
117,5295001,5298000,2999,False,29,scaffold_9
118,5309001,5312000,2999,False,29,scaffold_9
119,5335001,5339000,3999,False,29,scaffold_9
120,5341001,5344000,2999,False,29,scaffold_9
121,5346001,5349000,2999,False,29,scaffold_9
122,5364001,5368000,3999,False,29,scaffold_9
123,5416001,5422000,5999,False,29,scaffold_9
124,5472001,5482000,9999,False,29,scaffold_9
125,5674001,5684000,9999,False,29,scaffold_9
126,5686001,5692000,5999,False,29,scaffold_9
127,5693001,5695000,1999,False,29,scaffold_9
128,5705001,5708000,2999,False,29,scaffold_9
129,5720001,5724000,3999,False,29,scaffold_9
130,5798001,5807000,8999,False,29,scaffold_9
131,5809001,5817000,7999,False,29,scaffold_9
132,5819001,5821000,1999,False,29,scaffold_9
133,5871001,5874000,2999,False,29,scaffold_9
134,5899001,5902000,2999,False,29,scaffold_9
135,5986001,5995000,8999,False,29,scaffold_9
136,5998001,6002000,3999,False,29,scaffold_9
137,6011001,6014000,2999,False,29,scaffold_9
138,6016001,6023000,6999,False,29,scaffold_9
139,6028001,6030000,1999,False,29,scaffold_9
140,6031001,6037000,5999,False,29,scaffold_9
141,6069001,6073000,3999,False,29,scaffold_9
142,6087001,6105000,17999,False,29,scaffold_9
143,6107001,6109000,1999,False,29,scaffold_9
144,6119001,6121000,1999,False,29,scaffold_9
145,6125001,6133000,7999,False,29,scaffold_9
146,6154001,6172000,17999,False,29,scaffold_9
147,6240001,6254000,13999,False,29,scaffold_9
148,6298001,6300000,1999,False,29,scaffold_9
149,6331001,6331288,287,True,29,scaffold_9
0,1,10000,9999,True,29,scaffold_10
1,119001,153000,33999,False,29,scaffold_10
2,270001,284000,13999,False,29,scaffold_10
3,387001,394000,6999,False,29,scaffold_10
4,399001,404000,4999,False,29,scaffold_10
5,474001,482000,7999,False,29,scaffold_10
6,483001,487000,3999,False,29,scaffold_10
7,494001,499000,4999,False,29,scaffold_10
8,522001,535000,12999,False,29,scaffold_10
9,538001,543000,4999,False,29,scaffold_10
10,644001,647000,2999,False,29,scaffold_10
11,1016001,1019000,2999,False,29,scaffold_10
12,1276001,1279000,2999,False,29,scaffold_10
13,1328001,1334000,5999,False,29,scaffold_10
14,1444001,1457000,12999,False,29,scaffold_10
15,1462001,1473000,10999,False,29,scaffold_10
16,1501001,1517000,15999,False,29,scaffold_10
17,1702001,1711000,8999,False,29,scaffold_10
18,1803001,1816000,12999,False,29,scaffold_10
19,1827001,1835000,7999,False,29,scaffold_10
20,1894001,1898000,3999,False,29,scaffold_10
21,2148001,2164000,15999,False,29,scaffold_10
22,2206001,2234000,27999,False,29,scaffold_10
23,2241001,2254000,12999,False,29,scaffold_10
24,2268001,2300000,31999,False,29,scaffold_10
25,2363001,2379000,15999,False,29,scaffold_10
26,2381001,2387000,5999,False,29,scaffold_10
27,2606001,2619000,12999,False,29,scaffold_10
28,2679001,2707000,27999,False,29,scaffold_10
29,2715001,2728000,12999,False,29,scaffold_10
30,2736001,2744000,7999,False,29,scaffold_10
31,2918001,2926000,7999,False,29,scaffold_10
32,3075001,3079000,3999,False,29,scaffold_10
33,3083001,3089000,5999,False,29,scaffold_10
34,3209001,3215000,5999,False,29,scaffold_10
35,3306001,3312000,5999,False,29,scaffold_10
36,3339001,3344000,4999,False,29,scaffold_10
37,3575001,3582000,6999,False,29,scaffold_10
38,3589001,3592000,2999,False,29,scaffold_10
39,3624001,3626000,1999,False,29,scaffold_10
40,3808001,3812000,3999,False,29,scaffold_10
41,3872001,3877000,4999,False,29,scaffold_10
42,3940001,3942000,1999,False,29,scaffold_10
43,4128001,4134000,5999,False,29,scaffold_10
44,4190001,4193000,2999,False,29,scaffold_10
45,4310001,4313000,2999,False,29,scaffold_10
46,4360001,4363000,2999,False,29,scaffold_10
47,4375001,4377000,1999,False,29,scaffold_10
48,4444001,4452000,7999,False,29,scaffold_10
49,4458001,4460000,1999,False,29,scaffold_10
50,4498001,4501000,2999,False,29,scaffold_10
51,4527001,4534000,6999,False,29,scaffold_10
52,4535001,4537000,1999,False,29,scaffold_10
53,4565001,4572000,6999,False,29,scaffold_10
54,4603001,4609000,5999,False,29,scaffold_10
55,4672001,4678000,5999,False,29,scaffold_10
56,4700001,4705000,4999,False,29,scaffold_10
57,4717001,4722000,4999,False,29,scaffold_10
58,4734001,4767000,32999,False,29,scaffold_10
59,4769001,4776000,6999,False,29,scaffold_10
60,4798001,4825000,26999,False,29,scaffold_10
61,4828001,4839000,10999,False,29,scaffold_10
62,4848001,4854000,5999,False,29,scaffold_10
63,4865001,4866973,1972,True,29,scaffold_10
0,13001,34000,20999,False,29,scaffold_11
1,51001,63000,11999,False,29,scaffold_11
2,65001,68000,2999,False,29,scaffold_11
3,69001,74000,4999,False,29,scaffold_11
4,146001,167000,20999,False,29,scaffold_11
5,171001,187000,15999,False,29,scaffold_11
6,224001,233000,8999,False,29,scaffold_11
7,242001,252000,9999,False,29,scaffold_11
8,291001,304000,12999,False,29,scaffold_11
9,311001,314000,2999,False,29,scaffold_11
10,342001,344000,1999,False,29,scaffold_11
11,350001,353000,2999,False,29,scaffold_11
12,384001,387000,2999,False,29,scaffold_11
13,404001,408000,3999,False,29,scaffold_11
14,411001,416000,4999,False,29,scaffold_11
15,419001,423000,3999,False,29,scaffold_11
16,428001,431000,2999,False,29,scaffold_11
17,535001,540000,4999,False,29,scaffold_11
18,580001,582000,1999,False,29,scaffold_11
19,651001,655000,3999,False,29,scaffold_11
20,860001,864000,3999,False,29,scaffold_11
21,1025001,1034000,8999,False,29,scaffold_11
22,1045001,1048000,2999,False,29,scaffold_11
23,1183001,1185000,1999,False,29,scaffold_11
24,1359001,1368000,8999,False,29,scaffold_11
25,1383001,1398000,14999,False,29,scaffold_11
26,1403001,1406000,2999,False,29,scaffold_11
27,1423001,1425000,1999,False,29,scaffold_11
28,1435001,1440000,4999,False,29,scaffold_11
29,1474001,1478000,3999,False,29,scaffold_11
30,1503001,1507000,3999,False,29,scaffold_11
31,1636001,1640000,3999,False,29,scaffold_11
32,1785001,1799000,13999,False,29,scaffold_11
33,2039001,2055000,15999,False,29,scaffold_11
34,2056001,2064000,7999,False,29,scaffold_11
35,2126001,2147000,20999,False,29,scaffold_11
36,2195001,2199000,3999,False,29,scaffold_11
37,2412001,2415000,2999,False,29,scaffold_11
38,2660001,2664000,3999,False,29,scaffold_11
39,2676001,2689000,12999,False,29,scaffold_11
40,2727001,2729000,1999,False,29,scaffold_11
41,3070001,3072000,1999,False,29,scaffold_11
42,3160001,3165000,4999,False,29,scaffold_11
43,3193001,3196000,2999,False,29,scaffold_11
44,3234001,3240000,5999,False,29,scaffold_11
45,3242001,3246000,3999,False,29,scaffold_11
46,3266001,3278000,11999,False,29,scaffold_11
47,3280001,3290000,9999,False,29,scaffold_11
48,3475001,3480000,4999,False,29,scaffold_11
49,3486001,3492000,5999,False,29,scaffold_11
50,3559001,3576000,16999,False,29,scaffold_11
51,3645001,3649000,3999,False,29,scaffold_11
52,3764001,3766000,1999,False,29,scaffold_11
53,3853001,3855000,1999,False,29,scaffold_11
54,3893001,3896000,2999,False,29,scaffold_11
55,4020001,4024000,3999,False,29,scaffold_11
56,4133001,4140000,6999,False,29,scaffold_11
57,4145001,4149000,3999,False,29,scaffold_11
58,4194001,4210000,15999,False,29,scaffold_11
59,4395001,4402000,6999,False,29,scaffold_11
60,4429001,4435000,5999,False,29,scaffold_11
61,4480001,4485000,4999,False,29,scaffold_11
62,4547001,4558000,10999,False,29,scaffold_11
63,4560001,4564000,3999,False,29,scaffold_11
64,4569001,4593000,23999,False,29,scaffold_11
65,4655001,4657000,1999,False,29,scaffold_11
66,4668001,4678000,9999,False,29,scaffold_11
67,4684001,4687000,2999,False,29,scaffold_11
68,4695001,4698000,2999,False,29,scaffold_11
69,4713001,4715000,1999,False,29,scaffold_11
70,4730001,4733000,2999,False,29,scaffold_11
0,11001,13000,1999,False,29,scaffold_12
1,64001,67000,2999,False,29,scaffold_12
2,68001,73000,4999,False,29,scaffold_12
3,132001,139000,6999,False,29,scaffold_12
4,140001,188000,47999,False,29,scaffold_12
5,189001,200000,10999,False,29,scaffold_12
6,221001,227000,5999,False,29,scaffold_12
7,230001,237000,6999,False,29,scaffold_12
8,303001,311000,7999,False,29,scaffold_12
9,405001,408000,2999,False,29,scaffold_12
10,491001,493000,1999,False,29,scaffold_12
11,827001,830000,2999,False,29,scaffold_12
12,835001,841000,5999,False,29,scaffold_12
13,972001,974000,1999,False,29,scaffold_12
14,1038001,1046000,7999,False,29,scaffold_12
15,1070001,1075000,4999,False,29,scaffold_12
16,1076001,1083000,6999,False,29,scaffold_12
17,1251001,1255000,3999,False,29,scaffold_12
18,1318001,1325000,6999,False,29,scaffold_12
19,1400001,1406000,5999,False,29,scaffold_12
20,1464001,1466000,1999,False,29,scaffold_12
21,1468001,1472000,3999,False,29,scaffold_12
22,1478001,1491000,12999,False,29,scaffold_12
23,1722001,1724000,1999,False,29,scaffold_12
24,2025001,2074000,48999,False,29,scaffold_12
25,2075001,2102000,26999,False,29,scaffold_12
26,2118001,2124000,5999,False,29,scaffold_12
27,2203001,2205000,1999,False,29,scaffold_12
28,2318001,2325000,6999,False,29,scaffold_12
29,2480001,2486000,5999,False,29,scaffold_12
30,2562001,2570000,7999,False,29,scaffold_12
31,2575001,2585000,9999,False,29,scaffold_12
32,2586001,2604000,17999,False,29,scaffold_12
33,2680001,2682000,1999,False,29,scaffold_12
0,1,332000,331999,True,30,scaffold_1
1,482001,498000,15999,False,30,scaffold_1
2,574001,643000,68999,False,30,scaffold_1
3,686001,716000,29999,False,30,scaffold_1
4,718001,743000,24999,False,30,scaffold_1
5,1281001,1292000,10999,False,30,scaffold_1
6,1954001,1964000,9999,False,30,scaffold_1
7,1965001,1984000,18999,False,30,scaffold_1
8,2449001,2465000,15999,False,30,scaffold_1
9,2729001,2746000,16999,False,30,scaffold_1
10,3181001,3208000,26999,False,30,scaffold_1
11,3715001,3733000,17999,False,30,scaffold_1
12,3916001,3941000,24999,False,30,scaffold_1
13,4066001,4111000,44999,False,30,scaffold_1
14,4323001,4354000,30999,False,30,scaffold_1
15,4929001,4959000,29999,False,30,scaffold_1
16,4971001,4983000,11999,False,30,scaffold_1
17,5496001,5511000,14999,False,30,scaffold_1
18,6108001,6153000,44999,False,30,scaffold_1
19,6228001,6382000,153999,False,30,scaffold_1
20,6384001,6507000,122999,False,30,scaffold_1
21,6545001,6554000,8999,False,30,scaffold_1
22,7038001,7247000,208999,False,30,scaffold_1
23,7248001,7584000,335999,False,30,scaffold_1
24,7590001,8656000,1065999,False,30,scaffold_1
25,8658001,8673000,14999,False,30,scaffold_1
26,8674001,8742000,67999,False,30,scaffold_1
27,8743001,9584000,840999,False,30,scaffold_1
28,9586001,10354000,767999,False,30,scaffold_1
29,10461001,10630000,168999,False,30,scaffold_1
30,10808001,10811000,2999,False,30,scaffold_1
31,10836001,10858000,21999,False,30,scaffold_1
32,11351001,11504000,152999,False,30,scaffold_1
33,11648001,11734000,85999,False,30,scaffold_1
34,11735001,11951000,215999,False,30,scaffold_1
35,12184001,12204000,19999,False,30,scaffold_1
36,12678001,12722000,43999,False,30,scaffold_1
37,12777001,12886000,108999,False,30,scaffold_1
38,13181001,13211000,29999,False,30,scaffold_1
39,13347001,13377000,29999,False,30,scaffold_1
40,13900001,13903000,2999,False,30,scaffold_1
41,14007001,14009000,1999,False,30,scaffold_1
0,22001,48000,25999,False,30,scaffold_2
1,93001,159000,65999,False,30,scaffold_2
2,165001,177000,11999,False,30,scaffold_2
3,303001,318000,14999,False,30,scaffold_2
4,330001,374000,43999,False,30,scaffold_2
5,2336001,2358000,21999,False,30,scaffold_2
6,2408001,2421000,12999,False,30,scaffold_2
7,2441001,2553000,111999,False,30,scaffold_2
8,2627001,2639000,11999,False,30,scaffold_2
9,2660001,2689000,28999,False,30,scaffold_2
10,2694001,2742000,47999,False,30,scaffold_2
11,2994001,3012000,17999,False,30,scaffold_2
12,3766001,3782000,15999,False,30,scaffold_2
13,4385001,4409000,23999,False,30,scaffold_2
14,4429001,4456000,26999,False,30,scaffold_2
15,4525001,4553000,27999,False,30,scaffold_2
16,4608001,4653000,44999,False,30,scaffold_2
17,5035001,5061000,25999,False,30,scaffold_2
18,5491001,5511000,19999,False,30,scaffold_2
19,5672001,5704000,31999,False,30,scaffold_2
20,6261001,6330000,68999,False,30,scaffold_2
21,6331001,6342000,10999,False,30,scaffold_2
22,6429001,6448000,18999,False,30,scaffold_2
23,7439001,7471000,31999,False,30,scaffold_2
24,7563001,7697000,133999,False,30,scaffold_2
25,7786001,7885000,98999,False,30,scaffold_2
26,7934001,7965000,30999,False,30,scaffold_2
27,7993001,8088000,94999,False,30,scaffold_2
28,8331001,8333000,1999,False,30,scaffold_2
29,8343001,8344000,999,False,30,scaffold_2
30,8346001,8389000,42999,False,30,scaffold_2
31,8509001,8535000,25999,False,30,scaffold_2
32,11366001,11374000,7999,False,30,scaffold_2
33,11520001,11785000,264999,False,30,scaffold_2
0,1,2000,1999,True,30,scaffold_3
1,51001,55000,3999,False,30,scaffold_3
2,102001,104000,1999,False,30,scaffold_3
3,204001,207000,2999,False,30,scaffold_3
4,799001,900000,100999,False,30,scaffold_3
5,2085001,2108000,22999,False,30,scaffold_3
6,2291001,2321000,29999,False,30,scaffold_3
7,2506001,2533000,26999,False,30,scaffold_3
8,4150001,4403000,252999,False,30,scaffold_3
9,4410001,4518000,107999,False,30,scaffold_3
10,4547001,4558000,10999,False,30,scaffold_3
11,4654001,4678000,23999,False,30,scaffold_3
12,6911001,6962000,50999,False,30,scaffold_3
13,6979001,7034000,54999,False,30,scaffold_3
14,7540001,7556000,15999,False,30,scaffold_3
15,7692001,7730000,37999,False,30,scaffold_3
16,7822001,7836000,13999,False,30,scaffold_3
17,8208001,8255000,46999,False,30,scaffold_3
18,8462001,8522000,59999,False,30,scaffold_3
19,8575001,8594000,18999,False,30,scaffold_3
20,9968001,9995000,26999,False,30,scaffold_3
21,10461001,10483000,21999,False,30,scaffold_3
22,10587001,11165000,577999,False,30,scaffold_3
0,17001,32000,14999,False,30,scaffold_4
1,49001,88000,38999,False,30,scaffold_4
2,132001,146000,13999,False,30,scaffold_4
3,147001,151000,3999,False,30,scaffold_4
4,163001,215000,51999,False,30,scaffold_4
5,217001,226000,8999,False,30,scaffold_4
6,248001,266000,17999,False,30,scaffold_4
7,355001,374000,18999,False,30,scaffold_4
8,375001,380000,4999,False,30,scaffold_4
9,392001,410000,17999,False,30,scaffold_4
10,412001,425000,12999,False,30,scaffold_4
11,429001,499000,69999,False,30,scaffold_4
12,545001,599000,53999,False,30,scaffold_4
13,608001,661000,52999,False,30,scaffold_4
14,670001,691000,20999,False,30,scaffold_4
15,701001,726000,24999,False,30,scaffold_4
16,1122001,1136000,13999,False,30,scaffold_4
17,1137001,1178000,40999,False,30,scaffold_4
18,1199001,1208000,8999,False,30,scaffold_4
19,1210001,1226000,15999,False,30,scaffold_4
20,1229001,1231000,1999,False,30,scaffold_4
21,1235001,1246000,10999,False,30,scaffold_4
22,1248001,1253000,4999,False,30,scaffold_4
23,1283001,1320000,36999,False,30,scaffold_4
24,1372001,1591000,218999,False,30,scaffold_4
25,1749001,1817000,67999,False,30,scaffold_4
26,1905001,1957000,51999,False,30,scaffold_4
27,1958001,1997000,38999,False,30,scaffold_4
28,2036001,2065000,28999,False,30,scaffold_4
29,2247001,2279000,31999,False,30,scaffold_4
30,2284001,2340000,55999,False,30,scaffold_4
31,2480001,2535000,54999,False,30,scaffold_4
32,3336001,3632000,295999,False,30,scaffold_4
33,3676001,3759000,82999,False,30,scaffold_4
34,4944001,4984000,39999,False,30,scaffold_4
35,5477001,5506000,28999,False,30,scaffold_4
36,5514001,5620000,105999,False,30,scaffold_4
37,5694001,5784000,89999,False,30,scaffold_4
38,6806001,6817000,10999,False,30,scaffold_4
39,8846001,9699000,852999,False,30,scaffold_4
40,9700001,9845951,145950,True,30,scaffold_4
0,318001,326000,7999,False,30,scaffold_5
1,327001,368000,40999,False,30,scaffold_5
2,469001,480000,10999,False,30,scaffold_5
3,498001,523000,24999,False,30,scaffold_5
4,933001,947000,13999,False,30,scaffold_5
5,1062001,1068000,5999,False,30,scaffold_5
6,2565001,2581000,15999,False,30,scaffold_5
7,2625001,2732000,106999,False,30,scaffold_5
8,2816001,2871000,54999,False,30,scaffold_5
9,3322001,3438000,115999,False,30,scaffold_5
10,3453001,3497000,43999,False,30,scaffold_5
11,3962001,4101000,138999,False,30,scaffold_5
12,4124001,4138000,13999,False,30,scaffold_5
13,4157001,4219000,61999,False,30,scaffold_5
14,4246001,4262000,15999,False,30,scaffold_5
15,4446001,4483000,36999,False,30,scaffold_5
16,4603001,4628000,24999,False,30,scaffold_5
17,4691001,4716000,24999,False,30,scaffold_5
18,4820001,4857000,36999,False,30,scaffold_5
19,4904001,4917000,12999,False,30,scaffold_5
20,5318001,5346000,27999,False,30,scaffold_5
21,7582001,7609000,26999,False,30,scaffold_5
22,7622001,7636000,13999,False,30,scaffold_5
23,8730001,9363000,632999,False,30,scaffold_5
0,79001,85000,5999,False,30,scaffold_6
1,86001,112000,25999,False,30,scaffold_6
2,241001,254000,12999,False,30,scaffold_6
3,267001,283000,15999,False,30,scaffold_6
4,1125001,1130000,4999,False,30,scaffold_6
5,1229001,1258000,28999,False,30,scaffold_6
6,1479001,1546000,66999,False,30,scaffold_6
7,2023001,2088000,64999,False,30,scaffold_6
8,2130001,2169000,38999,False,30,scaffold_6
9,2371001,2595000,223999,False,30,scaffold_6
10,2596001,2653000,56999,False,30,scaffold_6
11,2661001,2691000,29999,False,30,scaffold_6
12,2731001,2851000,119999,False,30,scaffold_6
13,2935001,2979000,43999,False,30,scaffold_6
14,2980001,3014000,33999,False,30,scaffold_6
15,3115001,3149000,33999,False,30,scaffold_6
16,3224001,3274000,49999,False,30,scaffold_6
17,3408001,3427000,18999,False,30,scaffold_6
18,3461001,3521000,59999,False,30,scaffold_6
19,3529001,3765000,235999,False,30,scaffold_6
20,3901001,3912000,10999,False,30,scaffold_6
21,4018001,4066000,47999,False,30,scaffold_6
22,4108001,4193000,84999,False,30,scaffold_6
23,6011001,6060000,48999,False,30,scaffold_6
24,7285001,7336000,50999,False,30,scaffold_6
25,7563001,7794000,230999,False,30,scaffold_6
26,7811001,8268281,457280,True,30,scaffold_6
0,1001,7000,5999,False,30,scaffold_7
1,13001,31000,17999,False,30,scaffold_7
2,323001,340000,16999,False,30,scaffold_7
3,342001,508000,165999,False,30,scaffold_7
4,554001,563000,8999,False,30,scaffold_7
5,571001,577000,5999,False,30,scaffold_7
6,706001,736000,29999,False,30,scaffold_7
7,764001,829000,64999,False,30,scaffold_7
8,830001,843000,12999,False,30,scaffold_7
9,859001,864000,4999,False,30,scaffold_7
10,868001,872000,3999,False,30,scaffold_7
11,874001,885000,10999,False,30,scaffold_7
12,953001,963000,9999,False,30,scaffold_7
13,968001,980000,11999,False,30,scaffold_7
14,982001,1039000,56999,False,30,scaffold_7
15,1191001,1512000,320999,False,30,scaffold_7
16,1589001,1688000,98999,False,30,scaffold_7
17,3329001,3369000,39999,False,30,scaffold_7
18,3596001,3649000,52999,False,30,scaffold_7
19,4416001,4517000,100999,False,30,scaffold_7
20,4658001,4681000,22999,False,30,scaffold_7
21,4979001,5029000,49999,False,30,scaffold_7
22,5074001,5108000,33999,False,30,scaffold_7
23,5472001,5515000,42999,False,30,scaffold_7
24,6955001,7270000,314999,False,30,scaffold_7
25,7271001,7502216,231215,True,30,scaffold_7
0,66001,85000,18999,False,30,scaffold_8
1,2662001,2683000,20999,False,30,scaffold_8
2,2745001,2756000,10999,False,30,scaffold_8
3,3060001,3525000,464999,False,30,scaffold_8
4,3584001,3612000,27999,False,30,scaffold_8
5,3615001,3810000,194999,False,30,scaffold_8
6,3811001,3912000,100999,False,30,scaffold_8
7,5200001,5241000,40999,False,30,scaffold_8
8,6331001,6334544,3543,True,30,scaffold_8
0,109001,117000,7999,False,30,scaffold_9
1,189001,194000,4999,False,30,scaffold_9
2,303001,315000,11999,False,30,scaffold_9
3,319001,332000,12999,False,30,scaffold_9
4,367001,404000,36999,False,30,scaffold_9
5,413001,434000,20999,False,30,scaffold_9
6,502001,531000,28999,False,30,scaffold_9
7,671001,696000,24999,False,30,scaffold_9
8,732001,742000,9999,False,30,scaffold_9
9,815001,841000,25999,False,30,scaffold_9
10,873001,986000,112999,False,30,scaffold_9
11,988001,995000,6999,False,30,scaffold_9
12,1001001,1007000,5999,False,30,scaffold_9
13,1010001,1031000,20999,False,30,scaffold_9
14,1036001,1085000,48999,False,30,scaffold_9
15,1087001,1150000,62999,False,30,scaffold_9
16,1151001,1164000,12999,False,30,scaffold_9
17,1312001,1377000,64999,False,30,scaffold_9
18,1768001,1790000,21999,False,30,scaffold_9
19,2601001,2616000,14999,False,30,scaffold_9
20,2871001,3381000,509999,False,30,scaffold_9
21,3383001,5100000,1716999,False,30,scaffold_9
22,5101001,5107000,5999,False,30,scaffold_9
23,5112001,5115000,2999,False,30,scaffold_9
24,5116001,5238000,121999,False,30,scaffold_9
25,5239001,5298000,58999,False,30,scaffold_9
26,5300001,5490000,189999,False,30,scaffold_9
27,5493001,6331288,838287,True,30,scaffold_9
0,1,197000,196999,True,30,scaffold_10
1,375001,414000,38999,False,30,scaffold_10
2,473001,482000,8999,False,30,scaffold_10
3,512001,576000,63999,False,30,scaffold_10
4,603001,721000,117999,False,30,scaffold_10
5,890001,916000,25999,False,30,scaffold_10
6,1087001,1105000,17999,False,30,scaffold_10
7,2346001,2367000,20999,False,30,scaffold_10
8,4053001,4091000,37999,False,30,scaffold_10
9,4154001,4174000,19999,False,30,scaffold_10
10,4515001,4523000,7999,False,30,scaffold_10
11,4526001,4548000,21999,False,30,scaffold_10
12,4679001,4688000,8999,False,30,scaffold_10
13,4734001,4766000,31999,False,30,scaffold_10
14,4767001,4776000,8999,False,30,scaffold_10
15,4798001,4824000,25999,False,30,scaffold_10
16,4827001,4843000,15999,False,30,scaffold_10
17,4848001,4861000,12999,False,30,scaffold_10
18,4865001,4866973,1972,True,30,scaffold_10
0,10001,93000,82999,False,30,scaffold_11
1,149001,167000,17999,False,30,scaffold_11
2,169001,189000,19999,False,30,scaffold_11
3,213001,235000,21999,False,30,scaffold_11
4,240001,247000,6999,False,30,scaffold_11
5,419001,431000,11999,False,30,scaffold_11
6,648001,656000,7999,False,30,scaffold_11
7,1025001,1034000,8999,False,30,scaffold_11
8,1423001,1426000,2999,False,30,scaffold_11
9,2702001,2743000,40999,False,30,scaffold_11
10,2744001,2872000,127999,False,30,scaffold_11
11,3217001,3254000,36999,False,30,scaffold_11
12,3331001,3364000,32999,False,30,scaffold_11
13,3702001,3926000,223999,False,30,scaffold_11
14,4322001,4710000,387999,False,30,scaffold_11
15,4713001,4766820,53819,True,30,scaffold_11
0,1,240000,239999,True,30,scaffold_12
1,291001,369000,77999,False,30,scaffold_12
2,474001,536000,61999,False,30,scaffold_12
3,582001,730000,147999,False,30,scaffold_12
4,740001,856000,115999,False,30,scaffold_12
5,865001,1354000,488999,False,30,scaffold_12
6,1720001,1733000,12999,False,30,scaffold_12
7,2571001,2617000,45999,False,30,scaffold_12
8,2747001,2747968,967,True,30,scaffold_12
0,1,342000,341999,True,31,scaffold_1
1,482001,498000,15999,False,31,scaffold_1
2,571001,643000,71999,False,31,scaffold_1
3,686001,749000,62999,False,31,scaffold_1
4,1281001,1292000,10999,False,31,scaffold_1
5,1615001,1660000,44999,False,31,scaffold_1
6,1814001,1899000,84999,False,31,scaffold_1
7,1951001,1964000,12999,False,31,scaffold_1
8,1965001,1984000,18999,False,31,scaffold_1
9,1987001,2002000,14999,False,31,scaffold_1
10,2362001,2387000,24999,False,31,scaffold_1
11,2449001,2517000,67999,False,31,scaffold_1
12,2564001,2582000,17999,False,31,scaffold_1
13,2729001,2746000,16999,False,31,scaffold_1
14,3172001,3209000,36999,False,31,scaffold_1
15,3714001,3741000,26999,False,31,scaffold_1
16,3826001,3872000,45999,False,31,scaffold_1
17,3916001,3941000,24999,False,31,scaffold_1
18,3953001,4029000,75999,False,31,scaffold_1
19,4060001,4112000,51999,False,31,scaffold_1
20,4314001,4354000,39999,False,31,scaffold_1
21,4796001,4814000,17999,False,31,scaffold_1
22,4927001,5021000,93999,False,31,scaffold_1
23,5481001,5514000,32999,False,31,scaffold_1
24,5536001,5570000,33999,False,31,scaffold_1
25,6108001,6153000,44999,False,31,scaffold_1
26,6154001,6177000,22999,False,31,scaffold_1
27,6202001,6379000,176999,False,31,scaffold_1
28,6384001,6555000,170999,False,31,scaffold_1
29,7038001,7247000,208999,False,31,scaffold_1
30,7248001,7583000,334999,False,31,scaffold_1
31,7590001,8477000,886999,False,31,scaffold_1
32,8478001,8656000,177999,False,31,scaffold_1
33,8658001,9584000,925999,False,31,scaffold_1
34,9586001,10356000,769999,False,31,scaffold_1
35,10461001,10640000,178999,False,31,scaffold_1
36,10808001,10811000,2999,False,31,scaffold_1
37,10832001,10857000,24999,False,31,scaffold_1
38,11274001,11504000,229999,False,31,scaffold_1
39,11551001,11960000,408999,False,31,scaffold_1
40,12184001,12239000,54999,False,31,scaffold_1
41,12652001,12723000,70999,False,31,scaffold_1
42,12775001,12888000,112999,False,31,scaffold_1
43,13113001,13216000,102999,False,31,scaffold_1
44,13345001,13429000,83999,False,31,scaffold_1
45,13816001,13830000,13999,False,31,scaffold_1
46,14162001,14164000,1999,False,31,scaffold_1
47,14285001,14307000,21999,False,31,scaffold_1
48,14513001,14515000,1999,False,31,scaffold_1
49,14648001,14664000,15999,False,31,scaffold_1
0,22001,48000,25999,False,31,scaffold_2
1,95001,159000,63999,False,31,scaffold_2
2,165001,177000,11999,False,31,scaffold_2
3,312001,318000,5999,False,31,scaffold_2
4,330001,374000,43999,False,31,scaffold_2
5,2085001,2111000,25999,False,31,scaffold_2
6,2336001,2384000,47999,False,31,scaffold_2
7,2404001,2424000,19999,False,31,scaffold_2
8,2441001,2609000,167999,False,31,scaffold_2
9,2658001,2689000,30999,False,31,scaffold_2
10,2694001,2742000,47999,False,31,scaffold_2
11,2868001,2900000,31999,False,31,scaffold_2
12,2974001,3013000,38999,False,31,scaffold_2
13,3174001,3186000,11999,False,31,scaffold_2
14,3332001,3344000,11999,False,31,scaffold_2
15,3454001,3464000,9999,False,31,scaffold_2
16,3758001,3783000,24999,False,31,scaffold_2
17,4397001,4407000,9999,False,31,scaffold_2
18,4427001,4458000,30999,False,31,scaffold_2
19,4515001,4658000,142999,False,31,scaffold_2
20,4783001,4790000,6999,False,31,scaffold_2
21,4918001,4954000,35999,False,31,scaffold_2
22,5021001,5061000,39999,False,31,scaffold_2
23,5080001,5104000,23999,False,31,scaffold_2
24,5199001,5222000,22999,False,31,scaffold_2
25,5369001,5394000,24999,False,31,scaffold_2
26,5413001,5488000,74999,False,31,scaffold_2
27,5490001,5514000,23999,False,31,scaffold_2
28,5668001,5707000,38999,False,31,scaffold_2
29,5719001,5758000,38999,False,31,scaffold_2
30,5913001,5992000,78999,False,31,scaffold_2
31,6247001,6330000,82999,False,31,scaffold_2
32,6331001,6350000,18999,False,31,scaffold_2
33,6394001,6449000,54999,False,31,scaffold_2
34,6591001,6628000,36999,False,31,scaffold_2
35,7018001,7036000,17999,False,31,scaffold_2
36,7062001,7097000,34999,False,31,scaffold_2
37,7439001,7472000,32999,False,31,scaffold_2
38,7563001,7697000,133999,False,31,scaffold_2
39,7785001,7891000,105999,False,31,scaffold_2
40,7933001,8161000,227999,False,31,scaffold_2
41,8261001,8297000,35999,False,31,scaffold_2
42,8331001,8333000,1999,False,31,scaffold_2
43,8346001,8454000,107999,False,31,scaffold_2
44,8495001,8561000,65999,False,31,scaffold_2
45,11367001,11381000,13999,False,31,scaffold_2
46,11520001,11786000,265999,False,31,scaffold_2
0,799001,900000,100999,False,31,scaffold_3
1,2008001,2108000,99999,False,31,scaffold_3
2,2291001,2336000,44999,False,31,scaffold_3
3,2487001,2533000,45999,False,31,scaffold_3
4,2716001,2737000,20999,False,31,scaffold_3
5,3608001,3645000,36999,False,31,scaffold_3
6,3768001,3821000,52999,False,31,scaffold_3
7,3822001,3889000,66999,False,31,scaffold_3
8,4007001,4032000,24999,False,31,scaffold_3
9,4096001,4403000,306999,False,31,scaffold_3
10,4416001,4518000,101999,False,31,scaffold_3
11,4547001,4558000,10999,False,31,scaffold_3
12,4652001,4679000,26999,False,31,scaffold_3
13,5165001,5190000,24999,False,31,scaffold_3
14,5493001,5509000,15999,False,31,scaffold_3
15,5809001,5940000,130999,False,31,scaffold_3
16,5970001,6020000,49999,False,31,scaffold_3
17,6909001,6962000,52999,False,31,scaffold_3
18,6963001,6972000,8999,False,31,scaffold_3
19,6979001,7097000,117999,False,31,scaffold_3
20,7286001,7328000,41999,False,31,scaffold_3
21,7332001,7398000,65999,False,31,scaffold_3
22,7518001,7562000,43999,False,31,scaffold_3
23,7692001,7854000,161999,False,31,scaffold_3
24,8056001,8066000,9999,False,31,scaffold_3
25,8091001,8116000,24999,False,31,scaffold_3
26,8183001,8255000,71999,False,31,scaffold_3
27,8462001,8527000,64999,False,31,scaffold_3
28,8575001,8594000,18999,False,31,scaffold_3
29,9058001,9075000,16999,False,31,scaffold_3
30,9105001,9151000,45999,False,31,scaffold_3
31,9967001,9995000,27999,False,31,scaffold_3
32,10461001,10484000,22999,False,31,scaffold_3
33,10587001,11166000,578999,False,31,scaffold_3
0,17001,32000,14999,False,31,scaffold_4
1,48001,88000,39999,False,31,scaffold_4
2,110001,115000,4999,False,31,scaffold_4
3,137001,146000,8999,False,31,scaffold_4
4,147001,151000,3999,False,31,scaffold_4
5,155001,160000,4999,False,31,scaffold_4
6,161001,215000,53999,False,31,scaffold_4
7,217001,226000,8999,False,31,scaffold_4
8,227001,241000,13999,False,31,scaffold_4
9,242001,266000,23999,False,31,scaffold_4
10,294001,310000,15999,False,31,scaffold_4
11,355001,374000,18999,False,31,scaffold_4
12,375001,380000,4999,False,31,scaffold_4
13,390001,410000,19999,False,31,scaffold_4
14,412001,425000,12999,False,31,scaffold_4
15,429001,500000,70999,False,31,scaffold_4
16,545001,606000,60999,False,31,scaffold_4
17,608001,661000,52999,False,31,scaffold_4
18,670001,691000,20999,False,31,scaffold_4
19,701001,714000,12999,False,31,scaffold_4
20,1120001,1136000,15999,False,31,scaffold_4
21,1137001,1198000,60999,False,31,scaffold_4
22,1199001,1208000,8999,False,31,scaffold_4
23,1210001,1226000,15999,False,31,scaffold_4
24,1235001,1253000,17999,False,31,scaffold_4
25,1254001,1262000,7999,False,31,scaffold_4
26,1265001,1279000,13999,False,31,scaffold_4
27,1283001,1336000,52999,False,31,scaffold_4
28,1372001,1392000,19999,False,31,scaffold_4
29,1393001,1601000,207999,False,31,scaffold_4
30,1613001,2117000,503999,False,31,scaffold_4
31,2156001,2185000,28999,False,31,scaffold_4
32,2223001,2279000,55999,False,31,scaffold_4
33,2284001,2310000,25999,False,31,scaffold_4
34,2312001,2340000,27999,False,31,scaffold_4
35,2428001,2461000,32999,False,31,scaffold_4
36,2476001,2635000,158999,False,31,scaffold_4
37,3075001,3127000,51999,False,31,scaffold_4
38,3336001,3767000,430999,False,31,scaffold_4
39,4056001,4077000,20999,False,31,scaffold_4
40,4901001,5047000,145999,False,31,scaffold_4
41,5173001,5223000,49999,False,31,scaffold_4
42,5300001,5326000,25999,False,31,scaffold_4
43,5471001,5506000,34999,False,31,scaffold_4
44,5514001,5620000,105999,False,31,scaffold_4
45,5658001,5784000,125999,False,31,scaffold_4
46,5786001,5824000,37999,False,31,scaffold_4
47,6146001,6194000,47999,False,31,scaffold_4
48,6764001,6817000,52999,False,31,scaffold_4
49,6901001,6924000,22999,False,31,scaffold_4
50,6969001,6995000,25999,False,31,scaffold_4
51,7036001,7062000,25999,False,31,scaffold_4
52,7227001,7304000,76999,False,31,scaffold_4
53,7355001,7372000,16999,False,31,scaffold_4
54,7629001,7665000,35999,False,31,scaffold_4
55,8844001,9699000,854999,False,31,scaffold_4
56,9701001,9845951,144950,True,31,scaffold_4
0,1,4000,3999,True,31,scaffold_5
1,318001,385000,66999,False,31,scaffold_5
2,463001,523000,59999,False,31,scaffold_5
3,933001,947000,13999,False,31,scaffold_5
4,2475001,2493000,17999,False,31,scaffold_5
5,2510001,2515000,4999,False,31,scaffold_5
6,2563001,2746000,182999,False,31,scaffold_5
7,2766001,2871000,104999,False,31,scaffold_5
8,3134001,3186000,51999,False,31,scaffold_5
9,3218001,3258000,39999,False,31,scaffold_5
10,3278001,3512000,233999,False,31,scaffold_5
11,3617001,3657000,39999,False,31,scaffold_5
12,3962001,4101000,138999,False,31,scaffold_5
13,4120001,4219000,98999,False,31,scaffold_5
14,4234001,4321000,86999,False,31,scaffold_5
15,4446001,4495000,48999,False,31,scaffold_5
16,4601001,4861000,259999,False,31,scaffold_5
17,4892001,4919000,26999,False,31,scaffold_5
18,5249001,5276000,26999,False,31,scaffold_5
19,5280001,5346000,65999,False,31,scaffold_5
20,6395001,6420000,24999,False,31,scaffold_5
21,6478001,6667000,188999,False,31,scaffold_5
22,7177001,7202000,24999,False,31,scaffold_5
23,7454001,7488000,33999,False,31,scaffold_5
24,7580001,7610000,29999,False,31,scaffold_5
25,7621001,7726000,104999,False,31,scaffold_5
26,8571001,8615000,43999,False,31,scaffold_5
27,8668001,8689000,20999,False,31,scaffold_5
28,8712001,9364176,652175,True,31,scaffold_5
0,79001,84000,4999,False,31,scaffold_6
1,86001,114000,27999,False,31,scaffold_6
2,241001,254000,12999,False,31,scaffold_6
3,257001,262000,4999,False,31,scaffold_6
4,267001,277000,9999,False,31,scaffold_6
5,1141001,1192000,50999,False,31,scaffold_6
6,1235001,1259000,23999,False,31,scaffold_6
7,1478001,1548000,69999,False,31,scaffold_6
8,1561001,1594000,32999,False,31,scaffold_6
9,1843001,1906000,62999,False,31,scaffold_6
10,2000001,2019000,18999,False,31,scaffold_6
11,2023001,2088000,64999,False,31,scaffold_6
12,2127001,2213000,85999,False,31,scaffold_6
13,2240001,2268000,27999,False,31,scaffold_6
14,2334001,2595000,260999,False,31,scaffold_6
15,2596001,2654000,57999,False,31,scaffold_6
16,2655001,2691000,35999,False,31,scaffold_6
17,2713001,2872000,158999,False,31,scaffold_6
18,2933001,3014000,80999,False,31,scaffold_6
19,3103001,3192000,88999,False,31,scaffold_6
20,3224001,3350000,125999,False,31,scaffold_6
21,3351001,3433000,81999,False,31,scaffold_6
22,3446001,3766000,319999,False,31,scaffold_6
23,3810001,3846000,35999,False,31,scaffold_6
24,3883001,3914000,30999,False,31,scaffold_6
25,4018001,4072000,53999,False,31,scaffold_6
26,4073001,4193000,119999,False,31,scaffold_6
27,4843001,4872000,28999,False,31,scaffold_6
28,5945001,5970000,24999,False,31,scaffold_6
29,6011001,6082000,70999,False,31,scaffold_6
30,6124001,6190000,65999,False,31,scaffold_6
31,6782001,6803000,20999,False,31,scaffold_6
32,7263001,7337000,73999,False,31,scaffold_6
33,7389001,7436000,46999,False,31,scaffold_6
34,7550001,8268281,718280,True,31,scaffold_6
0,13001,31000,17999,False,31,scaffold_7
1,50001,60000,9999,False,31,scaffold_7
2,323001,340000,16999,False,31,scaffold_7
3,342001,508000,165999,False,31,scaffold_7
4,571001,577000,5999,False,31,scaffold_7
5,706001,736000,29999,False,31,scaffold_7
6,741001,753000,11999,False,31,scaffold_7
7,764001,809000,44999,False,31,scaffold_7
8,859001,864000,4999,False,31,scaffold_7
9,890001,944000,53999,False,31,scaffold_7
10,964001,966000,1999,False,31,scaffold_7
11,968001,980000,11999,False,31,scaffold_7
12,982001,1044000,61999,False,31,scaffold_7
13,1048001,1104000,55999,False,31,scaffold_7
14,1191001,1460000,268999,False,31,scaffold_7
15,1461001,1512000,50999,False,31,scaffold_7
16,1588001,1695000,106999,False,31,scaffold_7
17,1769001,1782000,12999,False,31,scaffold_7
18,3325001,3370000,44999,False,31,scaffold_7
19,3523001,3551000,27999,False,31,scaffold_7
20,3576001,3787000,210999,False,31,scaffold_7
21,4415001,4517000,101999,False,31,scaffold_7
22,4633001,4737000,103999,False,31,scaffold_7
23,4978001,5149000,170999,False,31,scaffold_7
24,5482001,5536000,53999,False,31,scaffold_7
25,6751001,6785000,33999,False,31,scaffold_7
26,6954001,7270000,315999,False,31,scaffold_7
27,7271001,7502216,231215,True,31,scaffold_7
0,67001,85000,17999,False,31,scaffold_8
1,722001,724000,1999,False,31,scaffold_8
2,1859001,1928000,68999,False,31,scaffold_8
3,2442001,2528000,85999,False,31,scaffold_8
4,2539001,2547000,7999,False,31,scaffold_8
5,2652001,2683000,30999,False,31,scaffold_8
6,2740001,2844000,103999,False,31,scaffold_8
7,2847001,2876000,28999,False,31,scaffold_8
8,3044001,3549000,504999,False,31,scaffold_8
9,3581001,3612000,30999,False,31,scaffold_8
10,3615001,3938000,322999,False,31,scaffold_8
11,4034001,4108000,73999,False,31,scaffold_8
12,4398001,4426000,27999,False,31,scaffold_8
13,5080001,5137000,56999,False,31,scaffold_8
14,5169001,5241000,71999,False,31,scaffold_8
15,5579001,5596000,16999,False,31,scaffold_8
16,5661001,5695000,33999,False,31,scaffold_8
17,5761001,5774000,12999,False,31,scaffold_8
18,6319001,6334544,15543,True,31,scaffold_8
0,109001,117000,7999,False,31,scaffold_9
1,303001,315000,11999,False,31,scaffold_9
2,319001,332000,12999,False,31,scaffold_9
3,367001,411000,43999,False,31,scaffold_9
4,413001,434000,20999,False,31,scaffold_9
5,501001,531000,29999,False,31,scaffold_9
6,652001,664000,11999,False,31,scaffold_9
7,670001,696000,25999,False,31,scaffold_9
8,732001,742000,9999,False,31,scaffold_9
9,794001,803000,8999,False,31,scaffold_9
10,815001,843000,27999,False,31,scaffold_9
11,873001,986000,112999,False,31,scaffold_9
12,987001,995000,7999,False,31,scaffold_9
13,1001001,1007000,5999,False,31,scaffold_9
14,1009001,1031000,21999,False,31,scaffold_9
15,1040001,1085000,44999,False,31,scaffold_9
16,1087001,1150000,62999,False,31,scaffold_9
17,1151001,1166000,14999,False,31,scaffold_9
18,1312001,1377000,64999,False,31,scaffold_9
19,1458001,1464000,5999,False,31,scaffold_9
20,1749001,1791000,41999,False,31,scaffold_9
21,1987001,2037000,49999,False,31,scaffold_9
22,2038001,2057000,18999,False,31,scaffold_9
23,2076001,2110000,33999,False,31,scaffold_9
24,2147001,2171000,23999,False,31,scaffold_9
25,2174001,2197000,22999,False,31,scaffold_9
26,2598001,2616000,17999,False,31,scaffold_9
27,2738001,2759000,20999,False,31,scaffold_9
28,2768001,2824000,55999,False,31,scaffold_9
29,2870001,3381000,510999,False,31,scaffold_9
30,3383001,5107000,1723999,False,31,scaffold_9
31,5112001,5114000,1999,False,31,scaffold_9
32,5116001,5238000,121999,False,31,scaffold_9
33,5239001,5298000,58999,False,31,scaffold_9
34,5300001,5490000,189999,False,31,scaffold_9
35,5493001,6331288,838287,True,31,scaffold_9
0,1,234000,233999,True,31,scaffold_10
1,265001,414000,148999,False,31,scaffold_10
2,415001,482000,66999,False,31,scaffold_10
3,483001,584000,100999,False,31,scaffold_10
4,603001,795000,191999,False,31,scaffold_10
5,888001,917000,28999,False,31,scaffold_10
6,923001,963000,39999,False,31,scaffold_10
7,1088001,1145000,56999,False,31,scaffold_10
8,2140001,2171000,30999,False,31,scaffold_10
9,2273001,2300000,26999,False,31,scaffold_10
10,2346001,2425000,78999,False,31,scaffold_10
11,2565001,2571000,5999,False,31,scaffold_10
12,2599001,2621000,21999,False,31,scaffold_10
13,4053001,4091000,37999,False,31,scaffold_10
14,4154001,4174000,19999,False,31,scaffold_10
15,4337001,4360000,22999,False,31,scaffold_10
16,4443001,4462000,18999,False,31,scaffold_10
17,4467001,4476000,8999,False,31,scaffold_10
18,4506001,4513000,6999,False,31,scaffold_10
19,4515001,4523000,7999,False,31,scaffold_10
20,4526001,4548000,21999,False,31,scaffold_10
21,4575001,4596000,20999,False,31,scaffold_10
22,4681001,4688000,6999,False,31,scaffold_10
23,4734001,4766000,31999,False,31,scaffold_10
24,4767001,4776000,8999,False,31,scaffold_10
25,4791001,4797000,5999,False,31,scaffold_10
26,4798001,4824000,25999,False,31,scaffold_10
27,4828001,4843000,14999,False,31,scaffold_10
28,4848001,4861000,12999,False,31,scaffold_10
29,4865001,4866973,1972,True,31,scaffold_10
0,11001,33000,21999,False,31,scaffold_11
1,42001,93000,50999,False,31,scaffold_11
2,149001,167000,17999,False,31,scaffold_11
3,169001,191000,21999,False,31,scaffold_11
4,213001,235000,21999,False,31,scaffold_11
5,240001,247000,6999,False,31,scaffold_11
6,419001,431000,11999,False,31,scaffold_11
7,648001,656000,7999,False,31,scaffold_11
8,1025001,1034000,8999,False,31,scaffold_11
9,1423001,1426000,2999,False,31,scaffold_11
10,1474001,1478000,3999,False,31,scaffold_11
11,2701001,2876000,174999,False,31,scaffold_11
12,2957001,3015000,57999,False,31,scaffold_11
13,3090001,3147000,56999,False,31,scaffold_11
14,3185001,3292000,106999,False,31,scaffold_11
15,3328001,3383000,54999,False,31,scaffold_11
16,3436001,3477000,40999,False,31,scaffold_11
17,3521001,3651000,129999,False,31,scaffold_11
18,3702001,3927000,224999,False,31,scaffold_11
19,4004001,4159000,154999,False,31,scaffold_11
20,4180001,4710000,529999,False,31,scaffold_11
21,4713001,4766820,53819,True,31,scaffold_11
0,1,856000,855999,True,31,scaffold_12
1,865001,1469000,603999,False,31,scaffold_12
2,1720001,1733000,12999,False,31,scaffold_12
3,2137001,2166000,28999,False,31,scaffold_12
4,2571001,2618000,46999,False,31,scaffold_12
0,1,342000,341999,True,32,scaffold_1
1,482001,498000,15999,False,32,scaffold_1
2,571001,639000,67999,False,32,scaffold_1
3,686001,752000,65999,False,32,scaffold_1
4,1814001,1899000,84999,False,32,scaffold_1
5,1954001,1984000,29999,False,32,scaffold_1
6,1987001,2008000,20999,False,32,scaffold_1
7,2363001,2387000,23999,False,32,scaffold_1
8,2449001,2517000,67999,False,32,scaffold_1
9,2564001,2582000,17999,False,32,scaffold_1
10,2729001,2746000,16999,False,32,scaffold_1
11,3173001,3209000,35999,False,32,scaffold_1
12,3714001,3877000,162999,False,32,scaffold_1
13,3912001,3941000,28999,False,32,scaffold_1
14,4001001,4031000,29999,False,32,scaffold_1
15,4060001,4107000,46999,False,32,scaffold_1
16,4314001,4354000,39999,False,32,scaffold_1
17,4923001,5006000,82999,False,32,scaffold_1
18,5481001,5511000,29999,False,32,scaffold_1
19,5535001,5570000,34999,False,32,scaffold_1
20,6108001,6142000,33999,False,32,scaffold_1
21,6201001,6381000,179999,False,32,scaffold_1
22,6384001,6561000,176999,False,32,scaffold_1
23,7038001,7247000,208999,False,32,scaffold_1
24,7248001,7583000,334999,False,32,scaffold_1
25,7590001,8656000,1065999,False,32,scaffold_1
26,8658001,9584000,925999,False,32,scaffold_1
27,9586001,9999000,412999,False,32,scaffold_1
28,10000001,10353000,352999,False,32,scaffold_1
29,10461001,10639000,177999,False,32,scaffold_1
30,11276001,11503000,226999,False,32,scaffold_1
31,11555001,11826000,270999,False,32,scaffold_1
32,11827001,11861000,33999,False,32,scaffold_1
33,11881001,11951000,69999,False,32,scaffold_1
34,12184001,12204000,19999,False,32,scaffold_1
35,12649001,12721000,71999,False,32,scaffold_1
36,12775001,12884000,108999,False,32,scaffold_1
37,12975001,13042000,66999,False,32,scaffold_1
38,13112001,13162000,49999,False,32,scaffold_1
39,13179001,13211000,31999,False,32,scaffold_1
40,13347001,13431000,83999,False,32,scaffold_1
41,14134001,14137000,2999,False,32,scaffold_1
42,14290001,14307000,16999,False,32,scaffold_1
0,21001,48000,26999,False,32,scaffold_2
1,93001,111000,17999,False,32,scaffold_2
2,139001,159000,19999,False,32,scaffold_2
3,168001,177000,8999,False,32,scaffold_2
4,303001,318000,14999,False,32,scaffold_2
5,333001,374000,40999,False,32,scaffold_2
6,2087001,2099000,11999,False,32,scaffold_2
7,2336001,2358000,21999,False,32,scaffold_2
8,2404001,2424000,19999,False,32,scaffold_2
9,2454001,2600000,145999,False,32,scaffold_2
10,2658001,2686000,27999,False,32,scaffold_2
11,2694001,2745000,50999,False,32,scaffold_2
12,2974001,3013000,38999,False,32,scaffold_2
13,3174001,3186000,11999,False,32,scaffold_2
14,3450001,3465000,14999,False,32,scaffold_2
15,3754001,3784000,29999,False,32,scaffold_2
16,4335001,4365000,29999,False,32,scaffold_2
17,4388001,4408000,19999,False,32,scaffold_2
18,4427001,4457000,29999,False,32,scaffold_2
19,4515001,4580000,64999,False,32,scaffold_2
20,4606001,4661000,54999,False,32,scaffold_2
21,4781001,4790000,8999,False,32,scaffold_2
22,5018001,5052000,33999,False,32,scaffold_2
23,5350001,5488000,137999,False,32,scaffold_2
24,5490001,5563000,72999,False,32,scaffold_2
25,5658001,5752000,93999,False,32,scaffold_2
26,5909001,5959000,49999,False,32,scaffold_2
27,6261001,6278000,16999,False,32,scaffold_2
28,6291001,6330000,38999,False,32,scaffold_2
29,6331001,6352000,20999,False,32,scaffold_2
30,6429001,6449000,19999,False,32,scaffold_2
31,6589001,6624000,34999,False,32,scaffold_2
32,7006001,7038000,31999,False,32,scaffold_2
33,7434001,7472000,37999,False,32,scaffold_2
34,7492001,7516000,23999,False,32,scaffold_2
35,7550001,7561000,10999,False,32,scaffold_2
36,7563001,7697000,133999,False,32,scaffold_2
37,7754001,7891000,136999,False,32,scaffold_2
38,7934001,7964000,29999,False,32,scaffold_2
39,7984001,8056000,71999,False,32,scaffold_2
40,8260001,8296000,35999,False,32,scaffold_2
41,8331001,8333000,1999,False,32,scaffold_2
42,8346001,8454000,107999,False,32,scaffold_2
43,8495001,8530000,34999,False,32,scaffold_2
44,8531001,8559000,27999,False,32,scaffold_2
45,9028001,9046000,17999,False,32,scaffold_2
46,9139001,9168000,28999,False,32,scaffold_2
47,11366001,11377000,10999,False,32,scaffold_2
48,11519001,11691000,171999,False,32,scaffold_2
49,11693001,11775000,81999,False,32,scaffold_2
0,102001,104000,1999,False,32,scaffold_3
1,817001,901000,83999,False,32,scaffold_3
2,2010001,2108000,97999,False,32,scaffold_3
3,2288001,2322000,33999,False,32,scaffold_3
4,2486001,2508000,21999,False,32,scaffold_3
5,2514001,2533000,18999,False,32,scaffold_3
6,3610001,3643000,32999,False,32,scaffold_3
7,3771001,3790000,18999,False,32,scaffold_3
8,4108001,4293000,184999,False,32,scaffold_3
9,4295001,4305000,9999,False,32,scaffold_3
10,4306001,4404000,97999,False,32,scaffold_3
11,4415001,4518000,102999,False,32,scaffold_3
12,4546001,4558000,11999,False,32,scaffold_3
13,4637001,4680000,42999,False,32,scaffold_3
14,5001001,5032000,30999,False,32,scaffold_3
15,5167001,5192000,24999,False,32,scaffold_3
16,5494001,5509000,14999,False,32,scaffold_3
17,5623001,5675000,51999,False,32,scaffold_3
18,5805001,5916000,110999,False,32,scaffold_3
19,5926001,5946000,19999,False,32,scaffold_3
20,5990001,6025000,34999,False,32,scaffold_3
21,6741001,6807000,65999,False,32,scaffold_3
22,6906001,6972000,65999,False,32,scaffold_3
23,6978001,7047000,68999,False,32,scaffold_3
24,7286001,7328000,41999,False,32,scaffold_3
25,7332001,7398000,65999,False,32,scaffold_3
26,7522001,7556000,33999,False,32,scaffold_3
27,7678001,7799000,120999,False,32,scaffold_3
28,7822001,7852000,29999,False,32,scaffold_3
29,8176001,8253000,76999,False,32,scaffold_3
30,8428001,8447000,18999,False,32,scaffold_3
31,8470001,8527000,56999,False,32,scaffold_3
32,8575001,8591000,15999,False,32,scaffold_3
33,9968001,9996000,27999,False,32,scaffold_3
34,10446001,10458000,11999,False,32,scaffold_3
35,10461001,10482000,20999,False,32,scaffold_3
36,10588001,10788000,199999,False,32,scaffold_3
37,10789001,11159000,369999,False,32,scaffold_3
0,17001,32000,14999,False,32,scaffold_4
1,48001,88000,39999,False,32,scaffold_4
2,136001,146000,9999,False,32,scaffold_4
3,147001,151000,3999,False,32,scaffold_4
4,155001,160000,4999,False,32,scaffold_4
5,162001,215000,52999,False,32,scaffold_4
6,249001,266000,16999,False,32,scaffold_4
7,291001,306000,14999,False,32,scaffold_4
8,355001,374000,18999,False,32,scaffold_4
9,375001,380000,4999,False,32,scaffold_4
10,412001,425000,12999,False,32,scaffold_4
11,429001,498000,68999,False,32,scaffold_4
12,600001,606000,5999,False,32,scaffold_4
13,608001,646000,37999,False,32,scaffold_4
14,653001,658000,4999,False,32,scaffold_4
15,670001,691000,20999,False,32,scaffold_4
16,1121001,1136000,14999,False,32,scaffold_4
17,1137001,1198000,60999,False,32,scaffold_4
18,1199001,1208000,8999,False,32,scaffold_4
19,1210001,1226000,15999,False,32,scaffold_4
20,1235001,1253000,17999,False,32,scaffold_4
21,1254001,1264000,9999,False,32,scaffold_4
22,1265001,1279000,13999,False,32,scaffold_4
23,1283001,1314000,30999,False,32,scaffold_4
24,1369001,1403000,33999,False,32,scaffold_4
25,1404001,1596000,191999,False,32,scaffold_4
26,1613001,2001000,387999,False,32,scaffold_4
27,2033001,2114000,80999,False,32,scaffold_4
28,2161001,2185000,23999,False,32,scaffold_4
29,2211001,2218000,6999,False,32,scaffold_4
30,2219001,2246000,26999,False,32,scaffold_4
31,2247001,2280000,32999,False,32,scaffold_4
32,2284001,2340000,55999,False,32,scaffold_4
33,2342001,2461000,118999,False,32,scaffold_4
34,2476001,2634000,157999,False,32,scaffold_4
35,3030001,3127000,96999,False,32,scaffold_4
36,3336001,3766000,429999,False,32,scaffold_4
37,4900001,4977000,76999,False,32,scaffold_4
38,4978001,5041000,62999,False,32,scaffold_4
39,5172001,5224000,51999,False,32,scaffold_4
40,5477001,5506000,28999,False,32,scaffold_4
41,5515001,5636000,120999,False,32,scaffold_4
42,5655001,5710000,54999,False,32,scaffold_4
43,5711001,5784000,72999,False,32,scaffold_4
44,5786001,5824000,37999,False,32,scaffold_4
45,6148001,6173000,24999,False,32,scaffold_4
46,6175001,6192000,16999,False,32,scaffold_4
47,6765001,6817000,51999,False,32,scaffold_4
48,6901001,6924000,22999,False,32,scaffold_4
49,6950001,6995000,44999,False,32,scaffold_4
50,7036001,7124000,87999,False,32,scaffold_4
51,7200001,7377000,176999,False,32,scaffold_4
52,7636001,7665000,28999,False,32,scaffold_4
53,8852001,9535000,682999,False,32,scaffold_4
54,9538001,9699000,160999,False,32,scaffold_4
55,9701001,9710000,8999,False,32,scaffold_4
56,9711001,9845951,134950,True,32,scaffold_4
0,151001,173000,21999,False,32,scaffold_5
1,327001,401000,73999,False,32,scaffold_5
2,402001,416000,13999,False,32,scaffold_5
3,466001,478000,11999,False,32,scaffold_5
4,508001,523000,14999,False,32,scaffold_5
5,626001,635000,8999,False,32,scaffold_5
6,924001,947000,22999,False,32,scaffold_5
7,1062001,1068000,5999,False,32,scaffold_5
8,2510001,2515000,4999,False,32,scaffold_5
9,2563001,2746000,182999,False,32,scaffold_5
10,2816001,2867000,50999,False,32,scaffold_5
11,3133001,3178000,44999,False,32,scaffold_5
12,3216001,3509000,292999,False,32,scaffold_5
13,3963001,4101000,137999,False,32,scaffold_5
14,4119001,4219000,99999,False,32,scaffold_5
15,4246001,4321000,74999,False,32,scaffold_5
16,4446001,4506000,59999,False,32,scaffold_5
17,4603001,4681000,77999,False,32,scaffold_5
18,4691001,4764000,72999,False,32,scaffold_5
19,4765001,4770000,4999,False,32,scaffold_5
20,4820001,4858000,37999,False,32,scaffold_5
21,5249001,5274000,24999,False,32,scaffold_5
22,5320001,5344000,23999,False,32,scaffold_5
23,6478001,6656000,177999,False,32,scaffold_5
24,6888001,6906000,17999,False,32,scaffold_5
25,7559001,7619000,59999,False,32,scaffold_5
26,7620001,7720000,99999,False,32,scaffold_5
27,8553001,8616000,62999,False,32,scaffold_5
28,8659001,8689000,29999,False,32,scaffold_5
29,8713001,8773000,59999,False,32,scaffold_5
30,8774001,9364176,590175,True,32,scaffold_5
0,65001,75000,9999,False,32,scaffold_6
1,78001,85000,6999,False,32,scaffold_6
2,86001,113000,26999,False,32,scaffold_6
3,171001,207000,35999,False,32,scaffold_6
4,239001,254000,14999,False,32,scaffold_6
5,257001,262000,4999,False,32,scaffold_6
6,264001,295000,30999,False,32,scaffold_6
7,352001,376000,23999,False,32,scaffold_6
8,1234001,1265000,30999,False,32,scaffold_6
9,1428001,1459000,30999,False,32,scaffold_6
10,1478001,1546000,67999,False,32,scaffold_6
11,2030001,2086000,55999,False,32,scaffold_6
12,2124001,2214000,89999,False,32,scaffold_6
13,2334001,2595000,260999,False,32,scaffold_6
14,2596001,2654000,57999,False,32,scaffold_6
15,2655001,2679000,23999,False,32,scaffold_6
16,2712001,2851000,138999,False,32,scaffold_6
17,2934001,3016000,81999,False,32,scaffold_6
18,3099001,3191000,91999,False,32,scaffold_6
19,3223001,3367000,143999,False,32,scaffold_6
20,3407001,3427000,19999,False,32,scaffold_6
21,3458001,3521000,62999,False,32,scaffold_6
22,3522001,3565000,42999,False,32,scaffold_6
23,3566001,3765000,198999,False,32,scaffold_6
24,3898001,3913000,14999,False,32,scaffold_6
25,3969001,4193000,223999,False,32,scaffold_6
26,4836001,4868000,31999,False,32,scaffold_6
27,5945001,5971000,25999,False,32,scaffold_6
28,6010001,6089000,78999,False,32,scaffold_6
29,6124001,6189000,64999,False,32,scaffold_6
30,6776001,6804000,27999,False,32,scaffold_6
31,7263001,7339000,75999,False,32,scaffold_6
32,7392001,7436000,43999,False,32,scaffold_6
33,7531001,8268281,737280,True,32,scaffold_6
0,13001,31000,17999,False,32,scaffold_7
1,323001,340000,16999,False,32,scaffold_7
2,342001,421000,78999,False,32,scaffold_7
3,422001,509000,86999,False,32,scaffold_7
4,553001,563000,9999,False,32,scaffold_7
5,572001,577000,4999,False,32,scaffold_7
6,623001,641000,17999,False,32,scaffold_7
7,706001,753000,46999,False,32,scaffold_7
8,764001,809000,44999,False,32,scaffold_7
9,859001,864000,4999,False,32,scaffold_7
10,874001,938000,63999,False,32,scaffold_7
11,964001,966000,1999,False,32,scaffold_7
12,968001,979000,10999,False,32,scaffold_7
13,982001,1044000,61999,False,32,scaffold_7
14,1048001,1064000,15999,False,32,scaffold_7
15,1071001,1083000,11999,False,32,scaffold_7
16,1172001,1187000,14999,False,32,scaffold_7
17,1190001,1460000,269999,False,32,scaffold_7
18,1461001,1512000,50999,False,32,scaffold_7
19,1588001,1689000,100999,False,32,scaffold_7
20,3325001,3369000,43999,False,32,scaffold_7
21,3529001,3549000,19999,False,32,scaffold_7
22,3596001,3694000,97999,False,32,scaffold_7
23,4415001,4476000,60999,False,32,scaffold_7
24,4635001,4682000,46999,False,32,scaffold_7
25,4693001,4790000,96999,False,32,scaffold_7
26,4978001,5149000,170999,False,32,scaffold_7
27,5472001,5536000,63999,False,32,scaffold_7
28,6074001,6094000,19999,False,32,scaffold_7
29,6954001,7502216,548215,True,32,scaffold_7
0,66001,86000,19999,False,32,scaffold_8
1,93001,101000,7999,False,32,scaffold_8
2,869001,871000,1999,False,32,scaffold_8
3,1857001,1929000,71999,False,32,scaffold_8
4,2413001,2471000,57999,False,32,scaffold_8
5,2492001,2507000,14999,False,32,scaffold_8
6,2652001,2680000,27999,False,32,scaffold_8
7,2735001,2784000,48999,False,32,scaffold_8
8,2808001,2844000,35999,False,32,scaffold_8
9,2847001,2873000,25999,False,32,scaffold_8
10,3058001,3507000,448999,False,32,scaffold_8
11,3581001,3614000,32999,False,32,scaffold_8
12,3615001,3750000,134999,False,32,scaffold_8
13,3751001,3945000,193999,False,32,scaffold_8
14,4031001,4099000,67999,False,32,scaffold_8
15,4903001,4915000,11999,False,32,scaffold_8
16,5084001,5137000,52999,False,32,scaffold_8
17,5178001,5243000,64999,False,32,scaffold_8
18,5659001,5692000,32999,False,32,scaffold_8
19,6324001,6334544,10543,True,32,scaffold_8
0,303001,315000,11999,False,32,scaffold_9
1,367001,411000,43999,False,32,scaffold_9
2,413001,434000,20999,False,32,scaffold_9
3,517001,531000,13999,False,32,scaffold_9
4,671001,697000,25999,False,32,scaffold_9
5,731001,742000,10999,False,32,scaffold_9
6,794001,798000,3999,False,32,scaffold_9
7,815001,843000,27999,False,32,scaffold_9
8,850001,854000,3999,False,32,scaffold_9
9,873001,986000,112999,False,32,scaffold_9
10,987001,995000,7999,False,32,scaffold_9
11,1001001,1085000,83999,False,32,scaffold_9
12,1087001,1150000,62999,False,32,scaffold_9
13,1151001,1160000,8999,False,32,scaffold_9
14,1312001,1377000,64999,False,32,scaffold_9
15,1749001,1791000,41999,False,32,scaffold_9
16,1987001,2037000,49999,False,32,scaffold_9
17,2038001,2052000,13999,False,32,scaffold_9
18,2148001,2167000,18999,False,32,scaffold_9
19,2599001,2616000,16999,False,32,scaffold_9
20,2739001,2758000,18999,False,32,scaffold_9
21,2768001,2854000,85999,False,32,scaffold_9
22,2870001,3030000,159999,False,32,scaffold_9
23,3031001,3381000,349999,False,32,scaffold_9
24,3383001,5100000,1716999,False,32,scaffold_9
25,5101001,5107000,5999,False,32,scaffold_9
26,5112001,5114000,1999,False,32,scaffold_9
27,5116001,5238000,121999,False,32,scaffold_9
28,5239001,5298000,58999,False,32,scaffold_9
29,5300001,5466000,165999,False,32,scaffold_9
30,5467001,5484000,16999,False,32,scaffold_9
31,5485001,5501000,15999,False,32,scaffold_9
32,5504001,5977000,472999,False,32,scaffold_9
33,5978001,6331288,353287,True,32,scaffold_9
0,1,136000,135999,True,32,scaffold_10
1,137001,211000,73999,False,32,scaffold_10
2,260001,406000,145999,False,32,scaffold_10
3,421001,482000,60999,False,32,scaffold_10
4,483001,582000,98999,False,32,scaffold_10
5,597001,795000,197999,False,32,scaffold_10
6,888001,918000,29999,False,32,scaffold_10
7,923001,961000,37999,False,32,scaffold_10
8,1088001,1106000,17999,False,32,scaffold_10
9,1120001,1146000,25999,False,32,scaffold_10
10,2079001,2103000,23999,False,32,scaffold_10
11,2140001,2173000,32999,False,32,scaffold_10
12,2268001,2302000,33999,False,32,scaffold_10
13,2346001,2381000,34999,False,32,scaffold_10
14,2600001,2627000,26999,False,32,scaffold_10
15,4060001,4091000,30999,False,32,scaffold_10
16,4154001,4174000,19999,False,32,scaffold_10
17,4467001,4477000,9999,False,32,scaffold_10
18,4506001,4513000,6999,False,32,scaffold_10
19,4515001,4523000,7999,False,32,scaffold_10
20,4526001,4548000,21999,False,32,scaffold_10
21,4574001,4596000,21999,False,32,scaffold_10
22,4679001,4688000,8999,False,32,scaffold_10
23,4728001,4732000,3999,False,32,scaffold_10
24,4734001,4751000,16999,False,32,scaffold_10
25,4752001,4776000,23999,False,32,scaffold_10
26,4798001,4824000,25999,False,32,scaffold_10
27,4828001,4843000,14999,False,32,scaffold_10
28,4865001,4866973,1972,True,32,scaffold_10
0,10001,93000,82999,False,32,scaffold_11
1,149001,167000,17999,False,32,scaffold_11
2,169001,212000,42999,False,32,scaffold_11
3,214001,235000,20999,False,32,scaffold_11
4,240001,248000,7999,False,32,scaffold_11
5,419001,431000,11999,False,32,scaffold_11
6,649001,656000,6999,False,32,scaffold_11
7,1025001,1034000,8999,False,32,scaffold_11
8,1404001,1409000,4999,False,32,scaffold_11
9,1423001,1427000,3999,False,32,scaffold_11
10,2701001,2772000,70999,False,32,scaffold_11
11,2807001,2873000,65999,False,32,scaffold_11
12,2977001,3011000,33999,False,32,scaffold_11
13,3092001,3175000,82999,False,32,scaffold_11
14,3209001,3246000,36999,False,32,scaffold_11
15,3328001,3383000,54999,False,32,scaffold_11
16,3527001,3605000,77999,False,32,scaffold_11
17,3742001,3836000,93999,False,32,scaffold_11
18,3837001,3933000,95999,False,32,scaffold_11
19,4008001,4159000,150999,False,32,scaffold_11
20,4189001,4710000,520999,False,32,scaffold_11
21,4713001,4766820,53819,True,32,scaffold_11
0,1,67000,66999,True,32,scaffold_12
1,68001,400000,331999,False,32,scaffold_12
2,402001,854000,451999,False,32,scaffold_12
3,864001,1448000,583999,False,32,scaffold_12
4,1720001,1733000,12999,False,32,scaffold_12
5,2043001,2082000,38999,False,32,scaffold_12
6,2559001,2565000,5999,False,32,scaffold_12
7,2571001,2619000,47999,False,32,scaffold_12
8,2685001,2698000,12999,False,32,scaffold_12
0,1,336000,335999,True,33,scaffold_1
1,482001,495000,12999,False,33,scaffold_1
2,617001,642000,24999,False,33,scaffold_1
3,686001,749000,62999,False,33,scaffold_1
4,1281001,1292000,10999,False,33,scaffold_1
5,1811001,1898000,86999,False,33,scaffold_1
6,1965001,1984000,18999,False,33,scaffold_1
7,1988001,1995000,6999,False,33,scaffold_1
8,2449001,2517000,67999,False,33,scaffold_1
9,2568001,2579000,10999,False,33,scaffold_1
10,2729001,2746000,16999,False,33,scaffold_1
11,3193001,3208000,14999,False,33,scaffold_1
12,3388001,3390000,1999,False,33,scaffold_1
13,3714001,3738000,23999,False,33,scaffold_1
14,3916001,3941000,24999,False,33,scaffold_1
15,4005001,4020000,14999,False,33,scaffold_1
16,4061001,4112000,50999,False,33,scaffold_1
17,4315001,4354000,38999,False,33,scaffold_1
18,4796001,4812000,15999,False,33,scaffold_1
19,4928001,4997000,68999,False,33,scaffold_1
20,5482001,5511000,28999,False,33,scaffold_1
21,5535001,5570000,34999,False,33,scaffold_1
22,6108001,6153000,44999,False,33,scaffold_1
23,6228001,6340000,111999,False,33,scaffold_1
24,6341001,6380000,38999,False,33,scaffold_1
25,6384001,6507000,122999,False,33,scaffold_1
26,6545001,6554000,8999,False,33,scaffold_1
27,7037001,7247000,209999,False,33,scaffold_1
28,7248001,7588000,339999,False,33,scaffold_1
29,7590001,8656000,1065999,False,33,scaffold_1
30,8658001,9584000,925999,False,33,scaffold_1
31,9586001,10354000,767999,False,33,scaffold_1
32,10461001,10608000,146999,False,33,scaffold_1
33,10840001,10858000,17999,False,33,scaffold_1
34,11345001,11509000,163999,False,33,scaffold_1
35,11609001,11938000,328999,False,33,scaffold_1
36,12184001,12213000,28999,False,33,scaffold_1
37,12663001,12722000,58999,False,33,scaffold_1
38,12789001,12888000,98999,False,33,scaffold_1
39,13119001,13127000,7999,False,33,scaffold_1
40,13178001,13213000,34999,False,33,scaffold_1
41,13347001,13404000,56999,False,33,scaffold_1
42,14285001,14309000,23999,False,33,scaffold_1
0,22001,48000,25999,False,33,scaffold_2
1,117001,159000,41999,False,33,scaffold_2
2,168001,177000,8999,False,33,scaffold_2
3,302001,318000,15999,False,33,scaffold_2
4,333001,341000,7999,False,33,scaffold_2
5,342001,374000,31999,False,33,scaffold_2
6,2336001,2358000,21999,False,33,scaffold_2
7,2398001,2424000,25999,False,33,scaffold_2
8,2454001,2553000,98999,False,33,scaffold_2
9,2645001,2689000,43999,False,33,scaffold_2
10,2694001,2746000,51999,False,33,scaffold_2
11,2766001,2788000,21999,False,33,scaffold_2
12,2868001,2899000,30999,False,33,scaffold_2
13,3174001,3186000,11999,False,33,scaffold_2
14,3332001,3343000,10999,False,33,scaffold_2
15,3370001,3383000,12999,False,33,scaffold_2
16,3450001,3465000,14999,False,33,scaffold_2
17,3761001,3783000,21999,False,33,scaffold_2
18,4388001,4408000,19999,False,33,scaffold_2
19,4427001,4457000,29999,False,33,scaffold_2
20,4520001,4554000,33999,False,33,scaffold_2
21,4607001,4653000,45999,False,33,scaffold_2
22,4918001,4938000,19999,False,33,scaffold_2
23,5021001,5066000,44999,False,33,scaffold_2
24,5491001,5514000,22999,False,33,scaffold_2
25,5672001,5704000,31999,False,33,scaffold_2
26,5719001,5758000,38999,False,33,scaffold_2
27,6261001,6342000,80999,False,33,scaffold_2
28,6427001,6449000,21999,False,33,scaffold_2
29,7018001,7038000,19999,False,33,scaffold_2
30,7065001,7097000,31999,False,33,scaffold_2
31,7439001,7472000,32999,False,33,scaffold_2
32,7493001,7500000,6999,False,33,scaffold_2
33,7573001,7697000,123999,False,33,scaffold_2
34,7786001,7891000,104999,False,33,scaffold_2
35,7934001,8088000,153999,False,33,scaffold_2
36,8331001,8333000,1999,False,33,scaffold_2
37,8346001,8453000,106999,False,33,scaffold_2
38,8509001,8547000,37999,False,33,scaffold_2
39,11366001,11375000,8999,False,33,scaffold_2
40,11520001,11786000,265999,False,33,scaffold_2
0,1,2000,1999,True,33,scaffold_3
1,51001,55000,3999,False,33,scaffold_3
2,799001,901000,101999,False,33,scaffold_3
3,2084001,2108000,23999,False,33,scaffold_3
4,2291001,2321000,29999,False,33,scaffold_3
5,2487001,2533000,45999,False,33,scaffold_3
6,3768001,3821000,52999,False,33,scaffold_3
7,3822001,3890000,67999,False,33,scaffold_3
8,4148001,4401000,252999,False,33,scaffold_3
9,4423001,4518000,94999,False,33,scaffold_3
10,4638001,4686000,47999,False,33,scaffold_3
11,5494001,5509000,14999,False,33,scaffold_3
12,5990001,6020000,29999,False,33,scaffold_3
13,6910001,6962000,51999,False,33,scaffold_3
14,6978001,7078000,99999,False,33,scaffold_3
15,7371001,7396000,24999,False,33,scaffold_3
16,7520001,7556000,35999,False,33,scaffold_3
17,7692001,7799000,106999,False,33,scaffold_3
18,7818001,7838000,19999,False,33,scaffold_3
19,8184001,8253000,68999,False,33,scaffold_3
20,8462001,8527000,64999,False,33,scaffold_3
21,8575001,8593000,17999,False,33,scaffold_3
22,9968001,10000000,31999,False,33,scaffold_3
23,10552001,10571000,18999,False,33,scaffold_3
24,10574001,11165000,590999,False,33,scaffold_3
0,17001,32000,14999,False,33,scaffold_4
1,48001,88000,39999,False,33,scaffold_4
2,120001,146000,25999,False,33,scaffold_4
3,147001,151000,3999,False,33,scaffold_4
4,155001,215000,59999,False,33,scaffold_4
5,217001,226000,8999,False,33,scaffold_4
6,227001,264000,36999,False,33,scaffold_4
7,295001,307000,11999,False,33,scaffold_4
8,355001,374000,18999,False,33,scaffold_4
9,375001,380000,4999,False,33,scaffold_4
10,412001,425000,12999,False,33,scaffold_4
11,429001,502000,72999,False,33,scaffold_4
12,543001,592000,48999,False,33,scaffold_4
13,600001,606000,5999,False,33,scaffold_4
14,608001,691000,82999,False,33,scaffold_4
15,1087001,1097000,9999,False,33,scaffold_4
16,1121001,1136000,14999,False,33,scaffold_4
17,1137001,1178000,40999,False,33,scaffold_4
18,1199001,1208000,8999,False,33,scaffold_4
19,1210001,1226000,15999,False,33,scaffold_4
20,1283001,1337000,53999,False,33,scaffold_4
21,1358001,1596000,237999,False,33,scaffold_4
22,1613001,1855000,241999,False,33,scaffold_4
23,1904001,2003000,98999,False,33,scaffold_4
24,2016001,2065000,48999,False,33,scaffold_4
25,2071001,2116000,44999,False,33,scaffold_4
26,2265001,2279000,13999,False,33,scaffold_4
27,2284001,2340000,55999,False,33,scaffold_4
28,2342001,2352000,9999,False,33,scaffold_4
29,2391001,2445000,53999,False,33,scaffold_4
30,2447001,2461000,13999,False,33,scaffold_4
31,2476001,2582000,105999,False,33,scaffold_4
32,2618001,2634000,15999,False,33,scaffold_4
33,3336001,3633000,296999,False,33,scaffold_4
34,3646001,3760000,113999,False,33,scaffold_4
35,4055001,4071000,15999,False,33,scaffold_4
36,4942001,4996000,53999,False,33,scaffold_4
37,5344001,5354000,9999,False,33,scaffold_4
38,5476001,5506000,29999,False,33,scaffold_4
39,5516001,5620000,103999,False,33,scaffold_4
40,5698001,5784000,85999,False,33,scaffold_4
41,5786001,5816000,29999,False,33,scaffold_4
42,6798001,6817000,18999,False,33,scaffold_4
43,6896001,6924000,27999,False,33,scaffold_4
44,7641001,7666000,24999,False,33,scaffold_4
45,8845001,9699000,853999,False,33,scaffold_4
46,9703001,9845951,142950,True,33,scaffold_4
0,1,5000,4999,True,33,scaffold_5
1,189001,204000,14999,False,33,scaffold_5
2,296001,299000,2999,False,33,scaffold_5
3,318001,386000,67999,False,33,scaffold_5
4,463001,523000,59999,False,33,scaffold_5
5,933001,947000,13999,False,33,scaffold_5
6,1062001,1068000,5999,False,33,scaffold_5
7,2477001,2493000,15999,False,33,scaffold_5
8,2570001,2581000,10999,False,33,scaffold_5
9,2618001,2753000,134999,False,33,scaffold_5
10,2813001,2871000,57999,False,33,scaffold_5
11,3129001,3186000,56999,False,33,scaffold_5
12,3322001,3511000,188999,False,33,scaffold_5
13,3962001,4101000,138999,False,33,scaffold_5
14,4121001,4220000,98999,False,33,scaffold_5
15,4445001,4483000,37999,False,33,scaffold_5
16,4601001,4681000,79999,False,33,scaffold_5
17,4690001,4717000,26999,False,33,scaffold_5
18,4766001,4862000,95999,False,33,scaffold_5
19,4892001,4923000,30999,False,33,scaffold_5
20,5318001,5346000,27999,False,33,scaffold_5
21,6540001,6653000,112999,False,33,scaffold_5
22,6888001,6905000,16999,False,33,scaffold_5
23,7454001,7483000,28999,False,33,scaffold_5
24,7579001,7611000,31999,False,33,scaffold_5
25,7622001,7654000,31999,False,33,scaffold_5
26,8572001,8615000,42999,False,33,scaffold_5
27,8730001,9363000,632999,False,33,scaffold_5
28,9364001,9364176,175,True,33,scaffold_5
0,79001,84000,4999,False,33,scaffold_6
1,86001,112000,25999,False,33,scaffold_6
2,238001,254000,15999,False,33,scaffold_6
3,257001,262000,4999,False,33,scaffold_6
4,267001,283000,15999,False,33,scaffold_6
5,1479001,1553000,73999,False,33,scaffold_6
6,1557001,1583000,25999,False,33,scaffold_6
7,1871001,1906000,34999,False,33,scaffold_6
8,2037001,2085000,47999,False,33,scaffold_6
9,2130001,2194000,63999,False,33,scaffold_6
10,2371001,2593000,221999,False,33,scaffold_6
11,2596001,2653000,56999,False,33,scaffold_6
12,2657001,2691000,33999,False,33,scaffold_6
13,2712001,2872000,159999,False,33,scaffold_6
14,2927001,3014000,86999,False,33,scaffold_6
15,3115001,3176000,60999,False,33,scaffold_6
16,3224001,3299000,74999,False,33,scaffold_6
17,3461001,3768000,306999,False,33,scaffold_6
18,3772001,3785000,12999,False,33,scaffold_6
19,4017001,4066000,48999,False,33,scaffold_6
20,4067001,4072000,4999,False,33,scaffold_6
21,4073001,4195000,121999,False,33,scaffold_6
22,6011001,6062000,50999,False,33,scaffold_6
23,7269001,7337000,67999,False,33,scaffold_6
24,7389001,7414000,24999,False,33,scaffold_6
25,7554001,7717000,162999,False,33,scaffold_6
26,7732001,8268281,536280,True,33,scaffold_6
0,1,8000,7999,True,33,scaffold_7
1,13001,34000,20999,False,33,scaffold_7
2,323001,340000,16999,False,33,scaffold_7
3,342001,505000,162999,False,33,scaffold_7
4,554001,563000,8999,False,33,scaffold_7
5,570001,577000,6999,False,33,scaffold_7
6,706001,724000,17999,False,33,scaffold_7
7,725001,736000,10999,False,33,scaffold_7
8,743001,753000,9999,False,33,scaffold_7
9,764001,843000,78999,False,33,scaffold_7
10,859001,864000,4999,False,33,scaffold_7
11,982001,1044000,61999,False,33,scaffold_7
12,1067001,1104000,36999,False,33,scaffold_7
13,1204001,1460000,255999,False,33,scaffold_7
14,1461001,1512000,50999,False,33,scaffold_7
15,1588001,1689000,100999,False,33,scaffold_7
16,3326001,3369000,42999,False,33,scaffold_7
17,3524001,3548000,23999,False,33,scaffold_7
18,3593001,3662000,68999,False,33,scaffold_7
19,4416001,4512000,95999,False,33,scaffold_7
20,4658001,4733000,74999,False,33,scaffold_7
21,5035001,5147000,111999,False,33,scaffold_7
22,5472001,5516000,43999,False,33,scaffold_7
23,6070001,6094000,23999,False,33,scaffold_7
24,6955001,7502216,547215,True,33,scaffold_7
0,67001,85000,17999,False,33,scaffold_8
1,92001,103000,10999,False,33,scaffold_8
2,722001,724000,1999,False,33,scaffold_8
3,2444001,2471000,26999,False,33,scaffold_8
4,2491001,2530000,38999,False,33,scaffold_8
5,2536001,2551000,14999,False,33,scaffold_8
6,2652001,2683000,30999,False,33,scaffold_8
7,2741001,2757000,15999,False,33,scaffold_8
8,2798001,2844000,45999,False,33,scaffold_8
9,3058001,3525000,466999,False,33,scaffold_8
10,3584001,3611000,26999,False,33,scaffold_8
11,3623001,3945000,321999,False,33,scaffold_8
12,5123001,5135000,11999,False,33,scaffold_8
13,5187001,5241000,53999,False,33,scaffold_8
14,5678001,5691000,12999,False,33,scaffold_8
15,6322001,6334544,12543,True,33,scaffold_8
0,2001,15000,12999,False,33,scaffold_9
1,303001,316000,12999,False,33,scaffold_9
2,374001,411000,36999,False,33,scaffold_9
3,413001,434000,20999,False,33,scaffold_9
4,501001,531000,29999,False,33,scaffold_9
5,548001,560000,11999,False,33,scaffold_9
6,671001,696000,24999,False,33,scaffold_9
7,732001,742000,9999,False,33,scaffold_9
8,815001,842000,26999,False,33,scaffold_9
9,873001,984000,110999,False,33,scaffold_9
10,988001,995000,6999,False,33,scaffold_9
11,1001001,1007000,5999,False,33,scaffold_9
12,1010001,1031000,20999,False,33,scaffold_9
13,1036001,1085000,48999,False,33,scaffold_9
14,1087001,1150000,62999,False,33,scaffold_9
15,1151001,1164000,12999,False,33,scaffold_9
16,1312001,1377000,64999,False,33,scaffold_9
17,1766001,1791000,24999,False,33,scaffold_9
18,2601001,2616000,14999,False,33,scaffold_9
19,2782001,2823000,40999,False,33,scaffold_9
20,2845001,3381000,535999,False,33,scaffold_9
21,3383001,5107000,1723999,False,33,scaffold_9
22,5112001,5115000,2999,False,33,scaffold_9
23,5116001,5238000,121999,False,33,scaffold_9
24,5239001,5298000,58999,False,33,scaffold_9
25,5299001,5490000,190999,False,33,scaffold_9
26,5493001,6135000,641999,False,33,scaffold_9
27,6136001,6331288,195287,True,33,scaffold_9
0,1,201000,200999,True,33,scaffold_10
1,371001,482000,110999,False,33,scaffold_10
2,483001,582000,98999,False,33,scaffold_10
3,603001,794000,190999,False,33,scaffold_10
4,888001,917000,28999,False,33,scaffold_10
5,923001,963000,39999,False,33,scaffold_10
6,1073001,1111000,37999,False,33,scaffold_10
7,2141001,2170000,28999,False,33,scaffold_10
8,4054001,4091000,36999,False,33,scaffold_10
9,4154001,4184000,29999,False,33,scaffold_10
10,4443001,4462000,18999,False,33,scaffold_10
11,4467001,4477000,9999,False,33,scaffold_10
12,4503001,4513000,9999,False,33,scaffold_10
13,4515001,4523000,7999,False,33,scaffold_10
14,4526001,4548000,21999,False,33,scaffold_10
15,4554001,4562000,7999,False,33,scaffold_10
16,4574001,4595000,20999,False,33,scaffold_10
17,4679001,4688000,8999,False,33,scaffold_10
18,4734001,4751000,16999,False,33,scaffold_10
19,4752001,4767000,14999,False,33,scaffold_10
20,4768001,4776000,7999,False,33,scaffold_10
21,4798001,4824000,25999,False,33,scaffold_10
22,4827001,4843000,15999,False,33,scaffold_10
23,4848001,4861000,12999,False,33,scaffold_10
24,4865001,4866973,1972,True,33,scaffold_10
0,9001,93000,83999,False,33,scaffold_11
1,149001,167000,17999,False,33,scaffold_11
2,169001,190000,20999,False,33,scaffold_11
3,240001,252000,11999,False,33,scaffold_11
4,419001,431000,11999,False,33,scaffold_11
5,649001,656000,6999,False,33,scaffold_11
6,1025001,1034000,8999,False,33,scaffold_11
7,1305001,1307000,1999,False,33,scaffold_11
8,1423001,1426000,2999,False,33,scaffold_11
9,2701001,2872000,170999,False,33,scaffold_11
10,3193001,3259000,65999,False,33,scaffold_11
11,3331001,3381000,49999,False,33,scaffold_11
12,3744001,3933000,188999,False,33,scaffold_11
13,4133001,4159000,25999,False,33,scaffold_11
14,4289001,4384000,94999,False,33,scaffold_11
15,4393001,4710000,316999,False,33,scaffold_11
16,4713001,4766820,53819,True,33,scaffold_11
0,1,369000,368999,True,33,scaffold_12
1,404001,856000,451999,False,33,scaffold_12
2,865001,1313000,447999,False,33,scaffold_12
3,1315001,1449000,133999,False,33,scaffold_12
4,2571001,2619000,47999,False,33,scaffold_12
0,1,340000,339999,True,34,scaffold_1
1,482001,498000,15999,False,34,scaffold_1
2,574001,643000,68999,False,34,scaffold_1
3,686001,713000,26999,False,34,scaffold_1
4,728001,743000,14999,False,34,scaffold_1
5,1281001,1292000,10999,False,34,scaffold_1
6,1954001,1964000,9999,False,34,scaffold_1
7,1965001,1984000,18999,False,34,scaffold_1
8,2449001,2517000,67999,False,34,scaffold_1
9,2729001,2746000,16999,False,34,scaffold_1
10,3181001,3208000,26999,False,34,scaffold_1
11,3715001,3733000,17999,False,34,scaffold_1
12,3916001,3941000,24999,False,34,scaffold_1
13,4065001,4111000,45999,False,34,scaffold_1
14,4322001,4354000,31999,False,34,scaffold_1
15,4928001,4984000,55999,False,34,scaffold_1
16,5484001,5511000,26999,False,34,scaffold_1
17,6108001,6153000,44999,False,34,scaffold_1
18,6228001,6318000,89999,False,34,scaffold_1
19,6332001,6381000,48999,False,34,scaffold_1
20,6384001,6507000,122999,False,34,scaffold_1
21,6545001,6554000,8999,False,34,scaffold_1
22,7038001,7247000,208999,False,34,scaffold_1
23,7248001,7584000,335999,False,34,scaffold_1
24,7590001,8656000,1065999,False,34,scaffold_1
25,8658001,9584000,925999,False,34,scaffold_1
26,9586001,10354000,767999,False,34,scaffold_1
27,10461001,10630000,168999,False,34,scaffold_1
28,10808001,10811000,2999,False,34,scaffold_1
29,10836001,10858000,21999,False,34,scaffold_1
30,11351001,11504000,152999,False,34,scaffold_1
31,11615001,11951000,335999,False,34,scaffold_1
32,12184001,12204000,19999,False,34,scaffold_1
33,12668001,12722000,53999,False,34,scaffold_1
34,12777001,12888000,110999,False,34,scaffold_1
35,13181001,13211000,29999,False,34,scaffold_1
36,13347001,13377000,29999,False,34,scaffold_1
0,1,48000,47999,True,34,scaffold_2
1,93001,159000,65999,False,34,scaffold_2
2,168001,177000,8999,False,34,scaffold_2
3,303001,318000,14999,False,34,scaffold_2
4,330001,374000,43999,False,34,scaffold_2
5,2336001,2358000,21999,False,34,scaffold_2
6,2404001,2424000,19999,False,34,scaffold_2
7,2441001,2553000,111999,False,34,scaffold_2
8,2660001,2689000,28999,False,34,scaffold_2
9,2694001,2742000,47999,False,34,scaffold_2
10,3454001,3463000,8999,False,34,scaffold_2
11,3767001,3782000,14999,False,34,scaffold_2
12,4385001,4409000,23999,False,34,scaffold_2
13,4429001,4456000,26999,False,34,scaffold_2
14,4525001,4553000,27999,False,34,scaffold_2
15,4608001,4653000,44999,False,34,scaffold_2
16,4783001,4790000,6999,False,34,scaffold_2
17,5022001,5031000,8999,False,34,scaffold_2
18,5033001,5061000,27999,False,34,scaffold_2
19,5491001,5511000,19999,False,34,scaffold_2
20,5672001,5704000,31999,False,34,scaffold_2
21,6261001,6330000,68999,False,34,scaffold_2
22,6331001,6350000,18999,False,34,scaffold_2
23,7439001,7472000,32999,False,34,scaffold_2
24,7563001,7697000,133999,False,34,scaffold_2
25,7786001,7890000,103999,False,34,scaffold_2
26,7934001,7969000,34999,False,34,scaffold_2
27,7982001,8088000,105999,False,34,scaffold_2
28,8331001,8333000,1999,False,34,scaffold_2
29,8346001,8389000,42999,False,34,scaffold_2
30,8509001,8535000,25999,False,34,scaffold_2
31,11367001,11373000,5999,False,34,scaffold_2
32,11520001,11785000,264999,False,34,scaffold_2
0,1,2000,1999,True,34,scaffold_3
1,51001,55000,3999,False,34,scaffold_3
2,102001,104000,1999,False,34,scaffold_3
3,799001,900000,100999,False,34,scaffold_3
4,2085001,2108000,22999,False,34,scaffold_3
5,2291001,2321000,29999,False,34,scaffold_3
6,2508001,2533000,24999,False,34,scaffold_3
7,4150001,4383000,232999,False,34,scaffold_3
8,4418001,4518000,99999,False,34,scaffold_3
9,4547001,4558000,10999,False,34,scaffold_3
10,4654001,4678000,23999,False,34,scaffold_3
11,6911001,6962000,50999,False,34,scaffold_3
12,6980001,7036000,55999,False,34,scaffold_3
13,7540001,7556000,15999,False,34,scaffold_3
14,7692001,7724000,31999,False,34,scaffold_3
15,7822001,7838000,15999,False,34,scaffold_3
16,8462001,8527000,64999,False,34,scaffold_3
17,8575001,8594000,18999,False,34,scaffold_3
18,9968001,9996000,27999,False,34,scaffold_3
19,10461001,10480000,18999,False,34,scaffold_3
20,10587001,11162000,574999,False,34,scaffold_3
0,17001,32000,14999,False,34,scaffold_4
1,48001,86000,37999,False,34,scaffold_4
2,155001,160000,4999,False,34,scaffold_4
3,161001,215000,53999,False,34,scaffold_4
4,217001,226000,8999,False,34,scaffold_4
5,227001,266000,38999,False,34,scaffold_4
6,320001,344000,23999,False,34,scaffold_4
7,355001,374000,18999,False,34,scaffold_4
8,375001,380000,4999,False,34,scaffold_4
9,412001,425000,12999,False,34,scaffold_4
10,429001,500000,70999,False,34,scaffold_4
11,545001,599000,53999,False,34,scaffold_4
12,600001,606000,5999,False,34,scaffold_4
13,608001,661000,52999,False,34,scaffold_4
14,670001,691000,20999,False,34,scaffold_4
15,1121001,1136000,14999,False,34,scaffold_4
16,1137001,1178000,40999,False,34,scaffold_4
17,1199001,1208000,8999,False,34,scaffold_4
18,1210001,1226000,15999,False,34,scaffold_4
19,1254001,1262000,7999,False,34,scaffold_4
20,1265001,1279000,13999,False,34,scaffold_4
21,1283001,1314000,30999,False,34,scaffold_4
22,1373001,1591000,217999,False,34,scaffold_4
23,1749001,1817000,67999,False,34,scaffold_4
24,1932001,1957000,24999,False,34,scaffold_4
25,2036001,2065000,28999,False,34,scaffold_4
26,2284001,2340000,55999,False,34,scaffold_4
27,2480001,2533000,52999,False,34,scaffold_4
28,3336001,3632000,295999,False,34,scaffold_4
29,3676001,3760000,83999,False,34,scaffold_4
30,4944001,4984000,39999,False,34,scaffold_4
31,5477001,5506000,28999,False,34,scaffold_4
32,5514001,5620000,105999,False,34,scaffold_4
33,5669001,5784000,114999,False,34,scaffold_4
34,6807001,6817000,9999,False,34,scaffold_4
35,7037001,7062000,24999,False,34,scaffold_4
36,8849001,9699000,849999,False,34,scaffold_4
37,9700001,9845951,145950,True,34,scaffold_4
0,189001,204000,14999,False,34,scaffold_5
1,318001,326000,7999,False,34,scaffold_5
2,327001,368000,40999,False,34,scaffold_5
3,469001,480000,10999,False,34,scaffold_5
4,498001,523000,24999,False,34,scaffold_5
5,836001,838000,1999,False,34,scaffold_5
6,839001,842000,2999,False,34,scaffold_5
7,933001,947000,13999,False,34,scaffold_5
8,2565001,2581000,15999,False,34,scaffold_5
9,2649001,2732000,82999,False,34,scaffold_5
10,2816001,2871000,54999,False,34,scaffold_5
11,3138001,3185000,46999,False,34,scaffold_5
12,3322001,3438000,115999,False,34,scaffold_5
13,3451001,3497000,45999,False,34,scaffold_5
14,3962001,4101000,138999,False,34,scaffold_5
15,4121001,4142000,20999,False,34,scaffold_5
16,4155001,4219000,63999,False,34,scaffold_5
17,4246001,4262000,15999,False,34,scaffold_5
18,4446001,4483000,36999,False,34,scaffold_5
19,4601001,4650000,48999,False,34,scaffold_5
20,4691001,4717000,25999,False,34,scaffold_5
21,4792001,4861000,68999,False,34,scaffold_5
22,4904001,4917000,12999,False,34,scaffold_5
23,5318001,5346000,27999,False,34,scaffold_5
24,7097001,7100000,2999,False,34,scaffold_5
25,7582001,7608000,25999,False,34,scaffold_5
26,8730001,9363000,632999,False,34,scaffold_5
0,79001,84000,4999,False,34,scaffold_6
1,86001,112000,25999,False,34,scaffold_6
2,241001,253000,11999,False,34,scaffold_6
3,257001,262000,4999,False,34,scaffold_6
4,267001,278000,10999,False,34,scaffold_6
5,1229001,1261000,31999,False,34,scaffold_6
6,1479001,1546000,66999,False,34,scaffold_6
7,2023001,2086000,62999,False,34,scaffold_6
8,2130001,2169000,38999,False,34,scaffold_6
9,2371001,2595000,223999,False,34,scaffold_6
10,2596001,2653000,56999,False,34,scaffold_6
11,2657001,2691000,33999,False,34,scaffold_6
12,2731001,2852000,120999,False,34,scaffold_6
13,2936001,3014000,77999,False,34,scaffold_6
14,3115001,3149000,33999,False,34,scaffold_6
15,3224001,3301000,76999,False,34,scaffold_6
16,3408001,3427000,18999,False,34,scaffold_6
17,3462001,3521000,58999,False,34,scaffold_6
18,3527001,3766000,238999,False,34,scaffold_6
19,3901001,3912000,10999,False,34,scaffold_6
20,4019001,4040000,20999,False,34,scaffold_6
21,4086001,4193000,106999,False,34,scaffold_6
22,6011001,6060000,48999,False,34,scaffold_6
23,7269001,7337000,67999,False,34,scaffold_6
24,7560001,7795000,234999,False,34,scaffold_6
25,7811001,8268281,457280,True,34,scaffold_6
0,13001,31000,17999,False,34,scaffold_7
1,243001,249000,5999,False,34,scaffold_7
2,323001,340000,16999,False,34,scaffold_7
3,342001,508000,165999,False,34,scaffold_7
4,554001,563000,8999,False,34,scaffold_7
5,571001,577000,5999,False,34,scaffold_7
6,706001,736000,29999,False,34,scaffold_7
7,741001,753000,11999,False,34,scaffold_7
8,764001,809000,44999,False,34,scaffold_7
9,859001,864000,4999,False,34,scaffold_7
10,964001,966000,1999,False,34,scaffold_7
11,968001,980000,11999,False,34,scaffold_7
12,982001,1044000,61999,False,34,scaffold_7
13,1203001,1512000,308999,False,34,scaffold_7
14,1588001,1689000,100999,False,34,scaffold_7
15,3326001,3370000,43999,False,34,scaffold_7
16,3596001,3649000,52999,False,34,scaffold_7
17,4419001,4517000,97999,False,34,scaffold_7
18,4658001,4681000,22999,False,34,scaffold_7
19,4981001,5027000,45999,False,34,scaffold_7
20,5077001,5111000,33999,False,34,scaffold_7
21,6955001,7270000,314999,False,34,scaffold_7
22,7271001,7502216,231215,True,34,scaffold_7
0,67001,85000,17999,False,34,scaffold_8
1,2656001,2683000,26999,False,34,scaffold_8
2,2745001,2756000,10999,False,34,scaffold_8
3,3060001,3525000,464999,False,34,scaffold_8
4,3584001,3612000,27999,False,34,scaffold_8
5,3615001,3913000,297999,False,34,scaffold_8
6,5200001,5241000,40999,False,34,scaffold_8
0,109001,117000,7999,False,34,scaffold_9
1,303001,315000,11999,False,34,scaffold_9
2,367001,411000,43999,False,34,scaffold_9
3,413001,434000,20999,False,34,scaffold_9
4,502001,531000,28999,False,34,scaffold_9
5,670001,696000,25999,False,34,scaffold_9
6,732001,742000,9999,False,34,scaffold_9
7,816001,842000,25999,False,34,scaffold_9
8,873001,986000,112999,False,34,scaffold_9
9,987001,995000,7999,False,34,scaffold_9
10,1001001,1007000,5999,False,34,scaffold_9
11,1010001,1031000,20999,False,34,scaffold_9
12,1036001,1083000,46999,False,34,scaffold_9
13,1087001,1150000,62999,False,34,scaffold_9
14,1151001,1164000,12999,False,34,scaffold_9
15,1312001,1377000,64999,False,34,scaffold_9
16,1770001,1783000,12999,False,34,scaffold_9
17,2600001,2616000,15999,False,34,scaffold_9
18,2870001,3381000,510999,False,34,scaffold_9
19,3383001,5099000,1715999,False,34,scaffold_9
20,5101001,5107000,5999,False,34,scaffold_9
21,5112001,5115000,2999,False,34,scaffold_9
22,5116001,5237000,120999,False,34,scaffold_9
23,5239001,5298000,58999,False,34,scaffold_9
24,5300001,6331288,1031287,True,34,scaffold_9
0,1,136000,135999,True,34,scaffold_10
1,137001,197000,59999,False,34,scaffold_10
2,375001,405000,29999,False,34,scaffold_10
3,472001,482000,9999,False,34,scaffold_10
4,508001,576000,67999,False,34,scaffold_10
5,603001,753000,149999,False,34,scaffold_10
6,888001,917000,28999,False,34,scaffold_10
7,924001,962000,37999,False,34,scaffold_10
8,1087001,1105000,17999,False,34,scaffold_10
9,2347001,2364000,16999,False,34,scaffold_10
10,4053001,4091000,37999,False,34,scaffold_10
11,4154001,4174000,19999,False,34,scaffold_10
12,4515001,4523000,7999,False,34,scaffold_10
13,4526001,4548000,21999,False,34,scaffold_10
14,4574001,4596000,21999,False,34,scaffold_10
15,4679001,4688000,8999,False,34,scaffold_10
16,4734001,4766000,31999,False,34,scaffold_10
17,4769001,4776000,6999,False,34,scaffold_10
18,4798001,4824000,25999,False,34,scaffold_10
19,4828001,4843000,14999,False,34,scaffold_10
20,4848001,4861000,12999,False,34,scaffold_10
21,4865001,4866973,1972,True,34,scaffold_10
0,10001,34000,23999,False,34,scaffold_11
1,38001,92000,53999,False,34,scaffold_11
2,149001,167000,17999,False,34,scaffold_11
3,169001,191000,21999,False,34,scaffold_11
4,213001,235000,21999,False,34,scaffold_11
5,240001,247000,6999,False,34,scaffold_11
6,419001,431000,11999,False,34,scaffold_11
7,648001,656000,7999,False,34,scaffold_11
8,1025001,1034000,8999,False,34,scaffold_11
9,2701001,2873000,171999,False,34,scaffold_11
10,3205001,3254000,48999,False,34,scaffold_11
11,3331001,3380000,48999,False,34,scaffold_11
12,3702001,3926000,223999,False,34,scaffold_11
13,4322001,4710000,387999,False,34,scaffold_11
14,4713001,4766820,53819,True,34,scaffold_11
0,1,240000,239999,True,34,scaffold_12
1,291001,369000,77999,False,34,scaffold_12
2,474001,537000,62999,False,34,scaffold_12
3,582001,731000,148999,False,34,scaffold_12
4,739001,856000,116999,False,34,scaffold_12
5,865001,1354000,488999,False,34,scaffold_12
6,1720001,1733000,12999,False,34,scaffold_12
7,2571001,2618000,46999,False,34,scaffold_12
0,1,357000,356999,True,35,scaffold_1
1,376001,396000,19999,False,35,scaffold_1
2,482001,498000,15999,False,35,scaffold_1
3,571001,643000,71999,False,35,scaffold_1
4,686001,784000,97999,False,35,scaffold_1
5,793001,942000,148999,False,35,scaffold_1
6,1168001,1195000,26999,False,35,scaffold_1
7,1281001,1292000,10999,False,35,scaffold_1
8,1613001,1660000,46999,False,35,scaffold_1
9,1661001,1696000,34999,False,35,scaffold_1
10,1728001,1964000,235999,False,35,scaffold_1
11,1965001,1985000,19999,False,35,scaffold_1
12,1987001,2015000,27999,False,35,scaffold_1
13,2346001,2387000,40999,False,35,scaffold_1
14,2449001,2519000,69999,False,35,scaffold_1
15,2564001,2580000,15999,False,35,scaffold_1
16,2717001,2746000,28999,False,35,scaffold_1
17,2902001,2921000,18999,False,35,scaffold_1
18,2962001,3023000,60999,False,35,scaffold_1
19,3170001,3240000,69999,False,35,scaffold_1
20,3442001,3499000,56999,False,35,scaffold_1
21,3711001,4168000,456999,False,35,scaffold_1
22,4255001,4302000,46999,False,35,scaffold_1
23,4304001,4558000,253999,False,35,scaffold_1
24,4639001,4795000,155999,False,35,scaffold_1
25,4796001,5066000,269999,False,35,scaffold_1
26,5087001,5119000,31999,False,35,scaffold_1
27,5144001,5155000,10999,False,35,scaffold_1
28,5163001,5202000,38999,False,35,scaffold_1
29,5343001,5377000,33999,False,35,scaffold_1
30,5437001,5463000,25999,False,35,scaffold_1
31,5481001,5521000,39999,False,35,scaffold_1
32,5535001,5598000,62999,False,35,scaffold_1
33,5859001,5871000,11999,False,35,scaffold_1
34,5898001,5910000,11999,False,35,scaffold_1
35,6108001,6153000,44999,False,35,scaffold_1
36,6154001,6177000,22999,False,35,scaffold_1
37,6201001,6380000,178999,False,35,scaffold_1
38,6383001,6575000,191999,False,35,scaffold_1
39,6810001,6852000,41999,False,35,scaffold_1
40,6923001,6953000,29999,False,35,scaffold_1
41,6973001,6991000,17999,False,35,scaffold_1
42,7038001,7247000,208999,False,35,scaffold_1
43,7248001,7531000,282999,False,35,scaffold_1
44,7532001,7589000,56999,False,35,scaffold_1
45,7590001,8656000,1065999,False,35,scaffold_1
46,8658001,9584000,925999,False,35,scaffold_1
47,9586001,10370000,783999,False,35,scaffold_1
48,10437001,10637000,199999,False,35,scaffold_1
49,10837001,10857000,19999,False,35,scaffold_1
50,10896001,10986000,89999,False,35,scaffold_1
51,11013001,11072000,58999,False,35,scaffold_1
52,11123001,11228000,104999,False,35,scaffold_1
53,11266001,11509000,242999,False,35,scaffold_1
54,11550001,11964000,413999,False,35,scaffold_1
55,12184001,12242000,57999,False,35,scaffold_1
56,12330001,12372000,41999,False,35,scaffold_1
57,12420001,12950000,529999,False,35,scaffold_1
58,12965001,13068000,102999,False,35,scaffold_1
59,13102001,13215000,112999,False,35,scaffold_1
60,13347001,13496000,148999,False,35,scaffold_1
61,13517001,13538000,20999,False,35,scaffold_1
62,13550001,13590000,39999,False,35,scaffold_1
63,13668001,13709000,40999,False,35,scaffold_1
64,13784001,13845000,60999,False,35,scaffold_1
65,13846001,13864000,17999,False,35,scaffold_1
66,13865001,13927000,61999,False,35,scaffold_1
67,13928001,13954000,25999,False,35,scaffold_1
68,13959001,13977000,17999,False,35,scaffold_1
69,14007001,14064000,56999,False,35,scaffold_1
70,14285001,14309000,23999,False,35,scaffold_1
71,14530001,14591000,60999,False,35,scaffold_1
72,14650001,14664000,13999,False,35,scaffold_1
73,14770001,14794116,24115,True,35,scaffold_1
0,22001,48000,25999,False,35,scaffold_2
1,95001,159000,63999,False,35,scaffold_2
2,165001,177000,11999,False,35,scaffold_2
3,178001,184000,5999,False,35,scaffold_2
4,297001,318000,20999,False,35,scaffold_2
5,333001,374000,40999,False,35,scaffold_2
6,379001,381000,1999,False,35,scaffold_2
7,392001,405000,12999,False,35,scaffold_2
8,479001,546000,66999,False,35,scaffold_2
9,559001,584000,24999,False,35,scaffold_2
10,732001,739000,6999,False,35,scaffold_2
11,1233001,1254000,20999,False,35,scaffold_2
12,1310001,1416000,105999,False,35,scaffold_2
13,1438001,1557000,118999,False,35,scaffold_2
14,1625001,1658000,32999,False,35,scaffold_2
15,1693001,1720000,26999,False,35,scaffold_2
16,1836001,1861000,24999,False,35,scaffold_2
17,1875001,1900000,24999,False,35,scaffold_2
18,2085001,2132000,46999,False,35,scaffold_2
19,2222001,2245000,22999,False,35,scaffold_2
20,2302001,2334000,31999,False,35,scaffold_2
21,2336001,2600000,263999,False,35,scaffold_2
22,2626001,2639000,12999,False,35,scaffold_2
23,2658001,2689000,30999,False,35,scaffold_2
24,2694001,2747000,52999,False,35,scaffold_2
25,2766001,2857000,90999,False,35,scaffold_2
26,2868001,3021000,152999,False,35,scaffold_2
27,3022001,3065000,42999,False,35,scaffold_2
28,3226001,3284000,57999,False,35,scaffold_2
29,3294001,3390000,95999,False,35,scaffold_2
30,3450001,3696000,245999,False,35,scaffold_2
31,3754001,3828000,73999,False,35,scaffold_2
32,3884001,3946000,61999,False,35,scaffold_2
33,4008001,4038000,29999,False,35,scaffold_2
34,4243001,4409000,165999,False,35,scaffold_2
35,4426001,4458000,31999,False,35,scaffold_2
36,4474001,4791000,316999,False,35,scaffold_2
37,4793001,4810000,16999,False,35,scaffold_2
38,4917001,4969000,51999,False,35,scaffold_2
39,5020001,5031000,10999,False,35,scaffold_2
40,5033001,5068000,34999,False,35,scaffold_2
41,5080001,5104000,23999,False,35,scaffold_2
42,5198001,5226000,27999,False,35,scaffold_2
43,5249001,5278000,28999,False,35,scaffold_2
44,5286001,5315000,28999,False,35,scaffold_2
45,5342001,5488000,145999,False,35,scaffold_2
46,5490001,5564000,73999,False,35,scaffold_2
47,5607001,5779000,171999,False,35,scaffold_2
48,5827001,5892000,64999,False,35,scaffold_2
49,5908001,5994000,85999,False,35,scaffold_2
50,6122001,6158000,35999,False,35,scaffold_2
51,6159001,6195000,35999,False,35,scaffold_2
52,6261001,6351000,89999,False,35,scaffold_2
53,6366001,6471000,104999,False,35,scaffold_2
54,6577001,6628000,50999,False,35,scaffold_2
55,6693001,6738000,44999,False,35,scaffold_2
56,6811001,6853000,41999,False,35,scaffold_2
57,6941001,6979000,37999,False,35,scaffold_2
58,7002001,7040000,37999,False,35,scaffold_2
59,7049001,7097000,47999,False,35,scaffold_2
60,7162001,7220000,57999,False,35,scaffold_2
61,7427001,7473000,45999,False,35,scaffold_2
62,7491001,7518000,26999,False,35,scaffold_2
63,7550001,7561000,10999,False,35,scaffold_2
64,7563001,7699000,135999,False,35,scaffold_2
65,7717001,7920000,202999,False,35,scaffold_2
66,7933001,8328000,394999,False,35,scaffold_2
67,8346001,8493000,146999,False,35,scaffold_2
68,8495001,8565000,69999,False,35,scaffold_2
69,8998001,9051000,52999,False,35,scaffold_2
70,9139001,9175000,35999,False,35,scaffold_2
71,9285001,9382000,96999,False,35,scaffold_2
72,9602001,9636000,33999,False,35,scaffold_2
73,9671001,9714000,42999,False,35,scaffold_2
74,9752001,9828000,75999,False,35,scaffold_2
75,9868001,9901000,32999,False,35,scaffold_2
76,10404001,10467000,62999,False,35,scaffold_2
77,10645001,10708000,62999,False,35,scaffold_2
78,10710001,10736000,25999,False,35,scaffold_2
79,10774001,10807000,32999,False,35,scaffold_2
80,11329001,11424000,94999,False,35,scaffold_2
81,11519001,11786000,266999,False,35,scaffold_2
0,167001,183000,15999,False,35,scaffold_3
1,218001,230000,11999,False,35,scaffold_3
2,618001,646000,27999,False,35,scaffold_3
3,798001,900000,101999,False,35,scaffold_3
4,1202001,1225000,22999,False,35,scaffold_3
5,1525001,1556000,30999,False,35,scaffold_3
6,1584001,1716000,131999,False,35,scaffold_3
7,1835001,1860000,24999,False,35,scaffold_3
8,1906001,1916000,9999,False,35,scaffold_3
9,1937001,1981000,43999,False,35,scaffold_3
10,1991001,2185000,193999,False,35,scaffold_3
11,2209001,2268000,58999,False,35,scaffold_3
12,2287001,2336000,48999,False,35,scaffold_3
13,2376001,2428000,51999,False,35,scaffold_3
14,2433001,2532000,98999,False,35,scaffold_3
15,2637001,2935000,297999,False,35,scaffold_3
16,2984001,3062000,77999,False,35,scaffold_3
17,3066001,3165000,98999,False,35,scaffold_3
18,3167001,3280000,112999,False,35,scaffold_3
19,3409001,3427000,17999,False,35,scaffold_3
20,3497001,3522000,24999,False,35,scaffold_3
21,3559001,3735000,175999,False,35,scaffold_3
22,3768001,3821000,52999,False,35,scaffold_3
23,3822001,3892000,69999,False,35,scaffold_3
24,3922001,3946000,23999,False,35,scaffold_3
25,3997001,4039000,41999,False,35,scaffold_3
26,4040001,4403000,362999,False,35,scaffold_3
27,4410001,4519000,108999,False,35,scaffold_3
28,4546001,4558000,11999,False,35,scaffold_3
29,4652001,4679000,26999,False,35,scaffold_3
30,4854001,4926000,71999,False,35,scaffold_3
31,4997001,5033000,35999,False,35,scaffold_3
32,5064001,5279000,214999,False,35,scaffold_3
33,5377001,5676000,298999,False,35,scaffold_3
34,5700001,5766000,65999,False,35,scaffold_3
35,5768001,5789000,20999,False,35,scaffold_3
36,5804001,6108000,303999,False,35,scaffold_3
37,6220001,6244000,23999,False,35,scaffold_3
38,6743001,6807000,63999,False,35,scaffold_3
39,6859001,7157000,297999,False,35,scaffold_3
40,7255001,7323000,67999,False,35,scaffold_3
41,7332001,7445000,112999,False,35,scaffold_3
42,7483001,7563000,79999,False,35,scaffold_3
43,7575001,7631000,55999,False,35,scaffold_3
44,7660001,7798000,137999,False,35,scaffold_3
45,7818001,7895000,76999,False,35,scaffold_3
46,8028001,8116000,87999,False,35,scaffold_3
47,8121001,8156000,34999,False,35,scaffold_3
48,8176001,8253000,76999,False,35,scaffold_3
49,8333001,8359000,25999,False,35,scaffold_3
50,8427001,8594000,166999,False,35,scaffold_3
51,8956001,9080000,123999,False,35,scaffold_3
52,9106001,9254000,147999,False,35,scaffold_3
53,9275001,9310000,34999,False,35,scaffold_3
54,9644001,9693000,48999,False,35,scaffold_3
55,9967001,9996000,28999,False,35,scaffold_3
56,10065001,10090000,24999,False,35,scaffold_3
57,10461001,10485000,23999,False,35,scaffold_3
58,10551001,11166000,614999,False,35,scaffold_3
0,17001,32000,14999,False,35,scaffold_4
1,48001,88000,39999,False,35,scaffold_4
2,107001,115000,7999,False,35,scaffold_4
3,121001,146000,24999,False,35,scaffold_4
4,147001,151000,3999,False,35,scaffold_4
5,155001,160000,4999,False,35,scaffold_4
6,161001,185000,23999,False,35,scaffold_4
7,186001,215000,28999,False,35,scaffold_4
8,217001,226000,8999,False,35,scaffold_4
9,227001,278000,50999,False,35,scaffold_4
10,283001,311000,27999,False,35,scaffold_4
11,318001,344000,25999,False,35,scaffold_4
12,355001,374000,18999,False,35,scaffold_4
13,375001,388000,12999,False,35,scaffold_4
14,389001,425000,35999,False,35,scaffold_4
15,429001,504000,74999,False,35,scaffold_4
16,545001,592000,46999,False,35,scaffold_4
17,593001,599000,5999,False,35,scaffold_4
18,600001,606000,5999,False,35,scaffold_4
19,608001,691000,82999,False,35,scaffold_4
20,695001,697000,1999,False,35,scaffold_4
21,701001,717000,15999,False,35,scaffold_4
22,1043001,1047000,3999,False,35,scaffold_4
23,1122001,1136000,13999,False,35,scaffold_4
24,1137001,1226000,88999,False,35,scaffold_4
25,1229001,1253000,23999,False,35,scaffold_4
26,1254001,1263000,8999,False,35,scaffold_4
27,1265001,1279000,13999,False,35,scaffold_4
28,1283001,1605000,321999,False,35,scaffold_4
29,1609001,1612000,2999,False,35,scaffold_4
30,1613001,2185000,571999,False,35,scaffold_4
31,2188001,2206000,17999,False,35,scaffold_4
32,2210001,2218000,7999,False,35,scaffold_4
33,2219001,2281000,61999,False,35,scaffold_4
34,2283001,2461000,177999,False,35,scaffold_4
35,2477001,2675000,197999,False,35,scaffold_4
36,2676001,2816000,139999,False,35,scaffold_4
37,2891001,3131000,239999,False,35,scaffold_4
38,3157001,3860000,702999,False,35,scaffold_4
39,4010001,4046000,35999,False,35,scaffold_4
40,4058001,4108000,49999,False,35,scaffold_4
41,4233001,4308000,74999,False,35,scaffold_4
42,4892001,5095000,202999,False,35,scaffold_4
43,5169001,5225000,55999,False,35,scaffold_4
44,5288001,5506000,217999,False,35,scaffold_4
45,5514001,5784000,269999,False,35,scaffold_4
46,5786001,6197000,410999,False,35,scaffold_4
47,6213001,6538000,324999,False,35,scaffold_4
48,6561001,6612000,50999,False,35,scaffold_4
49,6620001,6669000,48999,False,35,scaffold_4
50,6752001,6817000,64999,False,35,scaffold_4
51,6837001,6924000,86999,False,35,scaffold_4
52,6926001,6995000,68999,False,35,scaffold_4
53,7036001,7174000,137999,False,35,scaffold_4
54,7207001,7429000,221999,False,35,scaffold_4
55,7498001,7570000,71999,False,35,scaffold_4
56,7628001,7665000,36999,False,35,scaffold_4
57,7843001,7924000,80999,False,35,scaffold_4
58,7975001,7999000,23999,False,35,scaffold_4
59,8051001,8104000,52999,False,35,scaffold_4
60,8520001,8532000,11999,False,35,scaffold_4
61,8743001,8764000,20999,False,35,scaffold_4
62,8840001,9699000,858999,False,35,scaffold_4
63,9700001,9845951,145950,True,35,scaffold_4
0,189001,207000,17999,False,35,scaffold_5
1,318001,428000,109999,False,35,scaffold_5
2,462001,526000,63999,False,35,scaffold_5
3,639001,655000,15999,False,35,scaffold_5
4,671001,711000,39999,False,35,scaffold_5
5,804001,832000,27999,False,35,scaffold_5
6,906001,947000,40999,False,35,scaffold_5
7,1204001,1221000,16999,False,35,scaffold_5
8,1255001,1284000,28999,False,35,scaffold_5
9,1355001,1392000,36999,False,35,scaffold_5
10,1712001,1728000,15999,False,35,scaffold_5
11,1946001,1967000,20999,False,35,scaffold_5
12,2255001,2299000,43999,False,35,scaffold_5
13,2475001,2494000,18999,False,35,scaffold_5
14,2511001,2515000,3999,False,35,scaffold_5
15,2516001,2809000,292999,False,35,scaffold_5
16,2812001,2903000,90999,False,35,scaffold_5
17,3133001,3520000,386999,False,35,scaffold_5
18,3616001,3659000,42999,False,35,scaffold_5
19,3835001,3946000,110999,False,35,scaffold_5
20,3962001,4101000,138999,False,35,scaffold_5
21,4119001,4862000,742999,False,35,scaffold_5
22,4883001,4925000,41999,False,35,scaffold_5
23,4937001,4990000,52999,False,35,scaffold_5
24,5059001,5084000,24999,False,35,scaffold_5
25,5199001,5346000,146999,False,35,scaffold_5
26,5513001,5540000,26999,False,35,scaffold_5
27,6390001,6726000,335999,False,35,scaffold_5
28,6781001,6851000,69999,False,35,scaffold_5
29,6881001,6960000,78999,False,35,scaffold_5
30,7173001,7234000,60999,False,35,scaffold_5
31,7258001,7328000,69999,False,35,scaffold_5
32,7413001,7441000,27999,False,35,scaffold_5
33,7454001,7513000,58999,False,35,scaffold_5
34,7542001,7619000,76999,False,35,scaffold_5
35,7620001,7758000,137999,False,35,scaffold_5
36,7760001,7807000,46999,False,35,scaffold_5
37,8413001,8469000,55999,False,35,scaffold_5
38,8552001,8616000,63999,False,35,scaffold_5
39,8636001,8689000,52999,False,35,scaffold_5
40,8711001,9364176,653175,True,35,scaffold_5
0,86001,121000,34999,False,35,scaffold_6
1,134001,208000,73999,False,35,scaffold_6
2,239001,255000,15999,False,35,scaffold_6
3,256001,318000,61999,False,35,scaffold_6
4,467001,496000,28999,False,35,scaffold_6
5,618001,674000,55999,False,35,scaffold_6
6,731001,760000,28999,False,35,scaffold_6
7,765001,800000,34999,False,35,scaffold_6
8,833001,853000,19999,False,35,scaffold_6
9,906001,1039000,132999,False,35,scaffold_6
10,1119001,1226000,106999,False,35,scaffold_6
11,1229001,1266000,36999,False,35,scaffold_6
12,1284001,1311000,26999,False,35,scaffold_6
13,1326001,1367000,40999,False,35,scaffold_6
14,1426001,1608000,181999,False,35,scaffold_6
15,1658001,1779000,120999,False,35,scaffold_6
16,1837001,1966000,128999,False,35,scaffold_6
17,1977001,2020000,42999,False,35,scaffold_6
18,2023001,2112000,88999,False,35,scaffold_6
19,2123001,2216000,92999,False,35,scaffold_6
20,2236001,2284000,47999,False,35,scaffold_6
21,2304001,2872000,567999,False,35,scaffold_6
22,2926001,3350000,423999,False,35,scaffold_6
23,3351001,3799000,447999,False,35,scaffold_6
24,3826001,3852000,25999,False,35,scaffold_6
25,3877001,3926000,48999,False,35,scaffold_6
26,3942001,4206000,263999,False,35,scaffold_6
27,4699001,4756000,56999,False,35,scaffold_6
28,4779001,4916000,136999,False,35,scaffold_6
29,4925001,4997000,71999,False,35,scaffold_6
30,5619001,5654000,34999,False,35,scaffold_6
31,5678001,5797000,118999,False,35,scaffold_6
32,5863001,6105000,241999,False,35,scaffold_6
33,6124001,6215000,90999,False,35,scaffold_6
34,6473001,6506000,32999,False,35,scaffold_6
35,6683001,6715000,31999,False,35,scaffold_6
36,6758001,6804000,45999,False,35,scaffold_6
37,6833001,6859000,25999,False,35,scaffold_6
38,6976001,7009000,32999,False,35,scaffold_6
39,7199001,7248000,48999,False,35,scaffold_6
40,7254001,7338000,83999,False,35,scaffold_6
41,7384001,7488000,103999,False,35,scaffold_6
42,7531001,8268281,737280,True,35,scaffold_6
0,1,34000,33999,True,35,scaffold_7
1,311001,340000,28999,False,35,scaffold_7
2,342001,508000,165999,False,35,scaffold_7
3,571001,577000,5999,False,35,scaffold_7
4,651001,677000,25999,False,35,scaffold_7
5,706001,736000,29999,False,35,scaffold_7
6,764001,829000,64999,False,35,scaffold_7
7,830001,843000,12999,False,35,scaffold_7
8,859001,864000,4999,False,35,scaffold_7
9,868001,872000,3999,False,35,scaffold_7
10,875001,938000,62999,False,35,scaffold_7
11,967001,980000,12999,False,35,scaffold_7
12,982001,1044000,61999,False,35,scaffold_7
13,1048001,1082000,33999,False,35,scaffold_7
14,1191001,1460000,268999,False,35,scaffold_7
15,1461001,1512000,50999,False,35,scaffold_7
16,1588001,1701000,112999,False,35,scaffold_7
17,1730001,1782000,51999,False,35,scaffold_7
18,1848001,1939000,90999,False,35,scaffold_7
19,1972001,2017000,44999,False,35,scaffold_7
20,2368001,2410000,41999,False,35,scaffold_7
21,2442001,2464000,21999,False,35,scaffold_7
22,2514001,2743000,228999,False,35,scaffold_7
23,2801001,2842000,40999,False,35,scaffold_7
24,2931001,2959000,27999,False,35,scaffold_7
25,3127001,3188000,60999,False,35,scaffold_7
26,3192001,3230000,37999,False,35,scaffold_7
27,3249001,3275000,25999,False,35,scaffold_7
28,3297001,3370000,72999,False,35,scaffold_7
29,3521001,3766000,244999,False,35,scaffold_7
30,4020001,4066000,45999,False,35,scaffold_7
31,4322001,4361000,38999,False,35,scaffold_7
32,4407001,4515000,107999,False,35,scaffold_7
33,4527001,4580000,52999,False,35,scaffold_7
34,4633001,4914000,280999,False,35,scaffold_7
35,4978001,5169000,190999,False,35,scaffold_7
36,5470001,5645000,174999,False,35,scaffold_7
37,5666001,5684000,17999,False,35,scaffold_7
38,5814001,5857000,42999,False,35,scaffold_7
39,5921001,5931000,9999,False,35,scaffold_7
40,6049001,6095000,45999,False,35,scaffold_7
41,6143001,6249000,105999,False,35,scaffold_7
42,6559001,6722000,162999,False,35,scaffold_7
43,6748001,6798000,49999,False,35,scaffold_7
44,6817001,6839000,21999,False,35,scaffold_7
45,6950001,7270000,319999,False,35,scaffold_7
46,7271001,7502216,231215,True,35,scaffold_7
0,1,7000,6999,True,35,scaffold_8
1,66001,87000,20999,False,35,scaffold_8
2,93001,97000,3999,False,35,scaffold_8
3,1363001,1426000,62999,False,35,scaffold_8
4,1563001,1582000,18999,False,35,scaffold_8
5,1859001,1928000,68999,False,35,scaffold_8
6,2066001,2157000,90999,False,35,scaffold_8
7,2357001,2404000,46999,False,35,scaffold_8
8,2411001,2601000,189999,False,35,scaffold_8
9,2648001,2845000,196999,False,35,scaffold_8
10,2846001,3556000,709999,False,35,scaffold_8
11,3572001,3612000,39999,False,35,scaffold_8
12,3615001,3938000,322999,False,35,scaffold_8
13,3994001,4255000,260999,False,35,scaffold_8
14,4331001,4368000,36999,False,35,scaffold_8
15,4383001,4434000,50999,False,35,scaffold_8
16,4471001,4485000,13999,False,35,scaffold_8
17,4717001,4777000,59999,False,35,scaffold_8
18,4796001,4917000,120999,False,35,scaffold_8
19,4997001,5041000,43999,False,35,scaffold_8
20,5068001,5244000,175999,False,35,scaffold_8
21,5364001,5476000,111999,False,35,scaffold_8
22,5524001,5597000,72999,False,35,scaffold_8
23,5650001,5723000,72999,False,35,scaffold_8
24,5727001,5804000,76999,False,35,scaffold_8
25,5807001,6163000,355999,False,35,scaffold_8
26,6227001,6308000,80999,False,35,scaffold_8
27,6319001,6334544,15543,True,35,scaffold_8
0,109001,116000,6999,False,35,scaffold_9
1,366001,411000,44999,False,35,scaffold_9
2,413001,437000,23999,False,35,scaffold_9
3,501001,531000,29999,False,35,scaffold_9
4,547001,563000,15999,False,35,scaffold_9
5,647001,665000,17999,False,35,scaffold_9
6,671001,696000,24999,False,35,scaffold_9
7,814001,842000,27999,False,35,scaffold_9
8,886001,986000,99999,False,35,scaffold_9
9,987001,995000,7999,False,35,scaffold_9
10,1001001,1007000,5999,False,35,scaffold_9
11,1009001,1085000,75999,False,35,scaffold_9
12,1087001,1150000,62999,False,35,scaffold_9
13,1151001,1196000,44999,False,35,scaffold_9
14,1201001,1230000,28999,False,35,scaffold_9
15,1312001,1378000,65999,False,35,scaffold_9
16,1413001,1423000,9999,False,35,scaffold_9
17,1427001,1441000,13999,False,35,scaffold_9
18,1457001,1465000,7999,False,35,scaffold_9
19,1486001,1500000,13999,False,35,scaffold_9
20,1534001,1624000,89999,False,35,scaffold_9
21,1637001,1701000,63999,False,35,scaffold_9
22,1702001,1727000,24999,False,35,scaffold_9
23,1747001,1808000,60999,False,35,scaffold_9
24,1814001,1857000,42999,False,35,scaffold_9
25,1866001,1959000,92999,False,35,scaffold_9
26,1970001,2067000,96999,False,35,scaffold_9
27,2075001,2354000,278999,False,35,scaffold_9
28,2388001,2673000,284999,False,35,scaffold_9
29,2674001,2720000,45999,False,35,scaffold_9
30,2735001,3381000,645999,False,35,scaffold_9
31,3383001,5107000,1723999,False,35,scaffold_9
32,5112001,5238000,125999,False,35,scaffold_9
33,5239001,5298000,58999,False,35,scaffold_9
34,5299001,5491000,191999,False,35,scaffold_9
35,5493001,6331288,838287,True,35,scaffold_9
0,1,414000,413999,True,35,scaffold_10
1,415001,482000,66999,False,35,scaffold_10
2,483001,582000,98999,False,35,scaffold_10
3,597001,1069000,471999,False,35,scaffold_10
4,1072001,1154000,81999,False,35,scaffold_10
5,1312001,1472000,159999,False,35,scaffold_10
6,1499001,1570000,70999,False,35,scaffold_10
7,1591001,1668000,76999,False,35,scaffold_10
8,1686001,1742000,55999,False,35,scaffold_10
9,1803001,1844000,40999,False,35,scaffold_10
10,1861001,1923000,61999,False,35,scaffold_10
11,2017001,2112000,94999,False,35,scaffold_10
12,2139001,2475000,335999,False,35,scaffold_10
13,2498001,2520000,21999,False,35,scaffold_10
14,2522001,2811000,288999,False,35,scaffold_10
15,2919001,2955000,35999,False,35,scaffold_10
16,3112001,3136000,23999,False,35,scaffold_10
17,3154001,3177000,22999,False,35,scaffold_10
18,3363001,3424000,60999,False,35,scaffold_10
19,3463001,3476000,12999,False,35,scaffold_10
20,3560001,3582000,21999,False,35,scaffold_10
21,3634001,3675000,40999,False,35,scaffold_10
22,3775001,3795000,19999,False,35,scaffold_10
23,4052001,4091000,38999,False,35,scaffold_10
24,4154001,4182000,27999,False,35,scaffold_10
25,4316001,4322000,5999,False,35,scaffold_10
26,4335001,4361000,25999,False,35,scaffold_10
27,4442001,4462000,19999,False,35,scaffold_10
28,4467001,4502000,34999,False,35,scaffold_10
29,4503001,4513000,9999,False,35,scaffold_10
30,4515001,4523000,7999,False,35,scaffold_10
31,4526001,4548000,21999,False,35,scaffold_10
32,4574001,4596000,21999,False,35,scaffold_10
33,4680001,4689000,8999,False,35,scaffold_10
34,4716001,4732000,15999,False,35,scaffold_10
35,4734001,4776000,41999,False,35,scaffold_10
36,4798001,4824000,25999,False,35,scaffold_10
37,4828001,4843000,14999,False,35,scaffold_10
38,4848001,4861000,12999,False,35,scaffold_10
39,4865001,4866973,1972,True,35,scaffold_10
0,10001,34000,23999,False,35,scaffold_11
1,38001,89000,50999,False,35,scaffold_11
2,147001,167000,19999,False,35,scaffold_11
3,169001,212000,42999,False,35,scaffold_11
4,213001,236000,22999,False,35,scaffold_11
5,240001,252000,11999,False,35,scaffold_11
6,419001,431000,11999,False,35,scaffold_11
7,637001,657000,19999,False,35,scaffold_11
8,781001,785000,3999,False,35,scaffold_11
9,1025001,1034000,8999,False,35,scaffold_11
10,1105001,1113000,7999,False,35,scaffold_11
11,1219001,1241000,21999,False,35,scaffold_11
12,1287001,1295000,7999,False,35,scaffold_11
13,1304001,1314000,9999,False,35,scaffold_11
14,1315001,1398000,82999,False,35,scaffold_11
15,1403001,1410000,6999,False,35,scaffold_11
16,1435001,1451000,15999,False,35,scaffold_11
17,1474001,1478000,3999,False,35,scaffold_11
18,1525001,1551000,25999,False,35,scaffold_11
19,1572001,1599000,26999,False,35,scaffold_11
20,1711001,1736000,24999,False,35,scaffold_11
21,1853001,1886000,32999,False,35,scaffold_11
22,1936001,2034000,97999,False,35,scaffold_11
23,2035001,2058000,22999,False,35,scaffold_11
24,2076001,2172000,95999,False,35,scaffold_11
25,2176001,2225000,48999,False,35,scaffold_11
26,2674001,2698000,23999,False,35,scaffold_11
27,2700001,3029000,328999,False,35,scaffold_11
28,3082001,3183000,100999,False,35,scaffold_11
29,3184001,3383000,198999,False,35,scaffold_11
30,3420001,3972000,551999,False,35,scaffold_11
31,3982001,4161000,178999,False,35,scaffold_11
32,4179001,4710000,530999,False,35,scaffold_11
33,4713001,4766820,53819,True,35,scaffold_11
0,1,1074000,1073999,True,35,scaffold_12
1,1075001,1498000,422999,False,35,scaffold_12
2,1565001,1589000,23999,False,35,scaffold_12
3,1640001,1666000,25999,False,35,scaffold_12
4,1719001,1752000,32999,False,35,scaffold_12
5,1784001,1812000,27999,False,35,scaffold_12
6,1878001,2005000,126999,False,35,scaffold_12
7,2024001,2103000,78999,False,35,scaffold_12
8,2136001,2192000,55999,False,35,scaffold_12
9,2202001,2205000,2999,False,35,scaffold_12
10,2206001,2211000,4999,False,35,scaffold_12
11,2224001,2263000,38999,False,35,scaffold_12
12,2336001,2380000,43999,False,35,scaffold_12
13,2571001,2609000,37999,False,35,scaffold_12
14,2685001,2699000,13999,False,35,scaffold_12
0,1,341000,340999,True,36,scaffold_1
1,482001,498000,15999,False,36,scaffold_1
2,570001,642000,71999,False,36,scaffold_1
3,686001,756000,69999,False,36,scaffold_1
4,873001,905000,31999,False,36,scaffold_1
5,1279001,1292000,12999,False,36,scaffold_1
6,1831001,1935000,103999,False,36,scaffold_1
7,1965001,1984000,18999,False,36,scaffold_1
8,1986001,2015000,28999,False,36,scaffold_1
9,2354001,2415000,60999,False,36,scaffold_1
10,2449001,2519000,69999,False,36,scaffold_1
11,2564001,2582000,17999,False,36,scaffold_1
12,2725001,2746000,20999,False,36,scaffold_1
13,3171001,3209000,37999,False,36,scaffold_1
14,3703001,3741000,37999,False,36,scaffold_1
15,3809001,3897000,87999,False,36,scaffold_1
16,3908001,3941000,32999,False,36,scaffold_1
17,3942001,4027000,84999,False,36,scaffold_1
18,4066001,4112000,45999,False,36,scaffold_1
19,4323001,4355000,31999,False,36,scaffold_1
20,4462001,4519000,56999,False,36,scaffold_1
21,4640001,4669000,28999,False,36,scaffold_1
22,4760001,4786000,25999,False,36,scaffold_1
23,4796001,4898000,101999,False,36,scaffold_1
24,4911001,5022000,110999,False,36,scaffold_1
25,5041001,5065000,23999,False,36,scaffold_1
26,5087001,5123000,35999,False,36,scaffold_1
27,5142001,5189000,46999,False,36,scaffold_1
28,5481001,5515000,33999,False,36,scaffold_1
29,5535001,5579000,43999,False,36,scaffold_1
30,6108001,6118000,9999,False,36,scaffold_1
31,6202001,6330000,127999,False,36,scaffold_1
32,6331001,6361000,29999,False,36,scaffold_1
33,6363001,6508000,144999,False,36,scaffold_1
34,6547001,6553000,5999,False,36,scaffold_1
35,6643001,6657000,13999,False,36,scaffold_1
36,6938001,6953000,14999,False,36,scaffold_1
37,7042001,7191000,148999,False,36,scaffold_1
38,7192001,7247000,54999,False,36,scaffold_1
39,7248001,7331000,82999,False,36,scaffold_1
40,7332001,7531000,198999,False,36,scaffold_1
41,7532001,7589000,56999,False,36,scaffold_1
42,7590001,8470000,879999,False,36,scaffold_1
43,8471001,8656000,184999,False,36,scaffold_1
44,8658001,8663000,4999,False,36,scaffold_1
45,8664001,8838000,173999,False,36,scaffold_1
46,8841001,9584000,742999,False,36,scaffold_1
47,9586001,9632000,45999,False,36,scaffold_1
48,9635001,10372000,736999,False,36,scaffold_1
49,10462001,10639000,176999,False,36,scaffold_1
50,10739001,10756000,16999,False,36,scaffold_1
51,10808001,10811000,2999,False,36,scaffold_1
52,10920001,10938000,17999,False,36,scaffold_1
53,11141001,11196000,54999,False,36,scaffold_1
54,11261001,11390000,128999,False,36,scaffold_1
55,11407001,11515000,107999,False,36,scaffold_1
56,11549001,11951000,401999,False,36,scaffold_1
57,12184001,12210000,25999,False,36,scaffold_1
58,12400001,12450000,49999,False,36,scaffold_1
59,12497001,12588000,90999,False,36,scaffold_1
60,12633001,12756000,122999,False,36,scaffold_1
61,12775001,12855000,79999,False,36,scaffold_1
62,12856001,12884000,27999,False,36,scaffold_1
63,13118001,13169000,50999,False,36,scaffold_1
64,13181001,13216000,34999,False,36,scaffold_1
65,13345001,13431000,85999,False,36,scaffold_1
66,13517001,13536000,18999,False,36,scaffold_1
67,13554001,13583000,28999,False,36,scaffold_1
68,13668001,13708000,39999,False,36,scaffold_1
69,13783001,13845000,61999,False,36,scaffold_1
70,13918001,13927000,8999,False,36,scaffold_1
71,13949001,13955000,5999,False,36,scaffold_1
72,13959001,13977000,17999,False,36,scaffold_1
73,14285001,14313000,27999,False,36,scaffold_1
74,14425001,14427000,1999,False,36,scaffold_1
75,14648001,14664000,15999,False,36,scaffold_1
0,21001,48000,26999,False,36,scaffold_2
1,93001,152000,58999,False,36,scaffold_2
2,154001,159000,4999,False,36,scaffold_2
3,276001,288000,11999,False,36,scaffold_2
4,313001,318000,4999,False,36,scaffold_2
5,333001,374000,40999,False,36,scaffold_2
6,379001,381000,1999,False,36,scaffold_2
7,731001,739000,7999,False,36,scaffold_2
8,1233001,1259000,25999,False,36,scaffold_2
9,1353001,1416000,62999,False,36,scaffold_2
10,1523001,1555000,31999,False,36,scaffold_2
11,1595001,1613000,17999,False,36,scaffold_2
12,1883001,1898000,14999,False,36,scaffold_2
13,2085001,2133000,47999,False,36,scaffold_2
14,2336001,2358000,21999,False,36,scaffold_2
15,2361001,2424000,62999,False,36,scaffold_2
16,2441001,2589000,147999,False,36,scaffold_2
17,2590001,2604000,13999,False,36,scaffold_2
18,2661001,2689000,27999,False,36,scaffold_2
19,2694001,2747000,52999,False,36,scaffold_2
20,2766001,2788000,21999,False,36,scaffold_2
21,2840001,2855000,14999,False,36,scaffold_2
22,2878001,2937000,58999,False,36,scaffold_2
23,2993001,3012000,18999,False,36,scaffold_2
24,3330001,3366000,35999,False,36,scaffold_2
25,3367001,3385000,17999,False,36,scaffold_2
26,3450001,3573000,122999,False,36,scaffold_2
27,3754001,3790000,35999,False,36,scaffold_2
28,3884001,3931000,46999,False,36,scaffold_2
29,4243001,4279000,35999,False,36,scaffold_2
30,4296001,4409000,112999,False,36,scaffold_2
31,4434001,4462000,27999,False,36,scaffold_2
32,4515001,4790000,274999,False,36,scaffold_2
33,4793001,4807000,13999,False,36,scaffold_2
34,5018001,5066000,47999,False,36,scaffold_2
35,5081001,5096000,14999,False,36,scaffold_2
36,5200001,5224000,23999,False,36,scaffold_2
37,5285001,5315000,29999,False,36,scaffold_2
38,5368001,5389000,20999,False,36,scaffold_2
39,5413001,5564000,150999,False,36,scaffold_2
40,5621001,5696000,74999,False,36,scaffold_2
41,5699001,5764000,64999,False,36,scaffold_2
42,5841001,5892000,50999,False,36,scaffold_2
43,5904001,5993000,88999,False,36,scaffold_2
44,6005001,6053000,47999,False,36,scaffold_2
45,6091001,6178000,86999,False,36,scaffold_2
46,6261001,6330000,68999,False,36,scaffold_2
47,6577001,6628000,50999,False,36,scaffold_2
48,6710001,6726000,15999,False,36,scaffold_2
49,6940001,7046000,105999,False,36,scaffold_2
50,7049001,7098000,48999,False,36,scaffold_2
51,7439001,7473000,33999,False,36,scaffold_2
52,7491001,7514000,22999,False,36,scaffold_2
53,7552001,7561000,8999,False,36,scaffold_2
54,7602001,7916000,313999,False,36,scaffold_2
55,7933001,8028000,94999,False,36,scaffold_2
56,8029001,8172000,142999,False,36,scaffold_2
57,8259001,8328000,68999,False,36,scaffold_2
58,8331001,8333000,1999,False,36,scaffold_2
59,8346001,8454000,107999,False,36,scaffold_2
60,8463001,8493000,29999,False,36,scaffold_2
61,8495001,8557000,61999,False,36,scaffold_2
62,9147001,9178000,30999,False,36,scaffold_2
63,9238001,9276000,37999,False,36,scaffold_2
64,9281001,9340000,58999,False,36,scaffold_2
65,9347001,9382000,34999,False,36,scaffold_2
66,10444001,10466000,21999,False,36,scaffold_2
67,10677001,10708000,30999,False,36,scaffold_2
68,11471001,11496000,24999,False,36,scaffold_2
69,11520001,11786000,265999,False,36,scaffold_2
0,531001,548000,16999,False,36,scaffold_3
1,641001,646000,4999,False,36,scaffold_3
2,795001,900000,104999,False,36,scaffold_3
3,1667001,1672000,4999,False,36,scaffold_3
4,1836001,1856000,19999,False,36,scaffold_3
5,1895001,1976000,80999,False,36,scaffold_3
6,1998001,2108000,109999,False,36,scaffold_3
7,2110001,2147000,36999,False,36,scaffold_3
8,2168001,2180000,11999,False,36,scaffold_3
9,2288001,2333000,44999,False,36,scaffold_3
10,2407001,2428000,20999,False,36,scaffold_3
11,2486001,2533000,46999,False,36,scaffold_3
12,2641001,2760000,118999,False,36,scaffold_3
13,2892001,2920000,27999,False,36,scaffold_3
14,3066001,3164000,97999,False,36,scaffold_3
15,3167001,3280000,112999,False,36,scaffold_3
16,3562001,3737000,174999,False,36,scaffold_3
17,3867001,3882000,14999,False,36,scaffold_3
18,3883001,3889000,5999,False,36,scaffold_3
19,3928001,3943000,14999,False,36,scaffold_3
20,4007001,4033000,25999,False,36,scaffold_3
21,4069001,4404000,334999,False,36,scaffold_3
22,4417001,4514000,96999,False,36,scaffold_3
23,5000001,5016000,15999,False,36,scaffold_3
24,5082001,5125000,42999,False,36,scaffold_3
25,5158001,5271000,112999,False,36,scaffold_3
26,5376001,5450000,73999,False,36,scaffold_3
27,5465001,5509000,43999,False,36,scaffold_3
28,5511001,5532000,20999,False,36,scaffold_3
29,5601001,5676000,74999,False,36,scaffold_3
30,5704001,5714000,9999,False,36,scaffold_3
31,5770001,5938000,167999,False,36,scaffold_3
32,5956001,6029000,72999,False,36,scaffold_3
33,6741001,6779000,37999,False,36,scaffold_3
34,6888001,7072000,183999,False,36,scaffold_3
35,7073001,7089000,15999,False,36,scaffold_3
36,7255001,7309000,53999,False,36,scaffold_3
37,7336001,7398000,61999,False,36,scaffold_3
38,7462001,7480000,17999,False,36,scaffold_3
39,7483001,7556000,72999,False,36,scaffold_3
40,7676001,7788000,111999,False,36,scaffold_3
41,7822001,7856000,33999,False,36,scaffold_3
42,8028001,8115000,86999,False,36,scaffold_3
43,8183001,8256000,72999,False,36,scaffold_3
44,8463001,8515000,51999,False,36,scaffold_3
45,8517001,8594000,76999,False,36,scaffold_3
46,8993001,9080000,86999,False,36,scaffold_3
47,9107001,9168000,60999,False,36,scaffold_3
48,9197001,9234000,36999,False,36,scaffold_3
49,9659001,9687000,27999,False,36,scaffold_3
50,9967001,9993000,25999,False,36,scaffold_3
51,10461001,10482000,20999,False,36,scaffold_3
52,10596001,11009000,412999,False,36,scaffold_3
53,11010001,11037000,26999,False,36,scaffold_3
54,11038001,11182071,144070,True,36,scaffold_3
0,48001,88000,39999,False,36,scaffold_4
1,137001,146000,8999,False,36,scaffold_4
2,147001,151000,3999,False,36,scaffold_4
3,155001,160000,4999,False,36,scaffold_4
4,161001,215000,53999,False,36,scaffold_4
5,218001,226000,7999,False,36,scaffold_4
6,227001,237000,9999,False,36,scaffold_4
7,241001,267000,25999,False,36,scaffold_4
8,355001,374000,18999,False,36,scaffold_4
9,404001,425000,20999,False,36,scaffold_4
10,429001,498000,68999,False,36,scaffold_4
11,547001,592000,44999,False,36,scaffold_4
12,593001,599000,5999,False,36,scaffold_4
13,608001,661000,52999,False,36,scaffold_4
14,674001,691000,16999,False,36,scaffold_4
15,695001,697000,1999,False,36,scaffold_4
16,701001,726000,24999,False,36,scaffold_4
17,1087001,1097000,9999,False,36,scaffold_4
18,1098001,1108000,9999,False,36,scaffold_4
19,1119001,1136000,16999,False,36,scaffold_4
20,1138001,1226000,87999,False,36,scaffold_4
21,1229001,1253000,23999,False,36,scaffold_4
22,1254001,1262000,7999,False,36,scaffold_4
23,1265001,1279000,13999,False,36,scaffold_4
24,1283001,1566000,282999,False,36,scaffold_4
25,1568001,1605000,36999,False,36,scaffold_4
26,1613001,2187000,573999,False,36,scaffold_4
27,2190001,2206000,15999,False,36,scaffold_4
28,2207001,2218000,10999,False,36,scaffold_4
29,2219001,2279000,59999,False,36,scaffold_4
30,2282001,2462000,179999,False,36,scaffold_4
31,2477001,2675000,197999,False,36,scaffold_4
32,2676001,2815000,138999,False,36,scaffold_4
33,2891001,2967000,75999,False,36,scaffold_4
34,3030001,3127000,96999,False,36,scaffold_4
35,3174001,3568000,393999,False,36,scaffold_4
36,3569001,3616000,46999,False,36,scaffold_4
37,3645001,3684000,38999,False,36,scaffold_4
38,3685001,3768000,82999,False,36,scaffold_4
39,4056001,4143000,86999,False,36,scaffold_4
40,4179001,4197000,17999,False,36,scaffold_4
41,4243001,4311000,67999,False,36,scaffold_4
42,4900001,5082000,181999,False,36,scaffold_4
43,5170001,5224000,53999,False,36,scaffold_4
44,5337001,5402000,64999,False,36,scaffold_4
45,5430001,5506000,75999,False,36,scaffold_4
46,5514001,5620000,105999,False,36,scaffold_4
47,5659001,5784000,124999,False,36,scaffold_4
48,5786001,5825000,38999,False,36,scaffold_4
49,5882001,5968000,85999,False,36,scaffold_4
50,6060001,6113000,52999,False,36,scaffold_4
51,6148001,6192000,43999,False,36,scaffold_4
52,6214001,6277000,62999,False,36,scaffold_4
53,6315001,6376000,60999,False,36,scaffold_4
54,6503001,6538000,34999,False,36,scaffold_4
55,6620001,6640000,19999,False,36,scaffold_4
56,6757001,6817000,59999,False,36,scaffold_4
57,6904001,6924000,19999,False,36,scaffold_4
58,6950001,6995000,44999,False,36,scaffold_4
59,7036001,7124000,87999,False,36,scaffold_4
60,7225001,7428000,202999,False,36,scaffold_4
61,7628001,7665000,36999,False,36,scaffold_4
62,7860001,7913000,52999,False,36,scaffold_4
63,7984001,7998000,13999,False,36,scaffold_4
64,8843001,9074000,230999,False,36,scaffold_4
65,9075001,9569000,493999,False,36,scaffold_4
66,9570001,9699000,128999,False,36,scaffold_4
67,9700001,9752000,51999,False,36,scaffold_4
68,9753001,9845951,92950,True,36,scaffold_4
0,1,5000,4999,True,36,scaffold_5
1,318001,388000,69999,False,36,scaffold_5
2,445001,524000,78999,False,36,scaffold_5
3,932001,947000,14999,False,36,scaffold_5
4,1096001,1104000,7999,False,36,scaffold_5
5,1263001,1284000,20999,False,36,scaffold_5
6,1361001,1378000,16999,False,36,scaffold_5
7,1663001,1684000,20999,False,36,scaffold_5
8,2474001,2494000,19999,False,36,scaffold_5
9,2552001,2583000,30999,False,36,scaffold_5
10,2618001,2759000,140999,False,36,scaffold_5
11,2761001,2899000,137999,False,36,scaffold_5
12,3132001,3401000,268999,False,36,scaffold_5
13,3434001,3518000,83999,False,36,scaffold_5
14,3626001,3658000,31999,False,36,scaffold_5
15,3956001,4223000,266999,False,36,scaffold_5
16,4226001,4321000,94999,False,36,scaffold_5
17,4420001,4554000,133999,False,36,scaffold_5
18,4587001,4856000,268999,False,36,scaffold_5
19,4892001,4921000,28999,False,36,scaffold_5
20,5059001,5082000,22999,False,36,scaffold_5
21,5249001,5310000,60999,False,36,scaffold_5
22,5324001,5346000,21999,False,36,scaffold_5
23,5516001,5527000,10999,False,36,scaffold_5
24,5720001,5738000,17999,False,36,scaffold_5
25,6404001,6437000,32999,False,36,scaffold_5
26,6451001,6669000,217999,False,36,scaffold_5
27,6887001,6924000,36999,False,36,scaffold_5
28,7035001,7086000,50999,False,36,scaffold_5
29,7097001,7100000,2999,False,36,scaffold_5
30,7167001,7210000,42999,False,36,scaffold_5
31,7334001,7365000,30999,False,36,scaffold_5
32,7454001,7512000,57999,False,36,scaffold_5
33,7552001,7748000,195999,False,36,scaffold_5
34,7794001,7805000,10999,False,36,scaffold_5
35,8415001,8469000,53999,False,36,scaffold_5
36,8572001,8616000,43999,False,36,scaffold_5
37,8640001,8689000,48999,False,36,scaffold_5
38,8702001,9290000,587999,False,36,scaffold_5
39,9291001,9364176,73175,True,36,scaffold_5
0,78001,84000,5999,False,36,scaffold_6
1,86001,114000,27999,False,36,scaffold_6
2,165001,207000,41999,False,36,scaffold_6
3,241001,262000,20999,False,36,scaffold_6
4,267001,288000,20999,False,36,scaffold_6
5,467001,497000,29999,False,36,scaffold_6
6,731001,747000,15999,False,36,scaffold_6
7,782001,802000,19999,False,36,scaffold_6
8,833001,852000,18999,False,36,scaffold_6
9,987001,999000,11999,False,36,scaffold_6
10,1018001,1038000,19999,False,36,scaffold_6
11,1120001,1177000,56999,False,36,scaffold_6
12,1230001,1263000,32999,False,36,scaffold_6
13,1288001,1299000,10999,False,36,scaffold_6
14,1435001,1546000,110999,False,36,scaffold_6
15,1558001,1600000,41999,False,36,scaffold_6
16,1648001,1673000,24999,False,36,scaffold_6
17,1793001,1906000,112999,False,36,scaffold_6
18,1907001,1933000,25999,False,36,scaffold_6
19,2023001,2038000,14999,False,36,scaffold_6
20,2039001,2051000,11999,False,36,scaffold_6
21,2052001,2088000,35999,False,36,scaffold_6
22,2124001,2205000,80999,False,36,scaffold_6
23,2236001,2266000,29999,False,36,scaffold_6
24,2314001,2595000,280999,False,36,scaffold_6
25,2596001,2654000,57999,False,36,scaffold_6
26,2656001,2691000,34999,False,36,scaffold_6
27,2713001,2848000,134999,False,36,scaffold_6
28,2849001,2872000,22999,False,36,scaffold_6
29,2907001,3032000,124999,False,36,scaffold_6
30,3103001,3212000,108999,False,36,scaffold_6
31,3222001,3767000,544999,False,36,scaffold_6
32,3772001,3806000,33999,False,36,scaffold_6
33,3810001,3848000,37999,False,36,scaffold_6
34,3897001,3913000,15999,False,36,scaffold_6
35,4018001,4195000,176999,False,36,scaffold_6
36,4836001,4916000,79999,False,36,scaffold_6
37,4925001,4992000,66999,False,36,scaffold_6
38,5720001,5742000,21999,False,36,scaffold_6
39,5902001,5973000,70999,False,36,scaffold_6
40,6002001,6087000,84999,False,36,scaffold_6
41,6119001,6190000,70999,False,36,scaffold_6
42,6473001,6505000,31999,False,36,scaffold_6
43,6695001,6710000,14999,False,36,scaffold_6
44,6765001,6804000,38999,False,36,scaffold_6
45,6833001,6857000,23999,False,36,scaffold_6
46,6911001,6942000,30999,False,36,scaffold_6
47,6972001,7008000,35999,False,36,scaffold_6
48,7074001,7100000,25999,False,36,scaffold_6
49,7221001,7251000,29999,False,36,scaffold_6
50,7263001,7305000,41999,False,36,scaffold_6
51,7306001,7337000,30999,False,36,scaffold_6
52,7389001,7444000,54999,False,36,scaffold_6
53,7531001,7595000,63999,False,36,scaffold_6
54,7596001,7636000,39999,False,36,scaffold_6
55,7694001,7720000,25999,False,36,scaffold_6
56,7733001,7798000,64999,False,36,scaffold_6
57,7830001,8221000,390999,False,36,scaffold_6
58,8222001,8268281,46280,True,36,scaffold_6
0,323001,340000,16999,False,36,scaffold_7
1,342001,369000,26999,False,36,scaffold_7
2,370001,508000,137999,False,36,scaffold_7
3,571001,577000,5999,False,36,scaffold_7
4,654001,673000,18999,False,36,scaffold_7
5,706001,736000,29999,False,36,scaffold_7
6,764001,799000,34999,False,36,scaffold_7
7,800001,843000,42999,False,36,scaffold_7
8,859001,864000,4999,False,36,scaffold_7
9,868001,872000,3999,False,36,scaffold_7
10,875001,885000,9999,False,36,scaffold_7
11,887001,945000,57999,False,36,scaffold_7
12,954001,963000,8999,False,36,scaffold_7
13,964001,966000,1999,False,36,scaffold_7
14,968001,980000,11999,False,36,scaffold_7
15,982001,1044000,61999,False,36,scaffold_7
16,1191001,1261000,69999,False,36,scaffold_7
17,1262001,1512000,249999,False,36,scaffold_7
18,1588001,1695000,106999,False,36,scaffold_7
19,1727001,1782000,54999,False,36,scaffold_7
20,1848001,1897000,48999,False,36,scaffold_7
21,1975001,2017000,41999,False,36,scaffold_7
22,2636001,2711000,74999,False,36,scaffold_7
23,3097001,3187000,89999,False,36,scaffold_7
24,3249001,3271000,21999,False,36,scaffold_7
25,3305001,3353000,47999,False,36,scaffold_7
26,3354001,3369000,14999,False,36,scaffold_7
27,3517001,3563000,45999,False,36,scaffold_7
28,3576001,3620000,43999,False,36,scaffold_7
29,3621001,3715000,93999,False,36,scaffold_7
30,3717001,3806000,88999,False,36,scaffold_7
31,3902001,3931000,28999,False,36,scaffold_7
32,4415001,4492000,76999,False,36,scaffold_7
33,4525001,4539000,13999,False,36,scaffold_7
34,4550001,4579000,28999,False,36,scaffold_7
35,4631001,4790000,158999,False,36,scaffold_7
36,4794001,4856000,61999,False,36,scaffold_7
37,4857001,4867000,9999,False,36,scaffold_7
38,4870001,4908000,37999,False,36,scaffold_7
39,4981001,5169000,187999,False,36,scaffold_7
40,5473001,5598000,124999,False,36,scaffold_7
41,6057001,6094000,36999,False,36,scaffold_7
42,6096001,6113000,16999,False,36,scaffold_7
43,6168001,6248000,79999,False,36,scaffold_7
44,6615001,6675000,59999,False,36,scaffold_7
45,6694001,6714000,19999,False,36,scaffold_7
46,6945001,7030000,84999,False,36,scaffold_7
47,7031001,7141000,109999,False,36,scaffold_7
48,7147001,7270000,122999,False,36,scaffold_7
49,7271001,7502216,231215,True,36,scaffold_7
0,67001,85000,17999,False,36,scaffold_8
1,93001,101000,7999,False,36,scaffold_8
2,1885001,1928000,42999,False,36,scaffold_8
3,2444001,2529000,84999,False,36,scaffold_8
4,2536001,2552000,15999,False,36,scaffold_8
5,2647001,2844000,196999,False,36,scaffold_8
6,2847001,2928000,80999,False,36,scaffold_8
7,2945001,3549000,603999,False,36,scaffold_8
8,3577001,3612000,34999,False,36,scaffold_8
9,3615001,3927000,311999,False,36,scaffold_8
10,4027001,4148000,120999,False,36,scaffold_8
11,4204001,4221000,16999,False,36,scaffold_8
12,4400001,4431000,30999,False,36,scaffold_8
13,4724001,4776000,51999,False,36,scaffold_8
14,4893001,4915000,21999,False,36,scaffold_8
15,5085001,5137000,51999,False,36,scaffold_8
16,5185001,5245000,59999,False,36,scaffold_8
17,5579001,5595000,15999,False,36,scaffold_8
18,5650001,5695000,44999,False,36,scaffold_8
19,5696001,5714000,17999,False,36,scaffold_8
20,5728001,5775000,46999,False,36,scaffold_8
21,5776001,5803000,26999,False,36,scaffold_8
22,5842001,5873000,30999,False,36,scaffold_8
23,5887001,5949000,61999,False,36,scaffold_8
24,5960001,5998000,37999,False,36,scaffold_8
25,6180001,6307000,126999,False,36,scaffold_8
26,6326001,6334544,8543,True,36,scaffold_8
0,109001,118000,8999,False,36,scaffold_9
1,121001,135000,13999,False,36,scaffold_9
2,372001,404000,31999,False,36,scaffold_9
3,413001,434000,20999,False,36,scaffold_9
4,519001,531000,11999,False,36,scaffold_9
5,671001,696000,24999,False,36,scaffold_9
6,732001,741000,8999,False,36,scaffold_9
7,817001,842000,24999,False,36,scaffold_9
8,876001,986000,109999,False,36,scaffold_9
9,987001,995000,7999,False,36,scaffold_9
10,1001001,1007000,5999,False,36,scaffold_9
11,1009001,1175000,165999,False,36,scaffold_9
12,1201001,1232000,30999,False,36,scaffold_9
13,1313001,1386000,72999,False,36,scaffold_9
14,1427001,1441000,13999,False,36,scaffold_9
15,1457001,1465000,7999,False,36,scaffold_9
16,1506001,1586000,79999,False,36,scaffold_9
17,1587001,1623000,35999,False,36,scaffold_9
18,1637001,1692000,54999,False,36,scaffold_9
19,1748001,1786000,37999,False,36,scaffold_9
20,1838001,1857000,18999,False,36,scaffold_9
21,1894001,1909000,14999,False,36,scaffold_9
22,1985001,2062000,76999,False,36,scaffold_9
23,2075001,2135000,59999,False,36,scaffold_9
24,2136001,2171000,34999,False,36,scaffold_9
25,2174001,2355000,180999,False,36,scaffold_9
26,2388001,2435000,46999,False,36,scaffold_9
27,2510001,2543000,32999,False,36,scaffold_9
28,2598001,2615000,16999,False,36,scaffold_9
29,2737001,2788000,50999,False,36,scaffold_9
30,2789001,3381000,591999,False,36,scaffold_9
31,3383001,5107000,1723999,False,36,scaffold_9
32,5112001,5238000,125999,False,36,scaffold_9
33,5239001,5298000,58999,False,36,scaffold_9
34,5299001,5486000,186999,False,36,scaffold_9
35,5487001,5582000,94999,False,36,scaffold_9
36,5583001,6074000,490999,False,36,scaffold_9
37,6075001,6113000,37999,False,36,scaffold_9
38,6114001,6331288,217287,True,36,scaffold_9
0,1,405000,404999,True,36,scaffold_10
1,415001,576000,160999,False,36,scaffold_10
2,596001,761000,164999,False,36,scaffold_10
3,781001,796000,14999,False,36,scaffold_10
4,812001,840000,27999,False,36,scaffold_10
5,866001,874000,7999,False,36,scaffold_10
6,888001,1069000,180999,False,36,scaffold_10
7,1087001,1153000,65999,False,36,scaffold_10
8,1370001,1468000,97999,False,36,scaffold_10
9,1499001,1528000,28999,False,36,scaffold_10
10,1608001,1613000,4999,False,36,scaffold_10
11,1689001,1760000,70999,False,36,scaffold_10
12,1862001,1923000,60999,False,36,scaffold_10
13,2042001,2112000,69999,False,36,scaffold_10
14,2140001,2174000,33999,False,36,scaffold_10
15,2197001,2475000,277999,False,36,scaffold_10
16,2504001,2520000,15999,False,36,scaffold_10
17,2521001,2636000,114999,False,36,scaffold_10
18,2638001,2653000,14999,False,36,scaffold_10
19,2671001,2707000,35999,False,36,scaffold_10
20,2715001,2751000,35999,False,36,scaffold_10
21,2754001,2812000,57999,False,36,scaffold_10
22,2817001,2861000,43999,False,36,scaffold_10
23,3467001,3476000,8999,False,36,scaffold_10
24,3590001,3595000,4999,False,36,scaffold_10
25,3634001,3653000,18999,False,36,scaffold_10
26,4154001,4177000,22999,False,36,scaffold_10
27,4445001,4462000,16999,False,36,scaffold_10
28,4503001,4513000,9999,False,36,scaffold_10
29,4526001,4548000,21999,False,36,scaffold_10
30,4574001,4597000,22999,False,36,scaffold_10
31,4681001,4688000,6999,False,36,scaffold_10
32,4733001,4766000,32999,False,36,scaffold_10
33,4767001,4776000,8999,False,36,scaffold_10
34,4798001,4824000,25999,False,36,scaffold_10
35,4828001,4843000,14999,False,36,scaffold_10
36,4848001,4861000,12999,False,36,scaffold_10
37,4865001,4866973,1972,True,36,scaffold_10
0,10001,33000,22999,False,36,scaffold_11
1,42001,89000,46999,False,36,scaffold_11
2,149001,167000,17999,False,36,scaffold_11
3,169001,191000,21999,False,36,scaffold_11
4,213001,235000,21999,False,36,scaffold_11
5,240001,248000,7999,False,36,scaffold_11
6,419001,431000,11999,False,36,scaffold_11
7,609001,613000,3999,False,36,scaffold_11
8,648001,656000,7999,False,36,scaffold_11
9,1025001,1034000,8999,False,36,scaffold_11
10,1102001,1113000,10999,False,36,scaffold_11
11,1315001,1358000,42999,False,36,scaffold_11
12,1360001,1398000,37999,False,36,scaffold_11
13,1403001,1409000,5999,False,36,scaffold_11
14,1423001,1426000,2999,False,36,scaffold_11
15,1474001,1478000,3999,False,36,scaffold_11
16,1525001,1551000,25999,False,36,scaffold_11
17,1853001,1928000,74999,False,36,scaffold_11
18,1931001,2034000,102999,False,36,scaffold_11
19,2035001,2058000,22999,False,36,scaffold_11
20,2126001,2172000,45999,False,36,scaffold_11
21,2179001,2221000,41999,False,36,scaffold_11
22,2701001,2751000,49999,False,36,scaffold_11
23,2752001,2920000,167999,False,36,scaffold_11
24,2950001,3021000,70999,False,36,scaffold_11
25,3079001,3241000,161999,False,36,scaffold_11
26,3242001,3320000,77999,False,36,scaffold_11
27,3327001,3383000,55999,False,36,scaffold_11
28,3433001,3481000,47999,False,36,scaffold_11
29,3520001,3642000,121999,False,36,scaffold_11
30,3705001,3721000,15999,False,36,scaffold_11
31,3744001,3886000,141999,False,36,scaffold_11
32,3906001,3960000,53999,False,36,scaffold_11
33,3985001,4159000,173999,False,36,scaffold_11
34,4182001,4710000,527999,False,36,scaffold_11
35,4713001,4766820,53819,True,36,scaffold_11
0,1,101000,100999,True,36,scaffold_12
1,102001,1366000,1263999,False,36,scaffold_12
2,1376001,1500000,123999,False,36,scaffold_12
3,1720001,1733000,12999,False,36,scaffold_12
4,1785001,1811000,25999,False,36,scaffold_12
5,1882001,2004000,121999,False,36,scaffold_12
6,2023001,2087000,63999,False,36,scaffold_12
7,2088001,2103000,14999,False,36,scaffold_12
8,2130001,2190000,59999,False,36,scaffold_12
9,2286001,2301000,14999,False,36,scaffold_12
10,2340001,2379000,38999,False,36,scaffold_12
11,2531001,2547000,15999,False,36,scaffold_12
12,2571001,2609000,37999,False,36,scaffold_12
13,2685001,2699000,13999,False,36,scaffold_12
14,2700001,2705000,4999,False,36,scaffold_12
15,2747001,2747968,967,True,36,scaffold_12
0,1,357000,356999,True,37,scaffold_1
1,481001,498000,16999,False,37,scaffold_1
2,571001,671000,99999,False,37,scaffold_1
3,686001,785000,98999,False,37,scaffold_1
4,792001,947000,154999,False,37,scaffold_1
5,1168001,1195000,26999,False,37,scaffold_1
6,1282001,1294000,11999,False,37,scaffold_1
7,1297001,1341000,43999,False,37,scaffold_1
8,1608001,1660000,51999,False,37,scaffold_1
9,1661001,1701000,39999,False,37,scaffold_1
10,1727001,1964000,236999,False,37,scaffold_1
11,1965001,1985000,19999,False,37,scaffold_1
12,1986001,2025000,38999,False,37,scaffold_1
13,2343001,2415000,71999,False,37,scaffold_1
14,2449001,2531000,81999,False,37,scaffold_1
15,2555001,2582000,26999,False,37,scaffold_1
16,2716001,2746000,29999,False,37,scaffold_1
17,2897001,2921000,23999,False,37,scaffold_1
18,2962001,3030000,67999,False,37,scaffold_1
19,3160001,3240000,79999,False,37,scaffold_1
20,3304001,3355000,50999,False,37,scaffold_1
21,3443001,3510000,66999,False,37,scaffold_1
22,3548001,3619000,70999,False,37,scaffold_1
23,3685001,3941000,255999,False,37,scaffold_1
24,3942001,4168000,225999,False,37,scaffold_1
25,4261001,4554000,292999,False,37,scaffold_1
26,4644001,4795000,150999,False,37,scaffold_1
27,4796001,5066000,269999,False,37,scaffold_1
28,5087001,5205000,117999,False,37,scaffold_1
29,5345001,5376000,30999,False,37,scaffold_1
30,5436001,5468000,31999,False,37,scaffold_1
31,5481001,5521000,39999,False,37,scaffold_1
32,5528001,5589000,60999,False,37,scaffold_1
33,5855001,5952000,96999,False,37,scaffold_1
34,6041001,6067000,25999,False,37,scaffold_1
35,6108001,6153000,44999,False,37,scaffold_1
36,6154001,6178000,23999,False,37,scaffold_1
37,6201001,6567000,365999,False,37,scaffold_1
38,6641001,6656000,14999,False,37,scaffold_1
39,6811001,6862000,50999,False,37,scaffold_1
40,6864001,6953000,88999,False,37,scaffold_1
41,6970001,6991000,20999,False,37,scaffold_1
42,6993001,7029000,35999,False,37,scaffold_1
43,7038001,7247000,208999,False,37,scaffold_1
44,7248001,7589000,340999,False,37,scaffold_1
45,7590001,8656000,1065999,False,37,scaffold_1
46,8658001,9584000,925999,False,37,scaffold_1
47,9586001,10364000,777999,False,37,scaffold_1
48,10436001,10638000,201999,False,37,scaffold_1
49,10737001,10756000,18999,False,37,scaffold_1
50,10832001,10857000,24999,False,37,scaffold_1
51,10895001,10987000,91999,False,37,scaffold_1
52,11013001,11099000,85999,False,37,scaffold_1
53,11117001,11222000,104999,False,37,scaffold_1
54,11271001,11964000,692999,False,37,scaffold_1
55,12184001,12243000,58999,False,37,scaffold_1
56,12329001,12375000,45999,False,37,scaffold_1
57,12414001,12589000,174999,False,37,scaffold_1
58,12617001,12950000,332999,False,37,scaffold_1
59,12963001,13075000,111999,False,37,scaffold_1
60,13102001,13217000,114999,False,37,scaffold_1
61,13319001,13496000,176999,False,37,scaffold_1
62,13499001,13516000,16999,False,37,scaffold_1
63,13517001,13626000,108999,False,37,scaffold_1
64,13668001,13721000,52999,False,37,scaffold_1
65,13783001,13845000,61999,False,37,scaffold_1
66,13846001,13927000,80999,False,37,scaffold_1
67,13928001,13955000,26999,False,37,scaffold_1
68,13959001,13998000,38999,False,37,scaffold_1
69,14007001,14077000,69999,False,37,scaffold_1
70,14288001,14313000,24999,False,37,scaffold_1
71,14501001,14591000,89999,False,37,scaffold_1
72,14648001,14664000,15999,False,37,scaffold_1
73,14717001,14725000,7999,False,37,scaffold_1
74,14744001,14794116,50115,True,37,scaffold_1
0,1,48000,47999,True,37,scaffold_2
1,95001,159000,63999,False,37,scaffold_2
2,168001,176000,7999,False,37,scaffold_2
3,178001,183000,4999,False,37,scaffold_2
4,296001,318000,21999,False,37,scaffold_2
5,332001,374000,41999,False,37,scaffold_2
6,428001,446000,17999,False,37,scaffold_2
7,495001,505000,9999,False,37,scaffold_2
8,731001,739000,7999,False,37,scaffold_2
9,1116001,1135000,18999,False,37,scaffold_2
10,1233001,1260000,26999,False,37,scaffold_2
11,1310001,1334000,23999,False,37,scaffold_2
12,1335001,1557000,221999,False,37,scaffold_2
13,1625001,1718000,92999,False,37,scaffold_2
14,1805001,1861000,55999,False,37,scaffold_2
15,1874001,1900000,25999,False,37,scaffold_2
16,1916001,1959000,42999,False,37,scaffold_2
17,2085001,2143000,57999,False,37,scaffold_2
18,2203001,2245000,41999,False,37,scaffold_2
19,2301001,2334000,32999,False,37,scaffold_2
20,2336001,2608000,271999,False,37,scaffold_2
21,2627001,2639000,11999,False,37,scaffold_2
22,2645001,2689000,43999,False,37,scaffold_2
23,2694001,2747000,52999,False,37,scaffold_2
24,2766001,2776000,9999,False,37,scaffold_2
25,2777001,2866000,88999,False,37,scaffold_2
26,2868001,3021000,152999,False,37,scaffold_2
27,3022001,3106000,83999,False,37,scaffold_2
28,3226001,3282000,55999,False,37,scaffold_2
29,3285001,3390000,104999,False,37,scaffold_2
30,3448001,3719000,270999,False,37,scaffold_2
31,3752001,3957000,204999,False,37,scaffold_2
32,3958001,4061000,102999,False,37,scaffold_2
33,4102001,4148000,45999,False,37,scaffold_2
34,4164001,4192000,27999,False,37,scaffold_2
35,4221001,4409000,187999,False,37,scaffold_2
36,4426001,4463000,36999,False,37,scaffold_2
37,4472001,4790000,317999,False,37,scaffold_2
38,4793001,4809000,15999,False,37,scaffold_2
39,4892001,4986000,93999,False,37,scaffold_2
40,5020001,5104000,83999,False,37,scaffold_2
41,5250001,5273000,22999,False,37,scaffold_2
42,5288001,5779000,490999,False,37,scaffold_2
43,5815001,6059000,243999,False,37,scaffold_2
44,6065001,6080000,14999,False,37,scaffold_2
45,6091001,6188000,96999,False,37,scaffold_2
46,6227001,6351000,123999,False,37,scaffold_2
47,6365001,6478000,112999,False,37,scaffold_2
48,6507001,6636000,128999,False,37,scaffold_2
49,6697001,6740000,42999,False,37,scaffold_2
50,6802001,6864000,61999,False,37,scaffold_2
51,6940001,7097000,156999,False,37,scaffold_2
52,7351001,7477000,125999,False,37,scaffold_2
53,7491001,7518000,26999,False,37,scaffold_2
54,7548001,7561000,12999,False,37,scaffold_2
55,7563001,8328000,764999,False,37,scaffold_2
56,8331001,8345000,13999,False,37,scaffold_2
57,8346001,8494000,147999,False,37,scaffold_2
58,8495001,8564000,68999,False,37,scaffold_2
59,9001001,9073000,71999,False,37,scaffold_2
60,9139001,9382000,242999,False,37,scaffold_2
61,9596001,9638000,41999,False,37,scaffold_2
62,9669001,9750000,80999,False,37,scaffold_2
63,9752001,9902000,149999,False,37,scaffold_2
64,10404001,10495000,90999,False,37,scaffold_2
65,10645001,10708000,62999,False,37,scaffold_2
66,10710001,10736000,25999,False,37,scaffold_2
67,10774001,10806000,31999,False,37,scaffold_2
68,10859001,10886000,26999,False,37,scaffold_2
69,11023001,11071000,47999,False,37,scaffold_2
70,11314001,11411000,96999,False,37,scaffold_2
71,11520001,11802476,282475,True,37,scaffold_2
0,1,2000,1999,True,37,scaffold_3
1,218001,230000,11999,False,37,scaffold_3
2,796001,936000,139999,False,37,scaffold_3
3,938001,941000,2999,False,37,scaffold_3
4,1153001,1162000,8999,False,37,scaffold_3
5,1204001,1232000,27999,False,37,scaffold_3
6,1358001,1377000,18999,False,37,scaffold_3
7,1529001,1540000,10999,False,37,scaffold_3
8,1563001,1582000,18999,False,37,scaffold_3
9,1584001,1672000,87999,False,37,scaffold_3
10,1722001,1785000,62999,False,37,scaffold_3
11,1828001,1860000,31999,False,37,scaffold_3
12,1936001,1980000,43999,False,37,scaffold_3
13,1993001,2195000,201999,False,37,scaffold_3
14,2208001,2336000,127999,False,37,scaffold_3
15,2376001,2428000,51999,False,37,scaffold_3
16,2433001,2533000,99999,False,37,scaffold_3
17,2593001,2610000,16999,False,37,scaffold_3
18,2644001,2877000,232999,False,37,scaffold_3
19,2890001,2947000,56999,False,37,scaffold_3
20,2985001,3062000,76999,False,37,scaffold_3
21,3064001,3292000,227999,False,37,scaffold_3
22,3304001,3353000,48999,False,37,scaffold_3
23,3410001,3427000,16999,False,37,scaffold_3
24,3473001,3515000,41999,False,37,scaffold_3
25,3560001,3738000,177999,False,37,scaffold_3
26,3768001,3891000,122999,False,37,scaffold_3
27,3907001,3921000,13999,False,37,scaffold_3
28,3922001,3953000,30999,False,37,scaffold_3
29,3998001,4039000,40999,False,37,scaffold_3
30,4040001,4404000,363999,False,37,scaffold_3
31,4415001,4521000,105999,False,37,scaffold_3
32,4546001,4558000,11999,False,37,scaffold_3
33,4652001,4680000,27999,False,37,scaffold_3
34,4853001,4926000,72999,False,37,scaffold_3
35,4997001,5038000,40999,False,37,scaffold_3
36,5047001,5312000,264999,False,37,scaffold_3
37,5370001,5676000,305999,False,37,scaffold_3
38,5678001,6123000,444999,False,37,scaffold_3
39,6218001,6244000,25999,False,37,scaffold_3
40,6741001,6807000,65999,False,37,scaffold_3
41,6886001,7098000,211999,False,37,scaffold_3
42,7111001,7157000,45999,False,37,scaffold_3
43,7224001,7321000,96999,False,37,scaffold_3
44,7332001,7446000,113999,False,37,scaffold_3
45,7449001,7458000,8999,False,37,scaffold_3
46,7462001,7563000,100999,False,37,scaffold_3
47,7575001,7980000,404999,False,37,scaffold_3
48,8028001,8116000,87999,False,37,scaffold_3
49,8121001,8157000,35999,False,37,scaffold_3
50,8175001,8253000,77999,False,37,scaffold_3
51,8312001,8555000,242999,False,37,scaffold_3
52,8574001,8594000,19999,False,37,scaffold_3
53,8756001,8805000,48999,False,37,scaffold_3
54,8956001,9262000,305999,False,37,scaffold_3
55,9453001,9618000,164999,False,37,scaffold_3
56,9645001,9695000,49999,False,37,scaffold_3
57,9967001,9996000,28999,False,37,scaffold_3
58,10043001,10090000,46999,False,37,scaffold_3
59,10461001,10486000,24999,False,37,scaffold_3
60,10551001,11182071,631070,True,37,scaffold_3
0,1,7000,6999,True,37,scaffold_4
1,11001,13000,1999,False,37,scaffold_4
2,17001,32000,14999,False,37,scaffold_4
3,48001,88000,39999,False,37,scaffold_4
4,101001,115000,13999,False,37,scaffold_4
5,120001,146000,25999,False,37,scaffold_4
6,147001,151000,3999,False,37,scaffold_4
7,155001,214000,58999,False,37,scaffold_4
8,217001,270000,52999,False,37,scaffold_4
9,283001,353000,69999,False,37,scaffold_4
10,355001,374000,18999,False,37,scaffold_4
11,404001,425000,20999,False,37,scaffold_4
12,429001,606000,176999,False,37,scaffold_4
13,608001,691000,82999,False,37,scaffold_4
14,705001,716000,10999,False,37,scaffold_4
15,1050001,1063000,12999,False,37,scaffold_4
16,1087001,1097000,9999,False,37,scaffold_4
17,1099001,1108000,8999,False,37,scaffold_4
18,1113001,1136000,22999,False,37,scaffold_4
19,1137001,1227000,89999,False,37,scaffold_4
20,1229001,1279000,49999,False,37,scaffold_4
21,1283001,1605000,321999,False,37,scaffold_4
22,1609001,2206000,596999,False,37,scaffold_4
23,2207001,2280000,72999,False,37,scaffold_4
24,2282001,2461000,178999,False,37,scaffold_4
25,2476001,2675000,198999,False,37,scaffold_4
26,2676001,2814000,137999,False,37,scaffold_4
27,2891001,3139000,247999,False,37,scaffold_4
28,3160001,3819000,658999,False,37,scaffold_4
29,3917001,3952000,34999,False,37,scaffold_4
30,3968001,3987000,18999,False,37,scaffold_4
31,4001001,4147000,145999,False,37,scaffold_4
32,4224001,4306000,81999,False,37,scaffold_4
33,4868001,5102000,233999,False,37,scaffold_4
34,5169001,5239000,69999,False,37,scaffold_4
35,5269001,5329000,59999,False,37,scaffold_4
36,5338001,5506000,167999,False,37,scaffold_4
37,5513001,5784000,270999,False,37,scaffold_4
38,5785001,6197000,411999,False,37,scaffold_4
39,6198001,6538000,339999,False,37,scaffold_4
40,6550001,6612000,61999,False,37,scaffold_4
41,6615001,6617000,1999,False,37,scaffold_4
42,6619001,6640000,20999,False,37,scaffold_4
43,6705001,6924000,218999,False,37,scaffold_4
44,6926001,6995000,68999,False,37,scaffold_4
45,7036001,7430000,393999,False,37,scaffold_4
46,7457001,7571000,113999,False,37,scaffold_4
47,7628001,7666000,37999,False,37,scaffold_4
48,7836001,7925000,88999,False,37,scaffold_4
49,7968001,8015000,46999,False,37,scaffold_4
50,8051001,8139000,87999,False,37,scaffold_4
51,8453001,8466000,12999,False,37,scaffold_4
52,8714001,8830000,115999,False,37,scaffold_4
53,8844001,9699000,854999,False,37,scaffold_4
54,9711001,9845951,134950,True,37,scaffold_4
0,1,4000,3999,True,37,scaffold_5
1,28001,32000,3999,False,37,scaffold_5
2,141001,207000,65999,False,37,scaffold_5
3,318001,428000,109999,False,37,scaffold_5
4,463001,526000,62999,False,37,scaffold_5
5,610001,661000,50999,False,37,scaffold_5
6,668001,720000,51999,False,37,scaffold_5
7,751001,762000,10999,False,37,scaffold_5
8,803001,832000,28999,False,37,scaffold_5
9,909001,947000,37999,False,37,scaffold_5
10,1081001,1153000,71999,False,37,scaffold_5
11,1168001,1182000,13999,False,37,scaffold_5
12,1355001,1419000,63999,False,37,scaffold_5
13,1647001,1661000,13999,False,37,scaffold_5
14,1663001,1685000,21999,False,37,scaffold_5
15,1759001,1816000,56999,False,37,scaffold_5
16,1946001,1966000,19999,False,37,scaffold_5
17,2083001,2104000,20999,False,37,scaffold_5
18,2255001,2303000,47999,False,37,scaffold_5
19,2473001,2515000,41999,False,37,scaffold_5
20,2516001,2898000,381999,False,37,scaffold_5
21,3133001,3518000,384999,False,37,scaffold_5
22,3615001,3663000,47999,False,37,scaffold_5
23,3834001,3947000,112999,False,37,scaffold_5
24,3960001,4101000,140999,False,37,scaffold_5
25,4117001,4385000,267999,False,37,scaffold_5
26,4443001,4995000,551999,False,37,scaffold_5
27,5004001,5034000,29999,False,37,scaffold_5
28,5054001,5161000,106999,False,37,scaffold_5
29,5197001,5346000,148999,False,37,scaffold_5
30,5497001,5541000,43999,False,37,scaffold_5
31,6391001,6727000,335999,False,37,scaffold_5
32,6762001,6853000,90999,False,37,scaffold_5
33,6881001,6967000,85999,False,37,scaffold_5
34,7169001,7328000,158999,False,37,scaffold_5
35,7406001,7441000,34999,False,37,scaffold_5
36,7454001,7841000,386999,False,37,scaffold_5
37,8400001,8470000,69999,False,37,scaffold_5
38,8546001,8619000,72999,False,37,scaffold_5
39,8636001,8689000,52999,False,37,scaffold_5
40,8691001,9364176,673175,True,37,scaffold_5
0,65001,75000,9999,False,37,scaffold_6
1,79001,85000,5999,False,37,scaffold_6
2,86001,121000,34999,False,37,scaffold_6
3,122001,208000,85999,False,37,scaffold_6
4,239001,321000,81999,False,37,scaffold_6
5,456001,498000,41999,False,37,scaffold_6
6,590001,596000,5999,False,37,scaffold_6
7,618001,674000,55999,False,37,scaffold_6
8,695001,806000,110999,False,37,scaffold_6
9,833001,851000,17999,False,37,scaffold_6
10,900001,1089000,188999,False,37,scaffold_6
11,1120001,1226000,105999,False,37,scaffold_6
12,1229001,1267000,37999,False,37,scaffold_6
13,1284001,1303000,18999,False,37,scaffold_6
14,1327001,1367000,39999,False,37,scaffold_6
15,1384001,1779000,394999,False,37,scaffold_6
16,1801001,1966000,164999,False,37,scaffold_6
17,1976001,2019000,42999,False,37,scaffold_6
18,2023001,2215000,191999,False,37,scaffold_6
19,2236001,2284000,47999,False,37,scaffold_6
20,2295001,2872000,576999,False,37,scaffold_6
21,2904001,2925000,20999,False,37,scaffold_6
22,2927001,3210000,282999,False,37,scaffold_6
23,3223001,3350000,126999,False,37,scaffold_6
24,3351001,3799000,447999,False,37,scaffold_6
25,3810001,3933000,122999,False,37,scaffold_6
26,3950001,4206000,255999,False,37,scaffold_6
27,4446001,4484000,37999,False,37,scaffold_6
28,4631001,4757000,125999,False,37,scaffold_6
29,4802001,4918000,115999,False,37,scaffold_6
30,4924001,4997000,72999,False,37,scaffold_6
31,5152001,5176000,23999,False,37,scaffold_6
32,5290001,5320000,29999,False,37,scaffold_6
33,5619001,5788000,168999,False,37,scaffold_6
34,5862001,6277000,414999,False,37,scaffold_6
35,6470001,6505000,34999,False,37,scaffold_6
36,6652001,6715000,62999,False,37,scaffold_6
37,6776001,6805000,28999,False,37,scaffold_6
38,6834001,6859000,24999,False,37,scaffold_6
39,6926001,6941000,14999,False,37,scaffold_6
40,6974001,7008000,33999,False,37,scaffold_6
41,7074001,7102000,27999,False,37,scaffold_6
42,7188001,7343000,154999,False,37,scaffold_6
43,7382001,7530000,147999,False,37,scaffold_6
44,7531001,8268281,737280,True,37,scaffold_6
0,13001,31000,17999,False,37,scaffold_7
1,310001,340000,29999,False,37,scaffold_7
2,342001,509000,166999,False,37,scaffold_7
3,571001,577000,5999,False,37,scaffold_7
4,580001,591000,10999,False,37,scaffold_7
5,621001,641000,19999,False,37,scaffold_7
6,651001,674000,22999,False,37,scaffold_7
7,706001,736000,29999,False,37,scaffold_7
8,740001,753000,12999,False,37,scaffold_7
9,764001,843000,78999,False,37,scaffold_7
10,859001,864000,4999,False,37,scaffold_7
11,868001,963000,94999,False,37,scaffold_7
12,964001,980000,15999,False,37,scaffold_7
13,982001,1044000,61999,False,37,scaffold_7
14,1165001,1513000,347999,False,37,scaffold_7
15,1588001,1719000,130999,False,37,scaffold_7
16,1738001,1757000,18999,False,37,scaffold_7
17,1758001,1782000,23999,False,37,scaffold_7
18,1817001,2055000,237999,False,37,scaffold_7
19,2365001,2410000,44999,False,37,scaffold_7
20,2427001,2467000,39999,False,37,scaffold_7
21,2511001,2748000,236999,False,37,scaffold_7
22,2803001,2842000,38999,False,37,scaffold_7
23,2931001,2958000,26999,False,37,scaffold_7
24,3005001,3024000,18999,False,37,scaffold_7
25,3076001,3271000,194999,False,37,scaffold_7
26,3297001,3407000,109999,False,37,scaffold_7
27,3517001,3978000,460999,False,37,scaffold_7
28,4021001,4066000,44999,False,37,scaffold_7
29,4322001,4361000,38999,False,37,scaffold_7
30,4413001,4515000,101999,False,37,scaffold_7
31,4550001,4582000,31999,False,37,scaffold_7
32,4633001,5169000,535999,False,37,scaffold_7
33,5420001,5679000,258999,False,37,scaffold_7
34,5780001,5809000,28999,False,37,scaffold_7
35,5814001,5858000,43999,False,37,scaffold_7
36,5872001,5932000,59999,False,37,scaffold_7
37,5933001,5996000,62999,False,37,scaffold_7
38,6046001,6250000,203999,False,37,scaffold_7
39,6317001,6429000,111999,False,37,scaffold_7
40,6467001,6510000,42999,False,37,scaffold_7
41,6558001,6874000,315999,False,37,scaffold_7
42,6953001,7270000,316999,False,37,scaffold_7
43,7271001,7502216,231215,True,37,scaffold_7
0,1,5000,4999,True,37,scaffold_8
1,66001,85000,18999,False,37,scaffold_8
2,96001,102000,5999,False,37,scaffold_8
3,168001,170000,1999,False,37,scaffold_8
4,364001,367000,2999,False,37,scaffold_8
5,749001,760000,10999,False,37,scaffold_8
6,790001,792000,1999,False,37,scaffold_8
7,1020001,1038000,17999,False,37,scaffold_8
8,1369001,1433000,63999,False,37,scaffold_8
9,1859001,1931000,71999,False,37,scaffold_8
10,2066001,2154000,87999,False,37,scaffold_8
11,2223001,2237000,13999,False,37,scaffold_8
12,2338001,2530000,191999,False,37,scaffold_8
13,2536001,2597000,60999,False,37,scaffold_8
14,2650001,3125000,474999,False,37,scaffold_8
15,3126001,3938000,811999,False,37,scaffold_8
16,3996001,4274000,277999,False,37,scaffold_8
17,4331001,4376000,44999,False,37,scaffold_8
18,4394001,4432000,37999,False,37,scaffold_8
19,4470001,4488000,17999,False,37,scaffold_8
20,4610001,4646000,35999,False,37,scaffold_8
21,4717001,4777000,59999,False,37,scaffold_8
22,4796001,4956000,159999,False,37,scaffold_8
23,4983001,5042000,58999,False,37,scaffold_8
24,5078001,5271000,192999,False,37,scaffold_8
25,5363001,5477000,113999,False,37,scaffold_8
26,5503001,5596000,92999,False,37,scaffold_8
27,5649001,5723000,73999,False,37,scaffold_8
28,5727001,5806000,78999,False,37,scaffold_8
29,5807001,5879000,71999,False,37,scaffold_8
30,5881001,6200000,318999,False,37,scaffold_8
31,6221001,6308000,86999,False,37,scaffold_8
32,6320001,6334544,14543,True,37,scaffold_8
0,1,22000,21999,True,37,scaffold_9
1,109001,118000,8999,False,37,scaffold_9
2,121001,137000,15999,False,37,scaffold_9
3,304001,315000,10999,False,37,scaffold_9
4,319001,330000,10999,False,37,scaffold_9
5,366001,411000,44999,False,37,scaffold_9
6,413001,434000,20999,False,37,scaffold_9
7,501001,531000,29999,False,37,scaffold_9
8,647001,659000,11999,False,37,scaffold_9
9,660001,665000,4999,False,37,scaffold_9
10,669001,696000,26999,False,37,scaffold_9
11,733001,741000,7999,False,37,scaffold_9
12,814001,847000,32999,False,37,scaffold_9
13,850001,854000,3999,False,37,scaffold_9
14,872001,986000,113999,False,37,scaffold_9
15,988001,995000,6999,False,37,scaffold_9
16,1001001,1007000,5999,False,37,scaffold_9
17,1009001,1085000,75999,False,37,scaffold_9
18,1087001,1196000,108999,False,37,scaffold_9
19,1201001,1257000,55999,False,37,scaffold_9
20,1312001,1402000,89999,False,37,scaffold_9
21,1404001,1423000,18999,False,37,scaffold_9
22,1426001,1455000,28999,False,37,scaffold_9
23,1457001,1465000,7999,False,37,scaffold_9
24,1486001,1623000,136999,False,37,scaffold_9
25,1637001,1728000,90999,False,37,scaffold_9
26,1730001,1812000,81999,False,37,scaffold_9
27,1814001,1859000,44999,False,37,scaffold_9
28,1866001,1959000,92999,False,37,scaffold_9
29,1971001,2354000,382999,False,37,scaffold_9
30,2388001,3381000,992999,False,37,scaffold_9
31,3383001,5107000,1723999,False,37,scaffold_9
32,5112001,5115000,2999,False,37,scaffold_9
33,5116001,5238000,121999,False,37,scaffold_9
34,5239001,5298000,58999,False,37,scaffold_9
35,5299001,5490000,190999,False,37,scaffold_9
36,5493001,6331288,838287,True,37,scaffold_9
0,1,136000,135999,True,37,scaffold_10
1,137001,414000,276999,False,37,scaffold_10
2,415001,482000,66999,False,37,scaffold_10
3,483001,881000,397999,False,37,scaffold_10
4,887001,1069000,181999,False,37,scaffold_10
5,1072001,1212000,139999,False,37,scaffold_10
6,1309001,1473000,163999,False,37,scaffold_10
7,1487001,1570000,82999,False,37,scaffold_10
8,1590001,1760000,169999,False,37,scaffold_10
9,1803001,1835000,31999,False,37,scaffold_10
10,1861001,1930000,68999,False,37,scaffold_10
11,2008001,2110000,101999,False,37,scaffold_10
12,2138001,2425000,286999,False,37,scaffold_10
13,2426001,2474000,47999,False,37,scaffold_10
14,2509001,2520000,10999,False,37,scaffold_10
15,2521001,2816000,294999,False,37,scaffold_10
16,2817001,2861000,43999,False,37,scaffold_10
17,2935001,2954000,18999,False,37,scaffold_10
18,3064001,3203000,138999,False,37,scaffold_10
19,3360001,3424000,63999,False,37,scaffold_10
20,3426001,3460000,33999,False,37,scaffold_10
21,3462001,3476000,13999,False,37,scaffold_10
22,3559001,3584000,24999,False,37,scaffold_10
23,3633001,3656000,22999,False,37,scaffold_10
24,4052001,4093000,40999,False,37,scaffold_10
25,4154001,4182000,27999,False,37,scaffold_10
26,4316001,4323000,6999,False,37,scaffold_10
27,4334001,4359000,24999,False,37,scaffold_10
28,4443001,4462000,18999,False,37,scaffold_10
29,4467001,4502000,34999,False,37,scaffold_10
30,4503001,4513000,9999,False,37,scaffold_10
31,4515001,4523000,7999,False,37,scaffold_10
32,4526001,4548000,21999,False,37,scaffold_10
33,4554001,4562000,7999,False,37,scaffold_10
34,4565001,4597000,31999,False,37,scaffold_10
35,4725001,4732000,6999,False,37,scaffold_10
36,4734001,4776000,41999,False,37,scaffold_10
37,4798001,4826000,27999,False,37,scaffold_10
38,4828001,4843000,14999,False,37,scaffold_10
39,4848001,4861000,12999,False,37,scaffold_10
40,4865001,4866973,1972,True,37,scaffold_10
0,10001,99000,88999,False,37,scaffold_11
1,149001,167000,17999,False,37,scaffold_11
2,169001,212000,42999,False,37,scaffold_11
3,213001,235000,21999,False,37,scaffold_11
4,296001,318000,21999,False,37,scaffold_11
5,419001,431000,11999,False,37,scaffold_11
6,637001,656000,18999,False,37,scaffold_11
7,1025001,1034000,8999,False,37,scaffold_11
8,1219001,1243000,23999,False,37,scaffold_11
9,1306001,1314000,7999,False,37,scaffold_11
10,1315001,1398000,82999,False,37,scaffold_11
11,1431001,1469000,37999,False,37,scaffold_11
12,1474001,1478000,3999,False,37,scaffold_11
13,1526001,1605000,78999,False,37,scaffold_11
14,1672001,1693000,20999,False,37,scaffold_11
15,1710001,1742000,31999,False,37,scaffold_11
16,1815001,1828000,12999,False,37,scaffold_11
17,1853001,1886000,32999,False,37,scaffold_11
18,1892001,2058000,165999,False,37,scaffold_11
19,2063001,2172000,108999,False,37,scaffold_11
20,2189001,2233000,43999,False,37,scaffold_11
21,2573001,2620000,46999,False,37,scaffold_11
22,2674001,2911000,236999,False,37,scaffold_11
23,2952001,3035000,82999,False,37,scaffold_11
24,3079001,3509000,429999,False,37,scaffold_11
25,3520001,4161000,640999,False,37,scaffold_11
26,4189001,4710000,520999,False,37,scaffold_11
27,4713001,4766820,53819,True,37,scaffold_11
0,1,1509000,1508999,True,37,scaffold_12
1,1570001,1588000,17999,False,37,scaffold_12
2,1638001,1683000,44999,False,37,scaffold_12
3,1717001,1747000,29999,False,37,scaffold_12
4,1782001,1809000,26999,False,37,scaffold_12
5,1824001,2005000,180999,False,37,scaffold_12
6,2006001,2041000,34999,False,37,scaffold_12
7,2043001,2103000,59999,False,37,scaffold_12
8,2129001,2192000,62999,False,37,scaffold_12
9,2202001,2205000,2999,False,37,scaffold_12
10,2220001,2263000,42999,False,37,scaffold_12
11,2320001,2398000,77999,False,37,scaffold_12
12,2571001,2617000,45999,False,37,scaffold_12
13,2689001,2699000,9999,False,37,scaffold_12
0,1,340000,339999,True,38,scaffold_1
1,482001,498000,15999,False,38,scaffold_1
2,571001,643000,71999,False,38,scaffold_1
3,686001,714000,27999,False,38,scaffold_1
4,727001,743000,15999,False,38,scaffold_1
5,1282001,1292000,9999,False,38,scaffold_1
6,1952001,1964000,11999,False,38,scaffold_1
7,1965001,1984000,18999,False,38,scaffold_1
8,2449001,2465000,15999,False,38,scaffold_1
9,2729001,2746000,16999,False,38,scaffold_1
10,3181001,3208000,26999,False,38,scaffold_1
11,3715001,3733000,17999,False,38,scaffold_1
12,3917001,3941000,23999,False,38,scaffold_1
13,4065001,4111000,45999,False,38,scaffold_1
14,4314001,4354000,39999,False,38,scaffold_1
15,4928001,4959000,30999,False,38,scaffold_1
16,4973001,4984000,10999,False,38,scaffold_1
17,5482001,5511000,28999,False,38,scaffold_1
18,6108001,6153000,44999,False,38,scaffold_1
19,6228001,6507000,278999,False,38,scaffold_1
20,7038001,7247000,208999,False,38,scaffold_1
21,7248001,7588000,339999,False,38,scaffold_1
22,7590001,8656000,1065999,False,38,scaffold_1
23,8658001,9584000,925999,False,38,scaffold_1
24,9586001,10354000,767999,False,38,scaffold_1
25,10461001,10630000,168999,False,38,scaffold_1
26,10808001,10811000,2999,False,38,scaffold_1
27,10839001,10857000,17999,False,38,scaffold_1
28,11351001,11504000,152999,False,38,scaffold_1
29,11643001,11951000,307999,False,38,scaffold_1
30,12184001,12204000,19999,False,38,scaffold_1
31,12678001,12722000,43999,False,38,scaffold_1
32,12777001,12888000,110999,False,38,scaffold_1
33,13181001,13211000,29999,False,38,scaffold_1
34,13347001,13378000,30999,False,38,scaffold_1
35,13392001,13404000,11999,False,38,scaffold_1
36,13900001,13903000,2999,False,38,scaffold_1
37,14007001,14009000,1999,False,38,scaffold_1
0,20001,48000,27999,False,38,scaffold_2
1,93001,159000,65999,False,38,scaffold_2
2,168001,177000,8999,False,38,scaffold_2
3,306001,318000,11999,False,38,scaffold_2
4,333001,374000,40999,False,38,scaffold_2
5,2336001,2358000,21999,False,38,scaffold_2
6,2405001,2424000,18999,False,38,scaffold_2
7,2441001,2553000,111999,False,38,scaffold_2
8,2660001,2689000,28999,False,38,scaffold_2
9,2694001,2742000,47999,False,38,scaffold_2
10,2777001,2788000,10999,False,38,scaffold_2
11,2994001,3012000,17999,False,38,scaffold_2
12,3454001,3463000,8999,False,38,scaffold_2
13,3767001,3781000,13999,False,38,scaffold_2
14,4385001,4409000,23999,False,38,scaffold_2
15,4429001,4456000,26999,False,38,scaffold_2
16,4525001,4553000,27999,False,38,scaffold_2
17,4607001,4653000,45999,False,38,scaffold_2
18,5022001,5031000,8999,False,38,scaffold_2
19,5033001,5061000,27999,False,38,scaffold_2
20,5491001,5511000,19999,False,38,scaffold_2
21,5672001,5704000,31999,False,38,scaffold_2
22,6261001,6330000,68999,False,38,scaffold_2
23,6331001,6342000,10999,False,38,scaffold_2
24,7439001,7472000,32999,False,38,scaffold_2
25,7563001,7697000,133999,False,38,scaffold_2
26,7786001,7890000,103999,False,38,scaffold_2
27,7934001,7965000,30999,False,38,scaffold_2
28,7985001,8088000,102999,False,38,scaffold_2
29,8331001,8333000,1999,False,38,scaffold_2
30,8340001,8345000,4999,False,38,scaffold_2
31,8346001,8388000,41999,False,38,scaffold_2
32,8509001,8535000,25999,False,38,scaffold_2
33,11367001,11373000,5999,False,38,scaffold_2
34,11520001,11785000,264999,False,38,scaffold_2
0,1,2000,1999,True,38,scaffold_3
1,51001,55000,3999,False,38,scaffold_3
2,102001,104000,1999,False,38,scaffold_3
3,799001,900000,100999,False,38,scaffold_3
4,2085001,2108000,22999,False,38,scaffold_3
5,2291001,2321000,29999,False,38,scaffold_3
6,2508001,2533000,24999,False,38,scaffold_3
7,4150001,4383000,232999,False,38,scaffold_3
8,4418001,4518000,99999,False,38,scaffold_3
9,4547001,4558000,10999,False,38,scaffold_3
10,4654001,4678000,23999,False,38,scaffold_3
11,6911001,6962000,50999,False,38,scaffold_3
12,6980001,7036000,55999,False,38,scaffold_3
13,7540001,7556000,15999,False,38,scaffold_3
14,7692001,7724000,31999,False,38,scaffold_3
15,7822001,7838000,15999,False,38,scaffold_3
16,8462001,8527000,64999,False,38,scaffold_3
17,8575001,8594000,18999,False,38,scaffold_3
18,9968001,9988000,19999,False,38,scaffold_3
19,10461001,10480000,18999,False,38,scaffold_3
20,10587001,11166000,578999,False,38,scaffold_3
0,17001,32000,14999,False,38,scaffold_4
1,49001,88000,38999,False,38,scaffold_4
2,134001,151000,16999,False,38,scaffold_4
3,155001,160000,4999,False,38,scaffold_4
4,161001,215000,53999,False,38,scaffold_4
5,217001,226000,8999,False,38,scaffold_4
6,227001,266000,38999,False,38,scaffold_4
7,294001,306000,11999,False,38,scaffold_4
8,355001,374000,18999,False,38,scaffold_4
9,411001,425000,13999,False,38,scaffold_4
10,429001,500000,70999,False,38,scaffold_4
11,545001,592000,46999,False,38,scaffold_4
12,593001,606000,12999,False,38,scaffold_4
13,608001,661000,52999,False,38,scaffold_4
14,670001,691000,20999,False,38,scaffold_4
15,695001,697000,1999,False,38,scaffold_4
16,701001,714000,12999,False,38,scaffold_4
17,1121001,1136000,14999,False,38,scaffold_4
18,1137001,1179000,41999,False,38,scaffold_4
19,1199001,1208000,8999,False,38,scaffold_4
20,1210001,1226000,15999,False,38,scaffold_4
21,1235001,1246000,10999,False,38,scaffold_4
22,1248001,1253000,4999,False,38,scaffold_4
23,1254001,1262000,7999,False,38,scaffold_4
24,1265001,1279000,13999,False,38,scaffold_4
25,1283001,1314000,30999,False,38,scaffold_4
26,1372001,1591000,218999,False,38,scaffold_4
27,1749001,1816000,66999,False,38,scaffold_4
28,1850001,1860000,9999,False,38,scaffold_4
29,1935001,1957000,21999,False,38,scaffold_4
30,1958001,1997000,38999,False,38,scaffold_4
31,2036001,2065000,28999,False,38,scaffold_4
32,2247001,2268000,20999,False,38,scaffold_4
33,2269001,2279000,9999,False,38,scaffold_4
34,2284001,2339000,54999,False,38,scaffold_4
35,2480001,2567000,86999,False,38,scaffold_4
36,3335001,3632000,296999,False,38,scaffold_4
37,3676001,3759000,82999,False,38,scaffold_4
38,4944001,4984000,39999,False,38,scaffold_4
39,5477001,5506000,28999,False,38,scaffold_4
40,5514001,5620000,105999,False,38,scaffold_4
41,5669001,5784000,114999,False,38,scaffold_4
42,7037001,7062000,24999,False,38,scaffold_4
43,8846001,9699000,852999,False,38,scaffold_4
44,9700001,9845951,145950,True,38,scaffold_4
0,190001,204000,13999,False,38,scaffold_5
1,318001,326000,7999,False,38,scaffold_5
2,327001,368000,40999,False,38,scaffold_5
3,469001,480000,10999,False,38,scaffold_5
4,498001,523000,24999,False,38,scaffold_5
5,933001,947000,13999,False,38,scaffold_5
6,1062001,1068000,5999,False,38,scaffold_5
7,2565001,2581000,15999,False,38,scaffold_5
8,2625001,2732000,106999,False,38,scaffold_5
9,2816001,2871000,54999,False,38,scaffold_5
10,3142001,3185000,42999,False,38,scaffold_5
11,3322001,3438000,115999,False,38,scaffold_5
12,3451001,3497000,45999,False,38,scaffold_5
13,3962001,4101000,138999,False,38,scaffold_5
14,4121001,4142000,20999,False,38,scaffold_5
15,4155001,4219000,63999,False,38,scaffold_5
16,4246001,4263000,16999,False,38,scaffold_5
17,4446001,4497000,50999,False,38,scaffold_5
18,4605001,4627000,21999,False,38,scaffold_5
19,4691001,4717000,25999,False,38,scaffold_5
20,4816001,4861000,44999,False,38,scaffold_5
21,4904001,4917000,12999,False,38,scaffold_5
22,5318001,5346000,27999,False,38,scaffold_5
23,7582001,7609000,26999,False,38,scaffold_5
24,7622001,7636000,13999,False,38,scaffold_5
25,8730001,9364176,634175,True,38,scaffold_5
0,79001,112000,32999,False,38,scaffold_6
1,239001,253000,13999,False,38,scaffold_6
2,257001,262000,4999,False,38,scaffold_6
3,267001,278000,10999,False,38,scaffold_6
4,1238001,1255000,16999,False,38,scaffold_6
5,1479001,1546000,66999,False,38,scaffold_6
6,2023001,2086000,62999,False,38,scaffold_6
7,2130001,2168000,37999,False,38,scaffold_6
8,2371001,2595000,223999,False,38,scaffold_6
9,2596001,2653000,56999,False,38,scaffold_6
10,2657001,2691000,33999,False,38,scaffold_6
11,2731001,2851000,119999,False,38,scaffold_6
12,2933001,3014000,80999,False,38,scaffold_6
13,3115001,3149000,33999,False,38,scaffold_6
14,3224001,3301000,76999,False,38,scaffold_6
15,3408001,3427000,18999,False,38,scaffold_6
16,3462001,3521000,58999,False,38,scaffold_6
17,3527001,3766000,238999,False,38,scaffold_6
18,3901001,3912000,10999,False,38,scaffold_6
19,4019001,4040000,20999,False,38,scaffold_6
20,4086001,4193000,106999,False,38,scaffold_6
21,6011001,6060000,48999,False,38,scaffold_6
22,7283001,7337000,53999,False,38,scaffold_6
23,7541001,7795000,253999,False,38,scaffold_6
24,7811001,8268281,457280,True,38,scaffold_6
0,1,8000,7999,True,38,scaffold_7
1,13001,31000,17999,False,38,scaffold_7
2,323001,340000,16999,False,38,scaffold_7
3,342001,508000,165999,False,38,scaffold_7
4,554001,563000,8999,False,38,scaffold_7
5,571001,577000,5999,False,38,scaffold_7
6,706001,736000,29999,False,38,scaffold_7
7,764001,809000,44999,False,38,scaffold_7
8,859001,864000,4999,False,38,scaffold_7
9,964001,966000,1999,False,38,scaffold_7
10,968001,980000,11999,False,38,scaffold_7
11,982001,1044000,61999,False,38,scaffold_7
12,1048001,1096000,47999,False,38,scaffold_7
13,1191001,1512000,320999,False,38,scaffold_7
14,1588001,1695000,106999,False,38,scaffold_7
15,3327001,3369000,41999,False,38,scaffold_7
16,3596001,3649000,52999,False,38,scaffold_7
17,4419001,4517000,97999,False,38,scaffold_7
18,4658001,4682000,23999,False,38,scaffold_7
19,4979001,5029000,49999,False,38,scaffold_7
20,5077001,5111000,33999,False,38,scaffold_7
21,6955001,7270000,314999,False,38,scaffold_7
22,7271001,7502216,231215,True,38,scaffold_7
0,67001,85000,17999,False,38,scaffold_8
1,2662001,2683000,20999,False,38,scaffold_8
2,2745001,2756000,10999,False,38,scaffold_8
3,3060001,3525000,464999,False,38,scaffold_8
4,3584001,3612000,27999,False,38,scaffold_8
5,3615001,3913000,297999,False,38,scaffold_8
6,5200001,5241000,40999,False,38,scaffold_8
7,6329001,6334544,5543,True,38,scaffold_8
0,109001,117000,7999,False,38,scaffold_9
1,299001,315000,15999,False,38,scaffold_9
2,319001,332000,12999,False,38,scaffold_9
3,367001,411000,43999,False,38,scaffold_9
4,413001,434000,20999,False,38,scaffold_9
5,502001,531000,28999,False,38,scaffold_9
6,670001,697000,26999,False,38,scaffold_9
7,732001,742000,9999,False,38,scaffold_9
8,794001,803000,8999,False,38,scaffold_9
9,816001,842000,25999,False,38,scaffold_9
10,873001,986000,112999,False,38,scaffold_9
11,988001,995000,6999,False,38,scaffold_9
12,1001001,1007000,5999,False,38,scaffold_9
13,1009001,1031000,21999,False,38,scaffold_9
14,1036001,1085000,48999,False,38,scaffold_9
15,1087001,1150000,62999,False,38,scaffold_9
16,1151001,1164000,12999,False,38,scaffold_9
17,1313001,1377000,63999,False,38,scaffold_9
18,1770001,1783000,12999,False,38,scaffold_9
19,2601001,2616000,14999,False,38,scaffold_9
20,2872001,3381000,508999,False,38,scaffold_9
21,3383001,5107000,1723999,False,38,scaffold_9
22,5112001,5238000,125999,False,38,scaffold_9
23,5239001,5298000,58999,False,38,scaffold_9
24,5300001,5490000,189999,False,38,scaffold_9
25,5493001,6331288,838287,True,38,scaffold_9
0,1,197000,196999,True,38,scaffold_10
1,375001,405000,29999,False,38,scaffold_10
2,472001,482000,9999,False,38,scaffold_10
3,508001,576000,67999,False,38,scaffold_10
4,603001,748000,144999,False,38,scaffold_10
5,888001,916000,27999,False,38,scaffold_10
6,924001,962000,37999,False,38,scaffold_10
7,1087001,1105000,17999,False,38,scaffold_10
8,2346001,2366000,19999,False,38,scaffold_10
9,4053001,4091000,37999,False,38,scaffold_10
10,4154001,4174000,19999,False,38,scaffold_10
11,4443001,4462000,18999,False,38,scaffold_10
12,4467001,4476000,8999,False,38,scaffold_10
13,4515001,4523000,7999,False,38,scaffold_10
14,4526001,4548000,21999,False,38,scaffold_10
15,4576001,4596000,19999,False,38,scaffold_10
16,4679001,4688000,8999,False,38,scaffold_10
17,4734001,4766000,31999,False,38,scaffold_10
18,4769001,4776000,6999,False,38,scaffold_10
19,4798001,4824000,25999,False,38,scaffold_10
20,4827001,4843000,15999,False,38,scaffold_10
21,4848001,4861000,12999,False,38,scaffold_10
22,4865001,4866973,1972,True,38,scaffold_10
0,11001,34000,22999,False,38,scaffold_11
1,40001,93000,52999,False,38,scaffold_11
2,149001,167000,17999,False,38,scaffold_11
3,169001,191000,21999,False,38,scaffold_11
4,213001,235000,21999,False,38,scaffold_11
5,240001,246000,5999,False,38,scaffold_11
6,419001,431000,11999,False,38,scaffold_11
7,648001,656000,7999,False,38,scaffold_11
8,1025001,1034000,8999,False,38,scaffold_11
9,1403001,1409000,5999,False,38,scaffold_11
10,1423001,1426000,2999,False,38,scaffold_11
11,2701001,2872000,170999,False,38,scaffold_11
12,3211001,3254000,42999,False,38,scaffold_11
13,3331001,3369000,37999,False,38,scaffold_11
14,3702001,3926000,223999,False,38,scaffold_11
15,4322001,4710000,387999,False,38,scaffold_11
16,4713001,4766820,53819,True,38,scaffold_11
0,1,240000,239999,True,38,scaffold_12
1,251001,369000,117999,False,38,scaffold_12
2,474001,494000,19999,False,38,scaffold_12
3,582001,729000,146999,False,38,scaffold_12
4,775001,856000,80999,False,38,scaffold_12
5,865001,1354000,488999,False,38,scaffold_12
6,1720001,1733000,12999,False,38,scaffold_12
7,2571001,2618000,46999,False,38,scaffold_12
8,2685001,2699000,13999,False,38,scaffold_12
9,2747001,2747968,967,True,38,scaffold_12
0,1,441000,440999,True,39,scaffold_1
1,482001,498000,15999,False,39,scaffold_1
2,570001,671000,100999,False,39,scaffold_1
3,686001,756000,69999,False,39,scaffold_1
4,774001,849000,74999,False,39,scaffold_1
5,855001,941000,85999,False,39,scaffold_1
6,969001,999000,29999,False,39,scaffold_1
7,1168001,1292000,123999,False,39,scaffold_1
8,1613001,1698000,84999,False,39,scaffold_1
9,1728001,2019000,290999,False,39,scaffold_1
10,2135001,2152000,16999,False,39,scaffold_1
11,2261001,2327000,65999,False,39,scaffold_1
12,2345001,2415000,69999,False,39,scaffold_1
13,2449001,2627000,177999,False,39,scaffold_1
14,2665001,2692000,26999,False,39,scaffold_1
15,2724001,2746000,21999,False,39,scaffold_1
16,2905001,3024000,118999,False,39,scaffold_1
17,3048001,3241000,192999,False,39,scaffold_1
18,3291001,3370000,78999,False,39,scaffold_1
19,3435001,4300000,864999,False,39,scaffold_1
20,4304001,4550000,245999,False,39,scaffold_1
21,4625001,4790000,164999,False,39,scaffold_1
22,4796001,5069000,272999,False,39,scaffold_1
23,5087001,5200000,112999,False,39,scaffold_1
24,5386001,5461000,74999,False,39,scaffold_1
25,5479001,5521000,41999,False,39,scaffold_1
26,5535001,5595000,59999,False,39,scaffold_1
27,5852001,5950000,97999,False,39,scaffold_1
28,6029001,6067000,37999,False,39,scaffold_1
29,6108001,6153000,44999,False,39,scaffold_1
30,6154001,6178000,23999,False,39,scaffold_1
31,6201001,6380000,178999,False,39,scaffold_1
32,6384001,6580000,195999,False,39,scaffold_1
33,6640001,6672000,31999,False,39,scaffold_1
34,6680001,6758000,77999,False,39,scaffold_1
35,6804001,6863000,58999,False,39,scaffold_1
36,6864001,6991000,126999,False,39,scaffold_1
37,7037001,7247000,209999,False,39,scaffold_1
38,7248001,7589000,340999,False,39,scaffold_1
39,7590001,8656000,1065999,False,39,scaffold_1
40,8658001,9584000,925999,False,39,scaffold_1
41,9586001,10639000,1052999,False,39,scaffold_1
42,10663001,10756000,92999,False,39,scaffold_1
43,10837001,10857000,19999,False,39,scaffold_1
44,10898001,10990000,91999,False,39,scaffold_1
45,11013001,11073000,59999,False,39,scaffold_1
46,11110001,11246000,135999,False,39,scaffold_1
47,11266001,11983000,716999,False,39,scaffold_1
48,12059001,12252000,192999,False,39,scaffold_1
49,12329001,12375000,45999,False,39,scaffold_1
50,12397001,12399000,1999,False,39,scaffold_1
51,12400001,12584000,183999,False,39,scaffold_1
52,12624001,13081000,456999,False,39,scaffold_1
53,13094001,13216000,121999,False,39,scaffold_1
54,13318001,13455000,136999,False,39,scaffold_1
55,13472001,13496000,23999,False,39,scaffold_1
56,13517001,13589000,71999,False,39,scaffold_1
57,13591001,13619000,27999,False,39,scaffold_1
58,13668001,13709000,40999,False,39,scaffold_1
59,13789001,13845000,55999,False,39,scaffold_1
60,13847001,13888000,40999,False,39,scaffold_1
61,13930001,13954000,23999,False,39,scaffold_1
62,13958001,14005000,46999,False,39,scaffold_1
63,14007001,14030000,22999,False,39,scaffold_1
64,14286001,14309000,22999,False,39,scaffold_1
65,14530001,14612000,81999,False,39,scaffold_1
0,1,48000,47999,True,39,scaffold_2
1,93001,159000,65999,False,39,scaffold_2
2,165001,177000,11999,False,39,scaffold_2
3,296001,318000,21999,False,39,scaffold_2
4,333001,374000,40999,False,39,scaffold_2
5,386001,412000,25999,False,39,scaffold_2
6,459001,546000,86999,False,39,scaffold_2
7,729001,739000,9999,False,39,scaffold_2
8,1114001,1140000,25999,False,39,scaffold_2
9,1234001,1260000,25999,False,39,scaffold_2
10,1310001,1334000,23999,False,39,scaffold_2
11,1354001,1557000,202999,False,39,scaffold_2
12,1625001,1677000,51999,False,39,scaffold_2
13,1742001,1861000,118999,False,39,scaffold_2
14,1875001,1897000,21999,False,39,scaffold_2
15,1916001,1959000,42999,False,39,scaffold_2
16,2036001,2153000,116999,False,39,scaffold_2
17,2302001,2334000,31999,False,39,scaffold_2
18,2336001,2639000,302999,False,39,scaffold_2
19,2645001,2689000,43999,False,39,scaffold_2
20,2694001,2747000,52999,False,39,scaffold_2
21,2777001,2855000,77999,False,39,scaffold_2
22,2869001,3012000,142999,False,39,scaffold_2
23,3027001,3098000,70999,False,39,scaffold_2
24,3224001,3282000,57999,False,39,scaffold_2
25,3286001,3292000,5999,False,39,scaffold_2
26,3295001,3395000,99999,False,39,scaffold_2
27,3406001,3408000,1999,False,39,scaffold_2
28,3448001,3714000,265999,False,39,scaffold_2
29,3741001,3935000,193999,False,39,scaffold_2
30,3989001,4039000,49999,False,39,scaffold_2
31,4102001,4194000,91999,False,39,scaffold_2
32,4203001,4409000,205999,False,39,scaffold_2
33,4426001,4791000,364999,False,39,scaffold_2
34,4793001,4814000,20999,False,39,scaffold_2
35,4876001,4985000,108999,False,39,scaffold_2
36,5016001,5104000,87999,False,39,scaffold_2
37,5125001,5279000,153999,False,39,scaffold_2
38,5285001,5779000,493999,False,39,scaffold_2
39,5819001,6079000,259999,False,39,scaffold_2
40,6091001,6225000,133999,False,39,scaffold_2
41,6226001,6351000,124999,False,39,scaffold_2
42,6370001,6483000,112999,False,39,scaffold_2
43,6575001,6894000,318999,False,39,scaffold_2
44,6946001,6997000,50999,False,39,scaffold_2
45,7001001,7097000,95999,False,39,scaffold_2
46,7108001,7205000,96999,False,39,scaffold_2
47,7336001,7473000,136999,False,39,scaffold_2
48,7491001,7518000,26999,False,39,scaffold_2
49,7548001,7561000,12999,False,39,scaffold_2
50,7563001,7707000,143999,False,39,scaffold_2
51,7719001,8328000,608999,False,39,scaffold_2
52,8331001,8333000,1999,False,39,scaffold_2
53,8335001,8345000,9999,False,39,scaffold_2
54,8346001,8494000,147999,False,39,scaffold_2
55,8495001,8565000,69999,False,39,scaffold_2
56,8612001,8651000,38999,False,39,scaffold_2
57,8808001,8827000,18999,False,39,scaffold_2
58,8934001,8944000,9999,False,39,scaffold_2
59,8951001,9052000,100999,False,39,scaffold_2
60,9139001,9512000,372999,False,39,scaffold_2
61,9599001,9641000,41999,False,39,scaffold_2
62,9659001,9750000,90999,False,39,scaffold_2
63,9752001,9828000,75999,False,39,scaffold_2
64,9829001,9901000,71999,False,39,scaffold_2
65,10333001,10350000,16999,False,39,scaffold_2
66,10400001,10499000,98999,False,39,scaffold_2
67,10512001,10563000,50999,False,39,scaffold_2
68,10630001,10664000,33999,False,39,scaffold_2
69,10675001,10708000,32999,False,39,scaffold_2
70,10710001,10736000,25999,False,39,scaffold_2
71,10792001,10815000,22999,False,39,scaffold_2
72,10929001,10962000,32999,False,39,scaffold_2
73,10995001,10998000,2999,False,39,scaffold_2
74,11000001,11129000,128999,False,39,scaffold_2
75,11322001,11429000,106999,False,39,scaffold_2
76,11451001,11502000,50999,False,39,scaffold_2
77,11519001,11794000,274999,False,39,scaffold_2
78,11796001,11802476,6475,True,39,scaffold_2
0,1,2000,1999,True,39,scaffold_3
1,10001,17000,6999,False,39,scaffold_3
2,28001,42000,13999,False,39,scaffold_3
3,76001,98000,21999,False,39,scaffold_3
4,218001,232000,13999,False,39,scaffold_3
5,618001,646000,27999,False,39,scaffold_3
6,796001,900000,103999,False,39,scaffold_3
7,1016001,1026000,9999,False,39,scaffold_3
8,1066001,1084000,17999,False,39,scaffold_3
9,1085001,1109000,23999,False,39,scaffold_3
10,1163001,1228000,64999,False,39,scaffold_3
11,1478001,1508000,29999,False,39,scaffold_3
12,1584001,1737000,152999,False,39,scaffold_3
13,1758001,1787000,28999,False,39,scaffold_3
14,1896001,1984000,87999,False,39,scaffold_3
15,1998001,2203000,204999,False,39,scaffold_3
16,2205001,2341000,135999,False,39,scaffold_3
17,2376001,2428000,51999,False,39,scaffold_3
18,2433001,2558000,124999,False,39,scaffold_3
19,2561001,2610000,48999,False,39,scaffold_3
20,2621001,2870000,248999,False,39,scaffold_3
21,2891001,3062000,170999,False,39,scaffold_3
22,3066001,3287000,220999,False,39,scaffold_3
23,3295001,3892000,596999,False,39,scaffold_3
24,3911001,3921000,9999,False,39,scaffold_3
25,3926001,4039000,112999,False,39,scaffold_3
26,4040001,4403000,362999,False,39,scaffold_3
27,4412001,4519000,106999,False,39,scaffold_3
28,4545001,4558000,12999,False,39,scaffold_3
29,4583001,4599000,15999,False,39,scaffold_3
30,4637001,4686000,48999,False,39,scaffold_3
31,4776001,4925000,148999,False,39,scaffold_3
32,4960001,5317000,356999,False,39,scaffold_3
33,5350001,5509000,158999,False,39,scaffold_3
34,5511001,5676000,164999,False,39,scaffold_3
35,5678001,6124000,445999,False,39,scaffold_3
36,6216001,6244000,27999,False,39,scaffold_3
37,6285001,6303000,17999,False,39,scaffold_3
38,6529001,6535000,5999,False,39,scaffold_3
39,6539001,6584000,44999,False,39,scaffold_3
40,6659001,6807000,147999,False,39,scaffold_3
41,6846001,7157000,310999,False,39,scaffold_3
42,7230001,7328000,97999,False,39,scaffold_3
43,7332001,7445000,112999,False,39,scaffold_3
44,7483001,7556000,72999,False,39,scaffold_3
45,7575001,7967000,391999,False,39,scaffold_3
46,8028001,8118000,89999,False,39,scaffold_3
47,8121001,8362000,240999,False,39,scaffold_3
48,8395001,8642000,246999,False,39,scaffold_3
49,8653001,8720000,66999,False,39,scaffold_3
50,8756001,8805000,48999,False,39,scaffold_3
51,8875001,8895000,19999,False,39,scaffold_3
52,8956001,9255000,298999,False,39,scaffold_3
53,9274001,9296000,21999,False,39,scaffold_3
54,9342001,9369000,26999,False,39,scaffold_3
55,9460001,9624000,163999,False,39,scaffold_3
56,9644001,9720000,75999,False,39,scaffold_3
57,9724001,9799000,74999,False,39,scaffold_3
58,9814001,9996000,181999,False,39,scaffold_3
59,10042001,10088000,45999,False,39,scaffold_3
60,10461001,10487000,25999,False,39,scaffold_3
61,10527001,11182071,655070,True,39,scaffold_3
0,1,7000,6999,True,39,scaffold_4
1,11001,13000,1999,False,39,scaffold_4
2,17001,32000,14999,False,39,scaffold_4
3,48001,88000,39999,False,39,scaffold_4
4,120001,146000,25999,False,39,scaffold_4
5,147001,151000,3999,False,39,scaffold_4
6,155001,160000,4999,False,39,scaffold_4
7,161001,216000,54999,False,39,scaffold_4
8,217001,226000,8999,False,39,scaffold_4
9,227001,266000,38999,False,39,scaffold_4
10,283001,311000,27999,False,39,scaffold_4
11,313001,344000,30999,False,39,scaffold_4
12,355001,374000,18999,False,39,scaffold_4
13,375001,410000,34999,False,39,scaffold_4
14,412001,425000,12999,False,39,scaffold_4
15,429001,500000,70999,False,39,scaffold_4
16,542001,606000,63999,False,39,scaffold_4
17,608001,691000,82999,False,39,scaffold_4
18,695001,697000,1999,False,39,scaffold_4
19,701001,727000,25999,False,39,scaffold_4
20,1043001,1047000,3999,False,39,scaffold_4
21,1087001,1097000,9999,False,39,scaffold_4
22,1115001,1136000,20999,False,39,scaffold_4
23,1138001,1226000,87999,False,39,scaffold_4
24,1229001,1264000,34999,False,39,scaffold_4
25,1265001,1279000,13999,False,39,scaffold_4
26,1283001,1605000,321999,False,39,scaffold_4
27,1608001,1612000,3999,False,39,scaffold_4
28,1613001,2069000,455999,False,39,scaffold_4
29,2071001,2186000,114999,False,39,scaffold_4
30,2188001,2218000,29999,False,39,scaffold_4
31,2219001,2268000,48999,False,39,scaffold_4
32,2269001,2281000,11999,False,39,scaffold_4
33,2282001,2461000,178999,False,39,scaffold_4
34,2476001,2835000,358999,False,39,scaffold_4
35,2848001,4045000,1196999,False,39,scaffold_4
36,4055001,4197000,141999,False,39,scaffold_4
37,4219001,4313000,93999,False,39,scaffold_4
38,4707001,4737000,29999,False,39,scaffold_4
39,4793001,5103000,309999,False,39,scaffold_4
40,5169001,5246000,76999,False,39,scaffold_4
41,5271001,5506000,234999,False,39,scaffold_4
42,5514001,5784000,269999,False,39,scaffold_4
43,5786001,6194000,407999,False,39,scaffold_4
44,6213001,6305000,91999,False,39,scaffold_4
45,6328001,6612000,283999,False,39,scaffold_4
46,6619001,6703000,83999,False,39,scaffold_4
47,6705001,6817000,111999,False,39,scaffold_4
48,6818001,6924000,105999,False,39,scaffold_4
49,6926001,6997000,70999,False,39,scaffold_4
50,7008001,7023000,14999,False,39,scaffold_4
51,7026001,7448000,421999,False,39,scaffold_4
52,7457001,7571000,113999,False,39,scaffold_4
53,7629001,7718000,88999,False,39,scaffold_4
54,7719001,7784000,64999,False,39,scaffold_4
55,7835001,7925000,89999,False,39,scaffold_4
56,7967001,8141000,173999,False,39,scaffold_4
57,8279001,8290000,10999,False,39,scaffold_4
58,8293001,8344000,50999,False,39,scaffold_4
59,8714001,8829000,114999,False,39,scaffold_4
60,8841001,9699000,857999,False,39,scaffold_4
61,9700001,9845951,145950,True,39,scaffold_4
0,142001,175000,32999,False,39,scaffold_5
1,189001,207000,17999,False,39,scaffold_5
2,318001,416000,97999,False,39,scaffold_5
3,445001,524000,78999,False,39,scaffold_5
4,639001,655000,15999,False,39,scaffold_5
5,669001,697000,27999,False,39,scaffold_5
6,921001,947000,25999,False,39,scaffold_5
7,1064001,1105000,40999,False,39,scaffold_5
8,1256001,1282000,25999,False,39,scaffold_5
9,1318001,1394000,75999,False,39,scaffold_5
10,1943001,1968000,24999,False,39,scaffold_5
11,2088001,2104000,15999,False,39,scaffold_5
12,2255001,2301000,45999,False,39,scaffold_5
13,2385001,2407000,21999,False,39,scaffold_5
14,2472001,2496000,23999,False,39,scaffold_5
15,2516001,2902000,385999,False,39,scaffold_5
16,3050001,3080000,29999,False,39,scaffold_5
17,3092001,3514000,421999,False,39,scaffold_5
18,3532001,3598000,65999,False,39,scaffold_5
19,3599001,3658000,58999,False,39,scaffold_5
20,3708001,3750000,41999,False,39,scaffold_5
21,3768001,3946000,177999,False,39,scaffold_5
22,3959001,5180000,1220999,False,39,scaffold_5
23,5195001,5346000,150999,False,39,scaffold_5
24,5348001,5451000,102999,False,39,scaffold_5
25,5507001,5541000,33999,False,39,scaffold_5
26,5687001,5738000,50999,False,39,scaffold_5
27,6392001,6737000,344999,False,39,scaffold_5
28,6750001,6969000,218999,False,39,scaffold_5
29,7034001,7086000,51999,False,39,scaffold_5
30,7165001,7383000,217999,False,39,scaffold_5
31,7413001,7451000,37999,False,39,scaffold_5
32,7454001,7512000,57999,False,39,scaffold_5
33,7523001,7619000,95999,False,39,scaffold_5
34,7620001,7909000,288999,False,39,scaffold_5
35,8258001,8303000,44999,False,39,scaffold_5
36,8362001,8465000,102999,False,39,scaffold_5
37,8548001,9364176,816175,True,39,scaffold_5
0,25001,39000,13999,False,39,scaffold_6
1,42001,75000,32999,False,39,scaffold_6
2,79001,121000,41999,False,39,scaffold_6
3,162001,208000,45999,False,39,scaffold_6
4,240001,371000,130999,False,39,scaffold_6
5,456001,496000,39999,False,39,scaffold_6
6,553001,577000,23999,False,39,scaffold_6
7,618001,670000,51999,False,39,scaffold_6
8,698001,800000,101999,False,39,scaffold_6
9,900001,1056000,155999,False,39,scaffold_6
10,1119001,1226000,106999,False,39,scaffold_6
11,1229001,1310000,80999,False,39,scaffold_6
12,1402001,1606000,203999,False,39,scaffold_6
13,1658001,1756000,97999,False,39,scaffold_6
14,1793001,1906000,112999,False,39,scaffold_6
15,1907001,2019000,111999,False,39,scaffold_6
16,2023001,2219000,195999,False,39,scaffold_6
17,2235001,2284000,48999,False,39,scaffold_6
18,2306001,2595000,288999,False,39,scaffold_6
19,2596001,2872000,275999,False,39,scaffold_6
20,2906001,2925000,18999,False,39,scaffold_6
21,2927001,3806000,878999,False,39,scaffold_6
22,3810001,3930000,119999,False,39,scaffold_6
23,3948001,4204000,255999,False,39,scaffold_6
24,4392001,4436000,43999,False,39,scaffold_6
25,4568001,4587000,18999,False,39,scaffold_6
26,4606001,4672000,65999,False,39,scaffold_6
27,4768001,4797000,28999,False,39,scaffold_6
28,4814001,4918000,103999,False,39,scaffold_6
29,4924001,5006000,81999,False,39,scaffold_6
30,5230001,5323000,92999,False,39,scaffold_6
31,5434001,5469000,34999,False,39,scaffold_6
32,5556001,5789000,232999,False,39,scaffold_6
33,5862001,6333000,470999,False,39,scaffold_6
34,6448001,6506000,57999,False,39,scaffold_6
35,6683001,6715000,31999,False,39,scaffold_6
36,6734001,6804000,69999,False,39,scaffold_6
37,6832001,6885000,52999,False,39,scaffold_6
38,6897001,7141000,243999,False,39,scaffold_6
39,7185001,7248000,62999,False,39,scaffold_6
40,7254001,8268281,1014280,True,39,scaffold_6
0,1,9000,8999,True,39,scaffold_7
1,10001,34000,23999,False,39,scaffold_7
2,50001,57000,6999,False,39,scaffold_7
3,142001,165000,22999,False,39,scaffold_7
4,294001,340000,45999,False,39,scaffold_7
5,342001,508000,165999,False,39,scaffold_7
6,552001,564000,11999,False,39,scaffold_7
7,571001,577000,5999,False,39,scaffold_7
8,580001,591000,10999,False,39,scaffold_7
9,615001,643000,27999,False,39,scaffold_7
10,645001,703000,57999,False,39,scaffold_7
11,706001,736000,29999,False,39,scaffold_7
12,737001,753000,15999,False,39,scaffold_7
13,760001,829000,68999,False,39,scaffold_7
14,830001,843000,12999,False,39,scaffold_7
15,859001,864000,4999,False,39,scaffold_7
16,865001,945000,79999,False,39,scaffold_7
17,968001,1044000,75999,False,39,scaffold_7
18,1048001,1100000,51999,False,39,scaffold_7
19,1191001,1513000,321999,False,39,scaffold_7
20,1588001,1782000,193999,False,39,scaffold_7
21,1818001,1898000,79999,False,39,scaffold_7
22,1956001,2058000,101999,False,39,scaffold_7
23,2186001,2244000,57999,False,39,scaffold_7
24,2366001,2410000,43999,False,39,scaffold_7
25,2438001,2709000,270999,False,39,scaffold_7
26,2720001,2738000,17999,False,39,scaffold_7
27,2790001,2958000,167999,False,39,scaffold_7
28,3005001,3270000,264999,False,39,scaffold_7
29,3293001,3422000,128999,False,39,scaffold_7
30,3498001,3987000,488999,False,39,scaffold_7
31,4021001,4081000,59999,False,39,scaffold_7
32,4297001,4379000,81999,False,39,scaffold_7
33,4412001,4512000,99999,False,39,scaffold_7
34,4524001,4611000,86999,False,39,scaffold_7
35,4630001,5227000,596999,False,39,scaffold_7
36,5320001,5332000,11999,False,39,scaffold_7
37,5400001,5448000,47999,False,39,scaffold_7
38,5470001,5645000,174999,False,39,scaffold_7
39,5666001,5686000,19999,False,39,scaffold_7
40,5719001,5841000,121999,False,39,scaffold_7
41,5868001,5932000,63999,False,39,scaffold_7
42,5933001,5996000,62999,False,39,scaffold_7
43,6048001,6369000,320999,False,39,scaffold_7
44,6482001,6508000,25999,False,39,scaffold_7
45,6555001,6801000,245999,False,39,scaffold_7
46,6815001,6872000,56999,False,39,scaffold_7
47,6950001,7270000,319999,False,39,scaffold_7
48,7271001,7502216,231215,True,39,scaffold_7
0,1,6000,5999,True,39,scaffold_8
1,66001,87000,20999,False,39,scaffold_8
2,364001,367000,2999,False,39,scaffold_8
3,722001,725000,2999,False,39,scaffold_8
4,1018001,1042000,23999,False,39,scaffold_8
5,1170001,1207000,36999,False,39,scaffold_8
6,1362001,1435000,72999,False,39,scaffold_8
7,1531001,1552000,20999,False,39,scaffold_8
8,1858001,1978000,119999,False,39,scaffold_8
9,2009001,2154000,144999,False,39,scaffold_8
10,2206001,2844000,637999,False,39,scaffold_8
11,2846001,3614000,767999,False,39,scaffold_8
12,3615001,4268000,652999,False,39,scaffold_8
13,4329001,4431000,101999,False,39,scaffold_8
14,4566001,4699000,132999,False,39,scaffold_8
15,4717001,4963000,245999,False,39,scaffold_8
16,4983001,5055000,71999,False,39,scaffold_8
17,5068001,5247000,178999,False,39,scaffold_8
18,5355001,5476000,120999,False,39,scaffold_8
19,5501001,5610000,108999,False,39,scaffold_8
20,5648001,5723000,74999,False,39,scaffold_8
21,5724001,5804000,79999,False,39,scaffold_8
22,5807001,6302000,494999,False,39,scaffold_8
23,6319001,6334544,15543,True,39,scaffold_8
0,1,22000,21999,True,39,scaffold_9
1,109001,118000,8999,False,39,scaffold_9
2,121001,136000,14999,False,39,scaffold_9
3,271001,276000,4999,False,39,scaffold_9
4,296001,332000,35999,False,39,scaffold_9
5,366001,411000,44999,False,39,scaffold_9
6,413001,434000,20999,False,39,scaffold_9
7,484001,531000,46999,False,39,scaffold_9
8,547001,563000,15999,False,39,scaffold_9
9,652001,659000,6999,False,39,scaffold_9
10,660001,665000,4999,False,39,scaffold_9
11,671001,697000,25999,False,39,scaffold_9
12,730001,742000,11999,False,39,scaffold_9
13,814001,842000,27999,False,39,scaffold_9
14,874001,986000,111999,False,39,scaffold_9
15,987001,995000,7999,False,39,scaffold_9
16,1001001,1007000,5999,False,39,scaffold_9
17,1009001,1085000,75999,False,39,scaffold_9
18,1087001,1150000,62999,False,39,scaffold_9
19,1151001,1198000,46999,False,39,scaffold_9
20,1200001,1257000,56999,False,39,scaffold_9
21,1312001,1394000,81999,False,39,scaffold_9
22,1413001,1422000,8999,False,39,scaffold_9
23,1428001,1438000,9999,False,39,scaffold_9
24,1457001,1465000,7999,False,39,scaffold_9
25,1486001,1625000,138999,False,39,scaffold_9
26,1637001,1688000,50999,False,39,scaffold_9
27,1716001,1811000,94999,False,39,scaffold_9
28,1822001,1857000,34999,False,39,scaffold_9
29,1866001,1957000,90999,False,39,scaffold_9
30,1970001,2064000,93999,False,39,scaffold_9
31,2075001,2171000,95999,False,39,scaffold_9
32,2174001,2673000,498999,False,39,scaffold_9
33,2674001,3381000,706999,False,39,scaffold_9
34,3383001,5107000,1723999,False,39,scaffold_9
35,5112001,5115000,2999,False,39,scaffold_9
36,5116001,5298000,181999,False,39,scaffold_9
37,5300001,5490000,189999,False,39,scaffold_9
38,5493001,6331288,838287,True,39,scaffold_9
0,1,136000,135999,True,39,scaffold_10
1,137001,584000,446999,False,39,scaffold_10
2,601001,921000,319999,False,39,scaffold_10
3,923001,1069000,145999,False,39,scaffold_10
4,1073001,1212000,138999,False,39,scaffold_10
5,1239001,1300000,60999,False,39,scaffold_10
6,1302001,1476000,173999,False,39,scaffold_10
7,1479001,1570000,90999,False,39,scaffold_10
8,1601001,1844000,242999,False,39,scaffold_10
9,1861001,1946000,84999,False,39,scaffold_10
10,2008001,2111000,102999,False,39,scaffold_10
11,2138001,2182000,43999,False,39,scaffold_10
12,2197001,2476000,278999,False,39,scaffold_10
13,2502001,2520000,17999,False,39,scaffold_10
14,2521001,3025000,503999,False,39,scaffold_10
15,3068001,3136000,67999,False,39,scaffold_10
16,3153001,3177000,23999,False,39,scaffold_10
17,3481001,3503000,21999,False,39,scaffold_10
18,3572001,3582000,9999,False,39,scaffold_10
19,3633001,3674000,40999,False,39,scaffold_10
20,3779001,3795000,15999,False,39,scaffold_10
21,4051001,4111000,59999,False,39,scaffold_10
22,4154001,4182000,27999,False,39,scaffold_10
23,4236001,4245000,8999,False,39,scaffold_10
24,4316001,4324000,7999,False,39,scaffold_10
25,4335001,4365000,29999,False,39,scaffold_10
26,4443001,4477000,33999,False,39,scaffold_10
27,4478001,4502000,23999,False,39,scaffold_10
28,4503001,4513000,9999,False,39,scaffold_10
29,4515001,4523000,7999,False,39,scaffold_10
30,4526001,4548000,21999,False,39,scaffold_10
31,4553001,4562000,8999,False,39,scaffold_10
32,4565001,4596000,30999,False,39,scaffold_10
33,4734001,4776000,41999,False,39,scaffold_10
34,4798001,4824000,25999,False,39,scaffold_10
35,4828001,4843000,14999,False,39,scaffold_10
36,4848001,4861000,12999,False,39,scaffold_10
37,4865001,4866973,1972,True,39,scaffold_10
0,10001,34000,23999,False,39,scaffold_11
1,38001,93000,54999,False,39,scaffold_11
2,132001,167000,34999,False,39,scaffold_11
3,169001,212000,42999,False,39,scaffold_11
4,213001,235000,21999,False,39,scaffold_11
5,240001,252000,11999,False,39,scaffold_11
6,292001,320000,27999,False,39,scaffold_11
7,419001,431000,11999,False,39,scaffold_11
8,648001,656000,7999,False,39,scaffold_11
9,1025001,1034000,8999,False,39,scaffold_11
10,1101001,1113000,11999,False,39,scaffold_11
11,1219001,1246000,26999,False,39,scaffold_11
12,1315001,1358000,42999,False,39,scaffold_11
13,1359001,1372000,12999,False,39,scaffold_11
14,1403001,1409000,5999,False,39,scaffold_11
15,1435001,1466000,30999,False,39,scaffold_11
16,1474001,1478000,3999,False,39,scaffold_11
17,1526001,1547000,20999,False,39,scaffold_11
18,1573001,1599000,25999,False,39,scaffold_11
19,1774001,1805000,30999,False,39,scaffold_11
20,1853001,2007000,153999,False,39,scaffold_11
21,2008001,2172000,163999,False,39,scaffold_11
22,2177001,2225000,47999,False,39,scaffold_11
23,2581001,2613000,31999,False,39,scaffold_11
24,2674001,3028000,353999,False,39,scaffold_11
25,3060001,3484000,423999,False,39,scaffold_11
26,3486001,4163000,676999,False,39,scaffold_11
27,4178001,4710000,531999,False,39,scaffold_11
28,4712001,4766820,54819,True,39,scaffold_11
0,1,1497000,1496999,True,39,scaffold_12
1,1562001,1600000,37999,False,39,scaffold_12
2,1638001,1673000,34999,False,39,scaffold_12
3,1713001,1754000,40999,False,39,scaffold_12
4,1781001,1809000,27999,False,39,scaffold_12
5,1824001,2103000,278999,False,39,scaffold_12
6,2129001,2192000,62999,False,39,scaffold_12
7,2206001,2239000,32999,False,39,scaffold_12
8,2319001,2380000,60999,False,39,scaffold_12
9,2571001,2610000,38999,False,39,scaffold_12
0,1,267000,266999,True,40,scaffold_1
1,268001,356000,87999,False,40,scaffold_1
2,483001,494000,10999,False,40,scaffold_1
3,571001,603000,31999,False,40,scaffold_1
4,617001,652000,34999,False,40,scaffold_1
5,686001,757000,70999,False,40,scaffold_1
6,873001,903000,29999,False,40,scaffold_1
7,1178001,1195000,16999,False,40,scaffold_1
8,1251001,1292000,40999,False,40,scaffold_1
9,1616001,1660000,43999,False,40,scaffold_1
10,1811001,1936000,124999,False,40,scaffold_1
11,1953001,1984000,30999,False,40,scaffold_1
12,1987001,2017000,29999,False,40,scaffold_1
13,2451001,2517000,65999,False,40,scaffold_1
14,2725001,2746000,20999,False,40,scaffold_1
15,3177001,3205000,27999,False,40,scaffold_1
16,3444001,3499000,54999,False,40,scaffold_1
17,3573001,3623000,49999,False,40,scaffold_1
18,3703001,3893000,189999,False,40,scaffold_1
19,3908001,3941000,32999,False,40,scaffold_1
20,3942001,4033000,90999,False,40,scaffold_1
21,4060001,4113000,52999,False,40,scaffold_1
22,4311001,4435000,123999,False,40,scaffold_1
23,4705001,4794000,88999,False,40,scaffold_1
24,4796001,4869000,72999,False,40,scaffold_1
25,4919001,5065000,145999,False,40,scaffold_1
26,5087001,5116000,28999,False,40,scaffold_1
27,5164001,5201000,36999,False,40,scaffold_1
28,5436001,5459000,22999,False,40,scaffold_1
29,5481001,5521000,39999,False,40,scaffold_1
30,5535001,5579000,43999,False,40,scaffold_1
31,5857001,5870000,12999,False,40,scaffold_1
32,6108001,6153000,44999,False,40,scaffold_1
33,6202001,6511000,308999,False,40,scaffold_1
34,6809001,6853000,43999,False,40,scaffold_1
35,6925001,6953000,27999,False,40,scaffold_1
36,7038001,7247000,208999,False,40,scaffold_1
37,7248001,7583000,334999,False,40,scaffold_1
38,7590001,8656000,1065999,False,40,scaffold_1
39,8658001,9584000,925999,False,40,scaffold_1
40,9586001,10363000,776999,False,40,scaffold_1
41,10436001,10638000,201999,False,40,scaffold_1
42,11014001,11059000,44999,False,40,scaffold_1
43,11123001,11208000,84999,False,40,scaffold_1
44,11272001,11510000,237999,False,40,scaffold_1
45,11550001,11951000,400999,False,40,scaffold_1
46,12184001,12206000,21999,False,40,scaffold_1
47,12418001,12449000,30999,False,40,scaffold_1
48,12491001,12585000,93999,False,40,scaffold_1
49,12649001,12723000,73999,False,40,scaffold_1
50,12746001,12758000,11999,False,40,scaffold_1
51,12772001,12891000,118999,False,40,scaffold_1
52,12965001,13001000,35999,False,40,scaffold_1
53,13025001,13044000,18999,False,40,scaffold_1
54,13117001,13135000,17999,False,40,scaffold_1
55,13178001,13216000,37999,False,40,scaffold_1
56,13343001,13455000,111999,False,40,scaffold_1
57,13554001,13588000,33999,False,40,scaffold_1
58,13668001,13703000,34999,False,40,scaffold_1
59,13796001,13844000,47999,False,40,scaffold_1
60,13914001,13927000,12999,False,40,scaffold_1
61,13959001,13977000,17999,False,40,scaffold_1
62,14285001,14309000,23999,False,40,scaffold_1
63,14647001,14664000,16999,False,40,scaffold_1
0,22001,48000,25999,False,40,scaffold_2
1,122001,129000,6999,False,40,scaffold_2
2,130001,159000,28999,False,40,scaffold_2
3,165001,177000,11999,False,40,scaffold_2
4,302001,318000,15999,False,40,scaffold_2
5,333001,374000,40999,False,40,scaffold_2
6,1346001,1415000,68999,False,40,scaffold_2
7,1507001,1556000,48999,False,40,scaffold_2
8,1837001,1861000,23999,False,40,scaffold_2
9,1881001,1897000,15999,False,40,scaffold_2
10,2087001,2132000,44999,False,40,scaffold_2
11,2336001,2603000,266999,False,40,scaffold_2
12,2660001,2689000,28999,False,40,scaffold_2
13,2694001,2747000,52999,False,40,scaffold_2
14,2766001,2787000,20999,False,40,scaffold_2
15,2835001,2856000,20999,False,40,scaffold_2
16,2878001,2910000,31999,False,40,scaffold_2
17,2974001,3012000,37999,False,40,scaffold_2
18,3330001,3389000,58999,False,40,scaffold_2
19,3450001,3575000,124999,False,40,scaffold_2
20,3658001,3712000,53999,False,40,scaffold_2
21,3754001,3790000,35999,False,40,scaffold_2
22,4242001,4277000,34999,False,40,scaffold_2
23,4342001,4409000,66999,False,40,scaffold_2
24,4426001,4790000,363999,False,40,scaffold_2
25,4793001,4803000,9999,False,40,scaffold_2
26,4917001,4959000,41999,False,40,scaffold_2
27,5016001,5104000,87999,False,40,scaffold_2
28,5199001,5224000,24999,False,40,scaffold_2
29,5285001,5314000,28999,False,40,scaffold_2
30,5343001,5488000,144999,False,40,scaffold_2
31,5490001,5559000,68999,False,40,scaffold_2
32,5631001,5761000,129999,False,40,scaffold_2
33,5840001,5888000,47999,False,40,scaffold_2
34,5908001,5995000,86999,False,40,scaffold_2
35,6123001,6140000,16999,False,40,scaffold_2
36,6230001,6349000,118999,False,40,scaffold_2
37,6367001,6464000,96999,False,40,scaffold_2
38,6589001,6626000,36999,False,40,scaffold_2
39,6711001,6723000,11999,False,40,scaffold_2
40,6940001,6979000,38999,False,40,scaffold_2
41,7001001,7045000,43999,False,40,scaffold_2
42,7049001,7097000,47999,False,40,scaffold_2
43,7449001,7475000,25999,False,40,scaffold_2
44,7550001,7561000,10999,False,40,scaffold_2
45,7563001,7706000,142999,False,40,scaffold_2
46,7780001,7896000,115999,False,40,scaffold_2
47,7936001,8136000,199999,False,40,scaffold_2
48,8261001,8327000,65999,False,40,scaffold_2
49,8331001,8333000,1999,False,40,scaffold_2
50,8334001,8344000,9999,False,40,scaffold_2
51,8346001,8493000,146999,False,40,scaffold_2
52,8495001,8564000,68999,False,40,scaffold_2
53,9139001,9175000,35999,False,40,scaffold_2
54,9212001,9265000,52999,False,40,scaffold_2
55,9312001,9382000,69999,False,40,scaffold_2
56,9601001,9629000,27999,False,40,scaffold_2
57,10404001,10467000,62999,False,40,scaffold_2
58,10639001,10657000,17999,False,40,scaffold_2
59,10676001,10708000,31999,False,40,scaffold_2
60,10710001,10736000,25999,False,40,scaffold_2
61,11520001,11786000,265999,False,40,scaffold_2
62,11797001,11802476,5475,True,40,scaffold_2
0,218001,232000,13999,False,40,scaffold_3
1,796001,901000,104999,False,40,scaffold_3
2,1757001,1786000,28999,False,40,scaffold_3
3,2008001,2108000,99999,False,40,scaffold_3
4,2109001,2147000,37999,False,40,scaffold_3
5,2288001,2336000,47999,False,40,scaffold_3
6,2386001,2428000,41999,False,40,scaffold_3
7,2433001,2533000,99999,False,40,scaffold_3
8,2534001,2558000,23999,False,40,scaffold_3
9,2647001,2766000,118999,False,40,scaffold_3
10,2891001,2932000,40999,False,40,scaffold_3
11,3066001,3164000,97999,False,40,scaffold_3
12,3167001,3290000,122999,False,40,scaffold_3
13,3410001,3425000,14999,False,40,scaffold_3
14,3606001,3737000,130999,False,40,scaffold_3
15,3764001,3821000,56999,False,40,scaffold_3
16,3822001,3845000,22999,False,40,scaffold_3
17,3908001,3921000,12999,False,40,scaffold_3
18,3922001,3946000,23999,False,40,scaffold_3
19,4007001,4037000,29999,False,40,scaffold_3
20,4070001,4403000,332999,False,40,scaffold_3
21,4410001,4518000,107999,False,40,scaffold_3
22,4582001,4598000,15999,False,40,scaffold_3
23,4652001,4681000,28999,False,40,scaffold_3
24,4854001,4921000,66999,False,40,scaffold_3
25,5147001,5271000,123999,False,40,scaffold_3
26,5354001,5509000,154999,False,40,scaffold_3
27,5554001,5676000,121999,False,40,scaffold_3
28,5701001,5761000,59999,False,40,scaffold_3
29,5804001,6089000,284999,False,40,scaffold_3
30,6742001,6808000,65999,False,40,scaffold_3
31,6886001,6972000,85999,False,40,scaffold_3
32,6979001,7124000,144999,False,40,scaffold_3
33,7262001,7328000,65999,False,40,scaffold_3
34,7332001,7413000,80999,False,40,scaffold_3
35,7483001,7562000,78999,False,40,scaffold_3
36,7588001,7622000,33999,False,40,scaffold_3
37,7680001,7866000,185999,False,40,scaffold_3
38,8029001,8116000,86999,False,40,scaffold_3
39,8176001,8255000,78999,False,40,scaffold_3
40,8427001,8449000,21999,False,40,scaffold_3
41,8462001,8528000,65999,False,40,scaffold_3
42,8575001,8594000,18999,False,40,scaffold_3
43,8961001,9079000,117999,False,40,scaffold_3
44,9091001,9168000,76999,False,40,scaffold_3
45,9198001,9247000,48999,False,40,scaffold_3
46,9464001,9525000,60999,False,40,scaffold_3
47,9558001,9579000,20999,False,40,scaffold_3
48,9645001,9718000,72999,False,40,scaffold_3
49,9968001,9996000,27999,False,40,scaffold_3
50,10059001,10089000,29999,False,40,scaffold_3
51,10448001,10458000,9999,False,40,scaffold_3
52,10461001,10485000,23999,False,40,scaffold_3
53,10588001,11163000,574999,False,40,scaffold_3
0,11001,13000,1999,False,40,scaffold_4
1,48001,88000,39999,False,40,scaffold_4
2,121001,146000,24999,False,40,scaffold_4
3,147001,151000,3999,False,40,scaffold_4
4,155001,216000,60999,False,40,scaffold_4
5,249001,266000,16999,False,40,scaffold_4
6,283001,307000,23999,False,40,scaffold_4
7,313001,344000,30999,False,40,scaffold_4
8,346001,353000,6999,False,40,scaffold_4
9,355001,374000,18999,False,40,scaffold_4
10,375001,380000,4999,False,40,scaffold_4
11,414001,425000,10999,False,40,scaffold_4
12,429001,502000,72999,False,40,scaffold_4
13,545001,592000,46999,False,40,scaffold_4
14,608001,691000,82999,False,40,scaffold_4
15,1120001,1136000,15999,False,40,scaffold_4
16,1137001,1208000,70999,False,40,scaffold_4
17,1209001,1226000,16999,False,40,scaffold_4
18,1236001,1253000,16999,False,40,scaffold_4
19,1254001,1259000,4999,False,40,scaffold_4
20,1266001,1279000,12999,False,40,scaffold_4
21,1283001,1573000,289999,False,40,scaffold_4
22,1574001,1604000,29999,False,40,scaffold_4
23,1613001,2206000,592999,False,40,scaffold_4
24,2211001,2218000,6999,False,40,scaffold_4
25,2219001,2280000,60999,False,40,scaffold_4
26,2283001,2461000,177999,False,40,scaffold_4
27,2477001,2541000,63999,False,40,scaffold_4
28,2542001,2675000,132999,False,40,scaffold_4
29,2676001,2813000,136999,False,40,scaffold_4
30,2892001,2990000,97999,False,40,scaffold_4
31,3031001,3136000,104999,False,40,scaffold_4
32,3205001,3329000,123999,False,40,scaffold_4
33,3334001,3571000,236999,False,40,scaffold_4
34,3572001,3774000,201999,False,40,scaffold_4
35,4055001,4104000,48999,False,40,scaffold_4
36,4184001,4197000,12999,False,40,scaffold_4
37,4253001,4306000,52999,False,40,scaffold_4
38,4900001,5087000,186999,False,40,scaffold_4
39,5171001,5215000,43999,False,40,scaffold_4
40,5216001,5224000,7999,False,40,scaffold_4
41,5339001,5409000,69999,False,40,scaffold_4
42,5433001,5506000,72999,False,40,scaffold_4
43,5514001,5784000,269999,False,40,scaffold_4
44,5786001,5827000,40999,False,40,scaffold_4
45,5928001,5967000,38999,False,40,scaffold_4
46,6067001,6117000,49999,False,40,scaffold_4
47,6145001,6193000,47999,False,40,scaffold_4
48,6287001,6299000,11999,False,40,scaffold_4
49,6300001,6391000,90999,False,40,scaffold_4
50,6615001,6617000,1999,False,40,scaffold_4
51,6754001,6864000,109999,False,40,scaffold_4
52,6893001,6924000,30999,False,40,scaffold_4
53,6964001,6995000,30999,False,40,scaffold_4
54,7036001,7124000,87999,False,40,scaffold_4
55,7126001,7170000,43999,False,40,scaffold_4
56,7218001,7304000,85999,False,40,scaffold_4
57,7352001,7429000,76999,False,40,scaffold_4
58,7526001,7555000,28999,False,40,scaffold_4
59,7629001,7665000,35999,False,40,scaffold_4
60,7856001,7924000,67999,False,40,scaffold_4
61,7968001,7999000,30999,False,40,scaffold_4
62,8049001,8102000,52999,False,40,scaffold_4
63,8743001,8765000,21999,False,40,scaffold_4
64,8846001,9698000,851999,False,40,scaffold_4
65,9700001,9833000,132999,False,40,scaffold_4
66,9834001,9845951,11950,True,40,scaffold_4
0,152001,175000,22999,False,40,scaffold_5
1,212001,214000,1999,False,40,scaffold_5
2,327001,385000,57999,False,40,scaffold_5
3,462001,523000,60999,False,40,scaffold_5
4,639001,662000,22999,False,40,scaffold_5
5,669001,694000,24999,False,40,scaffold_5
6,931001,947000,15999,False,40,scaffold_5
7,1652001,1661000,8999,False,40,scaffold_5
8,1663001,1685000,21999,False,40,scaffold_5
9,2082001,2104000,21999,False,40,scaffold_5
10,2473001,2493000,19999,False,40,scaffold_5
11,2511001,2515000,3999,False,40,scaffold_5
12,2516001,2901000,384999,False,40,scaffold_5
13,3133001,3513000,379999,False,40,scaffold_5
14,3616001,3657000,40999,False,40,scaffold_5
15,3863001,3946000,82999,False,40,scaffold_5
16,3962001,4063000,100999,False,40,scaffold_5
17,4119001,4358000,238999,False,40,scaffold_5
18,4445001,4923000,477999,False,40,scaffold_5
19,5217001,5346000,128999,False,40,scaffold_5
20,5720001,5738000,17999,False,40,scaffold_5
21,6395001,6725000,329999,False,40,scaffold_5
22,6812001,6854000,41999,False,40,scaffold_5
23,6888001,6905000,16999,False,40,scaffold_5
24,7036001,7086000,49999,False,40,scaffold_5
25,7097001,7100000,2999,False,40,scaffold_5
26,7170001,7246000,75999,False,40,scaffold_5
27,7406001,7440000,33999,False,40,scaffold_5
28,7454001,7484000,29999,False,40,scaffold_5
29,7523001,7744000,220999,False,40,scaffold_5
30,7782001,7803000,20999,False,40,scaffold_5
31,8552001,8616000,63999,False,40,scaffold_5
32,8636001,8689000,52999,False,40,scaffold_5
33,8711001,9062000,350999,False,40,scaffold_5
34,9063001,9364176,301175,True,40,scaffold_5
0,65001,75000,9999,False,40,scaffold_6
1,79001,84000,4999,False,40,scaffold_6
2,86001,114000,27999,False,40,scaffold_6
3,162001,208000,45999,False,40,scaffold_6
4,239001,262000,22999,False,40,scaffold_6
5,264001,317000,52999,False,40,scaffold_6
6,467001,488000,20999,False,40,scaffold_6
7,618001,624000,5999,False,40,scaffold_6
8,625001,663000,37999,False,40,scaffold_6
9,732001,753000,20999,False,40,scaffold_6
10,787001,797000,9999,False,40,scaffold_6
11,987001,1038000,50999,False,40,scaffold_6
12,1122001,1199000,76999,False,40,scaffold_6
13,1231001,1263000,31999,False,40,scaffold_6
14,1284001,1311000,26999,False,40,scaffold_6
15,1429001,1595000,165999,False,40,scaffold_6
16,1658001,1820000,161999,False,40,scaffold_6
17,1832001,1906000,73999,False,40,scaffold_6
18,1907001,1931000,23999,False,40,scaffold_6
19,2030001,2103000,72999,False,40,scaffold_6
20,2127001,2215000,87999,False,40,scaffold_6
21,2236001,2283000,46999,False,40,scaffold_6
22,2334001,2454000,119999,False,40,scaffold_6
23,2455001,2595000,139999,False,40,scaffold_6
24,2596001,2654000,57999,False,40,scaffold_6
25,2655001,2695000,39999,False,40,scaffold_6
26,2712001,2859000,146999,False,40,scaffold_6
27,2933001,3014000,80999,False,40,scaffold_6
28,3060001,3211000,150999,False,40,scaffold_6
29,3222001,3321000,98999,False,40,scaffold_6
30,3322001,3350000,27999,False,40,scaffold_6
31,3351001,3806000,454999,False,40,scaffold_6
32,3810001,3848000,37999,False,40,scaffold_6
33,3880001,3926000,45999,False,40,scaffold_6
34,3975001,4197000,221999,False,40,scaffold_6
35,4814001,4916000,101999,False,40,scaffold_6
36,4942001,4997000,54999,False,40,scaffold_6
37,5863001,5911000,47999,False,40,scaffold_6
38,5939001,5972000,32999,False,40,scaffold_6
39,6011001,6087000,75999,False,40,scaffold_6
40,6123001,6191000,67999,False,40,scaffold_6
41,6252001,6276000,23999,False,40,scaffold_6
42,6685001,6702000,16999,False,40,scaffold_6
43,6758001,6804000,45999,False,40,scaffold_6
44,7215001,7247000,31999,False,40,scaffold_6
45,7263001,7336000,72999,False,40,scaffold_6
46,7387001,7485000,97999,False,40,scaffold_6
47,7535001,7988000,452999,False,40,scaffold_6
48,7989001,8268281,279280,True,40,scaffold_6
0,13001,31000,17999,False,40,scaffold_7
1,320001,340000,19999,False,40,scaffold_7
2,342001,508000,165999,False,40,scaffold_7
3,571001,577000,5999,False,40,scaffold_7
4,706001,736000,29999,False,40,scaffold_7
5,764001,809000,44999,False,40,scaffold_7
6,811001,822000,10999,False,40,scaffold_7
7,859001,864000,4999,False,40,scaffold_7
8,964001,966000,1999,False,40,scaffold_7
9,968001,980000,11999,False,40,scaffold_7
10,982001,1039000,56999,False,40,scaffold_7
11,1048001,1101000,52999,False,40,scaffold_7
12,1191001,1512000,320999,False,40,scaffold_7
13,1588001,1721000,132999,False,40,scaffold_7
14,1726001,1782000,55999,False,40,scaffold_7
15,1850001,1896000,45999,False,40,scaffold_7
16,1976001,1999000,22999,False,40,scaffold_7
17,2544001,2593000,48999,False,40,scaffold_7
18,2639001,2711000,71999,False,40,scaffold_7
19,3199001,3230000,30999,False,40,scaffold_7
20,3296001,3369000,72999,False,40,scaffold_7
21,3521001,3765000,243999,False,40,scaffold_7
22,4021001,4050000,28999,False,40,scaffold_7
23,4332001,4359000,26999,False,40,scaffold_7
24,4416001,4518000,101999,False,40,scaffold_7
25,4633001,4737000,103999,False,40,scaffold_7
26,4751001,4856000,104999,False,40,scaffold_7
27,4978001,5167000,188999,False,40,scaffold_7
28,5482001,5536000,53999,False,40,scaffold_7
29,6049001,6094000,44999,False,40,scaffold_7
30,6143001,6249000,105999,False,40,scaffold_7
31,6565001,6676000,110999,False,40,scaffold_7
32,6694001,6724000,29999,False,40,scaffold_7
33,6748001,6797000,48999,False,40,scaffold_7
34,6954001,7502216,548215,True,40,scaffold_7
0,1,6000,5999,True,40,scaffold_8
1,66001,87000,20999,False,40,scaffold_8
2,112001,116000,3999,False,40,scaffold_8
3,299001,304000,4999,False,40,scaffold_8
4,1859001,1931000,71999,False,40,scaffold_8
5,2066001,2135000,68999,False,40,scaffold_8
6,2410001,2528000,117999,False,40,scaffold_8
7,2536001,2552000,15999,False,40,scaffold_8
8,2650001,2905000,254999,False,40,scaffold_8
9,2950001,2988000,37999,False,40,scaffold_8
10,3032001,3552000,519999,False,40,scaffold_8
11,3581001,3614000,32999,False,40,scaffold_8
12,3615001,3936000,320999,False,40,scaffold_8
13,4031001,4148000,116999,False,40,scaffold_8
14,4169001,4262000,92999,False,40,scaffold_8
15,4395001,4431000,35999,False,40,scaffold_8
16,4717001,4776000,58999,False,40,scaffold_8
17,4892001,4916000,23999,False,40,scaffold_8
18,4989001,5018000,28999,False,40,scaffold_8
19,5078001,5133000,54999,False,40,scaffold_8
20,5163001,5241000,77999,False,40,scaffold_8
21,5579001,5597000,17999,False,40,scaffold_8
22,5654001,5710000,55999,False,40,scaffold_8
23,5727001,5775000,47999,False,40,scaffold_8
24,5776001,5804000,27999,False,40,scaffold_8
25,5837001,5875000,37999,False,40,scaffold_8
26,5890001,5933000,42999,False,40,scaffold_8
27,5960001,5988000,27999,False,40,scaffold_8
28,6025001,6054000,28999,False,40,scaffold_8
29,6099001,6149000,49999,False,40,scaffold_8
30,6230001,6288000,57999,False,40,scaffold_8
31,6319001,6334544,15543,True,40,scaffold_8
0,109001,119000,9999,False,40,scaffold_9
1,121001,138000,16999,False,40,scaffold_9
2,299001,315000,15999,False,40,scaffold_9
3,319001,332000,12999,False,40,scaffold_9
4,367001,411000,43999,False,40,scaffold_9
5,413001,434000,20999,False,40,scaffold_9
6,490001,531000,40999,False,40,scaffold_9
7,670001,696000,25999,False,40,scaffold_9
8,814001,844000,29999,False,40,scaffold_9
9,872001,986000,113999,False,40,scaffold_9
10,988001,995000,6999,False,40,scaffold_9
11,1001001,1007000,5999,False,40,scaffold_9
12,1009001,1085000,75999,False,40,scaffold_9
13,1087001,1150000,62999,False,40,scaffold_9
14,1151001,1198000,46999,False,40,scaffold_9
15,1202001,1230000,27999,False,40,scaffold_9
16,1316001,1395000,78999,False,40,scaffold_9
17,1427001,1438000,10999,False,40,scaffold_9
18,1457001,1466000,8999,False,40,scaffold_9
19,1506001,1586000,79999,False,40,scaffold_9
20,1600001,1622000,21999,False,40,scaffold_9
21,1652001,1698000,45999,False,40,scaffold_9
22,1750001,1811000,60999,False,40,scaffold_9
23,1815001,1860000,44999,False,40,scaffold_9
24,1893001,1959000,65999,False,40,scaffold_9
25,1970001,2058000,87999,False,40,scaffold_9
26,2075001,2135000,59999,False,40,scaffold_9
27,2136001,2171000,34999,False,40,scaffold_9
28,2174001,2239000,64999,False,40,scaffold_9
29,2388001,2442000,53999,False,40,scaffold_9
30,2513001,2582000,68999,False,40,scaffold_9
31,2584001,2673000,88999,False,40,scaffold_9
32,2737001,3381000,643999,False,40,scaffold_9
33,3383001,4273000,889999,False,40,scaffold_9
34,4274001,5107000,832999,False,40,scaffold_9
35,5112001,5238000,125999,False,40,scaffold_9
36,5239001,5298000,58999,False,40,scaffold_9
37,5300001,5489000,188999,False,40,scaffold_9
38,5492001,6331288,839287,True,40,scaffold_9
0,1,798000,797999,True,40,scaffold_10
1,811001,876000,64999,False,40,scaffold_10
2,888001,921000,32999,False,40,scaffold_10
3,923001,994000,70999,False,40,scaffold_10
4,1061001,1069000,7999,False,40,scaffold_10
5,1072001,1148000,75999,False,40,scaffold_10
6,1313001,1360000,46999,False,40,scaffold_10
7,1369001,1472000,102999,False,40,scaffold_10
8,1590001,1676000,85999,False,40,scaffold_10
9,1697001,1758000,60999,False,40,scaffold_10
10,1862001,1917000,54999,False,40,scaffold_10
11,2041001,2103000,61999,False,40,scaffold_10
12,2131001,2176000,44999,False,40,scaffold_10
13,2201001,2328000,126999,False,40,scaffold_10
14,2334001,2475000,140999,False,40,scaffold_10
15,2509001,2520000,10999,False,40,scaffold_10
16,2521001,2634000,112999,False,40,scaffold_10
17,2670001,2700000,29999,False,40,scaffold_10
18,2714001,2751000,36999,False,40,scaffold_10
19,2777001,2812000,34999,False,40,scaffold_10
20,2817001,2832000,14999,False,40,scaffold_10
21,3154001,3177000,22999,False,40,scaffold_10
22,3776001,3795000,18999,False,40,scaffold_10
23,4052001,4091000,38999,False,40,scaffold_10
24,4335001,4365000,29999,False,40,scaffold_10
25,4443001,4466000,22999,False,40,scaffold_10
26,4467001,4491000,23999,False,40,scaffold_10
27,4494001,4502000,7999,False,40,scaffold_10
28,4503001,4513000,9999,False,40,scaffold_10
29,4515001,4523000,7999,False,40,scaffold_10
30,4526001,4548000,21999,False,40,scaffold_10
31,4574001,4596000,21999,False,40,scaffold_10
32,4681001,4688000,6999,False,40,scaffold_10
33,4726001,4732000,5999,False,40,scaffold_10
34,4734001,4751000,16999,False,40,scaffold_10
35,4752001,4776000,23999,False,40,scaffold_10
36,4798001,4824000,25999,False,40,scaffold_10
37,4827001,4839000,11999,False,40,scaffold_10
38,4840001,4843000,2999,False,40,scaffold_10
39,4848001,4861000,12999,False,40,scaffold_10
40,4865001,4866973,1972,True,40,scaffold_10
0,10001,93000,82999,False,40,scaffold_11
1,149001,167000,17999,False,40,scaffold_11
2,169001,212000,42999,False,40,scaffold_11
3,214001,236000,21999,False,40,scaffold_11
4,240001,250000,9999,False,40,scaffold_11
5,419001,431000,11999,False,40,scaffold_11
6,637001,657000,19999,False,40,scaffold_11
7,1025001,1034000,8999,False,40,scaffold_11
8,1219001,1242000,22999,False,40,scaffold_11
9,1327001,1358000,30999,False,40,scaffold_11
10,1359001,1398000,38999,False,40,scaffold_11
11,1423001,1426000,2999,False,40,scaffold_11
12,1431001,1448000,16999,False,40,scaffold_11
13,1474001,1478000,3999,False,40,scaffold_11
14,1526001,1543000,16999,False,40,scaffold_11
15,1572001,1598000,25999,False,40,scaffold_11
16,1853001,1885000,31999,False,40,scaffold_11
17,1971001,2006000,34999,False,40,scaffold_11
18,2008001,2034000,25999,False,40,scaffold_11
19,2035001,2057000,21999,False,40,scaffold_11
20,2088001,2172000,83999,False,40,scaffold_11
21,2192001,2224000,31999,False,40,scaffold_11
22,2701001,2746000,44999,False,40,scaffold_11
23,2747001,2909000,161999,False,40,scaffold_11
24,2955001,3028000,72999,False,40,scaffold_11
25,3083001,3176000,92999,False,40,scaffold_11
26,3184001,3385000,200999,False,40,scaffold_11
27,3421001,3508000,86999,False,40,scaffold_11
28,3520001,3721000,200999,False,40,scaffold_11
29,3742001,3972000,229999,False,40,scaffold_11
30,3984001,4160000,175999,False,40,scaffold_11
31,4182001,4710000,527999,False,40,scaffold_11
32,4713001,4766820,53819,True,40,scaffold_11
0,1,400000,399999,True,40,scaffold_12
1,402001,1067000,664999,False,40,scaffold_12
2,1068001,1365000,296999,False,40,scaffold_12
3,1372001,1496000,123999,False,40,scaffold_12
4,1716001,1733000,16999,False,40,scaffold_12
5,1784001,1806000,21999,False,40,scaffold_12
6,1882001,1962000,79999,False,40,scaffold_12
7,1972001,2000000,27999,False,40,scaffold_12
8,2023001,2103000,79999,False,40,scaffold_12
9,2137001,2191000,53999,False,40,scaffold_12
10,2338001,2377000,38999,False,40,scaffold_12
11,2571001,2609000,37999,False,40,scaffold_12
12,2675001,2682000,6999,False,40,scaffold_12
13,2686001,2699000,12999,False,40,scaffold_12
0,1,340000,339999,True,41,scaffold_1
1,482001,498000,15999,False,41,scaffold_1
2,574001,643000,68999,False,41,scaffold_1
3,686001,713000,26999,False,41,scaffold_1
4,1281001,1292000,10999,False,41,scaffold_1
5,1954001,1964000,9999,False,41,scaffold_1
6,1965001,1984000,18999,False,41,scaffold_1
7,2449001,2517000,67999,False,41,scaffold_1
8,2729001,2746000,16999,False,41,scaffold_1
9,3181001,3208000,26999,False,41,scaffold_1
10,3715001,3733000,17999,False,41,scaffold_1
11,3916001,3941000,24999,False,41,scaffold_1
12,4064001,4111000,46999,False,41,scaffold_1
13,4322001,4354000,31999,False,41,scaffold_1
14,4929001,4964000,34999,False,41,scaffold_1
15,4967001,4997000,29999,False,41,scaffold_1
16,5484001,5511000,26999,False,41,scaffold_1
17,6108001,6153000,44999,False,41,scaffold_1
18,6228001,6381000,152999,False,41,scaffold_1
19,6384001,6507000,122999,False,41,scaffold_1
20,6544001,6554000,9999,False,41,scaffold_1
21,7038001,7247000,208999,False,41,scaffold_1
22,7248001,7588000,339999,False,41,scaffold_1
23,7590001,8477000,886999,False,41,scaffold_1
24,8478001,8656000,177999,False,41,scaffold_1
25,8658001,9584000,925999,False,41,scaffold_1
26,9586001,10354000,767999,False,41,scaffold_1
27,10461001,10636000,174999,False,41,scaffold_1
28,10808001,10811000,2999,False,41,scaffold_1
29,10839001,10857000,17999,False,41,scaffold_1
30,11351001,11508000,156999,False,41,scaffold_1
31,11647001,11951000,303999,False,41,scaffold_1
32,12184001,12204000,19999,False,41,scaffold_1
33,12678001,12722000,43999,False,41,scaffold_1
34,12777001,12888000,110999,False,41,scaffold_1
35,13181001,13211000,29999,False,41,scaffold_1
36,13347001,13377000,29999,False,41,scaffold_1
37,13901001,13903000,1999,False,41,scaffold_1
38,14007001,14009000,1999,False,41,scaffold_1
0,22001,48000,25999,False,41,scaffold_2
1,93001,159000,65999,False,41,scaffold_2
2,303001,318000,14999,False,41,scaffold_2
3,330001,374000,43999,False,41,scaffold_2
4,2336001,2358000,21999,False,41,scaffold_2
5,2441001,2553000,111999,False,41,scaffold_2
6,2660001,2689000,28999,False,41,scaffold_2
7,2694001,2742000,47999,False,41,scaffold_2
8,2994001,3012000,17999,False,41,scaffold_2
9,3454001,3463000,8999,False,41,scaffold_2
10,3767001,3781000,13999,False,41,scaffold_2
11,4385001,4409000,23999,False,41,scaffold_2
12,4429001,4456000,26999,False,41,scaffold_2
13,4525001,4553000,27999,False,41,scaffold_2
14,4608001,4653000,44999,False,41,scaffold_2
15,5022001,5031000,8999,False,41,scaffold_2
16,5033001,5061000,27999,False,41,scaffold_2
17,5491001,5511000,19999,False,41,scaffold_2
18,5672001,5704000,31999,False,41,scaffold_2
19,6261001,6330000,68999,False,41,scaffold_2
20,6331001,6351000,19999,False,41,scaffold_2
21,7439001,7472000,32999,False,41,scaffold_2
22,7563001,7697000,133999,False,41,scaffold_2
23,7786001,7890000,103999,False,41,scaffold_2
24,7934001,7969000,34999,False,41,scaffold_2
25,7982001,8088000,105999,False,41,scaffold_2
26,8331001,8333000,1999,False,41,scaffold_2
27,8346001,8389000,42999,False,41,scaffold_2
28,8509001,8535000,25999,False,41,scaffold_2
29,11367001,11371000,3999,False,41,scaffold_2
30,11520001,11785000,264999,False,41,scaffold_2
0,1,2000,1999,True,41,scaffold_3
1,51001,55000,3999,False,41,scaffold_3
2,102001,104000,1999,False,41,scaffold_3
3,799001,900000,100999,False,41,scaffold_3
4,2085001,2108000,22999,False,41,scaffold_3
5,2291001,2321000,29999,False,41,scaffold_3
6,2488001,2531000,42999,False,41,scaffold_3
7,4150001,4403000,252999,False,41,scaffold_3
8,4410001,4518000,107999,False,41,scaffold_3
9,4547001,4558000,10999,False,41,scaffold_3
10,4652001,4684000,31999,False,41,scaffold_3
11,5578001,5581000,2999,False,41,scaffold_3
12,5708001,5711000,2999,False,41,scaffold_3
13,6911001,6962000,50999,False,41,scaffold_3
14,6980001,7036000,55999,False,41,scaffold_3
15,7540001,7556000,15999,False,41,scaffold_3
16,7692001,7724000,31999,False,41,scaffold_3
17,7823001,7838000,14999,False,41,scaffold_3
18,8208001,8255000,46999,False,41,scaffold_3
19,8462001,8527000,64999,False,41,scaffold_3
20,8575001,8594000,18999,False,41,scaffold_3
21,9968001,9996000,27999,False,41,scaffold_3
22,10461001,10480000,18999,False,41,scaffold_3
23,10587001,11163000,575999,False,41,scaffold_3
0,17001,32000,14999,False,41,scaffold_4
1,48001,88000,39999,False,41,scaffold_4
2,155001,215000,59999,False,41,scaffold_4
3,217001,226000,8999,False,41,scaffold_4
4,227001,266000,38999,False,41,scaffold_4
5,291001,307000,15999,False,41,scaffold_4
6,355001,374000,18999,False,41,scaffold_4
7,375001,380000,4999,False,41,scaffold_4
8,390001,410000,19999,False,41,scaffold_4
9,412001,425000,12999,False,41,scaffold_4
10,429001,445000,15999,False,41,scaffold_4
11,449001,498000,48999,False,41,scaffold_4
12,545001,592000,46999,False,41,scaffold_4
13,608001,661000,52999,False,41,scaffold_4
14,670001,691000,20999,False,41,scaffold_4
15,701001,714000,12999,False,41,scaffold_4
16,1121001,1136000,14999,False,41,scaffold_4
17,1137001,1180000,42999,False,41,scaffold_4
18,1199001,1208000,8999,False,41,scaffold_4
19,1210001,1226000,15999,False,41,scaffold_4
20,1254001,1262000,7999,False,41,scaffold_4
21,1265001,1279000,13999,False,41,scaffold_4
22,1283001,1314000,30999,False,41,scaffold_4
23,1372001,1591000,218999,False,41,scaffold_4
24,1749001,1817000,67999,False,41,scaffold_4
25,1826001,1849000,22999,False,41,scaffold_4
26,1850001,1863000,12999,False,41,scaffold_4
27,1940001,1957000,16999,False,41,scaffold_4
28,1958001,1997000,38999,False,41,scaffold_4
29,2039001,2063000,23999,False,41,scaffold_4
30,2284001,2340000,55999,False,41,scaffold_4
31,2480001,2533000,52999,False,41,scaffold_4
32,3335001,3632000,296999,False,41,scaffold_4
33,3676001,3759000,82999,False,41,scaffold_4
34,4944001,4984000,39999,False,41,scaffold_4
35,5477001,5506000,28999,False,41,scaffold_4
36,5514001,5620000,105999,False,41,scaffold_4
37,5669001,5784000,114999,False,41,scaffold_4
38,7037001,7062000,24999,False,41,scaffold_4
39,8846001,9699000,852999,False,41,scaffold_4
40,9700001,9845951,145950,True,41,scaffold_4
0,191001,204000,12999,False,41,scaffold_5
1,296001,299000,2999,False,41,scaffold_5
2,318001,326000,7999,False,41,scaffold_5
3,327001,368000,40999,False,41,scaffold_5
4,466001,485000,18999,False,41,scaffold_5
5,495001,523000,27999,False,41,scaffold_5
6,933001,947000,13999,False,41,scaffold_5
7,2565001,2581000,15999,False,41,scaffold_5
8,2625001,2737000,111999,False,41,scaffold_5
9,2816001,2871000,54999,False,41,scaffold_5
10,3138001,3185000,46999,False,41,scaffold_5
11,3322001,3438000,115999,False,41,scaffold_5
12,3451001,3497000,45999,False,41,scaffold_5
13,3962001,4101000,138999,False,41,scaffold_5
14,4121001,4142000,20999,False,41,scaffold_5
15,4155001,4219000,63999,False,41,scaffold_5
16,4246001,4262000,15999,False,41,scaffold_5
17,4446001,4488000,41999,False,41,scaffold_5
18,4601001,4649000,47999,False,41,scaffold_5
19,4691001,4717000,25999,False,41,scaffold_5
20,4819001,4861000,41999,False,41,scaffold_5
21,4904001,4917000,12999,False,41,scaffold_5
22,5318001,5346000,27999,False,41,scaffold_5
23,7582001,7608000,25999,False,41,scaffold_5
24,8730001,9364176,634175,True,41,scaffold_5
0,79001,85000,5999,False,41,scaffold_6
1,86001,112000,25999,False,41,scaffold_6
2,241001,253000,11999,False,41,scaffold_6
3,267001,283000,15999,False,41,scaffold_6
4,1229001,1266000,36999,False,41,scaffold_6
5,1479001,1546000,66999,False,41,scaffold_6
6,2023001,2086000,62999,False,41,scaffold_6
7,2130001,2169000,38999,False,41,scaffold_6
8,2371001,2595000,223999,False,41,scaffold_6
9,2596001,2653000,56999,False,41,scaffold_6
10,2661001,2691000,29999,False,41,scaffold_6
11,2731001,2851000,119999,False,41,scaffold_6
12,2933001,3014000,80999,False,41,scaffold_6
13,3115001,3149000,33999,False,41,scaffold_6
14,3224001,3301000,76999,False,41,scaffold_6
15,3408001,3427000,18999,False,41,scaffold_6
16,3462001,3521000,58999,False,41,scaffold_6
17,3527001,3766000,238999,False,41,scaffold_6
18,3901001,3912000,10999,False,41,scaffold_6
19,4019001,4040000,20999,False,41,scaffold_6
20,4082001,4193000,110999,False,41,scaffold_6
21,6011001,6060000,48999,False,41,scaffold_6
22,7271001,7336000,64999,False,41,scaffold_6
23,7560001,7795000,234999,False,41,scaffold_6
24,7811001,8268281,457280,True,41,scaffold_6
0,1,7000,6999,True,41,scaffold_7
1,13001,34000,20999,False,41,scaffold_7
2,323001,340000,16999,False,41,scaffold_7
3,342001,508000,165999,False,41,scaffold_7
4,554001,563000,8999,False,41,scaffold_7
5,571001,577000,5999,False,41,scaffold_7
6,706001,736000,29999,False,41,scaffold_7
7,764001,809000,44999,False,41,scaffold_7
8,859001,864000,4999,False,41,scaffold_7
9,964001,966000,1999,False,41,scaffold_7
10,968001,981000,12999,False,41,scaffold_7
11,982001,1044000,61999,False,41,scaffold_7
12,1048001,1099000,50999,False,41,scaffold_7
13,1191001,1201000,9999,False,41,scaffold_7
14,1203001,1512000,308999,False,41,scaffold_7
15,1588001,1688000,99999,False,41,scaffold_7
16,3329001,3369000,39999,False,41,scaffold_7
17,3596001,3649000,52999,False,41,scaffold_7
18,4419001,4517000,97999,False,41,scaffold_7
19,4658001,4682000,23999,False,41,scaffold_7
20,4979001,5030000,50999,False,41,scaffold_7
21,5077001,5111000,33999,False,41,scaffold_7
22,5498001,5513000,14999,False,41,scaffold_7
23,6955001,7270000,314999,False,41,scaffold_7
24,7271001,7502216,231215,True,41,scaffold_7
0,67001,85000,17999,False,41,scaffold_8
1,93001,101000,7999,False,41,scaffold_8
2,2662001,2683000,20999,False,41,scaffold_8
3,2745001,2756000,10999,False,41,scaffold_8
4,3060001,3525000,464999,False,41,scaffold_8
5,3584001,3612000,27999,False,41,scaffold_8
6,3615001,3913000,297999,False,41,scaffold_8
7,5199001,5241000,41999,False,41,scaffold_8
8,6332001,6334544,2543,True,41,scaffold_8
0,109001,117000,7999,False,41,scaffold_9
1,303001,315000,11999,False,41,scaffold_9
2,319001,332000,12999,False,41,scaffold_9
3,367001,411000,43999,False,41,scaffold_9
4,413001,434000,20999,False,41,scaffold_9
5,503001,531000,27999,False,41,scaffold_9
6,670001,696000,25999,False,41,scaffold_9
7,732001,742000,9999,False,41,scaffold_9
8,794001,803000,8999,False,41,scaffold_9
9,815001,842000,26999,False,41,scaffold_9
10,850001,854000,3999,False,41,scaffold_9
11,855001,862000,6999,False,41,scaffold_9
12,886001,986000,99999,False,41,scaffold_9
13,988001,995000,6999,False,41,scaffold_9
14,1001001,1006000,4999,False,41,scaffold_9
15,1010001,1031000,20999,False,41,scaffold_9
16,1036001,1083000,46999,False,41,scaffold_9
17,1087001,1150000,62999,False,41,scaffold_9
18,1151001,1160000,8999,False,41,scaffold_9
19,1312001,1378000,65999,False,41,scaffold_9
20,1770001,1783000,12999,False,41,scaffold_9
21,2601001,2616000,14999,False,41,scaffold_9
22,2874001,3381000,506999,False,41,scaffold_9
23,3383001,5099000,1715999,False,41,scaffold_9
24,5101001,5107000,5999,False,41,scaffold_9
25,5112001,5237000,124999,False,41,scaffold_9
26,5239001,5298000,58999,False,41,scaffold_9
27,5300001,5490000,189999,False,41,scaffold_9
28,5493001,6331288,838287,True,41,scaffold_9
0,1,136000,135999,True,41,scaffold_10
1,137001,197000,59999,False,41,scaffold_10
2,375001,414000,38999,False,41,scaffold_10
3,473001,482000,8999,False,41,scaffold_10
4,508001,576000,67999,False,41,scaffold_10
5,603001,721000,117999,False,41,scaffold_10
6,888001,916000,27999,False,41,scaffold_10
7,924001,962000,37999,False,41,scaffold_10
8,1087001,1105000,17999,False,41,scaffold_10
9,2346001,2366000,19999,False,41,scaffold_10
10,3264001,3268000,3999,False,41,scaffold_10
11,4054001,4091000,36999,False,41,scaffold_10
12,4154001,4174000,19999,False,41,scaffold_10
13,4446001,4462000,15999,False,41,scaffold_10
14,4467001,4477000,9999,False,41,scaffold_10
15,4515001,4523000,7999,False,41,scaffold_10
16,4526001,4548000,21999,False,41,scaffold_10
17,4576001,4596000,19999,False,41,scaffold_10
18,4679001,4688000,8999,False,41,scaffold_10
19,4734001,4766000,31999,False,41,scaffold_10
20,4769001,4776000,6999,False,41,scaffold_10
21,4798001,4824000,25999,False,41,scaffold_10
22,4828001,4843000,14999,False,41,scaffold_10
23,4848001,4861000,12999,False,41,scaffold_10
24,4865001,4866973,1972,True,41,scaffold_10
0,10001,34000,23999,False,41,scaffold_11
1,40001,93000,52999,False,41,scaffold_11
2,149001,167000,17999,False,41,scaffold_11
3,169001,189000,19999,False,41,scaffold_11
4,214001,235000,20999,False,41,scaffold_11
5,240001,248000,7999,False,41,scaffold_11
6,419001,431000,11999,False,41,scaffold_11
7,649001,656000,6999,False,41,scaffold_11
8,1025001,1034000,8999,False,41,scaffold_11
9,1305001,1307000,1999,False,41,scaffold_11
10,2701001,2872000,170999,False,41,scaffold_11
11,3213001,3254000,40999,False,41,scaffold_11
12,3328001,3367000,38999,False,41,scaffold_11
13,3702001,3926000,223999,False,41,scaffold_11
14,4322001,4710000,387999,False,41,scaffold_11
15,4713001,4766820,53819,True,41,scaffold_11
0,1,240000,239999,True,41,scaffold_12
1,290001,370000,79999,False,41,scaffold_12
2,474001,537000,62999,False,41,scaffold_12
3,582001,730000,147999,False,41,scaffold_12
4,739001,856000,116999,False,41,scaffold_12
5,865001,1354000,488999,False,41,scaffold_12
6,1720001,1733000,12999,False,41,scaffold_12
7,2559001,2566000,6999,False,41,scaffold_12
8,2571001,2618000,46999,False,41,scaffold_12
9,2747001,2747968,967,True,41,scaffold_12
0,1,329000,328999,True,42,scaffold_1
1,483001,498000,14999,False,42,scaffold_1
2,575001,604000,28999,False,42,scaffold_1
3,686001,713000,26999,False,42,scaffold_1
4,720001,742000,21999,False,42,scaffold_1
5,1279001,1292000,12999,False,42,scaffold_1
6,1965001,1984000,18999,False,42,scaffold_1
7,2729001,2746000,16999,False,42,scaffold_1
8,4325001,4353000,27999,False,42,scaffold_1
9,4929001,4984000,54999,False,42,scaffold_1
10,5482001,5511000,28999,False,42,scaffold_1
11,5536001,5570000,33999,False,42,scaffold_1
12,6108001,6140000,31999,False,42,scaffold_1
13,6228001,6264000,35999,False,42,scaffold_1
14,6276001,6288000,11999,False,42,scaffold_1
15,6290001,6316000,25999,False,42,scaffold_1
16,6337001,6381000,43999,False,42,scaffold_1
17,6384001,6394000,9999,False,42,scaffold_1
18,6397001,6414000,16999,False,42,scaffold_1
19,6415001,6448000,32999,False,42,scaffold_1
20,6483001,6506000,22999,False,42,scaffold_1
21,7037001,7247000,209999,False,42,scaffold_1
22,7248001,7584000,335999,False,42,scaffold_1
23,7590001,7635000,44999,False,42,scaffold_1
24,7638001,8090000,451999,False,42,scaffold_1
25,8091001,8323000,231999,False,42,scaffold_1
26,8324001,8402000,77999,False,42,scaffold_1
27,8411001,8618000,206999,False,42,scaffold_1
28,8619001,8626000,6999,False,42,scaffold_1
29,8628001,8656000,27999,False,42,scaffold_1
30,8658001,8670000,11999,False,42,scaffold_1
31,8671001,8745000,73999,False,42,scaffold_1
32,8748001,8879000,130999,False,42,scaffold_1
33,8880001,9336000,455999,False,42,scaffold_1
34,9342001,9487000,144999,False,42,scaffold_1
35,9495001,9548000,52999,False,42,scaffold_1
36,9549001,9559000,9999,False,42,scaffold_1
37,9561001,9584000,22999,False,42,scaffold_1
38,9586001,9716000,129999,False,42,scaffold_1
39,9717001,9837000,119999,False,42,scaffold_1
40,9839001,10015000,175999,False,42,scaffold_1
41,10016001,10033000,16999,False,42,scaffold_1
42,10035001,10281000,245999,False,42,scaffold_1
43,10282001,10354000,71999,False,42,scaffold_1
44,10496001,10535000,38999,False,42,scaffold_1
45,10557001,10593000,35999,False,42,scaffold_1
46,10808001,10811000,2999,False,42,scaffold_1
47,11407001,11425000,17999,False,42,scaffold_1
48,11474001,11502000,27999,False,42,scaffold_1
49,11802001,11819000,16999,False,42,scaffold_1
50,11883001,11917000,33999,False,42,scaffold_1
51,12184001,12203000,18999,False,42,scaffold_1
52,12651001,12723000,71999,False,42,scaffold_1
53,12784001,12817000,32999,False,42,scaffold_1
54,12837001,12878000,40999,False,42,scaffold_1
55,13184001,13212000,27999,False,42,scaffold_1
56,13347001,13361000,13999,False,42,scaffold_1
57,13842001,13845000,2999,False,42,scaffold_1
58,14007001,14009000,1999,False,42,scaffold_1
59,14316001,14320000,3999,False,42,scaffold_1
60,14560001,14562000,1999,False,42,scaffold_1
61,14605001,14610000,4999,False,42,scaffold_1
0,152001,159000,6999,False,42,scaffold_2
1,168001,177000,8999,False,42,scaffold_2
2,312001,318000,5999,False,42,scaffold_2
3,342001,374000,31999,False,42,scaffold_2
4,2477001,2524000,46999,False,42,scaffold_2
5,2525001,2541000,15999,False,42,scaffold_2
6,2676001,2689000,12999,False,42,scaffold_2
7,2694001,2738000,43999,False,42,scaffold_2
8,2780001,2788000,7999,False,42,scaffold_2
9,4785001,4790000,4999,False,42,scaffold_2
10,5022001,5031000,8999,False,42,scaffold_2
11,5033001,5061000,27999,False,42,scaffold_2
12,5498001,5514000,15999,False,42,scaffold_2
13,5678001,5704000,25999,False,42,scaffold_2
14,6262001,6275000,12999,False,42,scaffold_2
15,6298001,6330000,31999,False,42,scaffold_2
16,6331001,6336000,4999,False,42,scaffold_2
17,7786001,7850000,63999,False,42,scaffold_2
18,7993001,8004000,10999,False,42,scaffold_2
19,8267001,8294000,26999,False,42,scaffold_2
20,8331001,8333000,1999,False,42,scaffold_2
21,8509001,8535000,25999,False,42,scaffold_2
22,11366001,11376000,9999,False,42,scaffold_2
23,11555001,11591000,35999,False,42,scaffold_2
24,11592001,11652000,59999,False,42,scaffold_2
25,11653001,11675000,21999,False,42,scaffold_2
26,11692001,11749000,56999,False,42,scaffold_2
0,51001,54000,2999,False,42,scaffold_3
1,799001,901000,101999,False,42,scaffold_3
2,2085001,2108000,22999,False,42,scaffold_3
3,4149001,4233000,83999,False,42,scaffold_3
4,4242001,4383000,140999,False,42,scaffold_3
5,4422001,4453000,30999,False,42,scaffold_3
6,4467001,4522000,54999,False,42,scaffold_3
7,4567001,4578000,10999,False,42,scaffold_3
8,7540001,7555000,14999,False,42,scaffold_3
9,8428001,8449000,20999,False,42,scaffold_3
10,8452001,8457000,4999,False,42,scaffold_3
11,8459001,8527000,67999,False,42,scaffold_3
12,8575001,8594000,18999,False,42,scaffold_3
13,9971001,9992000,20999,False,42,scaffold_3
14,10153001,10155000,1999,False,42,scaffold_3
15,10550001,10569000,18999,False,42,scaffold_3
16,10594001,10758000,163999,False,42,scaffold_3
17,10760001,10788000,27999,False,42,scaffold_3
18,10789001,10953000,163999,False,42,scaffold_3
19,10955001,10998000,42999,False,42,scaffold_3
20,10999001,11025000,25999,False,42,scaffold_3
21,11026001,11042000,15999,False,42,scaffold_3
22,11043001,11070000,26999,False,42,scaffold_3
23,11072001,11163000,90999,False,42,scaffold_3
0,50001,88000,37999,False,42,scaffold_4
1,147001,151000,3999,False,42,scaffold_4
2,155001,160000,4999,False,42,scaffold_4
3,161001,173000,11999,False,42,scaffold_4
4,175001,215000,39999,False,42,scaffold_4
5,217001,226000,8999,False,42,scaffold_4
6,227001,240000,12999,False,42,scaffold_4
7,243001,263000,19999,False,42,scaffold_4
8,291001,344000,52999,False,42,scaffold_4
9,355001,374000,18999,False,42,scaffold_4
10,375001,380000,4999,False,42,scaffold_4
11,412001,425000,12999,False,42,scaffold_4
12,481001,500000,18999,False,42,scaffold_4
13,608001,632000,23999,False,42,scaffold_4
14,674001,691000,16999,False,42,scaffold_4
15,1121001,1136000,14999,False,42,scaffold_4
16,1137001,1178000,40999,False,42,scaffold_4
17,1199001,1208000,8999,False,42,scaffold_4
18,1254001,1262000,7999,False,42,scaffold_4
19,1265001,1279000,13999,False,42,scaffold_4
20,1283001,1320000,36999,False,42,scaffold_4
21,1437001,1563000,125999,False,42,scaffold_4
22,1749001,1840000,90999,False,42,scaffold_4
23,1906001,1957000,50999,False,42,scaffold_4
24,2074001,2090000,15999,False,42,scaffold_4
25,2210001,2218000,7999,False,42,scaffold_4
26,2269001,2279000,9999,False,42,scaffold_4
27,2284001,2310000,25999,False,42,scaffold_4
28,2311001,2340000,28999,False,42,scaffold_4
29,2434001,2461000,26999,False,42,scaffold_4
30,2476001,2504000,27999,False,42,scaffold_4
31,2505001,2533000,27999,False,42,scaffold_4
32,3466001,3542000,75999,False,42,scaffold_4
33,3698001,3760000,61999,False,42,scaffold_4
34,5479001,5506000,26999,False,42,scaffold_4
35,5514001,5543000,28999,False,42,scaffold_4
36,5551001,5620000,68999,False,42,scaffold_4
37,5731001,5784000,52999,False,42,scaffold_4
38,8844001,8871000,26999,False,42,scaffold_4
39,8875001,9178000,302999,False,42,scaffold_4
40,9179001,9200000,20999,False,42,scaffold_4
41,9203001,9236000,32999,False,42,scaffold_4
42,9237001,9268000,30999,False,42,scaffold_4
43,9270001,9352000,81999,False,42,scaffold_4
44,9353001,9483000,129999,False,42,scaffold_4
45,9485001,9699000,213999,False,42,scaffold_4
46,9705001,9759000,53999,False,42,scaffold_4
47,9760001,9845951,85950,True,42,scaffold_4
0,178001,180000,1999,False,42,scaffold_5
1,296001,300000,3999,False,42,scaffold_5
2,318001,326000,7999,False,42,scaffold_5
3,327001,352000,24999,False,42,scaffold_5
4,402001,415000,12999,False,42,scaffold_5
5,508001,523000,14999,False,42,scaffold_5
6,668001,679000,10999,False,42,scaffold_5
7,933001,947000,13999,False,42,scaffold_5
8,2698001,2730000,31999,False,42,scaffold_5
9,3322001,3365000,42999,False,42,scaffold_5
10,3452001,3492000,39999,False,42,scaffold_5
11,3963001,4070000,106999,False,42,scaffold_5
12,4129001,4141000,11999,False,42,scaffold_5
13,4163001,4179000,15999,False,42,scaffold_5
14,4180001,4221000,40999,False,42,scaffold_5
15,4226001,4262000,35999,False,42,scaffold_5
16,4446001,4488000,41999,False,42,scaffold_5
17,4605001,4615000,9999,False,42,scaffold_5
18,4694001,4717000,22999,False,42,scaffold_5
19,4819001,4852000,32999,False,42,scaffold_5
20,4906001,4918000,11999,False,42,scaffold_5
21,7097001,7100000,2999,False,42,scaffold_5
22,7622001,7626000,3999,False,42,scaffold_5
23,7627001,7641000,13999,False,42,scaffold_5
24,8667001,8689000,21999,False,42,scaffold_5
25,8735001,8981000,245999,False,42,scaffold_5
26,8984001,9159000,174999,False,42,scaffold_5
27,9160001,9221000,60999,False,42,scaffold_5
28,9223001,9248000,24999,False,42,scaffold_5
29,9250001,9364176,114175,True,42,scaffold_5
0,79001,84000,4999,False,42,scaffold_6
1,86001,113000,26999,False,42,scaffold_6
2,273001,288000,14999,False,42,scaffold_6
3,1504001,1546000,41999,False,42,scaffold_6
4,2129001,2193000,63999,False,42,scaffold_6
5,2347001,2581000,233999,False,42,scaffold_6
6,2596001,2610000,13999,False,42,scaffold_6
7,2636001,2654000,17999,False,42,scaffold_6
8,2657001,2691000,33999,False,42,scaffold_6
9,2764001,2849000,84999,False,42,scaffold_6
10,2968001,2978000,9999,False,42,scaffold_6
11,2980001,3011000,30999,False,42,scaffold_6
12,3462001,3491000,28999,False,42,scaffold_6
13,3530001,3624000,93999,False,42,scaffold_6
14,3626001,3699000,72999,False,42,scaffold_6
15,4136001,4191000,54999,False,42,scaffold_6
16,6022001,6027000,4999,False,42,scaffold_6
17,6028001,6055000,26999,False,42,scaffold_6
18,7263001,7336000,72999,False,42,scaffold_6
19,7394001,7413000,18999,False,42,scaffold_6
20,7689001,7711000,21999,False,42,scaffold_6
21,7752001,7795000,42999,False,42,scaffold_6
22,7824001,7882000,57999,False,42,scaffold_6
23,7893001,7984000,90999,False,42,scaffold_6
24,7985001,7987000,1999,False,42,scaffold_6
25,7989001,7994000,4999,False,42,scaffold_6
26,7995001,8212000,216999,False,42,scaffold_6
27,8213001,8268281,55280,True,42,scaffold_6
0,13001,17000,3999,False,42,scaffold_7
1,19001,34000,14999,False,42,scaffold_7
2,50001,55000,4999,False,42,scaffold_7
3,323001,340000,16999,False,42,scaffold_7
4,342001,463000,120999,False,42,scaffold_7
5,464001,468000,3999,False,42,scaffold_7
6,471001,508000,36999,False,42,scaffold_7
7,554001,559000,4999,False,42,scaffold_7
8,572001,577000,4999,False,42,scaffold_7
9,706001,718000,11999,False,42,scaffold_7
10,721001,736000,14999,False,42,scaffold_7
11,764001,803000,38999,False,42,scaffold_7
12,859001,864000,4999,False,42,scaffold_7
13,964001,966000,1999,False,42,scaffold_7
14,968001,981000,12999,False,42,scaffold_7
15,982001,1037000,54999,False,42,scaffold_7
16,1070001,1104000,33999,False,42,scaffold_7
17,1203001,1512000,308999,False,42,scaffold_7
18,1589001,1694000,104999,False,42,scaffold_7
19,3597001,3613000,15999,False,42,scaffold_7
20,3686001,3692000,5999,False,42,scaffold_7
21,4433001,4492000,58999,False,42,scaffold_7
22,6954001,7085000,130999,False,42,scaffold_7
23,7086001,7140000,53999,False,42,scaffold_7
24,7147001,7204000,56999,False,42,scaffold_7
25,7205001,7270000,64999,False,42,scaffold_7
26,7271001,7385000,113999,False,42,scaffold_7
27,7386001,7502216,116215,True,42,scaffold_7
0,2659001,2683000,23999,False,42,scaffold_8
1,2742001,2757000,14999,False,42,scaffold_8
2,3059001,3174000,114999,False,42,scaffold_8
3,3175001,3190000,14999,False,42,scaffold_8
4,3192001,3225000,32999,False,42,scaffold_8
5,3227001,3280000,52999,False,42,scaffold_8
6,3283001,3526000,242999,False,42,scaffold_8
7,3587001,3612000,24999,False,42,scaffold_8
8,3615001,3675000,59999,False,42,scaffold_8
9,3676001,3754000,77999,False,42,scaffold_8
10,3759001,3807000,47999,False,42,scaffold_8
11,3808001,3913000,104999,False,42,scaffold_8
12,4202001,4221000,18999,False,42,scaffold_8
13,5223001,5237000,13999,False,42,scaffold_8
14,6329001,6334544,5543,True,42,scaffold_8
0,109001,118000,8999,False,42,scaffold_9
1,304001,315000,10999,False,42,scaffold_9
2,319001,338000,18999,False,42,scaffold_9
3,367001,411000,43999,False,42,scaffold_9
4,413001,434000,20999,False,42,scaffold_9
5,671001,697000,25999,False,42,scaffold_9
6,731001,742000,10999,False,42,scaffold_9
7,816001,843000,26999,False,42,scaffold_9
8,850001,862000,11999,False,42,scaffold_9
9,873001,941000,67999,False,42,scaffold_9
10,942001,986000,43999,False,42,scaffold_9
11,988001,995000,6999,False,42,scaffold_9
12,1001001,1006000,4999,False,42,scaffold_9
13,1037001,1085000,47999,False,42,scaffold_9
14,1087001,1165000,77999,False,42,scaffold_9
15,1316001,1377000,60999,False,42,scaffold_9
16,2601001,2616000,14999,False,42,scaffold_9
17,2870001,3381000,510999,False,42,scaffold_9
18,3383001,3569000,185999,False,42,scaffold_9
19,3571001,4271000,699999,False,42,scaffold_9
20,4273001,5097000,823999,False,42,scaffold_9
21,5101001,5107000,5999,False,42,scaffold_9
22,5112001,5115000,2999,False,42,scaffold_9
23,5116001,5283000,166999,False,42,scaffold_9
24,5300001,5490000,189999,False,42,scaffold_9
25,5493001,5557000,63999,False,42,scaffold_9
26,5558001,6037000,478999,False,42,scaffold_9
27,6049001,6331288,282287,True,42,scaffold_9
0,1,198000,197999,True,42,scaffold_10
1,375001,402000,26999,False,42,scaffold_10
2,472001,482000,9999,False,42,scaffold_10
3,518001,575000,56999,False,42,scaffold_10
4,603001,640000,36999,False,42,scaffold_10
5,671001,719000,47999,False,42,scaffold_10
6,888001,912000,23999,False,42,scaffold_10
7,924001,958000,33999,False,42,scaffold_10
8,3264001,3268000,3999,False,42,scaffold_10
9,4054001,4088000,33999,False,42,scaffold_10
10,4154001,4173000,18999,False,42,scaffold_10
11,4407001,4410000,2999,False,42,scaffold_10
12,4467001,4477000,9999,False,42,scaffold_10
13,4529001,4548000,18999,False,42,scaffold_10
14,4683001,4688000,4999,False,42,scaffold_10
15,4734001,4766000,31999,False,42,scaffold_10
16,4768001,4776000,7999,False,42,scaffold_10
17,4798001,4824000,25999,False,42,scaffold_10
18,4828001,4843000,14999,False,42,scaffold_10
19,4865001,4866973,1972,True,42,scaffold_10
0,10001,37000,26999,False,42,scaffold_11
1,38001,91000,52999,False,42,scaffold_11
2,149001,168000,18999,False,42,scaffold_11
3,170001,192000,21999,False,42,scaffold_11
4,213001,236000,22999,False,42,scaffold_11
5,240001,252000,11999,False,42,scaffold_11
6,419001,431000,11999,False,42,scaffold_11
7,648001,656000,7999,False,42,scaffold_11
8,1025001,1034000,8999,False,42,scaffold_11
9,1423001,1426000,2999,False,42,scaffold_11
10,2747001,2771000,23999,False,42,scaffold_11
11,2807001,2867000,59999,False,42,scaffold_11
12,3215001,3251000,35999,False,42,scaffold_11
13,3705001,3721000,15999,False,42,scaffold_11
14,3805001,3834000,28999,False,42,scaffold_11
15,4317001,4357000,39999,False,42,scaffold_11
16,4396001,4651000,254999,False,42,scaffold_11
17,4652001,4710000,57999,False,42,scaffold_11
18,4713001,4725000,11999,False,42,scaffold_11
19,4726001,4748000,21999,False,42,scaffold_11
20,4754001,4766820,12819,True,42,scaffold_11
0,1,77000,76999,True,42,scaffold_12
1,81001,241000,159999,False,42,scaffold_12
2,250001,368000,117999,False,42,scaffold_12
3,405001,429000,23999,False,42,scaffold_12
4,627001,754000,126999,False,42,scaffold_12
5,776001,856000,79999,False,42,scaffold_12
6,864001,1121000,256999,False,42,scaffold_12
7,1128001,1250000,121999,False,42,scaffold_12
8,1276001,1356000,79999,False,42,scaffold_12
9,1725001,1735000,9999,False,42,scaffold_12
10,2574001,2618000,43999,False,42,scaffold_12
0,1,342000,341999,True,43,scaffold_1
1,482001,498000,15999,False,43,scaffold_1
2,574001,643000,68999,False,43,scaffold_1
3,686001,743000,56999,False,43,scaffold_1
4,1281001,1292000,10999,False,43,scaffold_1
5,1828001,1898000,69999,False,43,scaffold_1
6,1954001,1964000,9999,False,43,scaffold_1
7,1965001,1984000,18999,False,43,scaffold_1
8,1988001,1994000,5999,False,43,scaffold_1
9,2449001,2467000,17999,False,43,scaffold_1
10,2488001,2515000,26999,False,43,scaffold_1
11,2565001,2582000,16999,False,43,scaffold_1
12,2729001,2746000,16999,False,43,scaffold_1
13,3180001,3208000,27999,False,43,scaffold_1
14,3714001,3738000,23999,False,43,scaffold_1
15,3912001,3941000,28999,False,43,scaffold_1
16,4003001,4028000,24999,False,43,scaffold_1
17,4065001,4111000,45999,False,43,scaffold_1
18,4315001,4354000,38999,False,43,scaffold_1
19,4928001,5007000,78999,False,43,scaffold_1
20,5483001,5511000,27999,False,43,scaffold_1
21,5537001,5568000,30999,False,43,scaffold_1
22,6108001,6153000,44999,False,43,scaffold_1
23,6154001,6176000,21999,False,43,scaffold_1
24,6228001,6316000,87999,False,43,scaffold_1
25,6332001,6507000,174999,False,43,scaffold_1
26,6544001,6554000,9999,False,43,scaffold_1
27,7038001,7247000,208999,False,43,scaffold_1
28,7248001,7583000,334999,False,43,scaffold_1
29,7590001,8477000,886999,False,43,scaffold_1
30,8478001,8656000,177999,False,43,scaffold_1
31,8658001,9584000,925999,False,43,scaffold_1
32,9586001,10356000,769999,False,43,scaffold_1
33,10461001,10632000,170999,False,43,scaffold_1
34,10808001,10811000,2999,False,43,scaffold_1
35,10836001,10858000,21999,False,43,scaffold_1
36,11351001,11504000,152999,False,43,scaffold_1
37,11557001,11951000,393999,False,43,scaffold_1
38,12184001,12204000,19999,False,43,scaffold_1
39,12652001,12722000,69999,False,43,scaffold_1
40,12777001,12888000,110999,False,43,scaffold_1
41,13113001,13211000,97999,False,43,scaffold_1
42,13347001,13404000,56999,False,43,scaffold_1
43,14294001,14307000,12999,False,43,scaffold_1
44,14595001,14597000,1999,False,43,scaffold_1
45,14605001,14611000,5999,False,43,scaffold_1
0,22001,48000,25999,False,43,scaffold_2
1,93001,159000,65999,False,43,scaffold_2
2,168001,177000,8999,False,43,scaffold_2
3,330001,374000,43999,False,43,scaffold_2
4,2336001,2358000,21999,False,43,scaffold_2
5,2453001,2591000,137999,False,43,scaffold_2
6,2660001,2689000,28999,False,43,scaffold_2
7,2694001,2742000,47999,False,43,scaffold_2
8,2868001,2899000,30999,False,43,scaffold_2
9,3174001,3187000,12999,False,43,scaffold_2
10,3454001,3464000,9999,False,43,scaffold_2
11,3754001,3783000,28999,False,43,scaffold_2
12,4383001,4409000,25999,False,43,scaffold_2
13,4427001,4457000,29999,False,43,scaffold_2
14,4520001,4654000,133999,False,43,scaffold_2
15,4784001,4790000,5999,False,43,scaffold_2
16,5022001,5061000,38999,False,43,scaffold_2
17,5080001,5104000,23999,False,43,scaffold_2
18,5371001,5393000,21999,False,43,scaffold_2
19,5491001,5513000,21999,False,43,scaffold_2
20,5672001,5704000,31999,False,43,scaffold_2
21,5719001,5757000,37999,False,43,scaffold_2
22,5842001,5883000,40999,False,43,scaffold_2
23,6261001,6330000,68999,False,43,scaffold_2
24,6331001,6342000,10999,False,43,scaffold_2
25,6430001,6449000,18999,False,43,scaffold_2
26,6592001,6628000,35999,False,43,scaffold_2
27,7020001,7033000,12999,False,43,scaffold_2
28,7439001,7472000,32999,False,43,scaffold_2
29,7563001,7698000,134999,False,43,scaffold_2
30,7786001,7891000,104999,False,43,scaffold_2
31,7934001,7968000,33999,False,43,scaffold_2
32,7980001,8136000,155999,False,43,scaffold_2
33,8331001,8333000,1999,False,43,scaffold_2
34,8334001,8344000,9999,False,43,scaffold_2
35,8346001,8453000,106999,False,43,scaffold_2
36,8509001,8557000,47999,False,43,scaffold_2
37,11366001,11374000,7999,False,43,scaffold_2
38,11520001,11786000,265999,False,43,scaffold_2
0,1,2000,1999,True,43,scaffold_3
1,51001,55000,3999,False,43,scaffold_3
2,799001,900000,100999,False,43,scaffold_3
3,2085001,2108000,22999,False,43,scaffold_3
4,2291001,2321000,29999,False,43,scaffold_3
5,2487001,2533000,45999,False,43,scaffold_3
6,2716001,2734000,17999,False,43,scaffold_3
7,3772001,3811000,38999,False,43,scaffold_3
8,3830001,3840000,9999,False,43,scaffold_3
9,4108001,4262000,153999,False,43,scaffold_3
10,4266001,4403000,136999,False,43,scaffold_3
11,4410001,4518000,107999,False,43,scaffold_3
12,4547001,4558000,10999,False,43,scaffold_3
13,4654001,4678000,23999,False,43,scaffold_3
14,5494001,5509000,14999,False,43,scaffold_3
15,5976001,6020000,43999,False,43,scaffold_3
16,6908001,6962000,53999,False,43,scaffold_3
17,6963001,6970000,6999,False,43,scaffold_3
18,6979001,7082000,102999,False,43,scaffold_3
19,7339001,7358000,18999,False,43,scaffold_3
20,7535001,7556000,20999,False,43,scaffold_3
21,7692001,7848000,155999,False,43,scaffold_3
22,8176001,8253000,76999,False,43,scaffold_3
23,8462001,8527000,64999,False,43,scaffold_3
24,8575001,8594000,18999,False,43,scaffold_3
25,9968001,9996000,27999,False,43,scaffold_3
26,10461001,10483000,21999,False,43,scaffold_3
27,10587001,11165000,577999,False,43,scaffold_3
0,17001,32000,14999,False,43,scaffold_4
1,48001,86000,37999,False,43,scaffold_4
2,155001,160000,4999,False,43,scaffold_4
3,161001,215000,53999,False,43,scaffold_4
4,217001,226000,8999,False,43,scaffold_4
5,227001,241000,13999,False,43,scaffold_4
6,242001,266000,23999,False,43,scaffold_4
7,291001,308000,16999,False,43,scaffold_4
8,355001,374000,18999,False,43,scaffold_4
9,375001,380000,4999,False,43,scaffold_4
10,412001,425000,12999,False,43,scaffold_4
11,429001,441000,11999,False,43,scaffold_4
12,450001,498000,47999,False,43,scaffold_4
13,545001,599000,53999,False,43,scaffold_4
14,600001,606000,5999,False,43,scaffold_4
15,608001,661000,52999,False,43,scaffold_4
16,670001,691000,20999,False,43,scaffold_4
17,701001,714000,12999,False,43,scaffold_4
18,1121001,1136000,14999,False,43,scaffold_4
19,1138001,1178000,39999,False,43,scaffold_4
20,1199001,1208000,8999,False,43,scaffold_4
21,1210001,1226000,15999,False,43,scaffold_4
22,1235001,1253000,17999,False,43,scaffold_4
23,1254001,1262000,7999,False,43,scaffold_4
24,1265001,1279000,13999,False,43,scaffold_4
25,1283001,1318000,34999,False,43,scaffold_4
26,1373001,1595000,221999,False,43,scaffold_4
27,1613001,1869000,255999,False,43,scaffold_4
28,1904001,2004000,99999,False,43,scaffold_4
29,2026001,2066000,39999,False,43,scaffold_4
30,2071001,2117000,45999,False,43,scaffold_4
31,2255001,2268000,12999,False,43,scaffold_4
32,2269001,2279000,9999,False,43,scaffold_4
33,2284001,2310000,25999,False,43,scaffold_4
34,2312001,2340000,27999,False,43,scaffold_4
35,2342001,2376000,33999,False,43,scaffold_4
36,2477001,2582000,104999,False,43,scaffold_4
37,3336001,3760000,423999,False,43,scaffold_4
38,4944001,5044000,99999,False,43,scaffold_4
39,5173001,5206000,32999,False,43,scaffold_4
40,5476001,5506000,29999,False,43,scaffold_4
41,5514001,5620000,105999,False,43,scaffold_4
42,5659001,5784000,124999,False,43,scaffold_4
43,6183001,6189000,5999,False,43,scaffold_4
44,6770001,6788000,17999,False,43,scaffold_4
45,6789001,6817000,27999,False,43,scaffold_4
46,7037001,7062000,24999,False,43,scaffold_4
47,8846001,9699000,852999,False,43,scaffold_4
48,9700001,9845951,145950,True,43,scaffold_4
0,296001,300000,3999,False,43,scaffold_5
1,318001,368000,49999,False,43,scaffold_5
2,463001,523000,59999,False,43,scaffold_5
3,669001,678000,8999,False,43,scaffold_5
4,933001,947000,13999,False,43,scaffold_5
5,2564001,2582000,17999,False,43,scaffold_5
6,2624001,2738000,113999,False,43,scaffold_5
7,2813001,2871000,57999,False,43,scaffold_5
8,3136001,3185000,48999,False,43,scaffold_5
9,3322001,3512000,189999,False,43,scaffold_5
10,3962001,4101000,138999,False,43,scaffold_5
11,4119001,4219000,99999,False,43,scaffold_5
12,4246001,4262000,15999,False,43,scaffold_5
13,4446001,4506000,59999,False,43,scaffold_5
14,4601001,4665000,63999,False,43,scaffold_5
15,4691001,4717000,25999,False,43,scaffold_5
16,4761001,4861000,99999,False,43,scaffold_5
17,4904001,4918000,13999,False,43,scaffold_5
18,5250001,5274000,23999,False,43,scaffold_5
19,5287001,5312000,24999,False,43,scaffold_5
20,5314001,5346000,31999,False,43,scaffold_5
21,6408001,6420000,11999,False,43,scaffold_5
22,6503001,6653000,149999,False,43,scaffold_5
23,7454001,7483000,28999,False,43,scaffold_5
24,7580001,7609000,28999,False,43,scaffold_5
25,7622001,7657000,34999,False,43,scaffold_5
26,8674001,8688000,13999,False,43,scaffold_5
27,8730001,9364176,634175,True,43,scaffold_5
0,79001,84000,4999,False,43,scaffold_6
1,86001,114000,27999,False,43,scaffold_6
2,241001,254000,12999,False,43,scaffold_6
3,257001,262000,4999,False,43,scaffold_6
4,267001,278000,10999,False,43,scaffold_6
5,1240001,1255000,14999,False,43,scaffold_6
6,1479001,1542000,62999,False,43,scaffold_6
7,1870001,1899000,28999,False,43,scaffold_6
8,2023001,2086000,62999,False,43,scaffold_6
9,2130001,2175000,44999,False,43,scaffold_6
10,2336001,2595000,258999,False,43,scaffold_6
11,2596001,2654000,57999,False,43,scaffold_6
12,2655001,2691000,35999,False,43,scaffold_6
13,2731001,2851000,119999,False,43,scaffold_6
14,2933001,3015000,81999,False,43,scaffold_6
15,3110001,3178000,67999,False,43,scaffold_6
16,3223001,3301000,77999,False,43,scaffold_6
17,3407001,3428000,20999,False,43,scaffold_6
18,3457001,3766000,308999,False,43,scaffold_6
19,3898001,3913000,14999,False,43,scaffold_6
20,4018001,4072000,53999,False,43,scaffold_6
21,4080001,4193000,112999,False,43,scaffold_6
22,6011001,6065000,53999,False,43,scaffold_6
23,7266001,7337000,70999,False,43,scaffold_6
24,7391001,7435000,43999,False,43,scaffold_6
25,7549001,7798000,248999,False,43,scaffold_6
26,7811001,8268281,457280,True,43,scaffold_6
0,13001,34000,20999,False,43,scaffold_7
1,323001,340000,16999,False,43,scaffold_7
2,342001,508000,165999,False,43,scaffold_7
3,554001,563000,8999,False,43,scaffold_7
4,571001,577000,5999,False,43,scaffold_7
5,706001,736000,29999,False,43,scaffold_7
6,749001,753000,3999,False,43,scaffold_7
7,764001,809000,44999,False,43,scaffold_7
8,859001,864000,4999,False,43,scaffold_7
9,868001,872000,3999,False,43,scaffold_7
10,874001,938000,63999,False,43,scaffold_7
11,968001,980000,11999,False,43,scaffold_7
12,982001,1044000,61999,False,43,scaffold_7
13,1067001,1104000,36999,False,43,scaffold_7
14,1191001,1512000,320999,False,43,scaffold_7
15,1588001,1688000,99999,False,43,scaffold_7
16,1770001,1782000,11999,False,43,scaffold_7
17,3325001,3369000,43999,False,43,scaffold_7
18,3593001,3645000,51999,False,43,scaffold_7
19,3718001,3766000,47999,False,43,scaffold_7
20,4416001,4517000,100999,False,43,scaffold_7
21,4658001,4682000,23999,False,43,scaffold_7
22,4978001,5115000,136999,False,43,scaffold_7
23,5483001,5536000,52999,False,43,scaffold_7
24,6954001,7270000,315999,False,43,scaffold_7
25,7271001,7502216,231215,True,43,scaffold_7
0,66001,85000,18999,False,43,scaffold_8
1,722001,724000,1999,False,43,scaffold_8
2,2444001,2525000,80999,False,43,scaffold_8
3,2536001,2551000,14999,False,43,scaffold_8
4,2652001,2683000,30999,False,43,scaffold_8
5,2741001,2757000,15999,False,43,scaffold_8
6,2798001,2844000,45999,False,43,scaffold_8
7,3060001,3525000,464999,False,43,scaffold_8
8,3584001,3612000,27999,False,43,scaffold_8
9,3615001,3913000,297999,False,43,scaffold_8
10,4038001,4099000,60999,False,43,scaffold_8
11,5086001,5136000,49999,False,43,scaffold_8
12,5184001,5241000,56999,False,43,scaffold_8
13,6323001,6334544,11543,True,43,scaffold_8
0,109001,117000,7999,False,43,scaffold_9
1,121001,138000,16999,False,43,scaffold_9
2,144001,148000,3999,False,43,scaffold_9
3,303001,315000,11999,False,43,scaffold_9
4,367001,411000,43999,False,43,scaffold_9
5,413001,434000,20999,False,43,scaffold_9
6,503001,531000,27999,False,43,scaffold_9
7,671001,696000,24999,False,43,scaffold_9
8,732001,742000,9999,False,43,scaffold_9
9,794001,803000,8999,False,43,scaffold_9
10,817001,841000,23999,False,43,scaffold_9
11,873001,986000,112999,False,43,scaffold_9
12,988001,995000,6999,False,43,scaffold_9
13,1001001,1007000,5999,False,43,scaffold_9
14,1010001,1031000,20999,False,43,scaffold_9
15,1038001,1085000,46999,False,43,scaffold_9
16,1087001,1150000,62999,False,43,scaffold_9
17,1151001,1162000,10999,False,43,scaffold_9
18,1313001,1377000,63999,False,43,scaffold_9
19,1600001,1618000,17999,False,43,scaffold_9
20,2598001,2616000,17999,False,43,scaffold_9
21,2739001,2759000,19999,False,43,scaffold_9
22,2769001,2803000,33999,False,43,scaffold_9
23,2874001,3381000,506999,False,43,scaffold_9
24,3383001,5099000,1715999,False,43,scaffold_9
25,5101001,5106000,4999,False,43,scaffold_9
26,5112001,5115000,2999,False,43,scaffold_9
27,5116001,5238000,121999,False,43,scaffold_9
28,5239001,5298000,58999,False,43,scaffold_9
29,5300001,5490000,189999,False,43,scaffold_9
30,5493001,6331288,838287,True,43,scaffold_9
0,1,136000,135999,True,43,scaffold_10
1,137001,201000,63999,False,43,scaffold_10
2,278001,405000,126999,False,43,scaffold_10
3,460001,482000,21999,False,43,scaffold_10
4,483001,576000,92999,False,43,scaffold_10
5,603001,746000,142999,False,43,scaffold_10
6,888001,916000,27999,False,43,scaffold_10
7,924001,962000,37999,False,43,scaffold_10
8,1073001,1105000,31999,False,43,scaffold_10
9,2140001,2167000,26999,False,43,scaffold_10
10,2273001,2297000,23999,False,43,scaffold_10
11,2346001,2368000,21999,False,43,scaffold_10
12,4054001,4091000,36999,False,43,scaffold_10
13,4154001,4174000,19999,False,43,scaffold_10
14,4444001,4457000,12999,False,43,scaffold_10
15,4503001,4513000,9999,False,43,scaffold_10
16,4515001,4523000,7999,False,43,scaffold_10
17,4526001,4548000,21999,False,43,scaffold_10
18,4576001,4596000,19999,False,43,scaffold_10
19,4681001,4688000,6999,False,43,scaffold_10
20,4734001,4766000,31999,False,43,scaffold_10
21,4769001,4776000,6999,False,43,scaffold_10
22,4798001,4824000,25999,False,43,scaffold_10
23,4828001,4843000,14999,False,43,scaffold_10
24,4848001,4861000,12999,False,43,scaffold_10
25,4865001,4866973,1972,True,43,scaffold_10
0,11001,34000,22999,False,43,scaffold_11
1,40001,92000,51999,False,43,scaffold_11
2,149001,167000,17999,False,43,scaffold_11
3,169001,191000,21999,False,43,scaffold_11
4,213001,235000,21999,False,43,scaffold_11
5,240001,248000,7999,False,43,scaffold_11
6,419001,431000,11999,False,43,scaffold_11
7,648001,656000,7999,False,43,scaffold_11
8,1025001,1034000,8999,False,43,scaffold_11
9,1474001,1477000,2999,False,43,scaffold_11
10,2701001,2876000,174999,False,43,scaffold_11
11,3086001,3135000,48999,False,43,scaffold_11
12,3217001,3283000,65999,False,43,scaffold_11
13,3331001,3383000,51999,False,43,scaffold_11
14,3558001,3576000,17999,False,43,scaffold_11
15,3702001,3928000,225999,False,43,scaffold_11
16,4009001,4056000,46999,False,43,scaffold_11
17,4134001,4156000,21999,False,43,scaffold_11
18,4289001,4710000,420999,False,43,scaffold_11
19,4713001,4766820,53819,True,43,scaffold_11
0,1,731000,730999,True,43,scaffold_12
1,739001,856000,116999,False,43,scaffold_12
2,865001,1447000,581999,False,43,scaffold_12
3,1720001,1733000,12999,False,43,scaffold_12
4,2571001,2609000,37999,False,43,scaffold_12
5,2685001,2699000,13999,False,43,scaffold_12
6,2747001,2747968,967,True,43,scaffold_12
0,1,331000,330999,True,44,scaffold_1
1,482001,498000,15999,False,44,scaffold_1
2,571001,643000,71999,False,44,scaffold_1
3,686001,743000,56999,False,44,scaffold_1
4,1281001,1292000,10999,False,44,scaffold_1
5,1834001,1877000,42999,False,44,scaffold_1
6,1954001,1964000,9999,False,44,scaffold_1
7,1965001,1984000,18999,False,44,scaffold_1
8,2449001,2517000,67999,False,44,scaffold_1
9,2729001,2746000,16999,False,44,scaffold_1
10,2996001,3022000,25999,False,44,scaffold_1
11,3179001,3208000,28999,False,44,scaffold_1
12,3714001,3738000,23999,False,44,scaffold_1
13,3912001,3941000,28999,False,44,scaffold_1
14,4063001,4112000,48999,False,44,scaffold_1
15,4314001,4355000,40999,False,44,scaffold_1
16,4928001,4997000,68999,False,44,scaffold_1
17,5093001,5115000,21999,False,44,scaffold_1
18,5481001,5511000,29999,False,44,scaffold_1
19,5535001,5573000,37999,False,44,scaffold_1
20,6108001,6184000,75999,False,44,scaffold_1
21,6228001,6379000,150999,False,44,scaffold_1
22,6384001,6509000,124999,False,44,scaffold_1
23,6542001,6555000,12999,False,44,scaffold_1
24,7038001,7247000,208999,False,44,scaffold_1
25,7248001,7584000,335999,False,44,scaffold_1
26,7590001,8656000,1065999,False,44,scaffold_1
27,8658001,9584000,925999,False,44,scaffold_1
28,9586001,10361000,774999,False,44,scaffold_1
29,10461001,10639000,177999,False,44,scaffold_1
30,10739001,10755000,15999,False,44,scaffold_1
31,10808001,10811000,2999,False,44,scaffold_1
32,10841001,10856000,14999,False,44,scaffold_1
33,11016001,11029000,12999,False,44,scaffold_1
34,11347001,11504000,156999,False,44,scaffold_1
35,11616001,11963000,346999,False,44,scaffold_1
36,12184001,12204000,19999,False,44,scaffold_1
37,12667001,12722000,54999,False,44,scaffold_1
38,12775001,12888000,112999,False,44,scaffold_1
39,12968001,13001000,32999,False,44,scaffold_1
40,13113001,13212000,98999,False,44,scaffold_1
41,13347001,13403000,55999,False,44,scaffold_1
42,14289001,14313000,23999,False,44,scaffold_1
0,22001,48000,25999,False,44,scaffold_2
1,93001,159000,65999,False,44,scaffold_2
2,168001,176000,7999,False,44,scaffold_2
3,300001,318000,17999,False,44,scaffold_2
4,332001,374000,41999,False,44,scaffold_2
5,2336001,2358000,21999,False,44,scaffold_2
6,2404001,2424000,19999,False,44,scaffold_2
7,2441001,2552000,110999,False,44,scaffold_2
8,2627001,2639000,11999,False,44,scaffold_2
9,2645001,2689000,43999,False,44,scaffold_2
10,2693001,2746000,52999,False,44,scaffold_2
11,2777001,2788000,10999,False,44,scaffold_2
12,2976001,3011000,34999,False,44,scaffold_2
13,3450001,3465000,14999,False,44,scaffold_2
14,3754001,3787000,32999,False,44,scaffold_2
15,4386001,4409000,22999,False,44,scaffold_2
16,4429001,4457000,27999,False,44,scaffold_2
17,4521001,4655000,133999,False,44,scaffold_2
18,4916001,4937000,20999,False,44,scaffold_2
19,5021001,5031000,9999,False,44,scaffold_2
20,5033001,5104000,70999,False,44,scaffold_2
21,5491001,5515000,23999,False,44,scaffold_2
22,5667001,5704000,36999,False,44,scaffold_2
23,5720001,5761000,40999,False,44,scaffold_2
24,6261001,6330000,68999,False,44,scaffold_2
25,6331001,6350000,18999,False,44,scaffold_2
26,6396001,6449000,52999,False,44,scaffold_2
27,6576001,6628000,51999,False,44,scaffold_2
28,7017001,7036000,18999,False,44,scaffold_2
29,7064001,7098000,33999,False,44,scaffold_2
30,7439001,7473000,33999,False,44,scaffold_2
31,7493001,7499000,5999,False,44,scaffold_2
32,7563001,7697000,133999,False,44,scaffold_2
33,7786001,7891000,104999,False,44,scaffold_2
34,7934001,8161000,226999,False,44,scaffold_2
35,8264001,8294000,29999,False,44,scaffold_2
36,8346001,8389000,42999,False,44,scaffold_2
37,8436001,8453000,16999,False,44,scaffold_2
38,8506001,8557000,50999,False,44,scaffold_2
39,9140001,9168000,27999,False,44,scaffold_2
40,11367001,11373000,5999,False,44,scaffold_2
41,11520001,11786000,265999,False,44,scaffold_2
0,51001,54000,2999,False,44,scaffold_3
1,528001,539000,10999,False,44,scaffold_3
2,618001,646000,27999,False,44,scaffold_3
3,798001,900000,101999,False,44,scaffold_3
4,2041001,2108000,66999,False,44,scaffold_3
5,2291001,2321000,29999,False,44,scaffold_3
6,2491001,2533000,41999,False,44,scaffold_3
7,2718001,2731000,12999,False,44,scaffold_3
8,3771001,3820000,48999,False,44,scaffold_3
9,3822001,3888000,65999,False,44,scaffold_3
10,4111001,4397000,285999,False,44,scaffold_3
11,4415001,4518000,102999,False,44,scaffold_3
12,4547001,4558000,10999,False,44,scaffold_3
13,4637001,4684000,46999,False,44,scaffold_3
14,5494001,5509000,14999,False,44,scaffold_3
15,5990001,6020000,29999,False,44,scaffold_3
16,6910001,6962000,51999,False,44,scaffold_3
17,6963001,7096000,132999,False,44,scaffold_3
18,7449001,7458000,8999,False,44,scaffold_3
19,7521001,7556000,34999,False,44,scaffold_3
20,7691001,7728000,36999,False,44,scaffold_3
21,7770001,7838000,67999,False,44,scaffold_3
22,8055001,8065000,9999,False,44,scaffold_3
23,8092001,8116000,23999,False,44,scaffold_3
24,8175001,8255000,79999,False,44,scaffold_3
25,8462001,8527000,64999,False,44,scaffold_3
26,8575001,8594000,18999,False,44,scaffold_3
27,9968001,9995000,26999,False,44,scaffold_3
28,10584001,11165000,580999,False,44,scaffold_3
0,12001,13000,999,False,44,scaffold_4
1,17001,32000,14999,False,44,scaffold_4
2,48001,88000,39999,False,44,scaffold_4
3,136001,146000,9999,False,44,scaffold_4
4,147001,151000,3999,False,44,scaffold_4
5,155001,160000,4999,False,44,scaffold_4
6,161001,216000,54999,False,44,scaffold_4
7,218001,226000,7999,False,44,scaffold_4
8,227001,267000,39999,False,44,scaffold_4
9,293001,353000,59999,False,44,scaffold_4
10,355001,374000,18999,False,44,scaffold_4
11,375001,380000,4999,False,44,scaffold_4
12,412001,425000,12999,False,44,scaffold_4
13,429001,500000,70999,False,44,scaffold_4
14,542001,592000,49999,False,44,scaffold_4
15,608001,660000,51999,False,44,scaffold_4
16,672001,691000,18999,False,44,scaffold_4
17,695001,697000,1999,False,44,scaffold_4
18,701001,715000,13999,False,44,scaffold_4
19,1098001,1110000,11999,False,44,scaffold_4
20,1112001,1198000,85999,False,44,scaffold_4
21,1199001,1226000,26999,False,44,scaffold_4
22,1239001,1253000,13999,False,44,scaffold_4
23,1272001,1279000,6999,False,44,scaffold_4
24,1283001,1336000,52999,False,44,scaffold_4
25,1356001,1594000,237999,False,44,scaffold_4
26,1613001,1849000,235999,False,44,scaffold_4
27,1850001,2066000,215999,False,44,scaffold_4
28,2071001,2096000,24999,False,44,scaffold_4
29,2247001,2281000,33999,False,44,scaffold_4
30,2282001,2370000,87999,False,44,scaffold_4
31,2391001,2461000,69999,False,44,scaffold_4
32,2476001,2577000,100999,False,44,scaffold_4
33,2597001,2635000,37999,False,44,scaffold_4
34,3095001,3126000,30999,False,44,scaffold_4
35,3335001,3760000,424999,False,44,scaffold_4
36,4944001,5000000,55999,False,44,scaffold_4
37,5175001,5222000,46999,False,44,scaffold_4
38,5477001,5506000,28999,False,44,scaffold_4
39,5514001,5620000,105999,False,44,scaffold_4
40,5669001,5784000,114999,False,44,scaffold_4
41,6145001,6191000,45999,False,44,scaffold_4
42,6901001,6924000,22999,False,44,scaffold_4
43,7036001,7081000,44999,False,44,scaffold_4
44,7089001,7092000,2999,False,44,scaffold_4
45,7112001,7124000,11999,False,44,scaffold_4
46,8846001,9699000,852999,False,44,scaffold_4
47,9700001,9845951,145950,True,44,scaffold_4
0,319001,384000,64999,False,44,scaffold_5
1,445001,525000,79999,False,44,scaffold_5
2,933001,947000,13999,False,44,scaffold_5
3,2562001,2581000,18999,False,44,scaffold_5
4,2620001,2738000,117999,False,44,scaffold_5
5,2814001,2876000,61999,False,44,scaffold_5
6,3133001,3187000,53999,False,44,scaffold_5
7,3321001,3511000,189999,False,44,scaffold_5
8,3962001,4101000,138999,False,44,scaffold_5
9,4121001,4222000,100999,False,44,scaffold_5
10,4246001,4265000,18999,False,44,scaffold_5
11,4446001,4488000,41999,False,44,scaffold_5
12,4601001,4649000,47999,False,44,scaffold_5
13,4691001,4720000,28999,False,44,scaffold_5
14,4761001,4862000,100999,False,44,scaffold_5
15,4904001,4918000,13999,False,44,scaffold_5
16,5288001,5346000,57999,False,44,scaffold_5
17,6410001,6420000,9999,False,44,scaffold_5
18,6473001,6652000,178999,False,44,scaffold_5
19,7454001,7485000,30999,False,44,scaffold_5
20,7580001,7609000,28999,False,44,scaffold_5
21,8258001,8266000,7999,False,44,scaffold_5
22,8554001,8616000,61999,False,44,scaffold_5
23,8730001,9364176,634175,True,44,scaffold_5
0,79001,84000,4999,False,44,scaffold_6
1,86001,113000,26999,False,44,scaffold_6
2,164001,208000,43999,False,44,scaffold_6
3,1236001,1258000,21999,False,44,scaffold_6
4,1480001,1546000,65999,False,44,scaffold_6
5,1864001,1906000,41999,False,44,scaffold_6
6,2005001,2019000,13999,False,44,scaffold_6
7,2023001,2087000,63999,False,44,scaffold_6
8,2130001,2180000,49999,False,44,scaffold_6
9,2237001,2284000,46999,False,44,scaffold_6
10,2337001,2653000,315999,False,44,scaffold_6
11,2661001,2872000,210999,False,44,scaffold_6
12,2934001,3014000,79999,False,44,scaffold_6
13,3115001,3150000,34999,False,44,scaffold_6
14,3223001,3314000,90999,False,44,scaffold_6
15,3404001,3786000,381999,False,44,scaffold_6
16,3897001,3913000,15999,False,44,scaffold_6
17,4018001,4072000,53999,False,44,scaffold_6
18,4080001,4192000,111999,False,44,scaffold_6
19,6011001,6082000,70999,False,44,scaffold_6
20,7263001,7338000,74999,False,44,scaffold_6
21,7394001,7413000,18999,False,44,scaffold_6
22,7550001,7798000,247999,False,44,scaffold_6
23,7811001,8268281,457280,True,44,scaffold_6
0,14001,31000,16999,False,44,scaffold_7
1,323001,341000,17999,False,44,scaffold_7
2,342001,508000,165999,False,44,scaffold_7
3,706001,736000,29999,False,44,scaffold_7
4,764001,820000,55999,False,44,scaffold_7
5,859001,864000,4999,False,44,scaffold_7
6,968001,979000,10999,False,44,scaffold_7
7,982001,1044000,61999,False,44,scaffold_7
8,1048001,1098000,49999,False,44,scaffold_7
9,1170001,1187000,16999,False,44,scaffold_7
10,1191001,1512000,320999,False,44,scaffold_7
11,1588001,1688000,99999,False,44,scaffold_7
12,3325001,3370000,44999,False,44,scaffold_7
13,3522001,3550000,27999,False,44,scaffold_7
14,3593001,3766000,172999,False,44,scaffold_7
15,4324001,4360000,35999,False,44,scaffold_7
16,4415001,4517000,101999,False,44,scaffold_7
17,4658001,4682000,23999,False,44,scaffold_7
18,4777001,4819000,41999,False,44,scaffold_7
19,4978001,5149000,170999,False,44,scaffold_7
20,5483001,5534000,50999,False,44,scaffold_7
21,6954001,7502216,548215,True,44,scaffold_7
0,67001,85000,17999,False,44,scaffold_8
1,93001,102000,8999,False,44,scaffold_8
2,299001,304000,4999,False,44,scaffold_8
3,722001,724000,1999,False,44,scaffold_8
4,2443001,2470000,26999,False,44,scaffold_8
5,2492001,2528000,35999,False,44,scaffold_8
6,2536001,2551000,14999,False,44,scaffold_8
7,2652001,2691000,38999,False,44,scaffold_8
8,2742001,2756000,13999,False,44,scaffold_8
9,2808001,2844000,35999,False,44,scaffold_8
10,3060001,3525000,464999,False,44,scaffold_8
11,3584001,3614000,29999,False,44,scaffold_8
12,3615001,3937000,321999,False,44,scaffold_8
13,4061001,4103000,41999,False,44,scaffold_8
14,5104001,5136000,31999,False,44,scaffold_8
15,5198001,5241000,42999,False,44,scaffold_8
16,6329001,6334544,5543,True,44,scaffold_8
0,1001,19000,17999,False,44,scaffold_9
1,109001,117000,7999,False,44,scaffold_9
2,121001,138000,16999,False,44,scaffold_9
3,366001,411000,44999,False,44,scaffold_9
4,413001,434000,20999,False,44,scaffold_9
5,436001,441000,4999,False,44,scaffold_9
6,484001,531000,46999,False,44,scaffold_9
7,652001,665000,12999,False,44,scaffold_9
8,671001,697000,25999,False,44,scaffold_9
9,732001,741000,8999,False,44,scaffold_9
10,817001,842000,24999,False,44,scaffold_9
11,873001,986000,112999,False,44,scaffold_9
12,988001,995000,6999,False,44,scaffold_9
13,1001001,1007000,5999,False,44,scaffold_9
14,1009001,1085000,75999,False,44,scaffold_9
15,1087001,1166000,78999,False,44,scaffold_9
16,1312001,1377000,64999,False,44,scaffold_9
17,1766001,1791000,24999,False,44,scaffold_9
18,2601001,2618000,16999,False,44,scaffold_9
19,2738001,2756000,17999,False,44,scaffold_9
20,2845001,3381000,535999,False,44,scaffold_9
21,3383001,5107000,1723999,False,44,scaffold_9
22,5112001,5238000,125999,False,44,scaffold_9
23,5239001,5298000,58999,False,44,scaffold_9
24,5299001,5490000,190999,False,44,scaffold_9
25,5492001,6331288,839287,True,44,scaffold_9
0,1,229000,228999,True,44,scaffold_10
1,339001,414000,74999,False,44,scaffold_10
2,472001,482000,9999,False,44,scaffold_10
3,483001,580000,96999,False,44,scaffold_10
4,602001,757000,154999,False,44,scaffold_10
5,783001,794000,10999,False,44,scaffold_10
6,888001,921000,32999,False,44,scaffold_10
7,923001,963000,39999,False,44,scaffold_10
8,1087001,1145000,57999,False,44,scaffold_10
9,2091001,2100000,8999,False,44,scaffold_10
10,2346001,2368000,21999,False,44,scaffold_10
11,4051001,4093000,41999,False,44,scaffold_10
12,4155001,4174000,18999,False,44,scaffold_10
13,4335001,4359000,23999,False,44,scaffold_10
14,4443001,4462000,18999,False,44,scaffold_10
15,4467001,4502000,34999,False,44,scaffold_10
16,4503001,4513000,9999,False,44,scaffold_10
17,4515001,4523000,7999,False,44,scaffold_10
18,4526001,4548000,21999,False,44,scaffold_10
19,4553001,4562000,8999,False,44,scaffold_10
20,4575001,4596000,20999,False,44,scaffold_10
21,4679001,4688000,8999,False,44,scaffold_10
22,4716001,4732000,15999,False,44,scaffold_10
23,4734001,4766000,31999,False,44,scaffold_10
24,4769001,4776000,6999,False,44,scaffold_10
25,4798001,4824000,25999,False,44,scaffold_10
26,4828001,4843000,14999,False,44,scaffold_10
27,4848001,4861000,12999,False,44,scaffold_10
28,4865001,4866973,1972,True,44,scaffold_10
0,10001,90000,79999,False,44,scaffold_11
1,132001,168000,35999,False,44,scaffold_11
2,169001,191000,21999,False,44,scaffold_11
3,214001,235000,20999,False,44,scaffold_11
4,240001,250000,9999,False,44,scaffold_11
5,301001,306000,4999,False,44,scaffold_11
6,419001,431000,11999,False,44,scaffold_11
7,648001,656000,7999,False,44,scaffold_11
8,781001,785000,3999,False,44,scaffold_11
9,1025001,1034000,8999,False,44,scaffold_11
10,1474001,1477000,2999,False,44,scaffold_11
11,2701001,2867000,165999,False,44,scaffold_11
12,2983001,3018000,34999,False,44,scaffold_11
13,3084001,3159000,74999,False,44,scaffold_11
14,3188001,3283000,94999,False,44,scaffold_11
15,3328001,3381000,52999,False,44,scaffold_11
16,3702001,3926000,223999,False,44,scaffold_11
17,4135001,4148000,12999,False,44,scaffold_11
18,4321001,4710000,388999,False,44,scaffold_11
19,4713001,4766820,53819,True,44,scaffold_11
0,1,434000,433999,True,44,scaffold_12
1,472001,537000,64999,False,44,scaffold_12
2,582001,857000,274999,False,44,scaffold_12
3,865001,1469000,603999,False,44,scaffold_12
4,1720001,1733000,12999,False,44,scaffold_12
5,2571001,2610000,38999,False,44,scaffold_12
0,1,340000,339999,True,45,scaffold_1
1,482001,498000,15999,False,45,scaffold_1
2,574001,643000,68999,False,45,scaffold_1
3,686001,743000,56999,False,45,scaffold_1
4,1281001,1292000,10999,False,45,scaffold_1
5,1828001,1898000,69999,False,45,scaffold_1
6,1954001,1964000,9999,False,45,scaffold_1
7,1965001,1984000,18999,False,45,scaffold_1
8,1988001,1993000,4999,False,45,scaffold_1
9,2449001,2517000,67999,False,45,scaffold_1
10,2729001,2746000,16999,False,45,scaffold_1
11,3179001,3208000,28999,False,45,scaffold_1
12,3715001,3733000,17999,False,45,scaffold_1
13,3916001,3941000,24999,False,45,scaffold_1
14,4062001,4111000,48999,False,45,scaffold_1
15,4322001,4355000,32999,False,45,scaffold_1
16,4928001,4997000,68999,False,45,scaffold_1
17,5481001,5511000,29999,False,45,scaffold_1
18,6108001,6153000,44999,False,45,scaffold_1
19,6154001,6176000,21999,False,45,scaffold_1
20,6228001,6381000,152999,False,45,scaffold_1
21,6384001,6507000,122999,False,45,scaffold_1
22,6545001,6554000,8999,False,45,scaffold_1
23,7038001,7247000,208999,False,45,scaffold_1
24,7248001,7584000,335999,False,45,scaffold_1
25,7590001,8656000,1065999,False,45,scaffold_1
26,8658001,9584000,925999,False,45,scaffold_1
27,9586001,10355000,768999,False,45,scaffold_1
28,10461001,10616000,154999,False,45,scaffold_1
29,10808001,10811000,2999,False,45,scaffold_1
30,10835001,10858000,22999,False,45,scaffold_1
31,11346001,11508000,161999,False,45,scaffold_1
32,11611001,11951000,339999,False,45,scaffold_1
33,12184001,12204000,19999,False,45,scaffold_1
34,12670001,12722000,51999,False,45,scaffold_1
35,12777001,12888000,110999,False,45,scaffold_1
36,13113001,13211000,97999,False,45,scaffold_1
37,13347001,13404000,56999,False,45,scaffold_1
0,22001,48000,25999,False,45,scaffold_2
1,93001,159000,65999,False,45,scaffold_2
2,168001,176000,7999,False,45,scaffold_2
3,330001,374000,43999,False,45,scaffold_2
4,2336001,2358000,21999,False,45,scaffold_2
5,2405001,2424000,18999,False,45,scaffold_2
6,2441001,2553000,111999,False,45,scaffold_2
7,2660001,2689000,28999,False,45,scaffold_2
8,2694001,2745000,50999,False,45,scaffold_2
9,2995001,3010000,14999,False,45,scaffold_2
10,3174001,3184000,9999,False,45,scaffold_2
11,3454001,3464000,9999,False,45,scaffold_2
12,3754001,3783000,28999,False,45,scaffold_2
13,4383001,4409000,25999,False,45,scaffold_2
14,4429001,4456000,26999,False,45,scaffold_2
15,4521001,4554000,32999,False,45,scaffold_2
16,4608001,4655000,46999,False,45,scaffold_2
17,5022001,5031000,8999,False,45,scaffold_2
18,5033001,5061000,27999,False,45,scaffold_2
19,5491001,5511000,19999,False,45,scaffold_2
20,5672001,5704000,31999,False,45,scaffold_2
21,6261001,6330000,68999,False,45,scaffold_2
22,6331001,6349000,17999,False,45,scaffold_2
23,7006001,7037000,30999,False,45,scaffold_2
24,7439001,7472000,32999,False,45,scaffold_2
25,7563001,7697000,133999,False,45,scaffold_2
26,7786001,7890000,103999,False,45,scaffold_2
27,7934001,8160000,225999,False,45,scaffold_2
28,8331001,8333000,1999,False,45,scaffold_2
29,8346001,8389000,42999,False,45,scaffold_2
30,8510001,8559000,48999,False,45,scaffold_2
31,11366001,11374000,7999,False,45,scaffold_2
32,11520001,11785000,264999,False,45,scaffold_2
0,51001,55000,3999,False,45,scaffold_3
1,796001,901000,104999,False,45,scaffold_3
2,2084001,2108000,23999,False,45,scaffold_3
3,2291001,2321000,29999,False,45,scaffold_3
4,2487001,2533000,45999,False,45,scaffold_3
5,4150001,4403000,252999,False,45,scaffold_3
6,4410001,4518000,107999,False,45,scaffold_3
7,4547001,4558000,10999,False,45,scaffold_3
8,4653001,4678000,24999,False,45,scaffold_3
9,6908001,6962000,53999,False,45,scaffold_3
10,6979001,7046000,66999,False,45,scaffold_3
11,7540001,7556000,15999,False,45,scaffold_3
12,7692001,7797000,104999,False,45,scaffold_3
13,7822001,7839000,16999,False,45,scaffold_3
14,8176001,8253000,76999,False,45,scaffold_3
15,8462001,8527000,64999,False,45,scaffold_3
16,8575001,8594000,18999,False,45,scaffold_3
17,9968001,9995000,26999,False,45,scaffold_3
18,10461001,10483000,21999,False,45,scaffold_3
19,10587001,11163000,575999,False,45,scaffold_3
0,17001,32000,14999,False,45,scaffold_4
1,48001,88000,39999,False,45,scaffold_4
2,147001,151000,3999,False,45,scaffold_4
3,155001,160000,4999,False,45,scaffold_4
4,161001,215000,53999,False,45,scaffold_4
5,217001,226000,8999,False,45,scaffold_4
6,227001,241000,13999,False,45,scaffold_4
7,242001,266000,23999,False,45,scaffold_4
8,317001,344000,26999,False,45,scaffold_4
9,355001,374000,18999,False,45,scaffold_4
10,375001,380000,4999,False,45,scaffold_4
11,412001,425000,12999,False,45,scaffold_4
12,429001,498000,68999,False,45,scaffold_4
13,546001,592000,45999,False,45,scaffold_4
14,600001,606000,5999,False,45,scaffold_4
15,608001,659000,50999,False,45,scaffold_4
16,670001,691000,20999,False,45,scaffold_4
17,695001,697000,1999,False,45,scaffold_4
18,701001,714000,12999,False,45,scaffold_4
19,1121001,1136000,14999,False,45,scaffold_4
20,1137001,1179000,41999,False,45,scaffold_4
21,1199001,1226000,26999,False,45,scaffold_4
22,1284001,1337000,52999,False,45,scaffold_4
23,1372001,1594000,221999,False,45,scaffold_4
24,1613001,1715000,101999,False,45,scaffold_4
25,1729001,1957000,227999,False,45,scaffold_4
26,1958001,2005000,46999,False,45,scaffold_4
27,2016001,2097000,80999,False,45,scaffold_4
28,2269001,2279000,9999,False,45,scaffold_4
29,2283001,2310000,26999,False,45,scaffold_4
30,2312001,2339000,26999,False,45,scaffold_4
31,2477001,2581000,103999,False,45,scaffold_4
32,3336001,3633000,296999,False,45,scaffold_4
33,3676001,3761000,84999,False,45,scaffold_4
34,4944001,4985000,40999,False,45,scaffold_4
35,5477001,5506000,28999,False,45,scaffold_4
36,5514001,5620000,105999,False,45,scaffold_4
37,5662001,5784000,121999,False,45,scaffold_4
38,6805001,6817000,11999,False,45,scaffold_4
39,7037001,7062000,24999,False,45,scaffold_4
40,8846001,9699000,852999,False,45,scaffold_4
41,9700001,9845951,145950,True,45,scaffold_4
0,318001,326000,7999,False,45,scaffold_5
1,327001,368000,40999,False,45,scaffold_5
2,466001,485000,18999,False,45,scaffold_5
3,495001,524000,28999,False,45,scaffold_5
4,933001,947000,13999,False,45,scaffold_5
5,2565001,2581000,15999,False,45,scaffold_5
6,2619001,2733000,113999,False,45,scaffold_5
7,2816001,2871000,54999,False,45,scaffold_5
8,3138001,3185000,46999,False,45,scaffold_5
9,3322001,3500000,177999,False,45,scaffold_5
10,3962001,4101000,138999,False,45,scaffold_5
11,4121001,4219000,97999,False,45,scaffold_5
12,4246001,4263000,16999,False,45,scaffold_5
13,4446001,4483000,36999,False,45,scaffold_5
14,4601001,4650000,48999,False,45,scaffold_5
15,4691001,4717000,25999,False,45,scaffold_5
16,4789001,4861000,71999,False,45,scaffold_5
17,4904001,4916000,11999,False,45,scaffold_5
18,5318001,5346000,27999,False,45,scaffold_5
19,6505001,6566000,60999,False,45,scaffold_5
20,7581001,7619000,37999,False,45,scaffold_5
21,7622001,7652000,29999,False,45,scaffold_5
22,8574001,8595000,20999,False,45,scaffold_5
23,8730001,9363000,632999,False,45,scaffold_5
0,79001,84000,4999,False,45,scaffold_6
1,86001,112000,25999,False,45,scaffold_6
2,239001,254000,14999,False,45,scaffold_6
3,256001,262000,5999,False,45,scaffold_6
4,267001,278000,10999,False,45,scaffold_6
5,1240001,1255000,14999,False,45,scaffold_6
6,1479001,1546000,66999,False,45,scaffold_6
7,1869001,1906000,36999,False,45,scaffold_6
8,2023001,2087000,63999,False,45,scaffold_6
9,2131001,2168000,36999,False,45,scaffold_6
10,2363001,2595000,231999,False,45,scaffold_6
11,2596001,2653000,56999,False,45,scaffold_6
12,2661001,2691000,29999,False,45,scaffold_6
13,2712001,2851000,138999,False,45,scaffold_6
14,2928001,2931000,2999,False,45,scaffold_6
15,2933001,3014000,80999,False,45,scaffold_6
16,3115001,3149000,33999,False,45,scaffold_6
17,3224001,3301000,76999,False,45,scaffold_6
18,3407001,3428000,20999,False,45,scaffold_6
19,3462001,3765000,302999,False,45,scaffold_6
20,3901001,3912000,10999,False,45,scaffold_6
21,4018001,4066000,47999,False,45,scaffold_6
22,4080001,4192000,111999,False,45,scaffold_6
23,6010001,6061000,50999,False,45,scaffold_6
24,7269001,7337000,67999,False,45,scaffold_6
25,7562001,7796000,233999,False,45,scaffold_6
26,7811001,8268281,457280,True,45,scaffold_6
0,1,7000,6999,True,45,scaffold_7
1,13001,34000,20999,False,45,scaffold_7
2,232001,235000,2999,False,45,scaffold_7
3,323001,340000,16999,False,45,scaffold_7
4,342001,508000,165999,False,45,scaffold_7
5,554001,563000,8999,False,45,scaffold_7
6,571001,577000,5999,False,45,scaffold_7
7,706001,736000,29999,False,45,scaffold_7
8,741001,753000,11999,False,45,scaffold_7
9,764001,809000,44999,False,45,scaffold_7
10,859001,864000,4999,False,45,scaffold_7
11,964001,966000,1999,False,45,scaffold_7
12,982001,1044000,61999,False,45,scaffold_7
13,1048001,1096000,47999,False,45,scaffold_7
14,1203001,1460000,256999,False,45,scaffold_7
15,1461001,1512000,50999,False,45,scaffold_7
16,1588001,1695000,106999,False,45,scaffold_7
17,3326001,3369000,42999,False,45,scaffold_7
18,3595001,3649000,53999,False,45,scaffold_7
19,4416001,4517000,100999,False,45,scaffold_7
20,4658001,4682000,23999,False,45,scaffold_7
21,4979001,5113000,133999,False,45,scaffold_7
22,5484001,5516000,31999,False,45,scaffold_7
23,5520001,5535000,14999,False,45,scaffold_7
24,6955001,7270000,314999,False,45,scaffold_7
25,7271001,7502216,231215,True,45,scaffold_7
0,67001,85000,17999,False,45,scaffold_8
1,93001,101000,7999,False,45,scaffold_8
2,2446001,2469000,22999,False,45,scaffold_8
3,2662001,2683000,20999,False,45,scaffold_8
4,2743001,2756000,12999,False,45,scaffold_8
5,2809001,2844000,34999,False,45,scaffold_8
6,3060001,3525000,464999,False,45,scaffold_8
7,3584001,3612000,27999,False,45,scaffold_8
8,3615001,3913000,297999,False,45,scaffold_8
9,4059001,4100000,40999,False,45,scaffold_8
10,5098001,5136000,37999,False,45,scaffold_8
11,5199001,5241000,41999,False,45,scaffold_8
12,6324001,6334544,10543,True,45,scaffold_8
0,109001,117000,7999,False,45,scaffold_9
1,302001,315000,12999,False,45,scaffold_9
2,319001,332000,12999,False,45,scaffold_9
3,367001,411000,43999,False,45,scaffold_9
4,413001,434000,20999,False,45,scaffold_9
5,502001,531000,28999,False,45,scaffold_9
6,670001,696000,25999,False,45,scaffold_9
7,732001,742000,9999,False,45,scaffold_9
8,794001,803000,8999,False,45,scaffold_9
9,815001,842000,26999,False,45,scaffold_9
10,873001,986000,112999,False,45,scaffold_9
11,988001,995000,6999,False,45,scaffold_9
12,1001001,1007000,5999,False,45,scaffold_9
13,1010001,1031000,20999,False,45,scaffold_9
14,1037001,1085000,47999,False,45,scaffold_9
15,1087001,1150000,62999,False,45,scaffold_9
16,1151001,1166000,14999,False,45,scaffold_9
17,1312001,1377000,64999,False,45,scaffold_9
18,1766001,1790000,23999,False,45,scaffold_9
19,2601001,2616000,14999,False,45,scaffold_9
20,2870001,3381000,510999,False,45,scaffold_9
21,3383001,5099000,1715999,False,45,scaffold_9
22,5101001,5107000,5999,False,45,scaffold_9
23,5112001,5115000,2999,False,45,scaffold_9
24,5116001,5238000,121999,False,45,scaffold_9
25,5239001,5298000,58999,False,45,scaffold_9
26,5300001,6331288,1031287,True,45,scaffold_9
0,1,199000,198999,True,45,scaffold_10
1,375001,414000,38999,False,45,scaffold_10
2,472001,482000,9999,False,45,scaffold_10
3,483001,576000,92999,False,45,scaffold_10
4,603001,749000,145999,False,45,scaffold_10
5,888001,917000,28999,False,45,scaffold_10
6,923001,962000,38999,False,45,scaffold_10
7,1087001,1105000,17999,False,45,scaffold_10
8,2141001,2167000,25999,False,45,scaffold_10
9,2273001,2298000,24999,False,45,scaffold_10
10,2349001,2367000,17999,False,45,scaffold_10
11,4053001,4091000,37999,False,45,scaffold_10
12,4154001,4174000,19999,False,45,scaffold_10
13,4515001,4523000,7999,False,45,scaffold_10
14,4526001,4548000,21999,False,45,scaffold_10
15,4576001,4595000,18999,False,45,scaffold_10
16,4681001,4688000,6999,False,45,scaffold_10
17,4734001,4766000,31999,False,45,scaffold_10
18,4769001,4776000,6999,False,45,scaffold_10
19,4798001,4824000,25999,False,45,scaffold_10
20,4828001,4843000,14999,False,45,scaffold_10
21,4848001,4861000,12999,False,45,scaffold_10
22,4865001,4866973,1972,True,45,scaffold_10
0,10001,34000,23999,False,45,scaffold_11
1,40001,93000,52999,False,45,scaffold_11
2,149001,167000,17999,False,45,scaffold_11
3,169001,191000,21999,False,45,scaffold_11
4,214001,235000,20999,False,45,scaffold_11
5,240001,248000,7999,False,45,scaffold_11
6,296001,312000,15999,False,45,scaffold_11
7,419001,431000,11999,False,45,scaffold_11
8,648001,656000,7999,False,45,scaffold_11
9,992001,994000,1999,False,45,scaffold_11
10,1025001,1034000,8999,False,45,scaffold_11
11,1423001,1426000,2999,False,45,scaffold_11
12,2701001,2873000,171999,False,45,scaffold_11
13,3213001,3259000,45999,False,45,scaffold_11
14,3331001,3383000,51999,False,45,scaffold_11
15,3702001,3928000,225999,False,45,scaffold_11
16,4320001,4710000,389999,False,45,scaffold_11
17,4713001,4766820,53819,True,45,scaffold_11
0,1,241000,240999,True,45,scaffold_12
1,250001,370000,119999,False,45,scaffold_12
2,474001,537000,62999,False,45,scaffold_12
3,582001,731000,148999,False,45,scaffold_12
4,739001,856000,116999,False,45,scaffold_12
5,865001,1430000,564999,False,45,scaffold_12
6,1720001,1733000,12999,False,45,scaffold_12
7,2571001,2618000,46999,False,45,scaffold_12
8,2747001,2747968,967,True,45,scaffold_12
0,1,342000,341999,True,46,scaffold_1
1,482001,498000,15999,False,46,scaffold_1
2,571001,643000,71999,False,46,scaffold_1
3,686001,759000,72999,False,46,scaffold_1
4,1281001,1292000,10999,False,46,scaffold_1
5,1812001,1898000,85999,False,46,scaffold_1
6,1954001,1964000,9999,False,46,scaffold_1
7,1965001,1984000,18999,False,46,scaffold_1
8,2449001,2517000,67999,False,46,scaffold_1
9,2729001,2746000,16999,False,46,scaffold_1
10,2897001,2921000,23999,False,46,scaffold_1
11,3175001,3209000,33999,False,46,scaffold_1
12,3712001,3738000,25999,False,46,scaffold_1
13,3904001,3941000,36999,False,46,scaffold_1
14,3992001,4032000,39999,False,46,scaffold_1
15,4063001,4112000,48999,False,46,scaffold_1
16,4314001,4355000,40999,False,46,scaffold_1
17,4925001,4997000,71999,False,46,scaffold_1
18,5480001,5511000,30999,False,46,scaffold_1
19,5535001,5579000,43999,False,46,scaffold_1
20,5852001,5875000,22999,False,46,scaffold_1
21,6108001,6177000,68999,False,46,scaffold_1
22,6228001,6379000,150999,False,46,scaffold_1
23,6384001,6509000,124999,False,46,scaffold_1
24,6545001,6554000,8999,False,46,scaffold_1
25,7038001,7247000,208999,False,46,scaffold_1
26,7248001,7588000,339999,False,46,scaffold_1
27,7590001,8477000,886999,False,46,scaffold_1
28,8478001,8656000,177999,False,46,scaffold_1
29,8658001,9584000,925999,False,46,scaffold_1
30,9586001,10362000,775999,False,46,scaffold_1
31,10460001,10616000,155999,False,46,scaffold_1
32,10741001,10754000,12999,False,46,scaffold_1
33,10832001,10857000,24999,False,46,scaffold_1
34,10929001,10938000,8999,False,46,scaffold_1
35,11277001,11509000,231999,False,46,scaffold_1
36,11560001,11957000,396999,False,46,scaffold_1
37,12184001,12204000,19999,False,46,scaffold_1
38,12652001,12722000,69999,False,46,scaffold_1
39,12775001,12888000,112999,False,46,scaffold_1
40,12967001,13002000,34999,False,46,scaffold_1
41,13113001,13211000,97999,False,46,scaffold_1
42,13346001,13405000,58999,False,46,scaffold_1
43,13846001,13851000,4999,False,46,scaffold_1
0,22001,48000,25999,False,46,scaffold_2
1,95001,159000,63999,False,46,scaffold_2
2,168001,177000,8999,False,46,scaffold_2
3,297001,318000,20999,False,46,scaffold_2
4,333001,374000,40999,False,46,scaffold_2
5,2085001,2100000,14999,False,46,scaffold_2
6,2336001,2358000,21999,False,46,scaffold_2
7,2404001,2424000,19999,False,46,scaffold_2
8,2437001,2553000,115999,False,46,scaffold_2
9,2627001,2639000,11999,False,46,scaffold_2
10,2645001,2689000,43999,False,46,scaffold_2
11,2694001,2745000,50999,False,46,scaffold_2
12,2868001,2909000,40999,False,46,scaffold_2
13,2974001,3021000,46999,False,46,scaffold_2
14,3022001,3043000,20999,False,46,scaffold_2
15,3334001,3342000,7999,False,46,scaffold_2
16,3454001,3464000,9999,False,46,scaffold_2
17,3754001,3784000,29999,False,46,scaffold_2
18,4382001,4409000,26999,False,46,scaffold_2
19,4429001,4457000,27999,False,46,scaffold_2
20,4521001,4556000,34999,False,46,scaffold_2
21,4593001,4657000,63999,False,46,scaffold_2
22,4783001,4790000,6999,False,46,scaffold_2
23,4918001,4938000,19999,False,46,scaffold_2
24,5020001,5104000,83999,False,46,scaffold_2
25,5491001,5515000,23999,False,46,scaffold_2
26,5671001,5759000,87999,False,46,scaffold_2
27,5840001,5887000,46999,False,46,scaffold_2
28,6005001,6037000,31999,False,46,scaffold_2
29,6244001,6330000,85999,False,46,scaffold_2
30,6331001,6351000,19999,False,46,scaffold_2
31,6409001,6449000,39999,False,46,scaffold_2
32,6506001,6522000,15999,False,46,scaffold_2
33,6591001,6628000,36999,False,46,scaffold_2
34,7017001,7038000,20999,False,46,scaffold_2
35,7064001,7097000,32999,False,46,scaffold_2
36,7439001,7472000,32999,False,46,scaffold_2
37,7563001,7698000,134999,False,46,scaffold_2
38,7780001,7920000,139999,False,46,scaffold_2
39,7934001,8161000,226999,False,46,scaffold_2
40,8265001,8313000,47999,False,46,scaffold_2
41,8331001,8333000,1999,False,46,scaffold_2
42,8346001,8454000,107999,False,46,scaffold_2
43,8509001,8559000,49999,False,46,scaffold_2
44,9033001,9046000,12999,False,46,scaffold_2
45,9141001,9174000,32999,False,46,scaffold_2
46,11366001,11375000,8999,False,46,scaffold_2
47,11520001,11786000,265999,False,46,scaffold_2
0,618001,646000,27999,False,46,scaffold_3
1,799001,901000,101999,False,46,scaffold_3
2,2040001,2108000,67999,False,46,scaffold_3
3,2291001,2341000,49999,False,46,scaffold_3
4,2487001,2533000,45999,False,46,scaffold_3
5,2717001,2735000,17999,False,46,scaffold_3
6,3768001,3821000,52999,False,46,scaffold_3
7,3822001,3892000,69999,False,46,scaffold_3
8,4107001,4403000,295999,False,46,scaffold_3
9,4417001,4518000,100999,False,46,scaffold_3
10,4546001,4558000,11999,False,46,scaffold_3
11,4643001,4682000,38999,False,46,scaffold_3
12,5167001,5191000,23999,False,46,scaffold_3
13,5975001,6020000,44999,False,46,scaffold_3
14,6910001,6962000,51999,False,46,scaffold_3
15,6963001,7097000,133999,False,46,scaffold_3
16,7449001,7458000,8999,False,46,scaffold_3
17,7523001,7556000,32999,False,46,scaffold_3
18,7678001,7841000,162999,False,46,scaffold_3
19,8176001,8253000,76999,False,46,scaffold_3
20,8462001,8528000,65999,False,46,scaffold_3
21,8575001,8593000,17999,False,46,scaffold_3
22,9967001,9996000,28999,False,46,scaffold_3
23,10066001,10089000,22999,False,46,scaffold_3
24,10461001,10486000,24999,False,46,scaffold_3
25,10551001,10572000,20999,False,46,scaffold_3
26,10574001,11168000,593999,False,46,scaffold_3
0,11001,16000,4999,False,46,scaffold_4
1,17001,32000,14999,False,46,scaffold_4
2,48001,88000,39999,False,46,scaffold_4
3,132001,146000,13999,False,46,scaffold_4
4,147001,151000,3999,False,46,scaffold_4
5,155001,160000,4999,False,46,scaffold_4
6,161001,215000,53999,False,46,scaffold_4
7,217001,226000,8999,False,46,scaffold_4
8,227001,267000,39999,False,46,scaffold_4
9,290001,342000,51999,False,46,scaffold_4
10,355001,374000,18999,False,46,scaffold_4
11,375001,380000,4999,False,46,scaffold_4
12,395001,410000,14999,False,46,scaffold_4
13,412001,425000,12999,False,46,scaffold_4
14,429001,498000,68999,False,46,scaffold_4
15,542001,592000,49999,False,46,scaffold_4
16,593001,606000,12999,False,46,scaffold_4
17,608001,691000,82999,False,46,scaffold_4
18,1121001,1136000,14999,False,46,scaffold_4
19,1138001,1226000,87999,False,46,scaffold_4
20,1270001,1279000,8999,False,46,scaffold_4
21,1283001,1336000,52999,False,46,scaffold_4
22,1353001,1600000,246999,False,46,scaffold_4
23,1613001,2065000,451999,False,46,scaffold_4
24,2073001,2115000,41999,False,46,scaffold_4
25,2148001,2206000,57999,False,46,scaffold_4
26,2210001,2218000,7999,False,46,scaffold_4
27,2219001,2246000,26999,False,46,scaffold_4
28,2247001,2280000,32999,False,46,scaffold_4
29,2282001,2461000,178999,False,46,scaffold_4
30,2476001,2635000,158999,False,46,scaffold_4
31,3336001,3633000,296999,False,46,scaffold_4
32,3648001,3760000,111999,False,46,scaffold_4
33,4198001,4201000,2999,False,46,scaffold_4
34,4900001,5001000,100999,False,46,scaffold_4
35,5005001,5060000,54999,False,46,scaffold_4
36,5178001,5187000,8999,False,46,scaffold_4
37,5476001,5506000,29999,False,46,scaffold_4
38,5513001,5620000,106999,False,46,scaffold_4
39,5659001,5784000,124999,False,46,scaffold_4
40,5786001,5824000,37999,False,46,scaffold_4
41,6145001,6193000,47999,False,46,scaffold_4
42,6902001,6924000,21999,False,46,scaffold_4
43,7036001,7094000,57999,False,46,scaffold_4
44,7201001,7323000,121999,False,46,scaffold_4
45,7641001,7665000,23999,False,46,scaffold_4
46,8846001,9699000,852999,False,46,scaffold_4
47,9700001,9845951,145950,True,46,scaffold_4
0,1,4000,3999,True,46,scaffold_5
1,140001,174000,33999,False,46,scaffold_5
2,318001,385000,66999,False,46,scaffold_5
3,463001,524000,60999,False,46,scaffold_5
4,669001,697000,27999,False,46,scaffold_5
5,933001,952000,18999,False,46,scaffold_5
6,2557001,2738000,180999,False,46,scaffold_5
7,2816001,2875000,58999,False,46,scaffold_5
8,3134001,3186000,51999,False,46,scaffold_5
9,3217001,3251000,33999,False,46,scaffold_5
10,3322001,3510000,187999,False,46,scaffold_5
11,3615001,3657000,41999,False,46,scaffold_5
12,3961001,4101000,139999,False,46,scaffold_5
13,4118001,4221000,102999,False,46,scaffold_5
14,4246001,4269000,22999,False,46,scaffold_5
15,4445001,4528000,82999,False,46,scaffold_5
16,4600001,4681000,80999,False,46,scaffold_5
17,4691001,4718000,26999,False,46,scaffold_5
18,4759001,4862000,102999,False,46,scaffold_5
19,4875001,4926000,50999,False,46,scaffold_5
20,5249001,5274000,24999,False,46,scaffold_5
21,5283001,5312000,28999,False,46,scaffold_5
22,5314001,5346000,31999,False,46,scaffold_5
23,6412001,6417000,4999,False,46,scaffold_5
24,6504001,6662000,157999,False,46,scaffold_5
25,7580001,7610000,29999,False,46,scaffold_5
26,7622001,7641000,18999,False,46,scaffold_5
27,8571001,8616000,44999,False,46,scaffold_5
28,8664001,8687000,22999,False,46,scaffold_5
29,8716001,9364176,648175,True,46,scaffold_5
0,65001,74000,8999,False,46,scaffold_6
1,78001,84000,5999,False,46,scaffold_6
2,86001,112000,25999,False,46,scaffold_6
3,162001,209000,46999,False,46,scaffold_6
4,239001,255000,15999,False,46,scaffold_6
5,257001,262000,4999,False,46,scaffold_6
6,264001,283000,18999,False,46,scaffold_6
7,1237001,1256000,18999,False,46,scaffold_6
8,1479001,1547000,67999,False,46,scaffold_6
9,1562001,1597000,34999,False,46,scaffold_6
10,1843001,1847000,3999,False,46,scaffold_6
11,1855001,1901000,45999,False,46,scaffold_6
12,2023001,2088000,64999,False,46,scaffold_6
13,2130001,2191000,60999,False,46,scaffold_6
14,2242001,2283000,40999,False,46,scaffold_6
15,2348001,2595000,246999,False,46,scaffold_6
16,2596001,2654000,57999,False,46,scaffold_6
17,2656001,2873000,216999,False,46,scaffold_6
18,2933001,3015000,81999,False,46,scaffold_6
19,3091001,3173000,81999,False,46,scaffold_6
20,3223001,3301000,77999,False,46,scaffold_6
21,3398001,3431000,32999,False,46,scaffold_6
22,3448001,3795000,346999,False,46,scaffold_6
23,3900001,3913000,12999,False,46,scaffold_6
24,4018001,4193000,174999,False,46,scaffold_6
25,5939001,5969000,29999,False,46,scaffold_6
26,6010001,6083000,72999,False,46,scaffold_6
27,7262001,7339000,76999,False,46,scaffold_6
28,7389001,7436000,46999,False,46,scaffold_6
29,7550001,7798000,247999,False,46,scaffold_6
30,7811001,8268281,457280,True,46,scaffold_6
0,1,8000,7999,True,46,scaffold_7
1,13001,34000,20999,False,46,scaffold_7
2,323001,340000,16999,False,46,scaffold_7
3,342001,509000,166999,False,46,scaffold_7
4,622001,643000,20999,False,46,scaffold_7
5,646001,675000,28999,False,46,scaffold_7
6,706001,736000,29999,False,46,scaffold_7
7,740001,753000,12999,False,46,scaffold_7
8,764001,822000,57999,False,46,scaffold_7
9,859001,864000,4999,False,46,scaffold_7
10,868001,872000,3999,False,46,scaffold_7
11,877001,899000,21999,False,46,scaffold_7
12,949001,963000,13999,False,46,scaffold_7
13,964001,966000,1999,False,46,scaffold_7
14,968001,980000,11999,False,46,scaffold_7
15,982001,1044000,61999,False,46,scaffold_7
16,1048001,1122000,73999,False,46,scaffold_7
17,1171001,1184000,12999,False,46,scaffold_7
18,1191001,1512000,320999,False,46,scaffold_7
19,1588001,1688000,99999,False,46,scaffold_7
20,3304001,3370000,65999,False,46,scaffold_7
21,3526001,3551000,24999,False,46,scaffold_7
22,3592001,3766000,173999,False,46,scaffold_7
23,4326001,4369000,42999,False,46,scaffold_7
24,4416001,4518000,101999,False,46,scaffold_7
25,4658001,4737000,78999,False,46,scaffold_7
26,4978001,5149000,170999,False,46,scaffold_7
27,5483001,5536000,52999,False,46,scaffold_7
28,6955001,7270000,314999,False,46,scaffold_7
29,7271001,7502216,231215,True,46,scaffold_7
0,67001,85000,17999,False,46,scaffold_8
1,92001,102000,9999,False,46,scaffold_8
2,2444001,2552000,107999,False,46,scaffold_8
3,2661001,2683000,21999,False,46,scaffold_8
4,2741001,2759000,17999,False,46,scaffold_8
5,2798001,2844000,45999,False,46,scaffold_8
6,3038001,3553000,514999,False,46,scaffold_8
7,3581001,3612000,30999,False,46,scaffold_8
8,3615001,3944000,328999,False,46,scaffold_8
9,4036001,4108000,71999,False,46,scaffold_8
10,4400001,4433000,32999,False,46,scaffold_8
11,5104001,5137000,32999,False,46,scaffold_8
12,5182001,5241000,58999,False,46,scaffold_8
13,5580001,5595000,14999,False,46,scaffold_8
14,6327001,6334544,7543,True,46,scaffold_8
0,1,21000,20999,True,46,scaffold_9
1,109001,118000,8999,False,46,scaffold_9
2,121001,135000,13999,False,46,scaffold_9
3,303001,315000,11999,False,46,scaffold_9
4,319001,332000,12999,False,46,scaffold_9
5,366001,411000,44999,False,46,scaffold_9
6,413001,434000,20999,False,46,scaffold_9
7,501001,531000,29999,False,46,scaffold_9
8,652001,665000,12999,False,46,scaffold_9
9,671001,696000,24999,False,46,scaffold_9
10,731001,741000,9999,False,46,scaffold_9
11,814001,844000,29999,False,46,scaffold_9
12,850001,862000,11999,False,46,scaffold_9
13,872001,986000,113999,False,46,scaffold_9
14,987001,995000,7999,False,46,scaffold_9
15,1001001,1007000,5999,False,46,scaffold_9
16,1008001,1085000,76999,False,46,scaffold_9
17,1087001,1150000,62999,False,46,scaffold_9
18,1151001,1166000,14999,False,46,scaffold_9
19,1311001,1377000,65999,False,46,scaffold_9
20,1428001,1440000,11999,False,46,scaffold_9
21,1605001,1616000,10999,False,46,scaffold_9
22,1766001,1791000,24999,False,46,scaffold_9
23,1970001,1974000,3999,False,46,scaffold_9
24,2597001,2659000,61999,False,46,scaffold_9
25,2737001,2834000,96999,False,46,scaffold_9
26,2870001,3381000,510999,False,46,scaffold_9
27,3383001,5107000,1723999,False,46,scaffold_9
28,5112001,5114000,1999,False,46,scaffold_9
29,5116001,5238000,121999,False,46,scaffold_9
30,5239001,5298000,58999,False,46,scaffold_9
31,5299001,5490000,190999,False,46,scaffold_9
32,5491001,6331288,840287,True,46,scaffold_9
0,1,414000,413999,True,46,scaffold_10
1,415001,482000,66999,False,46,scaffold_10
2,483001,582000,98999,False,46,scaffold_10
3,602001,756000,153999,False,46,scaffold_10
4,783001,796000,12999,False,46,scaffold_10
5,812001,877000,64999,False,46,scaffold_10
6,888001,917000,28999,False,46,scaffold_10
7,923001,963000,39999,False,46,scaffold_10
8,1088001,1137000,48999,False,46,scaffold_10
9,2131001,2167000,35999,False,46,scaffold_10
10,2346001,2386000,39999,False,46,scaffold_10
11,3571001,3582000,10999,False,46,scaffold_10
12,4053001,4091000,37999,False,46,scaffold_10
13,4154001,4174000,19999,False,46,scaffold_10
14,4443001,4462000,18999,False,46,scaffold_10
15,4467001,4502000,34999,False,46,scaffold_10
16,4503001,4513000,9999,False,46,scaffold_10
17,4515001,4523000,7999,False,46,scaffold_10
18,4526001,4548000,21999,False,46,scaffold_10
19,4575001,4596000,20999,False,46,scaffold_10
20,4681001,4688000,6999,False,46,scaffold_10
21,4734001,4766000,31999,False,46,scaffold_10
22,4768001,4776000,7999,False,46,scaffold_10
23,4791001,4797000,5999,False,46,scaffold_10
24,4798001,4824000,25999,False,46,scaffold_10
25,4828001,4846000,17999,False,46,scaffold_10
26,4848001,4861000,12999,False,46,scaffold_10
0,11001,99000,87999,False,46,scaffold_11
1,149001,167000,17999,False,46,scaffold_11
2,169001,212000,42999,False,46,scaffold_11
3,213001,236000,22999,False,46,scaffold_11
4,240001,253000,12999,False,46,scaffold_11
5,298001,311000,12999,False,46,scaffold_11
6,419001,431000,11999,False,46,scaffold_11
7,648001,656000,7999,False,46,scaffold_11
8,1025001,1034000,8999,False,46,scaffold_11
9,1423001,1426000,2999,False,46,scaffold_11
10,1474001,1477000,2999,False,46,scaffold_11
11,2065001,2071000,5999,False,46,scaffold_11
12,2701001,2878000,176999,False,46,scaffold_11
13,2979001,3018000,38999,False,46,scaffold_11
14,3188001,3296000,107999,False,46,scaffold_11
15,3331001,3383000,51999,False,46,scaffold_11
16,3525001,3578000,52999,False,46,scaffold_11
17,3703001,3932000,228999,False,46,scaffold_11
18,4004001,4090000,85999,False,46,scaffold_11
19,4134001,4159000,24999,False,46,scaffold_11
20,4260001,4710000,449999,False,46,scaffold_11
21,4713001,4766820,53819,True,46,scaffold_11
0,1,544000,543999,True,46,scaffold_12
1,560001,857000,296999,False,46,scaffold_12
2,865001,1469000,603999,False,46,scaffold_12
3,1720001,1733000,12999,False,46,scaffold_12
4,2063001,2097000,33999,False,46,scaffold_12
5,2571001,2610000,38999,False,46,scaffold_12
0,1,342000,341999,True,47,scaffold_1
1,482001,498000,15999,False,47,scaffold_1
2,574001,643000,68999,False,47,scaffold_1
3,686001,747000,60999,False,47,scaffold_1
4,1281001,1292000,10999,False,47,scaffold_1
5,1814001,1898000,83999,False,47,scaffold_1
6,1951001,1984000,32999,False,47,scaffold_1
7,2449001,2517000,67999,False,47,scaffold_1
8,2729001,2746000,16999,False,47,scaffold_1
9,2996001,3017000,20999,False,47,scaffold_1
10,3180001,3208000,27999,False,47,scaffold_1
11,3714001,3732000,17999,False,47,scaffold_1
12,3902001,3941000,38999,False,47,scaffold_1
13,4060001,4112000,51999,False,47,scaffold_1
14,4314001,4355000,40999,False,47,scaffold_1
15,4928001,4997000,68999,False,47,scaffold_1
16,5481001,5511000,29999,False,47,scaffold_1
17,5536001,5570000,33999,False,47,scaffold_1
18,6108001,6153000,44999,False,47,scaffold_1
19,6154001,6177000,22999,False,47,scaffold_1
20,6228001,6381000,152999,False,47,scaffold_1
21,6384001,6507000,122999,False,47,scaffold_1
22,6544001,6554000,9999,False,47,scaffold_1
23,7038001,7247000,208999,False,47,scaffold_1
24,7248001,7589000,340999,False,47,scaffold_1
25,7590001,8656000,1065999,False,47,scaffold_1
26,8658001,9584000,925999,False,47,scaffold_1
27,9586001,10370000,783999,False,47,scaffold_1
28,10461001,10625000,163999,False,47,scaffold_1
29,10808001,10811000,2999,False,47,scaffold_1
30,10839001,10857000,17999,False,47,scaffold_1
31,11309001,11509000,199999,False,47,scaffold_1
32,11613001,11954000,340999,False,47,scaffold_1
33,12184001,12204000,19999,False,47,scaffold_1
34,12638001,12722000,83999,False,47,scaffold_1
35,12775001,12888000,112999,False,47,scaffold_1
36,12976001,13001000,24999,False,47,scaffold_1
37,13112001,13211000,98999,False,47,scaffold_1
38,13347001,13431000,83999,False,47,scaffold_1
39,14290001,14309000,18999,False,47,scaffold_1
40,14649001,14663000,13999,False,47,scaffold_1
0,1,48000,47999,True,47,scaffold_2
1,95001,159000,63999,False,47,scaffold_2
2,168001,177000,8999,False,47,scaffold_2
3,302001,318000,15999,False,47,scaffold_2
4,332001,374000,41999,False,47,scaffold_2
5,2336001,2358000,21999,False,47,scaffold_2
6,2404001,2424000,19999,False,47,scaffold_2
7,2437001,2553000,115999,False,47,scaffold_2
8,2660001,2689000,28999,False,47,scaffold_2
9,2694001,2746000,51999,False,47,scaffold_2
10,2868001,2899000,30999,False,47,scaffold_2
11,3174001,3186000,11999,False,47,scaffold_2
12,3454001,3464000,9999,False,47,scaffold_2
13,3754001,3783000,28999,False,47,scaffold_2
14,4385001,4409000,23999,False,47,scaffold_2
15,4521001,4654000,132999,False,47,scaffold_2
16,4783001,4790000,6999,False,47,scaffold_2
17,5020001,5064000,43999,False,47,scaffold_2
18,5285001,5303000,17999,False,47,scaffold_2
19,5463001,5464000,999,False,47,scaffold_2
20,5467001,5469000,1999,False,47,scaffold_2
21,5491001,5514000,22999,False,47,scaffold_2
22,5658001,5759000,100999,False,47,scaffold_2
23,6261001,6330000,68999,False,47,scaffold_2
24,6331001,6350000,18999,False,47,scaffold_2
25,6429001,6448000,18999,False,47,scaffold_2
26,7019001,7036000,16999,False,47,scaffold_2
27,7439001,7472000,32999,False,47,scaffold_2
28,7563001,7697000,133999,False,47,scaffold_2
29,7786001,7891000,104999,False,47,scaffold_2
30,7934001,8131000,196999,False,47,scaffold_2
31,8261001,8297000,35999,False,47,scaffold_2
32,8331001,8333000,1999,False,47,scaffold_2
33,8346001,8453000,106999,False,47,scaffold_2
34,8509001,8562000,52999,False,47,scaffold_2
35,9140001,9167000,26999,False,47,scaffold_2
36,11367001,11374000,6999,False,47,scaffold_2
37,11520001,11785000,264999,False,47,scaffold_2
0,1,2000,1999,True,47,scaffold_3
1,618001,646000,27999,False,47,scaffold_3
2,795001,900000,104999,False,47,scaffold_3
3,2012001,2108000,95999,False,47,scaffold_3
4,2291001,2321000,29999,False,47,scaffold_3
5,2487001,2531000,43999,False,47,scaffold_3
6,2716001,2735000,18999,False,47,scaffold_3
7,3826001,3890000,63999,False,47,scaffold_3
8,4108001,4398000,289999,False,47,scaffold_3
9,4416001,4518000,101999,False,47,scaffold_3
10,4547001,4558000,10999,False,47,scaffold_3
11,4646001,4686000,39999,False,47,scaffold_3
12,5976001,6020000,43999,False,47,scaffold_3
13,6759001,6778000,18999,False,47,scaffold_3
14,6910001,6962000,51999,False,47,scaffold_3
15,6963001,7080000,116999,False,47,scaffold_3
16,7451001,7458000,6999,False,47,scaffold_3
17,7522001,7556000,33999,False,47,scaffold_3
18,7692001,7839000,146999,False,47,scaffold_3
19,8175001,8253000,77999,False,47,scaffold_3
20,8429001,8447000,17999,False,47,scaffold_3
21,8462001,8527000,64999,False,47,scaffold_3
22,8575001,8594000,18999,False,47,scaffold_3
23,9968001,9996000,27999,False,47,scaffold_3
24,10461001,10483000,21999,False,47,scaffold_3
25,10587001,11167000,579999,False,47,scaffold_3
0,11001,13000,1999,False,47,scaffold_4
1,17001,32000,14999,False,47,scaffold_4
2,48001,88000,39999,False,47,scaffold_4
3,106001,115000,8999,False,47,scaffold_4
4,155001,160000,4999,False,47,scaffold_4
5,161001,215000,53999,False,47,scaffold_4
6,217001,226000,8999,False,47,scaffold_4
7,227001,266000,38999,False,47,scaffold_4
8,317001,344000,26999,False,47,scaffold_4
9,355001,374000,18999,False,47,scaffold_4
10,375001,380000,4999,False,47,scaffold_4
11,384001,410000,25999,False,47,scaffold_4
12,412001,425000,12999,False,47,scaffold_4
13,429001,498000,68999,False,47,scaffold_4
14,542001,599000,56999,False,47,scaffold_4
15,600001,606000,5999,False,47,scaffold_4
16,608001,691000,82999,False,47,scaffold_4
17,701001,727000,25999,False,47,scaffold_4
18,1113001,1136000,22999,False,47,scaffold_4
19,1137001,1208000,70999,False,47,scaffold_4
20,1210001,1226000,15999,False,47,scaffold_4
21,1235001,1253000,17999,False,47,scaffold_4
22,1254001,1261000,6999,False,47,scaffold_4
23,1270001,1279000,8999,False,47,scaffold_4
24,1283001,1336000,52999,False,47,scaffold_4
25,1367001,1598000,230999,False,47,scaffold_4
26,1613001,2129000,515999,False,47,scaffold_4
27,2247001,2280000,32999,False,47,scaffold_4
28,2283001,2352000,68999,False,47,scaffold_4
29,2391001,2461000,69999,False,47,scaffold_4
30,2476001,2582000,105999,False,47,scaffold_4
31,2597001,2635000,37999,False,47,scaffold_4
32,3335001,3633000,297999,False,47,scaffold_4
33,3654001,3660000,5999,False,47,scaffold_4
34,3675001,3760000,84999,False,47,scaffold_4
35,4943001,5000000,56999,False,47,scaffold_4
36,5477001,5506000,28999,False,47,scaffold_4
37,5515001,5620000,104999,False,47,scaffold_4
38,5661001,5784000,122999,False,47,scaffold_4
39,5786001,5811000,24999,False,47,scaffold_4
40,6147001,6197000,49999,False,47,scaffold_4
41,6898001,6924000,25999,False,47,scaffold_4
42,7036001,7062000,25999,False,47,scaffold_4
43,8845001,9699000,853999,False,47,scaffold_4
44,9700001,9845951,145950,True,47,scaffold_4
0,152001,174000,21999,False,47,scaffold_5
1,323001,326000,2999,False,47,scaffold_5
2,327001,383000,55999,False,47,scaffold_5
3,463001,523000,59999,False,47,scaffold_5
4,933001,947000,13999,False,47,scaffold_5
5,2509001,2515000,5999,False,47,scaffold_5
6,2563001,2582000,18999,False,47,scaffold_5
7,2618001,2738000,119999,False,47,scaffold_5
8,2816001,2875000,58999,False,47,scaffold_5
9,3133001,3185000,51999,False,47,scaffold_5
10,3322001,3501000,178999,False,47,scaffold_5
11,3962001,4101000,138999,False,47,scaffold_5
12,4121001,4220000,98999,False,47,scaffold_5
13,4245001,4262000,16999,False,47,scaffold_5
14,4446001,4496000,49999,False,47,scaffold_5
15,4601001,4680000,78999,False,47,scaffold_5
16,4691001,4720000,28999,False,47,scaffold_5
17,4761001,4862000,100999,False,47,scaffold_5
18,4904001,4917000,12999,False,47,scaffold_5
19,5260001,5274000,13999,False,47,scaffold_5
20,5287001,5312000,24999,False,47,scaffold_5
21,5314001,5346000,31999,False,47,scaffold_5
22,6409001,6429000,19999,False,47,scaffold_5
23,6504001,6664000,159999,False,47,scaffold_5
24,7454001,7483000,28999,False,47,scaffold_5
25,7622001,7637000,14999,False,47,scaffold_5
26,8556001,8616000,59999,False,47,scaffold_5
27,8672001,8686000,13999,False,47,scaffold_5
28,8713001,9364176,651175,True,47,scaffold_5
0,65001,75000,9999,False,47,scaffold_6
1,79001,113000,33999,False,47,scaffold_6
2,166001,209000,42999,False,47,scaffold_6
3,238001,262000,23999,False,47,scaffold_6
4,264001,283000,18999,False,47,scaffold_6
5,1236001,1264000,27999,False,47,scaffold_6
6,1479001,1547000,67999,False,47,scaffold_6
7,1867001,1906000,38999,False,47,scaffold_6
8,2026001,2088000,61999,False,47,scaffold_6
9,2130001,2194000,63999,False,47,scaffold_6
10,2340001,2595000,254999,False,47,scaffold_6
11,2596001,2653000,56999,False,47,scaffold_6
12,2661001,2691000,29999,False,47,scaffold_6
13,2712001,2852000,139999,False,47,scaffold_6
14,2937001,3014000,76999,False,47,scaffold_6
15,3115001,3149000,33999,False,47,scaffold_6
16,3224001,3305000,80999,False,47,scaffold_6
17,3407001,3428000,20999,False,47,scaffold_6
18,3457001,3787000,329999,False,47,scaffold_6
19,3900001,3913000,12999,False,47,scaffold_6
20,4018001,4072000,53999,False,47,scaffold_6
21,4073001,4195000,121999,False,47,scaffold_6
22,6010001,6062000,51999,False,47,scaffold_6
23,7258001,7339000,80999,False,47,scaffold_6
24,7541001,8268281,727280,True,47,scaffold_6
0,1,7000,6999,True,47,scaffold_7
1,13001,34000,20999,False,47,scaffold_7
2,323001,340000,16999,False,47,scaffold_7
3,342001,508000,165999,False,47,scaffold_7
4,571001,577000,5999,False,47,scaffold_7
5,657001,675000,17999,False,47,scaffold_7
6,706001,736000,29999,False,47,scaffold_7
7,764001,829000,64999,False,47,scaffold_7
8,859001,864000,4999,False,47,scaffold_7
9,868001,929000,60999,False,47,scaffold_7
10,953001,980000,26999,False,47,scaffold_7
11,982001,1044000,61999,False,47,scaffold_7
12,1048001,1099000,50999,False,47,scaffold_7
13,1191001,1460000,268999,False,47,scaffold_7
14,1461001,1512000,50999,False,47,scaffold_7
15,1588001,1690000,101999,False,47,scaffold_7
16,3296001,3370000,73999,False,47,scaffold_7
17,3531001,3550000,18999,False,47,scaffold_7
18,3589001,3766000,176999,False,47,scaffold_7
19,4415001,4517000,101999,False,47,scaffold_7
20,4658001,4682000,23999,False,47,scaffold_7
21,4978001,5114000,135999,False,47,scaffold_7
22,5483001,5535000,51999,False,47,scaffold_7
23,6955001,7502216,547215,True,47,scaffold_7
0,66001,86000,19999,False,47,scaffold_8
1,112001,116000,3999,False,47,scaffold_8
2,2444001,2471000,26999,False,47,scaffold_8
3,2490001,2533000,42999,False,47,scaffold_8
4,2536001,2552000,15999,False,47,scaffold_8
5,2648001,2683000,34999,False,47,scaffold_8
6,2745001,2756000,10999,False,47,scaffold_8
7,2799001,2844000,44999,False,47,scaffold_8
8,3057001,3525000,467999,False,47,scaffold_8
9,3584001,3612000,27999,False,47,scaffold_8
10,3615001,3915000,299999,False,47,scaffold_8
11,4400001,4430000,29999,False,47,scaffold_8
12,5124001,5135000,10999,False,47,scaffold_8
13,5199001,5241000,41999,False,47,scaffold_8
14,6324001,6334544,10543,True,47,scaffold_8
0,109001,117000,7999,False,47,scaffold_9
1,121001,140000,18999,False,47,scaffold_9
2,366001,411000,44999,False,47,scaffold_9
3,413001,434000,20999,False,47,scaffold_9
4,501001,531000,29999,False,47,scaffold_9
5,547001,563000,15999,False,47,scaffold_9
6,655001,665000,9999,False,47,scaffold_9
7,671001,696000,24999,False,47,scaffold_9
8,815001,843000,27999,False,47,scaffold_9
9,853001,862000,8999,False,47,scaffold_9
10,873001,986000,112999,False,47,scaffold_9
11,988001,995000,6999,False,47,scaffold_9
12,1002001,1007000,4999,False,47,scaffold_9
13,1008001,1085000,76999,False,47,scaffold_9
14,1087001,1160000,72999,False,47,scaffold_9
15,1311001,1383000,71999,False,47,scaffold_9
16,1599001,1620000,20999,False,47,scaffold_9
17,1767001,1790000,22999,False,47,scaffold_9
18,1987001,2028000,40999,False,47,scaffold_9
19,2599001,2621000,21999,False,47,scaffold_9
20,2738001,2758000,19999,False,47,scaffold_9
21,2781001,2832000,50999,False,47,scaffold_9
22,2870001,3381000,510999,False,47,scaffold_9
23,3383001,5107000,1723999,False,47,scaffold_9
24,5112001,5238000,125999,False,47,scaffold_9
25,5239001,5298000,58999,False,47,scaffold_9
26,5300001,5490000,189999,False,47,scaffold_9
27,5491001,6331288,840287,True,47,scaffold_9
0,1,201000,200999,True,47,scaffold_10
1,270001,482000,211999,False,47,scaffold_10
2,483001,582000,98999,False,47,scaffold_10
3,603001,756000,152999,False,47,scaffold_10
4,888001,916000,27999,False,47,scaffold_10
5,924001,963000,38999,False,47,scaffold_10
6,1073001,1112000,38999,False,47,scaffold_10
7,2088001,2102000,13999,False,47,scaffold_10
8,2143001,2166000,22999,False,47,scaffold_10
9,2346001,2368000,21999,False,47,scaffold_10
10,4050001,4091000,40999,False,47,scaffold_10
11,4154001,4174000,19999,False,47,scaffold_10
12,4467001,4513000,45999,False,47,scaffold_10
13,4527001,4548000,20999,False,47,scaffold_10
14,4574001,4596000,21999,False,47,scaffold_10
15,4681001,4688000,6999,False,47,scaffold_10
16,4716001,4732000,15999,False,47,scaffold_10
17,4734001,4766000,31999,False,47,scaffold_10
18,4768001,4776000,7999,False,47,scaffold_10
19,4798001,4824000,25999,False,47,scaffold_10
20,4828001,4846000,17999,False,47,scaffold_10
21,4848001,4861000,12999,False,47,scaffold_10
22,4862001,4866973,4972,True,47,scaffold_10
0,11001,91000,79999,False,47,scaffold_11
1,149001,167000,17999,False,47,scaffold_11
2,169001,191000,21999,False,47,scaffold_11
3,213001,236000,22999,False,47,scaffold_11
4,240001,248000,7999,False,47,scaffold_11
5,419001,431000,11999,False,47,scaffold_11
6,648001,656000,7999,False,47,scaffold_11
7,895001,897000,1999,False,47,scaffold_11
8,1025001,1034000,8999,False,47,scaffold_11
9,1360001,1372000,11999,False,47,scaffold_11
10,1474001,1477000,2999,False,47,scaffold_11
11,2700001,2874000,173999,False,47,scaffold_11
12,2983001,3011000,27999,False,47,scaffold_11
13,3093001,3120000,26999,False,47,scaffold_11
14,3185001,3295000,109999,False,47,scaffold_11
15,3331001,3383000,51999,False,47,scaffold_11
16,3702001,3929000,226999,False,47,scaffold_11
17,4134001,4159000,24999,False,47,scaffold_11
18,4262001,4710000,447999,False,47,scaffold_11
19,4713001,4766820,53819,True,47,scaffold_11
0,1,370000,369999,True,47,scaffold_12
1,473001,545000,71999,False,47,scaffold_12
2,582001,856000,273999,False,47,scaffold_12
3,865001,1471000,605999,False,47,scaffold_12
4,1719001,1733000,13999,False,47,scaffold_12
5,2067001,2087000,19999,False,47,scaffold_12
6,2571001,2609000,37999,False,47,scaffold_12
0,1,340000,339999,True,48,scaffold_1
1,482001,498000,15999,False,48,scaffold_1
2,573001,643000,69999,False,48,scaffold_1
3,686001,713000,26999,False,48,scaffold_1
4,732001,742000,9999,False,48,scaffold_1
5,1281001,1292000,10999,False,48,scaffold_1
6,1833001,1897000,63999,False,48,scaffold_1
7,1954001,1964000,9999,False,48,scaffold_1
8,1965001,1984000,18999,False,48,scaffold_1
9,2449001,2467000,17999,False,48,scaffold_1
10,2477001,2514000,36999,False,48,scaffold_1
11,2729001,2746000,16999,False,48,scaffold_1
12,3181001,3208000,26999,False,48,scaffold_1
13,3715001,3733000,17999,False,48,scaffold_1
14,3916001,3941000,24999,False,48,scaffold_1
15,4063001,4111000,47999,False,48,scaffold_1
16,4322001,4354000,31999,False,48,scaffold_1
17,4929001,4964000,34999,False,48,scaffold_1
18,4968001,4997000,28999,False,48,scaffold_1
19,5484001,5511000,26999,False,48,scaffold_1
20,5537001,5568000,30999,False,48,scaffold_1
21,6108001,6153000,44999,False,48,scaffold_1
22,6228001,6381000,152999,False,48,scaffold_1
23,6384001,6507000,122999,False,48,scaffold_1
24,6545001,6554000,8999,False,48,scaffold_1
25,7038001,7247000,208999,False,48,scaffold_1
26,7248001,7588000,339999,False,48,scaffold_1
27,7590001,8477000,886999,False,48,scaffold_1
28,8478001,8656000,177999,False,48,scaffold_1
29,8658001,9584000,925999,False,48,scaffold_1
30,9586001,10354000,767999,False,48,scaffold_1
31,10461001,10616000,154999,False,48,scaffold_1
32,10808001,10811000,2999,False,48,scaffold_1
33,10836001,10858000,21999,False,48,scaffold_1
34,11351001,11504000,152999,False,48,scaffold_1
35,11646001,11951000,304999,False,48,scaffold_1
36,12184001,12204000,19999,False,48,scaffold_1
37,12671001,12722000,50999,False,48,scaffold_1
38,12777001,12888000,110999,False,48,scaffold_1
39,13117001,13131000,13999,False,48,scaffold_1
40,13181001,13211000,29999,False,48,scaffold_1
41,13347001,13378000,30999,False,48,scaffold_1
42,14298001,14306000,7999,False,48,scaffold_1
0,22001,48000,25999,False,48,scaffold_2
1,93001,159000,65999,False,48,scaffold_2
2,168001,177000,8999,False,48,scaffold_2
3,303001,318000,14999,False,48,scaffold_2
4,331001,374000,42999,False,48,scaffold_2
5,2336001,2358000,21999,False,48,scaffold_2
6,2441001,2553000,111999,False,48,scaffold_2
7,2660001,2689000,28999,False,48,scaffold_2
8,2694001,2742000,47999,False,48,scaffold_2
9,2868001,2897000,28999,False,48,scaffold_2
10,3454001,3463000,8999,False,48,scaffold_2
11,3767001,3781000,13999,False,48,scaffold_2
12,4385001,4409000,23999,False,48,scaffold_2
13,4428001,4457000,28999,False,48,scaffold_2
14,4522001,4554000,31999,False,48,scaffold_2
15,4608001,4653000,44999,False,48,scaffold_2
16,5022001,5031000,8999,False,48,scaffold_2
17,5033001,5061000,27999,False,48,scaffold_2
18,5491001,5511000,19999,False,48,scaffold_2
19,5670001,5704000,33999,False,48,scaffold_2
20,6261001,6330000,68999,False,48,scaffold_2
21,6331001,6350000,18999,False,48,scaffold_2
22,7439001,7472000,32999,False,48,scaffold_2
23,7563001,7697000,133999,False,48,scaffold_2
24,7786001,7890000,103999,False,48,scaffold_2
25,7934001,7966000,31999,False,48,scaffold_2
26,7984001,8132000,147999,False,48,scaffold_2
27,8331001,8333000,1999,False,48,scaffold_2
28,8341001,8344000,2999,False,48,scaffold_2
29,8346001,8389000,42999,False,48,scaffold_2
30,8509001,8536000,26999,False,48,scaffold_2
31,11520001,11785000,264999,False,48,scaffold_2
0,1,2000,1999,True,48,scaffold_3
1,51001,54000,2999,False,48,scaffold_3
2,102001,104000,1999,False,48,scaffold_3
3,293001,295000,1999,False,48,scaffold_3
4,799001,900000,100999,False,48,scaffold_3
5,2085001,2107000,21999,False,48,scaffold_3
6,2291001,2321000,29999,False,48,scaffold_3
7,2488001,2533000,44999,False,48,scaffold_3
8,4150001,4397000,246999,False,48,scaffold_3
9,4418001,4518000,99999,False,48,scaffold_3
10,4547001,4558000,10999,False,48,scaffold_3
11,4654001,4678000,23999,False,48,scaffold_3
12,6911001,6962000,50999,False,48,scaffold_3
13,6980001,7046000,65999,False,48,scaffold_3
14,7540001,7556000,15999,False,48,scaffold_3
15,7693001,7721000,27999,False,48,scaffold_3
16,7822001,7838000,15999,False,48,scaffold_3
17,8177001,8253000,75999,False,48,scaffold_3
18,8462001,8527000,64999,False,48,scaffold_3
19,8575001,8594000,18999,False,48,scaffold_3
20,9968001,9995000,26999,False,48,scaffold_3
21,10461001,10483000,21999,False,48,scaffold_3
22,10587001,11165000,577999,False,48,scaffold_3
0,11001,13000,1999,False,48,scaffold_4
1,17001,32000,14999,False,48,scaffold_4
2,48001,86000,37999,False,48,scaffold_4
3,147001,151000,3999,False,48,scaffold_4
4,155001,160000,4999,False,48,scaffold_4
5,161001,215000,53999,False,48,scaffold_4
6,217001,226000,8999,False,48,scaffold_4
7,227001,266000,38999,False,48,scaffold_4
8,289001,307000,17999,False,48,scaffold_4
9,313001,344000,30999,False,48,scaffold_4
10,355001,374000,18999,False,48,scaffold_4
11,375001,380000,4999,False,48,scaffold_4
12,390001,410000,19999,False,48,scaffold_4
13,412001,425000,12999,False,48,scaffold_4
14,429001,499000,69999,False,48,scaffold_4
15,545001,592000,46999,False,48,scaffold_4
16,593001,599000,5999,False,48,scaffold_4
17,608001,661000,52999,False,48,scaffold_4
18,670001,691000,20999,False,48,scaffold_4
19,695001,697000,1999,False,48,scaffold_4
20,701001,713000,11999,False,48,scaffold_4
21,739001,741000,1999,False,48,scaffold_4
22,1121001,1136000,14999,False,48,scaffold_4
23,1137001,1178000,40999,False,48,scaffold_4
24,1199001,1208000,8999,False,48,scaffold_4
25,1211001,1226000,14999,False,48,scaffold_4
26,1254001,1262000,7999,False,48,scaffold_4
27,1265001,1279000,13999,False,48,scaffold_4
28,1283001,1315000,31999,False,48,scaffold_4
29,1373001,1591000,217999,False,48,scaffold_4
30,1749001,1837000,87999,False,48,scaffold_4
31,1905001,1957000,51999,False,48,scaffold_4
32,2036001,2065000,28999,False,48,scaffold_4
33,2247001,2279000,31999,False,48,scaffold_4
34,2284001,2310000,25999,False,48,scaffold_4
35,2312001,2340000,27999,False,48,scaffold_4
36,2480001,2576000,95999,False,48,scaffold_4
37,3335001,3632000,296999,False,48,scaffold_4
38,3676001,3760000,83999,False,48,scaffold_4
39,4944001,4984000,39999,False,48,scaffold_4
40,5477001,5506000,28999,False,48,scaffold_4
41,5514001,5620000,105999,False,48,scaffold_4
42,5665001,5784000,118999,False,48,scaffold_4
43,5786001,5804000,17999,False,48,scaffold_4
44,6811001,6817000,5999,False,48,scaffold_4
45,7037001,7062000,24999,False,48,scaffold_4
46,8846001,9699000,852999,False,48,scaffold_4
47,9700001,9845951,145950,True,48,scaffold_4
0,193001,204000,10999,False,48,scaffold_5
1,318001,326000,7999,False,48,scaffold_5
2,327001,368000,40999,False,48,scaffold_5
3,463001,523000,59999,False,48,scaffold_5
4,669001,675000,5999,False,48,scaffold_5
5,933001,947000,13999,False,48,scaffold_5
6,2565001,2581000,15999,False,48,scaffold_5
7,2625001,2738000,112999,False,48,scaffold_5
8,2816001,2871000,54999,False,48,scaffold_5
9,3167001,3184000,16999,False,48,scaffold_5
10,3322001,3438000,115999,False,48,scaffold_5
11,3451001,3497000,45999,False,48,scaffold_5
12,3962001,4101000,138999,False,48,scaffold_5
13,4121001,4141000,19999,False,48,scaffold_5
14,4156001,4219000,62999,False,48,scaffold_5
15,4246001,4263000,16999,False,48,scaffold_5
16,4446001,4488000,41999,False,48,scaffold_5
17,4601001,4650000,48999,False,48,scaffold_5
18,4691001,4717000,25999,False,48,scaffold_5
19,4789001,4861000,71999,False,48,scaffold_5
20,4892001,4918000,25999,False,48,scaffold_5
21,5318001,5346000,27999,False,48,scaffold_5
22,8730001,9364176,634175,True,48,scaffold_5
0,79001,84000,4999,False,48,scaffold_6
1,86001,112000,25999,False,48,scaffold_6
2,240001,253000,12999,False,48,scaffold_6
3,1237001,1266000,28999,False,48,scaffold_6
4,1479001,1546000,66999,False,48,scaffold_6
5,2023001,2086000,62999,False,48,scaffold_6
6,2132001,2168000,35999,False,48,scaffold_6
7,2352001,2595000,242999,False,48,scaffold_6
8,2596001,2653000,56999,False,48,scaffold_6
9,2659001,2691000,31999,False,48,scaffold_6
10,2731001,2852000,120999,False,48,scaffold_6
11,2933001,3014000,80999,False,48,scaffold_6
12,3115001,3149000,33999,False,48,scaffold_6
13,3224001,3301000,76999,False,48,scaffold_6
14,3408001,3427000,18999,False,48,scaffold_6
15,3462001,3766000,303999,False,48,scaffold_6
16,3901001,3912000,10999,False,48,scaffold_6
17,4018001,4048000,29999,False,48,scaffold_6
18,4085001,4193000,107999,False,48,scaffold_6
19,6010001,6060000,49999,False,48,scaffold_6
20,7283001,7337000,53999,False,48,scaffold_6
21,7560001,7795000,234999,False,48,scaffold_6
22,7811001,8268281,457280,True,48,scaffold_6
0,1,7000,6999,True,48,scaffold_7
1,13001,31000,17999,False,48,scaffold_7
2,243001,249000,5999,False,48,scaffold_7
3,323001,340000,16999,False,48,scaffold_7
4,342001,508000,165999,False,48,scaffold_7
5,554001,563000,8999,False,48,scaffold_7
6,571001,577000,5999,False,48,scaffold_7
7,706001,736000,29999,False,48,scaffold_7
8,764001,809000,44999,False,48,scaffold_7
9,859001,864000,4999,False,48,scaffold_7
10,868001,929000,60999,False,48,scaffold_7
11,982001,1044000,61999,False,48,scaffold_7
12,1048001,1098000,49999,False,48,scaffold_7
13,1203001,1460000,256999,False,48,scaffold_7
14,1461001,1512000,50999,False,48,scaffold_7
15,1588001,1688000,99999,False,48,scaffold_7
16,3326001,3369000,42999,False,48,scaffold_7
17,3595001,3649000,53999,False,48,scaffold_7
18,4418001,4517000,98999,False,48,scaffold_7
19,4658001,4682000,23999,False,48,scaffold_7
20,4979001,5030000,50999,False,48,scaffold_7
21,5077001,5114000,36999,False,48,scaffold_7
22,6955001,7270000,314999,False,48,scaffold_7
23,7271001,7502216,231215,True,48,scaffold_7
0,67001,85000,17999,False,48,scaffold_8
1,93001,101000,7999,False,48,scaffold_8
2,2662001,2683000,20999,False,48,scaffold_8
3,2741001,2757000,15999,False,48,scaffold_8
4,3060001,3525000,464999,False,48,scaffold_8
5,3584001,3612000,27999,False,48,scaffold_8
6,3615001,3913000,297999,False,48,scaffold_8
7,5199001,5241000,41999,False,48,scaffold_8
8,6332001,6334544,2543,True,48,scaffold_8
0,109001,117000,7999,False,48,scaffold_9
1,303001,315000,11999,False,48,scaffold_9
2,319001,333000,13999,False,48,scaffold_9
3,367001,411000,43999,False,48,scaffold_9
4,413001,434000,20999,False,48,scaffold_9
5,502001,531000,28999,False,48,scaffold_9
6,548001,560000,11999,False,48,scaffold_9
7,670001,696000,25999,False,48,scaffold_9
8,732001,742000,9999,False,48,scaffold_9
9,794001,803000,8999,False,48,scaffold_9
10,817001,843000,25999,False,48,scaffold_9
11,885001,986000,100999,False,48,scaffold_9
12,988001,995000,6999,False,48,scaffold_9
13,1001001,1007000,5999,False,48,scaffold_9
14,1010001,1031000,20999,False,48,scaffold_9
15,1035001,1085000,49999,False,48,scaffold_9
16,1087001,1150000,62999,False,48,scaffold_9
17,1151001,1164000,12999,False,48,scaffold_9
18,1312001,1377000,64999,False,48,scaffold_9
19,1770001,1783000,12999,False,48,scaffold_9
20,2601001,2616000,14999,False,48,scaffold_9
21,2874001,3381000,506999,False,48,scaffold_9
22,3383001,5107000,1723999,False,48,scaffold_9
23,5112001,5115000,2999,False,48,scaffold_9
24,5116001,5238000,121999,False,48,scaffold_9
25,5239001,5298000,58999,False,48,scaffold_9
26,5300001,5490000,189999,False,48,scaffold_9
27,5492001,6331288,839287,True,48,scaffold_9
0,1,136000,135999,True,48,scaffold_10
1,137001,198000,60999,False,48,scaffold_10
2,376001,405000,28999,False,48,scaffold_10
3,473001,482000,8999,False,48,scaffold_10
4,506001,576000,69999,False,48,scaffold_10
5,603001,748000,144999,False,48,scaffold_10
6,888001,916000,27999,False,48,scaffold_10
7,924001,962000,37999,False,48,scaffold_10
8,1087001,1111000,23999,False,48,scaffold_10
9,2346001,2366000,19999,False,48,scaffold_10
10,3264001,3268000,3999,False,48,scaffold_10
11,4053001,4091000,37999,False,48,scaffold_10
12,4154001,4174000,19999,False,48,scaffold_10
13,4443001,4462000,18999,False,48,scaffold_10
14,4467001,4476000,8999,False,48,scaffold_10
15,4515001,4523000,7999,False,48,scaffold_10
16,4526001,4548000,21999,False,48,scaffold_10
17,4576001,4596000,19999,False,48,scaffold_10
18,4680001,4688000,7999,False,48,scaffold_10
19,4734001,4766000,31999,False,48,scaffold_10
20,4769001,4776000,6999,False,48,scaffold_10
21,4798001,4824000,25999,False,48,scaffold_10
22,4828001,4843000,14999,False,48,scaffold_10
23,4848001,4861000,12999,False,48,scaffold_10
24,4865001,4866973,1972,True,48,scaffold_10
0,10001,93000,82999,False,48,scaffold_11
1,149001,167000,17999,False,48,scaffold_11
2,169001,189000,19999,False,48,scaffold_11
3,213001,235000,21999,False,48,scaffold_11
4,240001,246000,5999,False,48,scaffold_11
5,419001,431000,11999,False,48,scaffold_11
6,648001,656000,7999,False,48,scaffold_11
7,1025001,1034000,8999,False,48,scaffold_11
8,1423001,1426000,2999,False,48,scaffold_11
9,2701001,2873000,171999,False,48,scaffold_11
10,3213001,3254000,40999,False,48,scaffold_11
11,3331001,3371000,39999,False,48,scaffold_11
12,3702001,3926000,223999,False,48,scaffold_11
13,4321001,4710000,388999,False,48,scaffold_11
14,4713001,4766820,53819,True,48,scaffold_11
0,1,240000,239999,True,48,scaffold_12
1,290001,369000,78999,False,48,scaffold_12
2,474001,537000,62999,False,48,scaffold_12
3,582001,731000,148999,False,48,scaffold_12
4,739001,856000,116999,False,48,scaffold_12
5,867001,1354000,486999,False,48,scaffold_12
6,1720001,1733000,12999,False,48,scaffold_12
7,2571001,2612000,40999,False,48,scaffold_12
8,2676001,2682000,5999,False,48,scaffold_12
9,2685001,2699000,13999,False,48,scaffold_12
10,2747001,2747968,967,True,48,scaffold_12
0,1,342000,341999,True,49,scaffold_1
1,482001,498000,15999,False,49,scaffold_1
2,572001,643000,70999,False,49,scaffold_1
3,686001,749000,62999,False,49,scaffold_1
4,1281001,1292000,10999,False,49,scaffold_1
5,1820001,1899000,78999,False,49,scaffold_1
6,1954001,1984000,29999,False,49,scaffold_1
7,1988001,1993000,4999,False,49,scaffold_1
8,2449001,2517000,67999,False,49,scaffold_1
9,2729001,2746000,16999,False,49,scaffold_1
10,3181001,3209000,27999,False,49,scaffold_1
11,3715001,3738000,22999,False,49,scaffold_1
12,3909001,3941000,31999,False,49,scaffold_1
13,4003001,4030000,26999,False,49,scaffold_1
14,4060001,4112000,51999,False,49,scaffold_1
15,4314001,4355000,40999,False,49,scaffold_1
16,4928001,5022000,93999,False,49,scaffold_1
17,5087001,5113000,25999,False,49,scaffold_1
18,5483001,5511000,27999,False,49,scaffold_1
19,5535001,5570000,34999,False,49,scaffold_1
20,6108001,6177000,68999,False,49,scaffold_1
21,6228001,6379000,150999,False,49,scaffold_1
22,6384001,6510000,125999,False,49,scaffold_1
23,6543001,6555000,11999,False,49,scaffold_1
24,7038001,7247000,208999,False,49,scaffold_1
25,7248001,7588000,339999,False,49,scaffold_1
26,7590001,8656000,1065999,False,49,scaffold_1
27,8657001,9584000,926999,False,49,scaffold_1
28,9586001,10354000,767999,False,49,scaffold_1
29,10461001,10638000,176999,False,49,scaffold_1
30,10740001,10755000,14999,False,49,scaffold_1
31,10839001,10857000,17999,False,49,scaffold_1
32,11284001,11307000,22999,False,49,scaffold_1
33,11308001,11506000,197999,False,49,scaffold_1
34,11562001,11577000,14999,False,49,scaffold_1
35,11590001,11951000,360999,False,49,scaffold_1
36,12184001,12204000,19999,False,49,scaffold_1
37,12652001,12722000,69999,False,49,scaffold_1
38,12776001,12887000,110999,False,49,scaffold_1
39,12965001,13002000,36999,False,49,scaffold_1
40,13113001,13211000,97999,False,49,scaffold_1
41,13347001,13404000,56999,False,49,scaffold_1
42,14290001,14309000,18999,False,49,scaffold_1
0,1,48000,47999,True,49,scaffold_2
1,93001,159000,65999,False,49,scaffold_2
2,165001,177000,11999,False,49,scaffold_2
3,303001,318000,14999,False,49,scaffold_2
4,333001,374000,40999,False,49,scaffold_2
5,2085001,2101000,15999,False,49,scaffold_2
6,2336001,2358000,21999,False,49,scaffold_2
7,2398001,2424000,25999,False,49,scaffold_2
8,2441001,2560000,118999,False,49,scaffold_2
9,2627001,2639000,11999,False,49,scaffold_2
10,2645001,2689000,43999,False,49,scaffold_2
11,2694001,2746000,51999,False,49,scaffold_2
12,2777001,2786000,8999,False,49,scaffold_2
13,2868001,2902000,33999,False,49,scaffold_2
14,2974001,3021000,46999,False,49,scaffold_2
15,3333001,3342000,8999,False,49,scaffold_2
16,3451001,3465000,13999,False,49,scaffold_2
17,3754001,3784000,29999,False,49,scaffold_2
18,4382001,4409000,26999,False,49,scaffold_2
19,4425001,4457000,31999,False,49,scaffold_2
20,4521001,4656000,134999,False,49,scaffold_2
21,4793001,4799000,5999,False,49,scaffold_2
22,4918001,4963000,44999,False,49,scaffold_2
23,5022001,5031000,8999,False,49,scaffold_2
24,5033001,5104000,70999,False,49,scaffold_2
25,5371001,5394000,22999,False,49,scaffold_2
26,5415001,5480000,64999,False,49,scaffold_2
27,5491001,5515000,23999,False,49,scaffold_2
28,5622001,5759000,136999,False,49,scaffold_2
29,5839001,5886000,46999,False,49,scaffold_2
30,6125001,6137000,11999,False,49,scaffold_2
31,6261001,6330000,68999,False,49,scaffold_2
32,6331001,6351000,19999,False,49,scaffold_2
33,6427001,6449000,21999,False,49,scaffold_2
34,6591001,6628000,36999,False,49,scaffold_2
35,7018001,7038000,19999,False,49,scaffold_2
36,7063001,7097000,33999,False,49,scaffold_2
37,7428001,7472000,43999,False,49,scaffold_2
38,7491001,7518000,26999,False,49,scaffold_2
39,7563001,7725000,161999,False,49,scaffold_2
40,7786001,7920000,133999,False,49,scaffold_2
41,7934001,8181000,246999,False,49,scaffold_2
42,8261001,8313000,51999,False,49,scaffold_2
43,8331001,8333000,1999,False,49,scaffold_2
44,8340001,8345000,4999,False,49,scaffold_2
45,8346001,8454000,107999,False,49,scaffold_2
46,8508001,8560000,51999,False,49,scaffold_2
47,9031001,9047000,15999,False,49,scaffold_2
48,9139001,9167000,27999,False,49,scaffold_2
49,9348001,9382000,33999,False,49,scaffold_2
50,11519001,11785000,265999,False,49,scaffold_2
51,11797001,11802476,5475,True,49,scaffold_2
0,1,2000,1999,True,49,scaffold_3
1,3001,6000,2999,False,49,scaffold_3
2,528001,539000,10999,False,49,scaffold_3
3,618001,647000,28999,False,49,scaffold_3
4,795001,900000,104999,False,49,scaffold_3
5,2035001,2108000,72999,False,49,scaffold_3
6,2288001,2321000,32999,False,49,scaffold_3
7,2487001,2533000,45999,False,49,scaffold_3
8,2637001,2683000,45999,False,49,scaffold_3
9,2716001,2734000,17999,False,49,scaffold_3
10,3261001,3277000,15999,False,49,scaffold_3
11,3769001,3893000,123999,False,49,scaffold_3
12,4108001,4399000,290999,False,49,scaffold_3
13,4415001,4519000,103999,False,49,scaffold_3
14,4545001,4559000,13999,False,49,scaffold_3
15,4567001,4575000,7999,False,49,scaffold_3
16,4644001,4689000,44999,False,49,scaffold_3
17,5990001,6019000,28999,False,49,scaffold_3
18,6745001,6787000,41999,False,49,scaffold_3
19,6910001,6962000,51999,False,49,scaffold_3
20,6963001,6972000,8999,False,49,scaffold_3
21,6979001,7096000,116999,False,49,scaffold_3
22,7522001,7556000,33999,False,49,scaffold_3
23,7679001,7842000,162999,False,49,scaffold_3
24,8046001,8069000,22999,False,49,scaffold_3
25,8177001,8253000,75999,False,49,scaffold_3
26,8462001,8527000,64999,False,49,scaffold_3
27,8575001,8593000,17999,False,49,scaffold_3
28,9968001,9996000,27999,False,49,scaffold_3
29,10587001,11182071,595070,True,49,scaffold_3
0,17001,32000,14999,False,49,scaffold_4
1,48001,88000,39999,False,49,scaffold_4
2,121001,146000,24999,False,49,scaffold_4
3,147001,151000,3999,False,49,scaffold_4
4,155001,215000,59999,False,49,scaffold_4
5,217001,226000,8999,False,49,scaffold_4
6,227001,241000,13999,False,49,scaffold_4
7,242001,267000,24999,False,49,scaffold_4
8,292001,303000,10999,False,49,scaffold_4
9,355001,374000,18999,False,49,scaffold_4
10,390001,410000,19999,False,49,scaffold_4
11,412001,425000,12999,False,49,scaffold_4
12,429001,501000,71999,False,49,scaffold_4
13,541001,592000,50999,False,49,scaffold_4
14,593001,599000,5999,False,49,scaffold_4
15,600001,607000,6999,False,49,scaffold_4
16,608001,691000,82999,False,49,scaffold_4
17,701001,727000,25999,False,49,scaffold_4
18,1043001,1047000,3999,False,49,scaffold_4
19,1087001,1097000,9999,False,49,scaffold_4
20,1113001,1136000,22999,False,49,scaffold_4
21,1137001,1198000,60999,False,49,scaffold_4
22,1199001,1226000,26999,False,49,scaffold_4
23,1236001,1262000,25999,False,49,scaffold_4
24,1265001,1279000,13999,False,49,scaffold_4
25,1283001,1336000,52999,False,49,scaffold_4
26,1369001,1599000,229999,False,49,scaffold_4
27,1627001,2065000,437999,False,49,scaffold_4
28,2073001,2114000,40999,False,49,scaffold_4
29,2142001,2184000,41999,False,49,scaffold_4
30,2197001,2205000,7999,False,49,scaffold_4
31,2210001,2246000,35999,False,49,scaffold_4
32,2247001,2280000,32999,False,49,scaffold_4
33,2283001,2461000,177999,False,49,scaffold_4
34,2477001,2534000,56999,False,49,scaffold_4
35,2552001,2635000,82999,False,49,scaffold_4
36,2924001,2955000,30999,False,49,scaffold_4
37,3241001,3266000,24999,False,49,scaffold_4
38,3335001,3761000,425999,False,49,scaffold_4
39,4900001,5061000,160999,False,49,scaffold_4
40,5172001,5222000,49999,False,49,scaffold_4
41,5476001,5506000,29999,False,49,scaffold_4
42,5514001,5620000,105999,False,49,scaffold_4
43,5659001,5784000,124999,False,49,scaffold_4
44,6145001,6197000,51999,False,49,scaffold_4
45,6795001,6817000,21999,False,49,scaffold_4
46,6902001,6924000,21999,False,49,scaffold_4
47,7036001,7097000,60999,False,49,scaffold_4
48,8846001,9699000,852999,False,49,scaffold_4
49,9700001,9845951,145950,True,49,scaffold_4
0,1,4000,3999,True,49,scaffold_5
1,28001,32000,3999,False,49,scaffold_5
2,318001,428000,109999,False,49,scaffold_5
3,445001,523000,77999,False,49,scaffold_5
4,671001,696000,24999,False,49,scaffold_5
5,933001,947000,13999,False,49,scaffold_5
6,2565001,2871000,305999,False,49,scaffold_5
7,3133001,3190000,56999,False,49,scaffold_5
8,3217001,3248000,30999,False,49,scaffold_5
9,3322001,3438000,115999,False,49,scaffold_5
10,3444001,3513000,68999,False,49,scaffold_5
11,3622001,3658000,35999,False,49,scaffold_5
12,3962001,4101000,138999,False,49,scaffold_5
13,4118001,4222000,103999,False,49,scaffold_5
14,4227001,4274000,46999,False,49,scaffold_5
15,4445001,4538000,92999,False,49,scaffold_5
16,4600001,4751000,150999,False,49,scaffold_5
17,4752001,4862000,109999,False,49,scaffold_5
18,4884001,4925000,40999,False,49,scaffold_5
19,5287001,5312000,24999,False,49,scaffold_5
20,5314001,5346000,31999,False,49,scaffold_5
21,6408001,6438000,29999,False,49,scaffold_5
22,6504001,6653000,148999,False,49,scaffold_5
23,7406001,7427000,20999,False,49,scaffold_5
24,7454001,7484000,29999,False,49,scaffold_5
25,7580001,7609000,28999,False,49,scaffold_5
26,7623001,7637000,13999,False,49,scaffold_5
27,8416001,8460000,43999,False,49,scaffold_5
28,8551001,8616000,64999,False,49,scaffold_5
29,8670001,8685000,14999,False,49,scaffold_5
30,8715001,9364176,649175,True,49,scaffold_5
0,78001,85000,6999,False,49,scaffold_6
1,86001,112000,25999,False,49,scaffold_6
2,172001,206000,33999,False,49,scaffold_6
3,238001,255000,16999,False,49,scaffold_6
4,267001,297000,29999,False,49,scaffold_6
5,1229001,1264000,34999,False,49,scaffold_6
6,1479001,1546000,66999,False,49,scaffold_6
7,1868001,1906000,37999,False,49,scaffold_6
8,2026001,2103000,76999,False,49,scaffold_6
9,2129001,2191000,61999,False,49,scaffold_6
10,2237001,2265000,27999,False,49,scaffold_6
11,2336001,2595000,258999,False,49,scaffold_6
12,2596001,2872000,275999,False,49,scaffold_6
13,2934001,3014000,79999,False,49,scaffold_6
14,3115001,3174000,58999,False,49,scaffold_6
15,3223001,3301000,77999,False,49,scaffold_6
16,3407001,3440000,32999,False,49,scaffold_6
17,3451001,3787000,335999,False,49,scaffold_6
18,3881001,3913000,31999,False,49,scaffold_6
19,3983001,4072000,88999,False,49,scaffold_6
20,4080001,4195000,114999,False,49,scaffold_6
21,5940001,5968000,27999,False,49,scaffold_6
22,6009001,6078000,68999,False,49,scaffold_6
23,7282001,7337000,54999,False,49,scaffold_6
24,7389001,7473000,83999,False,49,scaffold_6
25,7541001,8268281,727280,True,49,scaffold_6
0,13001,34000,20999,False,49,scaffold_7
1,243001,250000,6999,False,49,scaffold_7
2,321001,340000,18999,False,49,scaffold_7
3,342001,508000,165999,False,49,scaffold_7
4,622001,641000,18999,False,49,scaffold_7
5,650001,685000,34999,False,49,scaffold_7
6,688001,736000,47999,False,49,scaffold_7
7,742001,755000,12999,False,49,scaffold_7
8,764001,809000,44999,False,49,scaffold_7
9,811001,826000,14999,False,49,scaffold_7
10,858001,864000,5999,False,49,scaffold_7
11,868001,872000,3999,False,49,scaffold_7
12,875001,937000,61999,False,49,scaffold_7
13,953001,963000,9999,False,49,scaffold_7
14,964001,966000,1999,False,49,scaffold_7
15,968001,981000,12999,False,49,scaffold_7
16,982001,1044000,61999,False,49,scaffold_7
17,1048001,1104000,55999,False,49,scaffold_7
18,1106001,1123000,16999,False,49,scaffold_7
19,1191001,1512000,320999,False,49,scaffold_7
20,1578001,1688000,109999,False,49,scaffold_7
21,2851001,2869000,17999,False,49,scaffold_7
22,3298001,3369000,70999,False,49,scaffold_7
23,3520001,3767000,246999,False,49,scaffold_7
24,4328001,4361000,32999,False,49,scaffold_7
25,4415001,4517000,101999,False,49,scaffold_7
26,4658001,4682000,23999,False,49,scaffold_7
27,4754001,4819000,64999,False,49,scaffold_7
28,4979001,5148000,168999,False,49,scaffold_7
29,5482001,5516000,33999,False,49,scaffold_7
30,6953001,7270000,316999,False,49,scaffold_7
31,7271001,7502216,231215,True,49,scaffold_7
0,66001,85000,18999,False,49,scaffold_8
1,93001,102000,8999,False,49,scaffold_8
2,112001,116000,3999,False,49,scaffold_8
3,2438001,2470000,31999,False,49,scaffold_8
4,2491001,2552000,60999,False,49,scaffold_8
5,2650001,2682000,31999,False,49,scaffold_8
6,2742001,2844000,101999,False,49,scaffold_8
7,3033001,3525000,491999,False,49,scaffold_8
8,3581001,3612000,30999,False,49,scaffold_8
9,3615001,3913000,297999,False,49,scaffold_8
10,4061001,4106000,44999,False,49,scaffold_8
11,4206001,4221000,14999,False,49,scaffold_8
12,4400001,4434000,33999,False,49,scaffold_8
13,5095001,5136000,40999,False,49,scaffold_8
14,5186001,5241000,54999,False,49,scaffold_8
15,5580001,5594000,13999,False,49,scaffold_8
16,5651001,5692000,40999,False,49,scaffold_8
17,6321001,6334544,13543,True,49,scaffold_8
0,109001,117000,7999,False,49,scaffold_9
1,366001,411000,44999,False,49,scaffold_9
2,413001,434000,20999,False,49,scaffold_9
3,502001,531000,28999,False,49,scaffold_9
4,547001,563000,15999,False,49,scaffold_9
5,671001,696000,24999,False,49,scaffold_9
6,733001,740000,6999,False,49,scaffold_9
7,816001,842000,25999,False,49,scaffold_9
8,873001,986000,112999,False,49,scaffold_9
9,987001,995000,7999,False,49,scaffold_9
10,1001001,1007000,5999,False,49,scaffold_9
11,1010001,1150000,139999,False,49,scaffold_9
12,1151001,1165000,13999,False,49,scaffold_9
13,1312001,1378000,65999,False,49,scaffold_9
14,1487001,1499000,11999,False,49,scaffold_9
15,1599001,1625000,25999,False,49,scaffold_9
16,1749001,1791000,41999,False,49,scaffold_9
17,1885001,1908000,22999,False,49,scaffold_9
18,2000001,2029000,28999,False,49,scaffold_9
19,2598001,2630000,31999,False,49,scaffold_9
20,2738001,3381000,642999,False,49,scaffold_9
21,3383001,5107000,1723999,False,49,scaffold_9
22,5112001,5115000,2999,False,49,scaffold_9
23,5116001,5238000,121999,False,49,scaffold_9
24,5239001,5298000,58999,False,49,scaffold_9
25,5299001,6331288,1032287,True,49,scaffold_9
0,1,199000,198999,True,49,scaffold_10
1,260001,406000,145999,False,49,scaffold_10
2,458001,482000,23999,False,49,scaffold_10
3,483001,580000,96999,False,49,scaffold_10
4,596001,794000,197999,False,49,scaffold_10
5,888001,916000,27999,False,49,scaffold_10
6,923001,964000,40999,False,49,scaffold_10
7,1073001,1146000,72999,False,49,scaffold_10
8,2088001,2103000,14999,False,49,scaffold_10
9,2141001,2169000,27999,False,49,scaffold_10
10,2346001,2398000,51999,False,49,scaffold_10
11,3156001,3178000,21999,False,49,scaffold_10
12,4050001,4087000,36999,False,49,scaffold_10
13,4154001,4181000,26999,False,49,scaffold_10
14,4443001,4476000,32999,False,49,scaffold_10
15,4503001,4513000,9999,False,49,scaffold_10
16,4515001,4523000,7999,False,49,scaffold_10
17,4526001,4548000,21999,False,49,scaffold_10
18,4554001,4562000,7999,False,49,scaffold_10
19,4574001,4597000,22999,False,49,scaffold_10
20,4734001,4776000,41999,False,49,scaffold_10
21,4798001,4824000,25999,False,49,scaffold_10
22,4828001,4843000,14999,False,49,scaffold_10
23,4848001,4861000,12999,False,49,scaffold_10
24,4865001,4866973,1972,True,49,scaffold_10
0,11001,99000,87999,False,49,scaffold_11
1,132001,167000,34999,False,49,scaffold_11
2,169001,191000,21999,False,49,scaffold_11
3,213001,236000,22999,False,49,scaffold_11
4,240001,252000,11999,False,49,scaffold_11
5,296001,320000,23999,False,49,scaffold_11
6,419001,431000,11999,False,49,scaffold_11
7,637001,657000,19999,False,49,scaffold_11
8,1423001,1426000,2999,False,49,scaffold_11
9,1474001,1477000,2999,False,49,scaffold_11
10,2700001,2874000,173999,False,49,scaffold_11
11,2979001,3011000,31999,False,49,scaffold_11
12,3091001,3158000,66999,False,49,scaffold_11
13,3185001,3293000,107999,False,49,scaffold_11
14,3331001,3383000,51999,False,49,scaffold_11
15,3548001,3932000,383999,False,49,scaffold_11
16,4009001,4082000,72999,False,49,scaffold_11
17,4135001,4157000,21999,False,49,scaffold_11
18,4316001,4710000,393999,False,49,scaffold_11
19,4713001,4766820,53819,True,49,scaffold_11
0,1,544000,543999,True,49,scaffold_12
1,579001,857000,277999,False,49,scaffold_12
2,865001,1496000,630999,False,49,scaffold_12
3,1718001,1733000,14999,False,49,scaffold_12
4,2050001,2087000,36999,False,49,scaffold_12
5,2571001,2609000,37999,False,49,scaffold_12
6,2685001,2699000,13999,False,49,scaffold_12
7,2747001,2747968,967,True,49,scaffold_12
0,1,344000,343999,True,50,scaffold_1
1,482001,498000,15999,False,50,scaffold_1
2,571001,643000,71999,False,50,scaffold_1
3,686001,743000,56999,False,50,scaffold_1
4,1281001,1292000,10999,False,50,scaffold_1
5,1628001,1660000,31999,False,50,scaffold_1
6,1814001,1898000,83999,False,50,scaffold_1
7,1954001,1964000,9999,False,50,scaffold_1
8,1965001,1984000,18999,False,50,scaffold_1
9,1987001,2015000,27999,False,50,scaffold_1
10,2363001,2387000,23999,False,50,scaffold_1
11,2449001,2517000,67999,False,50,scaffold_1
12,2564001,2581000,16999,False,50,scaffold_1
13,2727001,2746000,18999,False,50,scaffold_1
14,3173001,3209000,35999,False,50,scaffold_1
15,3714001,3878000,163999,False,50,scaffold_1
16,3901001,3941000,39999,False,50,scaffold_1
17,3945001,4028000,82999,False,50,scaffold_1
18,4060001,4112000,51999,False,50,scaffold_1
19,4314001,4354000,39999,False,50,scaffold_1
20,4920001,5025000,104999,False,50,scaffold_1
21,5090001,5111000,20999,False,50,scaffold_1
22,5481001,5511000,29999,False,50,scaffold_1
23,5535001,5573000,37999,False,50,scaffold_1
24,5856001,5874000,17999,False,50,scaffold_1
25,6108001,6177000,68999,False,50,scaffold_1
26,6201001,6381000,179999,False,50,scaffold_1
27,6384001,6564000,179999,False,50,scaffold_1
28,7038001,7247000,208999,False,50,scaffold_1
29,7248001,7589000,340999,False,50,scaffold_1
30,7590001,8656000,1065999,False,50,scaffold_1
31,8658001,9584000,925999,False,50,scaffold_1
32,9586001,10363000,776999,False,50,scaffold_1
33,10461001,10616000,154999,False,50,scaffold_1
34,10808001,10811000,2999,False,50,scaffold_1
35,10836001,10858000,21999,False,50,scaffold_1
36,11270001,11509000,238999,False,50,scaffold_1
37,11560001,11956000,395999,False,50,scaffold_1
38,12184001,12204000,19999,False,50,scaffold_1
39,12652001,12756000,103999,False,50,scaffold_1
40,12777001,12888000,110999,False,50,scaffold_1
41,12983001,12992000,8999,False,50,scaffold_1
42,13113001,13214000,100999,False,50,scaffold_1
43,13346001,13405000,58999,False,50,scaffold_1
44,14285001,14310000,24999,False,50,scaffold_1
45,14471001,14479000,7999,False,50,scaffold_1
46,14671001,14674000,2999,False,50,scaffold_1
0,22001,48000,25999,False,50,scaffold_2
1,95001,159000,63999,False,50,scaffold_2
2,168001,177000,8999,False,50,scaffold_2
3,302001,318000,15999,False,50,scaffold_2
4,330001,374000,43999,False,50,scaffold_2
5,2085001,2111000,25999,False,50,scaffold_2
6,2336001,2358000,21999,False,50,scaffold_2
7,2404001,2424000,19999,False,50,scaffold_2
8,2438001,2607000,168999,False,50,scaffold_2
9,2660001,2689000,28999,False,50,scaffold_2
10,2694001,2746000,51999,False,50,scaffold_2
11,3450001,3466000,15999,False,50,scaffold_2
12,3754001,3790000,35999,False,50,scaffold_2
13,4335001,4409000,73999,False,50,scaffold_2
14,4426001,4457000,30999,False,50,scaffold_2
15,4515001,4657000,141999,False,50,scaffold_2
16,4752001,4766000,13999,False,50,scaffold_2
17,4779001,4790000,10999,False,50,scaffold_2
18,4918001,4951000,32999,False,50,scaffold_2
19,5021001,5104000,82999,False,50,scaffold_2
20,5349001,5395000,45999,False,50,scaffold_2
21,5491001,5515000,23999,False,50,scaffold_2
22,5659001,5757000,97999,False,50,scaffold_2
23,5840001,5891000,50999,False,50,scaffold_2
24,5909001,5989000,79999,False,50,scaffold_2
25,6261001,6330000,68999,False,50,scaffold_2
26,6331001,6341000,9999,False,50,scaffold_2
27,6429001,6449000,19999,False,50,scaffold_2
28,6589001,6628000,38999,False,50,scaffold_2
29,6947001,6978000,30999,False,50,scaffold_2
30,7004001,7038000,33999,False,50,scaffold_2
31,7064001,7096000,31999,False,50,scaffold_2
32,7439001,7472000,32999,False,50,scaffold_2
33,7550001,7561000,10999,False,50,scaffold_2
34,7563001,7698000,134999,False,50,scaffold_2
35,7780001,7891000,110999,False,50,scaffold_2
36,7934001,8198000,263999,False,50,scaffold_2
37,8261001,8297000,35999,False,50,scaffold_2
38,8331001,8333000,1999,False,50,scaffold_2
39,8335001,8344000,8999,False,50,scaffold_2
40,8346001,8454000,107999,False,50,scaffold_2
41,8509001,8562000,52999,False,50,scaffold_2
42,9146001,9167000,20999,False,50,scaffold_2
43,11520001,11785000,264999,False,50,scaffold_2
0,1,2000,1999,True,50,scaffold_3
1,798001,900000,101999,False,50,scaffold_3
2,2012001,2108000,95999,False,50,scaffold_3
3,2109001,2116000,6999,False,50,scaffold_3
4,2291001,2322000,30999,False,50,scaffold_3
5,2487001,2533000,45999,False,50,scaffold_3
6,2659001,2682000,22999,False,50,scaffold_3
7,2717001,2735000,17999,False,50,scaffold_3
8,3606001,3643000,36999,False,50,scaffold_3
9,3768001,3821000,52999,False,50,scaffold_3
10,3822001,3874000,51999,False,50,scaffold_3
11,4007001,4031000,23999,False,50,scaffold_3
12,4096001,4403000,306999,False,50,scaffold_3
13,4410001,4518000,107999,False,50,scaffold_3
14,4546001,4558000,11999,False,50,scaffold_3
15,4652001,4678000,25999,False,50,scaffold_3
16,5000001,5025000,24999,False,50,scaffold_3
17,5167001,5192000,24999,False,50,scaffold_3
18,5237001,5270000,32999,False,50,scaffold_3
19,5493001,5509000,15999,False,50,scaffold_3
20,5881001,5912000,30999,False,50,scaffold_3
21,5971001,6023000,51999,False,50,scaffold_3
22,6759001,6779000,19999,False,50,scaffold_3
23,6906001,6962000,55999,False,50,scaffold_3
24,6963001,7089000,125999,False,50,scaffold_3
25,7138001,7157000,18999,False,50,scaffold_3
26,7286001,7303000,16999,False,50,scaffold_3
27,7336001,7397000,60999,False,50,scaffold_3
28,7504001,7556000,51999,False,50,scaffold_3
29,7690001,7802000,111999,False,50,scaffold_3
30,7821001,7855000,33999,False,50,scaffold_3
31,8047001,8070000,22999,False,50,scaffold_3
32,8183001,8256000,72999,False,50,scaffold_3
33,8462001,8527000,64999,False,50,scaffold_3
34,8575001,8594000,18999,False,50,scaffold_3
35,9008001,9075000,66999,False,50,scaffold_3
36,9968001,9996000,27999,False,50,scaffold_3
37,10068001,10089000,20999,False,50,scaffold_3
38,10461001,10483000,21999,False,50,scaffold_3
39,10587001,11165000,577999,False,50,scaffold_3
0,11001,13000,1999,False,50,scaffold_4
1,17001,32000,14999,False,50,scaffold_4
2,49001,88000,38999,False,50,scaffold_4
3,107001,115000,7999,False,50,scaffold_4
4,147001,151000,3999,False,50,scaffold_4
5,155001,160000,4999,False,50,scaffold_4
6,161001,215000,53999,False,50,scaffold_4
7,217001,226000,8999,False,50,scaffold_4
8,227001,266000,38999,False,50,scaffold_4
9,290001,310000,19999,False,50,scaffold_4
10,337001,344000,6999,False,50,scaffold_4
11,355001,373000,17999,False,50,scaffold_4
12,375001,380000,4999,False,50,scaffold_4
13,412001,425000,12999,False,50,scaffold_4
14,429001,498000,68999,False,50,scaffold_4
15,543001,606000,62999,False,50,scaffold_4
16,608001,667000,58999,False,50,scaffold_4
17,669001,691000,21999,False,50,scaffold_4
18,701001,727000,25999,False,50,scaffold_4
19,1121001,1136000,14999,False,50,scaffold_4
20,1138001,1198000,59999,False,50,scaffold_4
21,1199001,1226000,26999,False,50,scaffold_4
22,1235001,1253000,17999,False,50,scaffold_4
23,1265001,1279000,13999,False,50,scaffold_4
24,1283001,1337000,53999,False,50,scaffold_4
25,1341001,1598000,256999,False,50,scaffold_4
26,1613001,2117000,503999,False,50,scaffold_4
27,2119001,2129000,9999,False,50,scaffold_4
28,2210001,2246000,35999,False,50,scaffold_4
29,2247001,2268000,20999,False,50,scaffold_4
30,2269001,2279000,9999,False,50,scaffold_4
31,2284001,2310000,25999,False,50,scaffold_4
32,2312001,2340000,27999,False,50,scaffold_4
33,2342001,2352000,9999,False,50,scaffold_4
34,2353001,2444000,90999,False,50,scaffold_4
35,2447001,2460000,12999,False,50,scaffold_4
36,2476001,2635000,158999,False,50,scaffold_4
37,2678001,2681000,2999,False,50,scaffold_4
38,2683001,2693000,9999,False,50,scaffold_4
39,3031001,3127000,95999,False,50,scaffold_4
40,3335001,3770000,434999,False,50,scaffold_4
41,4057001,4076000,18999,False,50,scaffold_4
42,4900001,5048000,147999,False,50,scaffold_4
43,5173001,5224000,50999,False,50,scaffold_4
44,5302001,5355000,52999,False,50,scaffold_4
45,5472001,5506000,33999,False,50,scaffold_4
46,5514001,5784000,269999,False,50,scaffold_4
47,5786001,5818000,31999,False,50,scaffold_4
48,6145001,6195000,49999,False,50,scaffold_4
49,6765001,6817000,51999,False,50,scaffold_4
50,6902001,6924000,21999,False,50,scaffold_4
51,6950001,6995000,44999,False,50,scaffold_4
52,7036001,7075000,38999,False,50,scaffold_4
53,7226001,7304000,77999,False,50,scaffold_4
54,7641001,7665000,23999,False,50,scaffold_4
55,8846001,9699000,852999,False,50,scaffold_4
56,9700001,9845951,145950,True,50,scaffold_4
0,151001,173000,21999,False,50,scaffold_5
1,190001,204000,13999,False,50,scaffold_5
2,318001,368000,49999,False,50,scaffold_5
3,462001,523000,60999,False,50,scaffold_5
4,839001,842000,2999,False,50,scaffold_5
5,933001,947000,13999,False,50,scaffold_5
6,1036001,1038000,1999,False,50,scaffold_5
7,2475001,2494000,18999,False,50,scaffold_5
8,2511001,2515000,3999,False,50,scaffold_5
9,2555001,2753000,197999,False,50,scaffold_5
10,2765001,2894000,128999,False,50,scaffold_5
11,3133001,3185000,51999,False,50,scaffold_5
12,3216001,3512000,295999,False,50,scaffold_5
13,3617001,3653000,35999,False,50,scaffold_5
14,3962001,4101000,138999,False,50,scaffold_5
15,4121001,4269000,147999,False,50,scaffold_5
16,4446001,4506000,59999,False,50,scaffold_5
17,4600001,4861000,260999,False,50,scaffold_5
18,4885001,4918000,32999,False,50,scaffold_5
19,5059001,5082000,22999,False,50,scaffold_5
20,5263001,5267000,3999,False,50,scaffold_5
21,5318001,5346000,27999,False,50,scaffold_5
22,6406001,6420000,13999,False,50,scaffold_5
23,6479001,6653000,173999,False,50,scaffold_5
24,7454001,7483000,28999,False,50,scaffold_5
25,7576001,7619000,42999,False,50,scaffold_5
26,7621001,7658000,36999,False,50,scaffold_5
27,8553001,8616000,62999,False,50,scaffold_5
28,8659001,8689000,29999,False,50,scaffold_5
29,8730001,9364176,634175,True,50,scaffold_5
0,66001,75000,8999,False,50,scaffold_6
1,78001,85000,6999,False,50,scaffold_6
2,86001,114000,27999,False,50,scaffold_6
3,239001,254000,14999,False,50,scaffold_6
4,257001,262000,4999,False,50,scaffold_6
5,264001,278000,13999,False,50,scaffold_6
6,1145001,1192000,46999,False,50,scaffold_6
7,1236001,1257000,20999,False,50,scaffold_6
8,1286001,1309000,22999,False,50,scaffold_6
9,1478001,1546000,67999,False,50,scaffold_6
10,1658001,1687000,28999,False,50,scaffold_6
11,1833001,1906000,72999,False,50,scaffold_6
12,2023001,2088000,64999,False,50,scaffold_6
13,2129001,2195000,65999,False,50,scaffold_6
14,2237001,2282000,44999,False,50,scaffold_6
15,2336001,2595000,258999,False,50,scaffold_6
16,2596001,2654000,57999,False,50,scaffold_6
17,2655001,2872000,216999,False,50,scaffold_6
18,2934001,3032000,97999,False,50,scaffold_6
19,3068001,3192000,123999,False,50,scaffold_6
20,3223001,3350000,126999,False,50,scaffold_6
21,3351001,3365000,13999,False,50,scaffold_6
22,3401001,3766000,364999,False,50,scaffold_6
23,3899001,3913000,13999,False,50,scaffold_6
24,3973001,3993000,19999,False,50,scaffold_6
25,4017001,4193000,175999,False,50,scaffold_6
26,4838001,4868000,29999,False,50,scaffold_6
27,6010001,6084000,73999,False,50,scaffold_6
28,6140001,6190000,49999,False,50,scaffold_6
29,6767001,6804000,36999,False,50,scaffold_6
30,7264001,7337000,72999,False,50,scaffold_6
31,7389001,7436000,46999,False,50,scaffold_6
32,7549001,8268281,719280,True,50,scaffold_6
0,1,7000,6999,True,50,scaffold_7
1,13001,31000,17999,False,50,scaffold_7
2,323001,340000,16999,False,50,scaffold_7
3,342001,508000,165999,False,50,scaffold_7
4,571001,577000,5999,False,50,scaffold_7
5,706001,737000,30999,False,50,scaffold_7
6,764001,809000,44999,False,50,scaffold_7
7,859001,864000,4999,False,50,scaffold_7
8,982001,1044000,61999,False,50,scaffold_7
9,1048001,1099000,50999,False,50,scaffold_7
10,1191001,1459000,267999,False,50,scaffold_7
11,1461001,1512000,50999,False,50,scaffold_7
12,1588001,1694000,105999,False,50,scaffold_7
13,1771001,1780000,8999,False,50,scaffold_7
14,3325001,3369000,43999,False,50,scaffold_7
15,3521001,3766000,244999,False,50,scaffold_7
16,4415001,4517000,101999,False,50,scaffold_7
17,4658001,4734000,75999,False,50,scaffold_7
18,4756001,4790000,33999,False,50,scaffold_7
19,4979001,5149000,169999,False,50,scaffold_7
20,5471001,5536000,64999,False,50,scaffold_7
21,6646001,6674000,27999,False,50,scaffold_7
22,6747001,6797000,49999,False,50,scaffold_7
23,6954001,7502216,548215,True,50,scaffold_7
0,66001,85000,18999,False,50,scaffold_8
1,722001,724000,1999,False,50,scaffold_8
2,1859001,1927000,67999,False,50,scaffold_8
3,2414001,2528000,113999,False,50,scaffold_8
4,2543001,2546000,2999,False,50,scaffold_8
5,2650001,2683000,32999,False,50,scaffold_8
6,2721001,2844000,122999,False,50,scaffold_8
7,2847001,2900000,52999,False,50,scaffold_8
8,3037001,3553000,515999,False,50,scaffold_8
9,3584001,3614000,29999,False,50,scaffold_8
10,3615001,3939000,323999,False,50,scaffold_8
11,4037001,4104000,66999,False,50,scaffold_8
12,4203001,4221000,17999,False,50,scaffold_8
13,5083001,5137000,53999,False,50,scaffold_8
14,5199001,5241000,41999,False,50,scaffold_8
15,5530001,5545000,14999,False,50,scaffold_8
16,5587001,5593000,5999,False,50,scaffold_8
17,5661001,5694000,32999,False,50,scaffold_8
18,5751001,5775000,23999,False,50,scaffold_8
19,6322001,6334544,12543,True,50,scaffold_8
0,109001,117000,7999,False,50,scaffold_9
1,366001,411000,44999,False,50,scaffold_9
2,413001,434000,20999,False,50,scaffold_9
3,502001,531000,28999,False,50,scaffold_9
4,671001,696000,24999,False,50,scaffold_9
5,732001,742000,9999,False,50,scaffold_9
6,794001,803000,8999,False,50,scaffold_9
7,816001,841000,24999,False,50,scaffold_9
8,872001,986000,113999,False,50,scaffold_9
9,987001,995000,7999,False,50,scaffold_9
10,1001001,1007000,5999,False,50,scaffold_9
11,1010001,1085000,74999,False,50,scaffold_9
12,1087001,1150000,62999,False,50,scaffold_9
13,1151001,1160000,8999,False,50,scaffold_9
14,1313001,1377000,63999,False,50,scaffold_9
15,1543001,1585000,41999,False,50,scaffold_9
16,1749001,1810000,60999,False,50,scaffold_9
17,1987001,2030000,42999,False,50,scaffold_9
18,2147001,2171000,23999,False,50,scaffold_9
19,2598001,2616000,17999,False,50,scaffold_9
20,2737001,2824000,86999,False,50,scaffold_9
21,2844001,3381000,536999,False,50,scaffold_9
22,3383001,5107000,1723999,False,50,scaffold_9
23,5112001,5115000,2999,False,50,scaffold_9
24,5116001,5237000,120999,False,50,scaffold_9
25,5239001,5298000,58999,False,50,scaffold_9
26,5300001,5490000,189999,False,50,scaffold_9
27,5493001,6331288,838287,True,50,scaffold_9
0,1,414000,413999,True,50,scaffold_10
1,415001,482000,66999,False,50,scaffold_10
2,483001,582000,98999,False,50,scaffold_10
3,603001,795000,191999,False,50,scaffold_10
4,864001,880000,15999,False,50,scaffold_10
5,887001,917000,29999,False,50,scaffold_10
6,923001,963000,39999,False,50,scaffold_10
7,1073001,1112000,38999,False,50,scaffold_10
8,1862001,1892000,29999,False,50,scaffold_10
9,2140001,2175000,34999,False,50,scaffold_10
10,2267001,2300000,32999,False,50,scaffold_10
11,2346001,2425000,78999,False,50,scaffold_10
12,2559001,2577000,17999,False,50,scaffold_10
13,2675001,2693000,17999,False,50,scaffold_10
14,4051001,4091000,39999,False,50,scaffold_10
15,4154001,4174000,19999,False,50,scaffold_10
16,4335001,4362000,26999,False,50,scaffold_10
17,4447001,4462000,14999,False,50,scaffold_10
18,4467001,4477000,9999,False,50,scaffold_10
19,4515001,4523000,7999,False,50,scaffold_10
20,4526001,4548000,21999,False,50,scaffold_10
21,4574001,4596000,21999,False,50,scaffold_10
22,4679001,4688000,8999,False,50,scaffold_10
23,4734001,4751000,16999,False,50,scaffold_10
24,4752001,4766000,13999,False,50,scaffold_10
25,4798001,4824000,25999,False,50,scaffold_10
26,4827001,4843000,15999,False,50,scaffold_10
27,4848001,4861000,12999,False,50,scaffold_10
28,4865001,4866973,1972,True,50,scaffold_10
0,11001,92000,80999,False,50,scaffold_11
1,149001,167000,17999,False,50,scaffold_11
2,169001,191000,21999,False,50,scaffold_11
3,213001,235000,21999,False,50,scaffold_11
4,240001,245000,4999,False,50,scaffold_11
5,419001,431000,11999,False,50,scaffold_11
6,648001,656000,7999,False,50,scaffold_11
7,1025001,1034000,8999,False,50,scaffold_11
8,1405001,1409000,3999,False,50,scaffold_11
9,1423001,1427000,3999,False,50,scaffold_11
10,2701001,2877000,175999,False,50,scaffold_11
11,2954001,3019000,64999,False,50,scaffold_11
12,3083001,3175000,91999,False,50,scaffold_11
13,3188001,3293000,104999,False,50,scaffold_11
14,3327001,3383000,55999,False,50,scaffold_11
15,3449001,3477000,27999,False,50,scaffold_11
16,3520001,3651000,130999,False,50,scaffold_11
17,3702001,3933000,230999,False,50,scaffold_11
18,3991001,4159000,167999,False,50,scaffold_11
19,4180001,4710000,529999,False,50,scaffold_11
20,4712001,4766820,54819,True,50,scaffold_11
0,1,545000,544999,True,50,scaffold_12
1,577001,856000,278999,False,50,scaffold_12
2,864001,1469000,604999,False,50,scaffold_12
3,1720001,1733000,12999,False,50,scaffold_12
4,2043001,2083000,39999,False,50,scaffold_12
5,2090001,2103000,12999,False,50,scaffold_12
6,2130001,2166000,35999,False,50,scaffold_12
7,2344001,2371000,26999,False,50,scaffold_12
8,2571001,2610000,38999,False,50,scaffold_12
0,1,340000,339999,True,51,scaffold_1
1,482001,498000,15999,False,51,scaffold_1
2,574001,643000,68999,False,51,scaffold_1
3,686001,743000,56999,False,51,scaffold_1
4,1281001,1292000,10999,False,51,scaffold_1
5,1817001,1898000,80999,False,51,scaffold_1
6,1951001,1984000,32999,False,51,scaffold_1
7,2449001,2517000,67999,False,51,scaffold_1
8,2727001,2746000,18999,False,51,scaffold_1
9,3179001,3209000,29999,False,51,scaffold_1
10,3448001,3480000,31999,False,51,scaffold_1
11,3714001,3734000,19999,False,51,scaffold_1
12,3916001,3934000,17999,False,51,scaffold_1
13,4062001,4111000,48999,False,51,scaffold_1
14,4322001,4354000,31999,False,51,scaffold_1
15,4928001,5011000,82999,False,51,scaffold_1
16,5091001,5105000,13999,False,51,scaffold_1
17,5482001,5511000,28999,False,51,scaffold_1
18,5536001,5569000,32999,False,51,scaffold_1
19,6108001,6153000,44999,False,51,scaffold_1
20,6154001,6176000,21999,False,51,scaffold_1
21,6228001,6381000,152999,False,51,scaffold_1
22,6384001,6507000,122999,False,51,scaffold_1
23,6544001,6554000,9999,False,51,scaffold_1
24,7038001,7247000,208999,False,51,scaffold_1
25,7248001,7583000,334999,False,51,scaffold_1
26,7590001,8477000,886999,False,51,scaffold_1
27,8478001,8656000,177999,False,51,scaffold_1
28,8658001,9584000,925999,False,51,scaffold_1
29,9586001,10356000,769999,False,51,scaffold_1
30,10461001,10616000,154999,False,51,scaffold_1
31,10808001,10811000,2999,False,51,scaffold_1
32,10836001,10857000,20999,False,51,scaffold_1
33,11280001,11307000,26999,False,51,scaffold_1
34,11344001,11504000,159999,False,51,scaffold_1
35,11614001,11951000,336999,False,51,scaffold_1
36,12184001,12204000,19999,False,51,scaffold_1
37,12650001,12722000,71999,False,51,scaffold_1
38,12777001,12888000,110999,False,51,scaffold_1
39,13113001,13216000,102999,False,51,scaffold_1
40,13347001,13430000,82999,False,51,scaffold_1
41,13562001,13581000,18999,False,51,scaffold_1
42,14093001,14095000,1999,False,51,scaffold_1
43,14287001,14310000,22999,False,51,scaffold_1
44,14471001,14476000,4999,False,51,scaffold_1
45,14605001,14611000,5999,False,51,scaffold_1
46,14649001,14664000,14999,False,51,scaffold_1
0,22001,48000,25999,False,51,scaffold_2
1,93001,159000,65999,False,51,scaffold_2
2,313001,318000,4999,False,51,scaffold_2
3,330001,374000,43999,False,51,scaffold_2
4,2336001,2358000,21999,False,51,scaffold_2
5,2399001,2425000,25999,False,51,scaffold_2
6,2438001,2554000,115999,False,51,scaffold_2
7,2659001,2689000,29999,False,51,scaffold_2
8,2694001,2742000,47999,False,51,scaffold_2
9,2868001,2900000,31999,False,51,scaffold_2
10,3335001,3342000,6999,False,51,scaffold_2
11,3450001,3466000,15999,False,51,scaffold_2
12,3754001,3783000,28999,False,51,scaffold_2
13,4382001,4409000,26999,False,51,scaffold_2
14,4427001,4457000,29999,False,51,scaffold_2
15,4519001,4656000,136999,False,51,scaffold_2
16,5022001,5061000,38999,False,51,scaffold_2
17,5372001,5392000,19999,False,51,scaffold_2
18,5434001,5488000,53999,False,51,scaffold_2
19,5490001,5511000,20999,False,51,scaffold_2
20,5668001,5704000,35999,False,51,scaffold_2
21,5719001,5757000,37999,False,51,scaffold_2
22,6261001,6330000,68999,False,51,scaffold_2
23,6331001,6350000,18999,False,51,scaffold_2
24,6430001,6448000,17999,False,51,scaffold_2
25,7019001,7036000,16999,False,51,scaffold_2
26,7063001,7097000,33999,False,51,scaffold_2
27,7439001,7472000,32999,False,51,scaffold_2
28,7550001,7561000,10999,False,51,scaffold_2
29,7563001,7697000,133999,False,51,scaffold_2
30,7782001,7890000,107999,False,51,scaffold_2
31,7933001,7969000,35999,False,51,scaffold_2
32,7978001,8136000,157999,False,51,scaffold_2
33,8261001,8294000,32999,False,51,scaffold_2
34,8331001,8333000,1999,False,51,scaffold_2
35,8346001,8455000,108999,False,51,scaffold_2
36,8509001,8559000,49999,False,51,scaffold_2
37,9140001,9168000,27999,False,51,scaffold_2
38,11367001,11377000,9999,False,51,scaffold_2
39,11520001,11785000,264999,False,51,scaffold_2
0,799001,900000,100999,False,51,scaffold_3
1,2022001,2108000,85999,False,51,scaffold_3
2,2291001,2326000,34999,False,51,scaffold_3
3,2485001,2533000,47999,False,51,scaffold_3
4,2720001,2729000,8999,False,51,scaffold_3
5,3624001,3639000,14999,False,51,scaffold_3
6,3827001,3845000,17999,False,51,scaffold_3
7,4108001,4403000,294999,False,51,scaffold_3
8,4418001,4518000,99999,False,51,scaffold_3
9,4546001,4558000,11999,False,51,scaffold_3
10,4652001,4685000,32999,False,51,scaffold_3
11,5181001,5192000,10999,False,51,scaffold_3
12,5494001,5509000,14999,False,51,scaffold_3
13,6907001,6962000,54999,False,51,scaffold_3
14,6963001,7089000,125999,False,51,scaffold_3
15,7522001,7556000,33999,False,51,scaffold_3
16,7686001,7798000,111999,False,51,scaffold_3
17,7821001,7854000,32999,False,51,scaffold_3
18,8175001,8253000,77999,False,51,scaffold_3
19,8462001,8527000,64999,False,51,scaffold_3
20,8575001,8594000,18999,False,51,scaffold_3
21,9968001,9996000,27999,False,51,scaffold_3
22,10461001,10485000,23999,False,51,scaffold_3
23,10587001,11163000,575999,False,51,scaffold_3
0,17001,32000,14999,False,51,scaffold_4
1,48001,88000,39999,False,51,scaffold_4
2,155001,160000,4999,False,51,scaffold_4
3,161001,215000,53999,False,51,scaffold_4
4,217001,226000,8999,False,51,scaffold_4
5,227001,266000,38999,False,51,scaffold_4
6,291001,307000,15999,False,51,scaffold_4
7,318001,344000,25999,False,51,scaffold_4
8,355001,374000,18999,False,51,scaffold_4
9,375001,380000,4999,False,51,scaffold_4
10,412001,425000,12999,False,51,scaffold_4
11,429001,498000,68999,False,51,scaffold_4
12,545001,599000,53999,False,51,scaffold_4
13,600001,606000,5999,False,51,scaffold_4
14,608001,691000,82999,False,51,scaffold_4
15,695001,697000,1999,False,51,scaffold_4
16,701001,712000,10999,False,51,scaffold_4
17,1113001,1136000,22999,False,51,scaffold_4
18,1138001,1198000,59999,False,51,scaffold_4
19,1199001,1226000,26999,False,51,scaffold_4
20,1235001,1253000,17999,False,51,scaffold_4
21,1265001,1279000,13999,False,51,scaffold_4
22,1283001,1336000,52999,False,51,scaffold_4
23,1372001,1598000,225999,False,51,scaffold_4
24,1613001,1898000,284999,False,51,scaffold_4
25,1900001,1957000,56999,False,51,scaffold_4
26,1958001,2118000,159999,False,51,scaffold_4
27,2162001,2185000,22999,False,51,scaffold_4
28,2247001,2268000,20999,False,51,scaffold_4
29,2269001,2279000,9999,False,51,scaffold_4
30,2284001,2340000,55999,False,51,scaffold_4
31,2394001,2411000,16999,False,51,scaffold_4
32,2480001,2584000,103999,False,51,scaffold_4
33,2597001,2635000,37999,False,51,scaffold_4
34,3336001,3633000,296999,False,51,scaffold_4
35,3655001,3660000,4999,False,51,scaffold_4
36,3675001,3761000,85999,False,51,scaffold_4
37,4056001,4078000,21999,False,51,scaffold_4
38,4941001,5046000,104999,False,51,scaffold_4
39,5341001,5353000,11999,False,51,scaffold_4
40,5477001,5506000,28999,False,51,scaffold_4
41,5514001,5620000,105999,False,51,scaffold_4
42,5657001,5784000,126999,False,51,scaffold_4
43,6145001,6191000,45999,False,51,scaffold_4
44,6764001,6817000,52999,False,51,scaffold_4
45,6902001,6924000,21999,False,51,scaffold_4
46,6973001,6995000,21999,False,51,scaffold_4
47,7036001,7075000,38999,False,51,scaffold_4
48,7245001,7252000,6999,False,51,scaffold_4
49,8846001,9699000,852999,False,51,scaffold_4
50,9700001,9845951,145950,True,51,scaffold_4
0,1,4000,3999,True,51,scaffold_5
1,151001,174000,22999,False,51,scaffold_5
2,189001,204000,14999,False,51,scaffold_5
3,296001,300000,3999,False,51,scaffold_5
4,318001,326000,7999,False,51,scaffold_5
5,327001,386000,58999,False,51,scaffold_5
6,463001,523000,59999,False,51,scaffold_5
7,933001,947000,13999,False,51,scaffold_5
8,1062001,1071000,8999,False,51,scaffold_5
9,2477001,2493000,15999,False,51,scaffold_5
10,2563001,2738000,174999,False,51,scaffold_5
11,2813001,2871000,57999,False,51,scaffold_5
12,3133001,3185000,51999,False,51,scaffold_5
13,3217001,3247000,29999,False,51,scaffold_5
14,3322001,3510000,187999,False,51,scaffold_5
15,3962001,4101000,138999,False,51,scaffold_5
16,4119001,4219000,99999,False,51,scaffold_5
17,4246001,4272000,25999,False,51,scaffold_5
18,4446001,4506000,59999,False,51,scaffold_5
19,4600001,4861000,260999,False,51,scaffold_5
20,4892001,4918000,25999,False,51,scaffold_5
21,5288001,5312000,23999,False,51,scaffold_5
22,5314001,5346000,31999,False,51,scaffold_5
23,6407001,6420000,12999,False,51,scaffold_5
24,6478001,6652000,173999,False,51,scaffold_5
25,7454001,7483000,28999,False,51,scaffold_5
26,7587001,7609000,21999,False,51,scaffold_5
27,7622001,7654000,31999,False,51,scaffold_5
28,8557001,8565000,7999,False,51,scaffold_5
29,8566001,8616000,49999,False,51,scaffold_5
30,8666001,8687000,20999,False,51,scaffold_5
31,8713001,9363000,649999,False,51,scaffold_5
0,79001,84000,4999,False,51,scaffold_6
1,87001,113000,25999,False,51,scaffold_6
2,239001,254000,14999,False,51,scaffold_6
3,1146001,1163000,16999,False,51,scaffold_6
4,1236001,1256000,19999,False,51,scaffold_6
5,1479001,1546000,66999,False,51,scaffold_6
6,1868001,1906000,37999,False,51,scaffold_6
7,2023001,2087000,63999,False,51,scaffold_6
8,2130001,2193000,62999,False,51,scaffold_6
9,2336001,2595000,258999,False,51,scaffold_6
10,2596001,2654000,57999,False,51,scaffold_6
11,2655001,2691000,35999,False,51,scaffold_6
12,2731001,2851000,119999,False,51,scaffold_6
13,2936001,3017000,80999,False,51,scaffold_6
14,3116001,3191000,74999,False,51,scaffold_6
15,3223001,3301000,77999,False,51,scaffold_6
16,3405001,3428000,22999,False,51,scaffold_6
17,3461001,3767000,305999,False,51,scaffold_6
18,3900001,3912000,11999,False,51,scaffold_6
19,4018001,4072000,53999,False,51,scaffold_6
20,4080001,4193000,112999,False,51,scaffold_6
21,4842001,4870000,27999,False,51,scaffold_6
22,6011001,6084000,72999,False,51,scaffold_6
23,7264001,7337000,72999,False,51,scaffold_6
24,7389001,7436000,46999,False,51,scaffold_6
25,7550001,8268281,718280,True,51,scaffold_6
0,13001,34000,20999,False,51,scaffold_7
1,323001,340000,16999,False,51,scaffold_7
2,342001,508000,165999,False,51,scaffold_7
3,554001,563000,8999,False,51,scaffold_7
4,571001,577000,5999,False,51,scaffold_7
5,706001,736000,29999,False,51,scaffold_7
6,741001,753000,11999,False,51,scaffold_7
7,764001,809000,44999,False,51,scaffold_7
8,859001,864000,4999,False,51,scaffold_7
9,982001,1044000,61999,False,51,scaffold_7
10,1048001,1100000,51999,False,51,scaffold_7
11,1191001,1459000,267999,False,51,scaffold_7
12,1461001,1512000,50999,False,51,scaffold_7
13,1588001,1695000,106999,False,51,scaffold_7
14,3325001,3369000,43999,False,51,scaffold_7
15,3528001,3556000,27999,False,51,scaffold_7
16,3593001,3766000,172999,False,51,scaffold_7
17,4416001,4518000,101999,False,51,scaffold_7
18,4658001,4734000,75999,False,51,scaffold_7
19,4978001,5149000,170999,False,51,scaffold_7
20,5482001,5516000,33999,False,51,scaffold_7
21,5520001,5531000,10999,False,51,scaffold_7
22,6955001,7502216,547215,True,51,scaffold_7
0,66001,85000,18999,False,51,scaffold_8
1,93001,101000,7999,False,51,scaffold_8
2,2444001,2528000,83999,False,51,scaffold_8
3,2536001,2551000,14999,False,51,scaffold_8
4,2652001,2682000,29999,False,51,scaffold_8
5,2742001,2758000,15999,False,51,scaffold_8
6,2808001,2844000,35999,False,51,scaffold_8
7,3058001,3525000,466999,False,51,scaffold_8
8,3580001,3614000,33999,False,51,scaffold_8
9,3615001,3936000,320999,False,51,scaffold_8
10,4038001,4104000,65999,False,51,scaffold_8
11,5186001,5241000,54999,False,51,scaffold_8
12,5761001,5772000,10999,False,51,scaffold_8
13,6324001,6334544,10543,True,51,scaffold_8
0,109001,117000,7999,False,51,scaffold_9
1,121001,134000,12999,False,51,scaffold_9
2,303001,315000,11999,False,51,scaffold_9
3,319001,332000,12999,False,51,scaffold_9
4,366001,411000,44999,False,51,scaffold_9
5,413001,434000,20999,False,51,scaffold_9
6,503001,531000,27999,False,51,scaffold_9
7,670001,696000,25999,False,51,scaffold_9
8,732001,742000,9999,False,51,scaffold_9
9,794001,800000,5999,False,51,scaffold_9
10,815001,843000,27999,False,51,scaffold_9
11,873001,986000,112999,False,51,scaffold_9
12,987001,995000,7999,False,51,scaffold_9
13,1001001,1007000,5999,False,51,scaffold_9
14,1010001,1085000,74999,False,51,scaffold_9
15,1087001,1150000,62999,False,51,scaffold_9
16,1151001,1165000,13999,False,51,scaffold_9
17,1312001,1378000,65999,False,51,scaffold_9
18,1486001,1500000,13999,False,51,scaffold_9
19,1759001,1791000,31999,False,51,scaffold_9
20,1970001,1978000,7999,False,51,scaffold_9
21,2001001,2030000,28999,False,51,scaffold_9
22,2077001,2133000,55999,False,51,scaffold_9
23,2148001,2167000,18999,False,51,scaffold_9
24,2599001,2616000,16999,False,51,scaffold_9
25,2782001,2803000,20999,False,51,scaffold_9
26,2848001,3381000,532999,False,51,scaffold_9
27,3383001,5100000,1716999,False,51,scaffold_9
28,5101001,5107000,5999,False,51,scaffold_9
29,5112001,5238000,125999,False,51,scaffold_9
30,5239001,5298000,58999,False,51,scaffold_9
31,5299001,5490000,190999,False,51,scaffold_9
32,5491001,6331288,840287,True,51,scaffold_9
0,1,136000,135999,True,51,scaffold_10
1,137001,212000,74999,False,51,scaffold_10
2,281001,407000,125999,False,51,scaffold_10
3,416001,482000,65999,False,51,scaffold_10
4,483001,576000,92999,False,51,scaffold_10
5,603001,795000,191999,False,51,scaffold_10
6,888001,916000,27999,False,51,scaffold_10
7,924001,962000,37999,False,51,scaffold_10
8,1073001,1113000,39999,False,51,scaffold_10
9,2141001,2167000,25999,False,51,scaffold_10
10,2268001,2296000,27999,False,51,scaffold_10
11,2346001,2391000,44999,False,51,scaffold_10
12,4053001,4091000,37999,False,51,scaffold_10
13,4154001,4174000,19999,False,51,scaffold_10
14,4445001,4462000,16999,False,51,scaffold_10
15,4467001,4476000,8999,False,51,scaffold_10
16,4503001,4513000,9999,False,51,scaffold_10
17,4515001,4523000,7999,False,51,scaffold_10
18,4526001,4548000,21999,False,51,scaffold_10
19,4576001,4595000,18999,False,51,scaffold_10
20,4679001,4688000,8999,False,51,scaffold_10
21,4734001,4776000,41999,False,51,scaffold_10
22,4798001,4824000,25999,False,51,scaffold_10
23,4828001,4843000,14999,False,51,scaffold_10
24,4848001,4861000,12999,False,51,scaffold_10
25,4865001,4866973,1972,True,51,scaffold_10
0,11001,34000,22999,False,51,scaffold_11
1,40001,89000,48999,False,51,scaffold_11
2,149001,167000,17999,False,51,scaffold_11
3,169001,189000,19999,False,51,scaffold_11
4,214001,235000,20999,False,51,scaffold_11
5,240001,248000,7999,False,51,scaffold_11
6,419001,431000,11999,False,51,scaffold_11
7,648001,656000,7999,False,51,scaffold_11
8,1025001,1034000,8999,False,51,scaffold_11
9,1423001,1426000,2999,False,51,scaffold_11
10,1474001,1477000,2999,False,51,scaffold_11
11,2701001,2875000,173999,False,51,scaffold_11
12,2983001,3018000,34999,False,51,scaffold_11
13,3089001,3127000,37999,False,51,scaffold_11
14,3188001,3261000,72999,False,51,scaffold_11
15,3331001,3383000,51999,False,51,scaffold_11
16,3433001,3477000,43999,False,51,scaffold_11
17,3521001,3651000,129999,False,51,scaffold_11
18,3702001,3932000,229999,False,51,scaffold_11
19,4010001,4159000,148999,False,51,scaffold_11
20,4189001,4211000,21999,False,51,scaffold_11
21,4256001,4710000,453999,False,51,scaffold_11
22,4713001,4766820,53819,True,51,scaffold_11
0,1,370000,369999,True,51,scaffold_12
1,402001,551000,148999,False,51,scaffold_12
2,579001,857000,277999,False,51,scaffold_12
3,863001,1469000,605999,False,51,scaffold_12
4,1719001,1733000,13999,False,51,scaffold_12
5,2088001,2103000,14999,False,51,scaffold_12
6,2571001,2609000,37999,False,51,scaffold_12
7,2747001,2747968,967,True,51,scaffold_12
0,1,342000,341999,True,52,scaffold_1
1,482001,498000,15999,False,52,scaffold_1
2,571001,642000,70999,False,52,scaffold_1
3,686001,750000,63999,False,52,scaffold_1
4,1280001,1292000,11999,False,52,scaffold_1
5,1618001,1660000,41999,False,52,scaffold_1
6,1809001,1900000,90999,False,52,scaffold_1
7,1920001,1984000,63999,False,52,scaffold_1
8,1986001,1994000,7999,False,52,scaffold_1
9,2270001,2301000,30999,False,52,scaffold_1
10,2372001,2383000,10999,False,52,scaffold_1
11,2449001,2520000,70999,False,52,scaffold_1
12,2726001,2746000,19999,False,52,scaffold_1
13,2900001,2925000,24999,False,52,scaffold_1
14,3179001,3209000,29999,False,52,scaffold_1
15,3471001,3476000,4999,False,52,scaffold_1
16,3684001,3754000,69999,False,52,scaffold_1
17,3848001,3881000,32999,False,52,scaffold_1
18,3901001,3941000,39999,False,52,scaffold_1
19,3991001,4032000,40999,False,52,scaffold_1
20,4063001,4112000,48999,False,52,scaffold_1
21,4305001,4375000,69999,False,52,scaffold_1
22,4796001,4809000,12999,False,52,scaffold_1
23,4925001,5025000,99999,False,52,scaffold_1
24,5087001,5115000,27999,False,52,scaffold_1
25,5481001,5514000,32999,False,52,scaffold_1
26,5535001,5580000,44999,False,52,scaffold_1
27,5850001,5911000,60999,False,52,scaffold_1
28,6108001,6380000,271999,False,52,scaffold_1
29,6384001,6531000,146999,False,52,scaffold_1
30,6542001,6564000,21999,False,52,scaffold_1
31,6642001,6659000,16999,False,52,scaffold_1
32,6834001,6856000,21999,False,52,scaffold_1
33,7038001,7584000,545999,False,52,scaffold_1
34,7590001,8656000,1065999,False,52,scaffold_1
35,8658001,9584000,925999,False,52,scaffold_1
36,9586001,10369000,782999,False,52,scaffold_1
37,10460001,10640000,179999,False,52,scaffold_1
38,10688001,10763000,74999,False,52,scaffold_1
39,10835001,10857000,21999,False,52,scaffold_1
40,10898001,10987000,88999,False,52,scaffold_1
41,11278001,11538000,259999,False,52,scaffold_1
42,11551001,11962000,410999,False,52,scaffold_1
43,12184001,12205000,20999,False,52,scaffold_1
44,12424001,12459000,34999,False,52,scaffold_1
45,12651001,12722000,70999,False,52,scaffold_1
46,12733001,12756000,22999,False,52,scaffold_1
47,12774001,12950000,175999,False,52,scaffold_1
48,12968001,13002000,33999,False,52,scaffold_1
49,13095001,13216000,120999,False,52,scaffold_1
50,13346001,13431000,84999,False,52,scaffold_1
51,13517001,13538000,20999,False,52,scaffold_1
52,13559001,13585000,25999,False,52,scaffold_1
53,13816001,13845000,28999,False,52,scaffold_1
54,14193001,14199000,5999,False,52,scaffold_1
55,14288001,14309000,20999,False,52,scaffold_1
0,20001,48000,27999,False,52,scaffold_2
1,95001,159000,63999,False,52,scaffold_2
2,165001,176000,10999,False,52,scaffold_2
3,296001,318000,21999,False,52,scaffold_2
4,330001,374000,43999,False,52,scaffold_2
5,729001,739000,9999,False,52,scaffold_2
6,2083001,2101000,17999,False,52,scaffold_2
7,2336001,2388000,51999,False,52,scaffold_2
8,2397001,2608000,210999,False,52,scaffold_2
9,2626001,2639000,12999,False,52,scaffold_2
10,2645001,2689000,43999,False,52,scaffold_2
11,2694001,2747000,52999,False,52,scaffold_2
12,2819001,2856000,36999,False,52,scaffold_2
13,2868001,2910000,41999,False,52,scaffold_2
14,2976001,3021000,44999,False,52,scaffold_2
15,3333001,3343000,9999,False,52,scaffold_2
16,3360001,3390000,29999,False,52,scaffold_2
17,3450001,3487000,36999,False,52,scaffold_2
18,3539001,3575000,35999,False,52,scaffold_2
19,3670001,3690000,19999,False,52,scaffold_2
20,3754001,3790000,35999,False,52,scaffold_2
21,4242001,4278000,35999,False,52,scaffold_2
22,4342001,4409000,66999,False,52,scaffold_2
23,4426001,4457000,30999,False,52,scaffold_2
24,4521001,4657000,135999,False,52,scaffold_2
25,4715001,4790000,74999,False,52,scaffold_2
26,4793001,4814000,20999,False,52,scaffold_2
27,4916001,4963000,46999,False,52,scaffold_2
28,5021001,5104000,82999,False,52,scaffold_2
29,5286001,5314000,27999,False,52,scaffold_2
30,5367001,5401000,33999,False,52,scaffold_2
31,5413001,5532000,118999,False,52,scaffold_2
32,5619001,5709000,89999,False,52,scaffold_2
33,5717001,5757000,39999,False,52,scaffold_2
34,5827001,6053000,225999,False,52,scaffold_2
35,6108001,6138000,29999,False,52,scaffold_2
36,6261001,6351000,89999,False,52,scaffold_2
37,6404001,6449000,44999,False,52,scaffold_2
38,6590001,6628000,37999,False,52,scaffold_2
39,6811001,6899000,87999,False,52,scaffold_2
40,7005001,7040000,34999,False,52,scaffold_2
41,7050001,7118000,67999,False,52,scaffold_2
42,7385001,7518000,132999,False,52,scaffold_2
43,7548001,7561000,12999,False,52,scaffold_2
44,7563001,7707000,143999,False,52,scaffold_2
45,7785001,7915000,129999,False,52,scaffold_2
46,7928001,8313000,384999,False,52,scaffold_2
47,8331001,8333000,1999,False,52,scaffold_2
48,8335001,8345000,9999,False,52,scaffold_2
49,8346001,8454000,107999,False,52,scaffold_2
50,8465001,8494000,28999,False,52,scaffold_2
51,8495001,8563000,67999,False,52,scaffold_2
52,9009001,9050000,40999,False,52,scaffold_2
53,9139001,9174000,34999,False,52,scaffold_2
54,9350001,9382000,31999,False,52,scaffold_2
55,9601001,9636000,34999,False,52,scaffold_2
56,11519001,11786000,266999,False,52,scaffold_2
0,352001,365000,12999,False,52,scaffold_3
1,618001,646000,27999,False,52,scaffold_3
2,795001,900000,104999,False,52,scaffold_3
3,1940001,1950000,9999,False,52,scaffold_3
4,2008001,2108000,99999,False,52,scaffold_3
5,2109001,2116000,6999,False,52,scaffold_3
6,2291001,2321000,29999,False,52,scaffold_3
7,2433001,2531000,97999,False,52,scaffold_3
8,2623001,2682000,58999,False,52,scaffold_3
9,2717001,2736000,18999,False,52,scaffold_3
10,3065001,3095000,29999,False,52,scaffold_3
11,3656001,3691000,34999,False,52,scaffold_3
12,3713001,3821000,107999,False,52,scaffold_3
13,3822001,3893000,70999,False,52,scaffold_3
14,4104001,4401000,296999,False,52,scaffold_3
15,4415001,4519000,103999,False,52,scaffold_3
16,4547001,4558000,10999,False,52,scaffold_3
17,4641001,4689000,47999,False,52,scaffold_3
18,5158001,5196000,37999,False,52,scaffold_3
19,5493001,5509000,15999,False,52,scaffold_3
20,5806001,5918000,111999,False,52,scaffold_3
21,5919001,5947000,27999,False,52,scaffold_3
22,5976001,6020000,43999,False,52,scaffold_3
23,6543001,6580000,36999,False,52,scaffold_3
24,6745001,6807000,61999,False,52,scaffold_3
25,6910001,6962000,51999,False,52,scaffold_3
26,6963001,7090000,126999,False,52,scaffold_3
27,7286001,7321000,34999,False,52,scaffold_3
28,7336001,7397000,60999,False,52,scaffold_3
29,7449001,7458000,8999,False,52,scaffold_3
30,7483001,7556000,72999,False,52,scaffold_3
31,7678001,7856000,177999,False,52,scaffold_3
32,7913001,7934000,20999,False,52,scaffold_3
33,8028001,8070000,41999,False,52,scaffold_3
34,8121001,8156000,34999,False,52,scaffold_3
35,8183001,8253000,69999,False,52,scaffold_3
36,8398001,8449000,50999,False,52,scaffold_3
37,8462001,8528000,65999,False,52,scaffold_3
38,8575001,8593000,17999,False,52,scaffold_3
39,9005001,9085000,79999,False,52,scaffold_3
40,9968001,9995000,26999,False,52,scaffold_3
41,10065001,10087000,21999,False,52,scaffold_3
42,10461001,10486000,24999,False,52,scaffold_3
43,10550001,10573000,22999,False,52,scaffold_3
44,10574001,11182071,608070,True,52,scaffold_3
0,11001,13000,1999,False,52,scaffold_4
1,17001,32000,14999,False,52,scaffold_4
2,48001,116000,67999,False,52,scaffold_4
3,120001,146000,25999,False,52,scaffold_4
4,147001,151000,3999,False,52,scaffold_4
5,155001,215000,59999,False,52,scaffold_4
6,217001,266000,48999,False,52,scaffold_4
7,283001,344000,60999,False,52,scaffold_4
8,345001,353000,7999,False,52,scaffold_4
9,355001,374000,18999,False,52,scaffold_4
10,375001,380000,4999,False,52,scaffold_4
11,383001,425000,41999,False,52,scaffold_4
12,429001,592000,162999,False,52,scaffold_4
13,600001,606000,5999,False,52,scaffold_4
14,608001,691000,82999,False,52,scaffold_4
15,1053001,1081000,27999,False,52,scaffold_4
16,1087001,1136000,48999,False,52,scaffold_4
17,1138001,1198000,59999,False,52,scaffold_4
18,1199001,1226000,26999,False,52,scaffold_4
19,1268001,1279000,10999,False,52,scaffold_4
20,1283001,1597000,313999,False,52,scaffold_4
21,1613001,2114000,500999,False,52,scaffold_4
22,2142001,2185000,42999,False,52,scaffold_4
23,2207001,2246000,38999,False,52,scaffold_4
24,2247001,2281000,33999,False,52,scaffold_4
25,2282001,2462000,179999,False,52,scaffold_4
26,2480001,2635000,154999,False,52,scaffold_4
27,2700001,2790000,89999,False,52,scaffold_4
28,2918001,2959000,40999,False,52,scaffold_4
29,3032001,3130000,97999,False,52,scaffold_4
30,3335001,3763000,427999,False,52,scaffold_4
31,4055001,4105000,49999,False,52,scaffold_4
32,4282001,4306000,23999,False,52,scaffold_4
33,4900001,5102000,201999,False,52,scaffold_4
34,5172001,5243000,70999,False,52,scaffold_4
35,5393001,5407000,13999,False,52,scaffold_4
36,5476001,5506000,29999,False,52,scaffold_4
37,5514001,5784000,269999,False,52,scaffold_4
38,5786001,5825000,38999,False,52,scaffold_4
39,6067001,6093000,25999,False,52,scaffold_4
40,6148001,6244000,95999,False,52,scaffold_4
41,6323001,6359000,35999,False,52,scaffold_4
42,6723001,6747000,23999,False,52,scaffold_4
43,6795001,6817000,21999,False,52,scaffold_4
44,6879001,6924000,44999,False,52,scaffold_4
45,6950001,6996000,45999,False,52,scaffold_4
46,7036001,7124000,87999,False,52,scaffold_4
47,7207001,7293000,85999,False,52,scaffold_4
48,7352001,7401000,48999,False,52,scaffold_4
49,7550001,7570000,19999,False,52,scaffold_4
50,7629001,7665000,35999,False,52,scaffold_4
51,7856001,7875000,18999,False,52,scaffold_4
52,8701001,8769000,67999,False,52,scaffold_4
53,8846001,9699000,852999,False,52,scaffold_4
54,9700001,9845951,145950,True,52,scaffold_4
0,28001,32000,3999,False,52,scaffold_5
1,141001,172000,30999,False,52,scaffold_5
2,185001,202000,16999,False,52,scaffold_5
3,318001,401000,82999,False,52,scaffold_5
4,402001,428000,25999,False,52,scaffold_5
5,463001,524000,60999,False,52,scaffold_5
6,669001,699000,29999,False,52,scaffold_5
7,931001,952000,20999,False,52,scaffold_5
8,1275001,1283000,7999,False,52,scaffold_5
9,2265001,2283000,17999,False,52,scaffold_5
10,2510001,2515000,4999,False,52,scaffold_5
11,2516001,2522000,5999,False,52,scaffold_5
12,2552001,2871000,318999,False,52,scaffold_5
13,2943001,2993000,49999,False,52,scaffold_5
14,3133001,3248000,114999,False,52,scaffold_5
15,3322001,3556000,233999,False,52,scaffold_5
16,3617001,3659000,41999,False,52,scaffold_5
17,3959001,4101000,141999,False,52,scaffold_5
18,4120001,4356000,235999,False,52,scaffold_5
19,4445001,4926000,480999,False,52,scaffold_5
20,4951001,4992000,40999,False,52,scaffold_5
21,5059001,5110000,50999,False,52,scaffold_5
22,5249001,5345000,95999,False,52,scaffold_5
23,5510001,5527000,16999,False,52,scaffold_5
24,6394001,6435000,40999,False,52,scaffold_5
25,6457001,6727000,269999,False,52,scaffold_5
26,6888001,6908000,19999,False,52,scaffold_5
27,7406001,7441000,34999,False,52,scaffold_5
28,7454001,7514000,59999,False,52,scaffold_5
29,7559001,7619000,59999,False,52,scaffold_5
30,7621001,7656000,34999,False,52,scaffold_5
31,7714001,7749000,34999,False,52,scaffold_5
32,8416001,8470000,53999,False,52,scaffold_5
33,8553001,8617000,63999,False,52,scaffold_5
34,8659001,8687000,27999,False,52,scaffold_5
35,8713001,9364176,651175,True,52,scaffold_5
0,42001,74000,31999,False,52,scaffold_6
1,78001,84000,5999,False,52,scaffold_6
2,86001,112000,25999,False,52,scaffold_6
3,171001,208000,36999,False,52,scaffold_6
4,239001,358000,118999,False,52,scaffold_6
5,553001,575000,21999,False,52,scaffold_6
6,987001,1001000,13999,False,52,scaffold_6
7,1018001,1034000,15999,False,52,scaffold_6
8,1146001,1226000,79999,False,52,scaffold_6
9,1228001,1265000,36999,False,52,scaffold_6
10,1286001,1311000,24999,False,52,scaffold_6
11,1428001,1470000,41999,False,52,scaffold_6
12,1475001,1595000,119999,False,52,scaffold_6
13,1657001,1711000,53999,False,52,scaffold_6
14,1832001,1901000,68999,False,52,scaffold_6
15,2025001,2104000,78999,False,52,scaffold_6
16,2130001,2211000,80999,False,52,scaffold_6
17,2236001,2286000,49999,False,52,scaffold_6
18,2340001,2872000,531999,False,52,scaffold_6
19,2936001,3026000,89999,False,52,scaffold_6
20,3083001,3210000,126999,False,52,scaffold_6
21,3223001,3343000,119999,False,52,scaffold_6
22,3394001,3795000,400999,False,52,scaffold_6
23,3878001,3935000,56999,False,52,scaffold_6
24,3965001,4195000,229999,False,52,scaffold_6
25,4835001,4870000,34999,False,52,scaffold_6
26,5577001,5649000,71999,False,52,scaffold_6
27,5680001,5713000,32999,False,52,scaffold_6
28,5884001,5972000,87999,False,52,scaffold_6
29,6004001,6094000,89999,False,52,scaffold_6
30,6122001,6190000,67999,False,52,scaffold_6
31,6783001,6805000,21999,False,52,scaffold_6
32,7182001,7248000,65999,False,52,scaffold_6
33,7256001,7339000,82999,False,52,scaffold_6
34,7389001,7476000,86999,False,52,scaffold_6
35,7550001,8268281,718280,True,52,scaffold_6
0,13001,31000,17999,False,52,scaffold_7
1,292001,340000,47999,False,52,scaffold_7
2,342001,508000,165999,False,52,scaffold_7
3,623001,736000,112999,False,52,scaffold_7
4,743001,754000,10999,False,52,scaffold_7
5,764001,829000,64999,False,52,scaffold_7
6,865001,948000,82999,False,52,scaffold_7
7,968001,980000,11999,False,52,scaffold_7
8,982001,1044000,61999,False,52,scaffold_7
9,1048001,1136000,87999,False,52,scaffold_7
10,1137001,1146000,8999,False,52,scaffold_7
11,1169001,1187000,17999,False,52,scaffold_7
12,1190001,1512000,321999,False,52,scaffold_7
13,1588001,1688000,99999,False,52,scaffold_7
14,1817001,1894000,76999,False,52,scaffold_7
15,2853001,2879000,25999,False,52,scaffold_7
16,3292001,3373000,80999,False,52,scaffold_7
17,3520001,3809000,288999,False,52,scaffold_7
18,4022001,4057000,34999,False,52,scaffold_7
19,4412001,4512000,99999,False,52,scaffold_7
20,4548001,4580000,31999,False,52,scaffold_7
21,4635001,4855000,219999,False,52,scaffold_7
22,4978001,5157000,178999,False,52,scaffold_7
23,5471001,5536000,64999,False,52,scaffold_7
24,6166001,6203000,36999,False,52,scaffold_7
25,6563001,6685000,121999,False,52,scaffold_7
26,6695001,6722000,26999,False,52,scaffold_7
27,6751001,6797000,45999,False,52,scaffold_7
28,6953001,7270000,316999,False,52,scaffold_7
29,7271001,7502216,231215,True,52,scaffold_7
0,1,7000,6999,True,52,scaffold_8
1,31001,85000,53999,False,52,scaffold_8
2,93001,102000,8999,False,52,scaffold_8
3,1031001,1047000,15999,False,52,scaffold_8
4,1392001,1422000,29999,False,52,scaffold_8
5,2333001,2400000,66999,False,52,scaffold_8
6,2413001,2587000,173999,False,52,scaffold_8
7,2646001,2690000,43999,False,52,scaffold_8
8,2741001,2844000,102999,False,52,scaffold_8
9,2847001,2873000,25999,False,52,scaffold_8
10,3058001,3612000,553999,False,52,scaffold_8
11,3615001,3947000,331999,False,52,scaffold_8
12,4039001,4108000,68999,False,52,scaffold_8
13,4166001,4221000,54999,False,52,scaffold_8
14,4399001,4432000,32999,False,52,scaffold_8
15,4819001,4848000,28999,False,52,scaffold_8
16,5027001,5055000,27999,False,52,scaffold_8
17,5076001,5241000,164999,False,52,scaffold_8
18,5578001,5595000,16999,False,52,scaffold_8
19,5651001,5692000,40999,False,52,scaffold_8
20,5750001,5774000,23999,False,52,scaffold_8
21,5776001,5856000,79999,False,52,scaffold_8
22,6320001,6334544,14543,True,52,scaffold_8
0,1001,19000,17999,False,52,scaffold_9
1,109001,119000,9999,False,52,scaffold_9
2,121001,148000,26999,False,52,scaffold_9
3,236001,242000,5999,False,52,scaffold_9
4,357001,411000,53999,False,52,scaffold_9
5,413001,434000,20999,False,52,scaffold_9
6,478001,531000,52999,False,52,scaffold_9
7,547001,563000,15999,False,52,scaffold_9
8,652001,665000,12999,False,52,scaffold_9
9,669001,696000,26999,False,52,scaffold_9
10,730001,742000,11999,False,52,scaffold_9
11,815001,842000,26999,False,52,scaffold_9
12,883001,986000,102999,False,52,scaffold_9
13,988001,995000,6999,False,52,scaffold_9
14,997001,1000000,2999,False,52,scaffold_9
15,1001001,1007000,5999,False,52,scaffold_9
16,1009001,1085000,75999,False,52,scaffold_9
17,1087001,1167000,79999,False,52,scaffold_9
18,1311001,1377000,65999,False,52,scaffold_9
19,1427001,1443000,15999,False,52,scaffold_9
20,1457001,1464000,6999,False,52,scaffold_9
21,1483001,1499000,15999,False,52,scaffold_9
22,1599001,1621000,21999,False,52,scaffold_9
23,1655001,1692000,36999,False,52,scaffold_9
24,1749001,1791000,41999,False,52,scaffold_9
25,1986001,2037000,50999,False,52,scaffold_9
26,2038001,2058000,19999,False,52,scaffold_9
27,2075001,2133000,57999,False,52,scaffold_9
28,2594001,2665000,70999,False,52,scaffold_9
29,2737001,3381000,643999,False,52,scaffold_9
30,3383001,5107000,1723999,False,52,scaffold_9
31,5112001,5114000,1999,False,52,scaffold_9
32,5116001,5298000,181999,False,52,scaffold_9
33,5299001,5491000,191999,False,52,scaffold_9
34,5493001,6331288,838287,True,52,scaffold_9
0,1,136000,135999,True,52,scaffold_10
1,137001,482000,344999,False,52,scaffold_10
2,483001,583000,99999,False,52,scaffold_10
3,603001,988000,384999,False,52,scaffold_10
4,1036001,1069000,32999,False,52,scaffold_10
5,1073001,1148000,74999,False,52,scaffold_10
6,1371001,1437000,65999,False,52,scaffold_10
7,1447001,1473000,25999,False,52,scaffold_10
8,1509001,1569000,59999,False,52,scaffold_10
9,1795001,1821000,25999,False,52,scaffold_10
10,2087001,2110000,22999,False,52,scaffold_10
11,2129001,2169000,39999,False,52,scaffold_10
12,2268001,2307000,38999,False,52,scaffold_10
13,2346001,2425000,78999,False,52,scaffold_10
14,2545001,2577000,31999,False,52,scaffold_10
15,2603001,2655000,51999,False,52,scaffold_10
16,2701001,2711000,9999,False,52,scaffold_10
17,2788001,2812000,23999,False,52,scaffold_10
18,2817001,2857000,39999,False,52,scaffold_10
19,3153001,3182000,28999,False,52,scaffold_10
20,3314001,3322000,7999,False,52,scaffold_10
21,3590001,3595000,4999,False,52,scaffold_10
22,3633001,3674000,40999,False,52,scaffold_10
23,4000001,4013000,12999,False,52,scaffold_10
24,4046001,4113000,66999,False,52,scaffold_10
25,4154001,4174000,19999,False,52,scaffold_10
26,4336001,4365000,28999,False,52,scaffold_10
27,4401001,4428000,26999,False,52,scaffold_10
28,4443001,4462000,18999,False,52,scaffold_10
29,4467001,4513000,45999,False,52,scaffold_10
30,4515001,4523000,7999,False,52,scaffold_10
31,4526001,4548000,21999,False,52,scaffold_10
32,4553001,4562000,8999,False,52,scaffold_10
33,4565001,4596000,30999,False,52,scaffold_10
34,4727001,4732000,4999,False,52,scaffold_10
35,4734001,4766000,31999,False,52,scaffold_10
36,4798001,4824000,25999,False,52,scaffold_10
37,4827001,4843000,15999,False,52,scaffold_10
38,4848001,4861000,12999,False,52,scaffold_10
39,4865001,4866973,1972,True,52,scaffold_10
0,14001,93000,78999,False,52,scaffold_11
1,132001,167000,34999,False,52,scaffold_11
2,169001,212000,42999,False,52,scaffold_11
3,213001,235000,21999,False,52,scaffold_11
4,240001,249000,8999,False,52,scaffold_11
5,288001,320000,31999,False,52,scaffold_11
6,419001,431000,11999,False,52,scaffold_11
7,648001,656000,7999,False,52,scaffold_11
8,703001,707000,3999,False,52,scaffold_11
9,1403001,1409000,5999,False,52,scaffold_11
10,1969001,1983000,13999,False,52,scaffold_11
11,2007001,2060000,52999,False,52,scaffold_11
12,2688001,2874000,185999,False,52,scaffold_11
13,2946001,3018000,71999,False,52,scaffold_11
14,3083001,3176000,92999,False,52,scaffold_11
15,3185001,3325000,139999,False,52,scaffold_11
16,3327001,3383000,55999,False,52,scaffold_11
17,3429001,3480000,50999,False,52,scaffold_11
18,3519001,3932000,412999,False,52,scaffold_11
19,3948001,3975000,26999,False,52,scaffold_11
20,3984001,4159000,174999,False,52,scaffold_11
21,4174001,4710000,535999,False,52,scaffold_11
22,4713001,4766820,53819,True,52,scaffold_11
0,1,1469000,1468999,True,52,scaffold_12
1,1563001,1587000,23999,False,52,scaffold_12
2,1717001,1733000,15999,False,52,scaffold_12
3,1968001,2001000,32999,False,52,scaffold_12
4,2040001,2066000,25999,False,52,scaffold_12
5,2067001,2097000,29999,False,52,scaffold_12
6,2135001,2161000,25999,False,52,scaffold_12
7,2559001,2570000,10999,False,52,scaffold_12
8,2571001,2610000,38999,False,52,scaffold_12
9,2659001,2682000,22999,False,52,scaffold_12
0,1,342000,341999,True,53,scaffold_1
1,482001,498000,15999,False,53,scaffold_1
2,574001,643000,68999,False,53,scaffold_1
3,686001,743000,56999,False,53,scaffold_1
4,1281001,1292000,10999,False,53,scaffold_1
5,1816001,1898000,81999,False,53,scaffold_1
6,1950001,1984000,33999,False,53,scaffold_1
7,2449001,2517000,67999,False,53,scaffold_1
8,2567001,2578000,10999,False,53,scaffold_1
9,2726001,2746000,19999,False,53,scaffold_1
10,3179001,3208000,28999,False,53,scaffold_1
11,3715001,3732000,16999,False,53,scaffold_1
12,3916001,3941000,24999,False,53,scaffold_1
13,4063001,4111000,47999,False,53,scaffold_1
14,4322001,4354000,31999,False,53,scaffold_1
15,4927001,4997000,69999,False,53,scaffold_1
16,5481001,5521000,39999,False,53,scaffold_1
17,5538001,5569000,30999,False,53,scaffold_1
18,6108001,6153000,44999,False,53,scaffold_1
19,6154001,6176000,21999,False,53,scaffold_1
20,6202001,6381000,178999,False,53,scaffold_1
21,6384001,6507000,122999,False,53,scaffold_1
22,6544001,6554000,9999,False,53,scaffold_1
23,7038001,7247000,208999,False,53,scaffold_1
24,7248001,7584000,335999,False,53,scaffold_1
25,7590001,8656000,1065999,False,53,scaffold_1
26,8658001,9584000,925999,False,53,scaffold_1
27,9586001,10355000,768999,False,53,scaffold_1
28,10461001,10609000,147999,False,53,scaffold_1
29,10808001,10811000,2999,False,53,scaffold_1
30,10836001,10858000,21999,False,53,scaffold_1
31,11346001,11508000,161999,False,53,scaffold_1
32,11612001,11951000,338999,False,53,scaffold_1
33,12184001,12203000,18999,False,53,scaffold_1
34,12652001,12722000,69999,False,53,scaffold_1
35,12777001,12888000,110999,False,53,scaffold_1
36,13113001,13150000,36999,False,53,scaffold_1
37,13178001,13211000,32999,False,53,scaffold_1
38,13347001,13405000,57999,False,53,scaffold_1
39,14162001,14164000,1999,False,53,scaffold_1
40,14455001,14457000,1999,False,53,scaffold_1
41,14605001,14611000,5999,False,53,scaffold_1
0,22001,48000,25999,False,53,scaffold_2
1,93001,159000,65999,False,53,scaffold_2
2,168001,177000,8999,False,53,scaffold_2
3,300001,318000,17999,False,53,scaffold_2
4,330001,374000,43999,False,53,scaffold_2
5,2336001,2358000,21999,False,53,scaffold_2
6,2399001,2424000,24999,False,53,scaffold_2
7,2441001,2555000,113999,False,53,scaffold_2
8,2665001,2689000,23999,False,53,scaffold_2
9,2694001,2743000,48999,False,53,scaffold_2
10,2868001,2899000,30999,False,53,scaffold_2
11,2994001,3012000,17999,False,53,scaffold_2
12,3451001,3464000,12999,False,53,scaffold_2
13,3754001,3783000,28999,False,53,scaffold_2
14,4385001,4409000,23999,False,53,scaffold_2
15,4429001,4455000,25999,False,53,scaffold_2
16,4523001,4554000,30999,False,53,scaffold_2
17,4592001,4654000,61999,False,53,scaffold_2
18,4783001,4790000,6999,False,53,scaffold_2
19,5022001,5031000,8999,False,53,scaffold_2
20,5033001,5061000,27999,False,53,scaffold_2
21,5446001,5488000,41999,False,53,scaffold_2
22,5490001,5512000,21999,False,53,scaffold_2
23,5677001,5704000,26999,False,53,scaffold_2
24,5719001,5757000,37999,False,53,scaffold_2
25,6261001,6330000,68999,False,53,scaffold_2
26,6331001,6350000,18999,False,53,scaffold_2
27,6428001,6449000,20999,False,53,scaffold_2
28,7021001,7031000,9999,False,53,scaffold_2
29,7064001,7089000,24999,False,53,scaffold_2
30,7439001,7472000,32999,False,53,scaffold_2
31,7563001,7697000,133999,False,53,scaffold_2
32,7785001,7890000,104999,False,53,scaffold_2
33,7934001,8089000,154999,False,53,scaffold_2
34,8261001,8294000,32999,False,53,scaffold_2
35,8331001,8333000,1999,False,53,scaffold_2
36,8334001,8344000,9999,False,53,scaffold_2
37,8346001,8395000,48999,False,53,scaffold_2
38,8416001,8453000,36999,False,53,scaffold_2
39,8509001,8560000,50999,False,53,scaffold_2
40,11366001,11375000,8999,False,53,scaffold_2
41,11520001,11786000,265999,False,53,scaffold_2
0,1,2000,1999,True,53,scaffold_3
1,51001,55000,3999,False,53,scaffold_3
2,203001,207000,3999,False,53,scaffold_3
3,799001,900000,100999,False,53,scaffold_3
4,2043001,2107000,63999,False,53,scaffold_3
5,2291001,2321000,29999,False,53,scaffold_3
6,2487001,2533000,45999,False,53,scaffold_3
7,3832001,3840000,7999,False,53,scaffold_3
8,4109001,4403000,293999,False,53,scaffold_3
9,4410001,4518000,107999,False,53,scaffold_3
10,4547001,4558000,10999,False,53,scaffold_3
11,4653001,4678000,24999,False,53,scaffold_3
12,5493001,5509000,15999,False,53,scaffold_3
13,5975001,6024000,48999,False,53,scaffold_3
14,6910001,6970000,59999,False,53,scaffold_3
15,6979001,7079000,99999,False,53,scaffold_3
16,7525001,7556000,30999,False,53,scaffold_3
17,7686001,7799000,112999,False,53,scaffold_3
18,7822001,7839000,16999,False,53,scaffold_3
19,8177001,8253000,75999,False,53,scaffold_3
20,8462001,8527000,64999,False,53,scaffold_3
21,8575001,8594000,18999,False,53,scaffold_3
22,9968001,9995000,26999,False,53,scaffold_3
23,10461001,10485000,23999,False,53,scaffold_3
24,10587001,11164000,576999,False,53,scaffold_3
0,11001,13000,1999,False,53,scaffold_4
1,17001,32000,14999,False,53,scaffold_4
2,48001,88000,39999,False,53,scaffold_4
3,147001,151000,3999,False,53,scaffold_4
4,155001,160000,4999,False,53,scaffold_4
5,161001,215000,53999,False,53,scaffold_4
6,218001,226000,7999,False,53,scaffold_4
7,227001,266000,38999,False,53,scaffold_4
8,291001,310000,18999,False,53,scaffold_4
9,313001,344000,30999,False,53,scaffold_4
10,355001,374000,18999,False,53,scaffold_4
11,375001,380000,4999,False,53,scaffold_4
12,392001,410000,17999,False,53,scaffold_4
13,412001,425000,12999,False,53,scaffold_4
14,429001,502000,72999,False,53,scaffold_4
15,545001,592000,46999,False,53,scaffold_4
16,608001,691000,82999,False,53,scaffold_4
17,701001,714000,12999,False,53,scaffold_4
18,1121001,1136000,14999,False,53,scaffold_4
19,1137001,1178000,40999,False,53,scaffold_4
20,1199001,1226000,26999,False,53,scaffold_4
21,1283001,1319000,35999,False,53,scaffold_4
22,1372001,1597000,224999,False,53,scaffold_4
23,1613001,1957000,343999,False,53,scaffold_4
24,1958001,2002000,43999,False,53,scaffold_4
25,2026001,2067000,40999,False,53,scaffold_4
26,2071001,2117000,45999,False,53,scaffold_4
27,2144001,2185000,40999,False,53,scaffold_4
28,2219001,2268000,48999,False,53,scaffold_4
29,2269001,2279000,9999,False,53,scaffold_4
30,2284001,2310000,25999,False,53,scaffold_4
31,2312001,2340000,27999,False,53,scaffold_4
32,2429001,2443000,13999,False,53,scaffold_4
33,2480001,2533000,52999,False,53,scaffold_4
34,2600001,2635000,34999,False,53,scaffold_4
35,3335001,3633000,297999,False,53,scaffold_4
36,3676001,3764000,87999,False,53,scaffold_4
37,4055001,4070000,14999,False,53,scaffold_4
38,4941001,4985000,43999,False,53,scaffold_4
39,5477001,5506000,28999,False,53,scaffold_4
40,5515001,5620000,104999,False,53,scaffold_4
41,5661001,5784000,122999,False,53,scaffold_4
42,5785001,5817000,31999,False,53,scaffold_4
43,6145001,6190000,44999,False,53,scaffold_4
44,6805001,6817000,11999,False,53,scaffold_4
45,7036001,7062000,25999,False,53,scaffold_4
46,7641001,7665000,23999,False,53,scaffold_4
47,8846001,9699000,852999,False,53,scaffold_4
48,9700001,9845951,145950,True,53,scaffold_4
0,320001,326000,5999,False,53,scaffold_5
1,327001,368000,40999,False,53,scaffold_5
2,463001,524000,60999,False,53,scaffold_5
3,933001,947000,13999,False,53,scaffold_5
4,2565001,2591000,25999,False,53,scaffold_5
5,2616001,2734000,117999,False,53,scaffold_5
6,2816001,2871000,54999,False,53,scaffold_5
7,3167001,3185000,17999,False,53,scaffold_5
8,3322001,3498000,175999,False,53,scaffold_5
9,3622001,3658000,35999,False,53,scaffold_5
10,3962001,4101000,138999,False,53,scaffold_5
11,4121001,4219000,97999,False,53,scaffold_5
12,4246001,4265000,18999,False,53,scaffold_5
13,4446001,4501000,54999,False,53,scaffold_5
14,4601001,4681000,79999,False,53,scaffold_5
15,4690001,4751000,60999,False,53,scaffold_5
16,4759001,4861000,101999,False,53,scaffold_5
17,4904001,4917000,12999,False,53,scaffold_5
18,5318001,5346000,27999,False,53,scaffold_5
19,6507001,6566000,58999,False,53,scaffold_5
20,7621001,7655000,33999,False,53,scaffold_5
21,8666001,8689000,22999,False,53,scaffold_5
22,8730001,9363000,632999,False,53,scaffold_5
23,9364001,9364176,175,True,53,scaffold_5
0,79001,84000,4999,False,53,scaffold_6
1,86001,113000,26999,False,53,scaffold_6
2,239001,253000,13999,False,53,scaffold_6
3,268001,283000,14999,False,53,scaffold_6
4,1247001,1253000,5999,False,53,scaffold_6
5,1479001,1546000,66999,False,53,scaffold_6
6,2023001,2087000,63999,False,53,scaffold_6
7,2130001,2179000,48999,False,53,scaffold_6
8,2348001,2595000,246999,False,53,scaffold_6
9,2596001,2691000,94999,False,53,scaffold_6
10,2712001,2852000,139999,False,53,scaffold_6
11,2928001,3014000,85999,False,53,scaffold_6
12,3100001,3174000,73999,False,53,scaffold_6
13,3223001,3301000,77999,False,53,scaffold_6
14,3407001,3428000,20999,False,53,scaffold_6
15,3462001,3766000,303999,False,53,scaffold_6
16,3900001,3911000,10999,False,53,scaffold_6
17,4018001,4066000,47999,False,53,scaffold_6
18,4080001,4193000,112999,False,53,scaffold_6
19,6010001,6060000,49999,False,53,scaffold_6
20,7269001,7337000,67999,False,53,scaffold_6
21,7389001,7436000,46999,False,53,scaffold_6
22,7550001,7798000,247999,False,53,scaffold_6
23,7811001,8268281,457280,True,53,scaffold_6
0,13001,34000,20999,False,53,scaffold_7
1,323001,340000,16999,False,53,scaffold_7
2,342001,508000,165999,False,53,scaffold_7
3,554001,563000,8999,False,53,scaffold_7
4,571001,577000,5999,False,53,scaffold_7
5,706001,736000,29999,False,53,scaffold_7
6,764001,809000,44999,False,53,scaffold_7
7,859001,864000,4999,False,53,scaffold_7
8,982001,1044000,61999,False,53,scaffold_7
9,1049001,1096000,46999,False,53,scaffold_7
10,1191001,1460000,268999,False,53,scaffold_7
11,1461001,1512000,50999,False,53,scaffold_7
12,1588001,1688000,99999,False,53,scaffold_7
13,3326001,3369000,42999,False,53,scaffold_7
14,3542001,3544000,1999,False,53,scaffold_7
15,3593001,3649000,55999,False,53,scaffold_7
16,4415001,4430000,14999,False,53,scaffold_7
17,4433001,4518000,84999,False,53,scaffold_7
18,4658001,4682000,23999,False,53,scaffold_7
19,4979001,5115000,135999,False,53,scaffold_7
20,5120001,5145000,24999,False,53,scaffold_7
21,5483001,5536000,52999,False,53,scaffold_7
22,6954001,7270000,315999,False,53,scaffold_7
23,7271001,7502216,231215,True,53,scaffold_7
0,67001,85000,17999,False,53,scaffold_8
1,93001,102000,8999,False,53,scaffold_8
2,2444001,2527000,82999,False,53,scaffold_8
3,2652001,2683000,30999,False,53,scaffold_8
4,2742001,2757000,14999,False,53,scaffold_8
5,2809001,2844000,34999,False,53,scaffold_8
6,3060001,3525000,464999,False,53,scaffold_8
7,3584001,3612000,27999,False,53,scaffold_8
8,3615001,3937000,321999,False,53,scaffold_8
9,4040001,4092000,51999,False,53,scaffold_8
10,4400001,4429000,28999,False,53,scaffold_8
11,5095001,5136000,40999,False,53,scaffold_8
12,5193001,5241000,47999,False,53,scaffold_8
13,5679001,5691000,11999,False,53,scaffold_8
14,6324001,6334544,10543,True,53,scaffold_8
0,109001,117000,7999,False,53,scaffold_9
1,121001,138000,16999,False,53,scaffold_9
2,300001,315000,14999,False,53,scaffold_9
3,319001,332000,12999,False,53,scaffold_9
4,367001,411000,43999,False,53,scaffold_9
5,413001,434000,20999,False,53,scaffold_9
6,502001,531000,28999,False,53,scaffold_9
7,671001,697000,25999,False,53,scaffold_9
8,732001,742000,9999,False,53,scaffold_9
9,817001,841000,23999,False,53,scaffold_9
10,873001,986000,112999,False,53,scaffold_9
11,988001,995000,6999,False,53,scaffold_9
12,1001001,1007000,5999,False,53,scaffold_9
13,1010001,1031000,20999,False,53,scaffold_9
14,1035001,1085000,49999,False,53,scaffold_9
15,1087001,1150000,62999,False,53,scaffold_9
16,1151001,1176000,24999,False,53,scaffold_9
17,1313001,1377000,63999,False,53,scaffold_9
18,1599001,1609000,9999,False,53,scaffold_9
19,1749001,1791000,41999,False,53,scaffold_9
20,2599001,2616000,16999,False,53,scaffold_9
21,2770001,2803000,32999,False,53,scaffold_9
22,2870001,3381000,510999,False,53,scaffold_9
23,3383001,5107000,1723999,False,53,scaffold_9
24,5112001,5237000,124999,False,53,scaffold_9
25,5239001,5298000,58999,False,53,scaffold_9
26,5300001,5491000,190999,False,53,scaffold_9
27,5493001,6331288,838287,True,53,scaffold_9
0,1,235000,234999,True,53,scaffold_10
1,280001,405000,124999,False,53,scaffold_10
2,472001,482000,9999,False,53,scaffold_10
3,483001,576000,92999,False,53,scaffold_10
4,603001,750000,146999,False,53,scaffold_10
5,888001,916000,27999,False,53,scaffold_10
6,924001,962000,37999,False,53,scaffold_10
7,1073001,1112000,38999,False,53,scaffold_10
8,2140001,2168000,27999,False,53,scaffold_10
9,2346001,2367000,20999,False,53,scaffold_10
10,4051001,4091000,39999,False,53,scaffold_10
11,4154001,4174000,19999,False,53,scaffold_10
12,4443001,4462000,18999,False,53,scaffold_10
13,4467001,4476000,8999,False,53,scaffold_10
14,4503001,4513000,9999,False,53,scaffold_10
15,4515001,4523000,7999,False,53,scaffold_10
16,4526001,4548000,21999,False,53,scaffold_10
17,4575001,4596000,20999,False,53,scaffold_10
18,4681001,4688000,6999,False,53,scaffold_10
19,4734001,4751000,16999,False,53,scaffold_10
20,4752001,4766000,13999,False,53,scaffold_10
21,4768001,4776000,7999,False,53,scaffold_10
22,4798001,4824000,25999,False,53,scaffold_10
23,4828001,4843000,14999,False,53,scaffold_10
24,4848001,4861000,12999,False,53,scaffold_10
25,4862001,4866973,4972,True,53,scaffold_10
0,10001,93000,82999,False,53,scaffold_11
1,149001,167000,17999,False,53,scaffold_11
2,169001,191000,21999,False,53,scaffold_11
3,214001,235000,20999,False,53,scaffold_11
4,419001,431000,11999,False,53,scaffold_11
5,649001,656000,6999,False,53,scaffold_11
6,1025001,1034000,8999,False,53,scaffold_11
7,1423001,1427000,3999,False,53,scaffold_11
8,1474001,1477000,2999,False,53,scaffold_11
9,2701001,2874000,172999,False,53,scaffold_11
10,3187001,3282000,94999,False,53,scaffold_11
11,3331001,3383000,51999,False,53,scaffold_11
12,3521001,3577000,55999,False,53,scaffold_11
13,3702001,3930000,227999,False,53,scaffold_11
14,4134001,4156000,21999,False,53,scaffold_11
15,4225001,4710000,484999,False,53,scaffold_11
16,4713001,4766820,53819,True,53,scaffold_11
0,1,369000,368999,True,53,scaffold_12
1,402001,550000,147999,False,53,scaffold_12
2,580001,856000,275999,False,53,scaffold_12
3,864001,1469000,604999,False,53,scaffold_12
4,1720001,1733000,12999,False,53,scaffold_12
5,2137001,2166000,28999,False,53,scaffold_12
6,2571001,2611000,39999,False,53,scaffold_12
7,2685001,2699000,13999,False,53,scaffold_12
0,1,342000,341999,True,54,scaffold_1
1,410001,421000,10999,False,54,scaffold_1
2,482001,498000,15999,False,54,scaffold_1
3,572001,643000,70999,False,54,scaffold_1
4,686001,754000,67999,False,54,scaffold_1
5,1064001,1087000,22999,False,54,scaffold_1
6,1180001,1192000,11999,False,54,scaffold_1
7,1281001,1292000,10999,False,54,scaffold_1
8,1811001,1899000,87999,False,54,scaffold_1
9,1954001,1984000,29999,False,54,scaffold_1
10,2367001,2391000,23999,False,54,scaffold_1
11,2449001,2517000,67999,False,54,scaffold_1
12,2726001,2746000,19999,False,54,scaffold_1
13,2900001,2920000,19999,False,54,scaffold_1
14,2984001,3025000,40999,False,54,scaffold_1
15,3172001,3209000,36999,False,54,scaffold_1
16,3388001,3390000,1999,False,54,scaffold_1
17,3684001,3749000,64999,False,54,scaffold_1
18,3770001,3878000,107999,False,54,scaffold_1
19,3901001,3941000,39999,False,54,scaffold_1
20,3960001,4028000,67999,False,54,scaffold_1
21,4062001,4113000,50999,False,54,scaffold_1
22,4305001,4356000,50999,False,54,scaffold_1
23,4796001,4819000,22999,False,54,scaffold_1
24,4928001,5027000,98999,False,54,scaffold_1
25,5087001,5117000,29999,False,54,scaffold_1
26,5164001,5200000,35999,False,54,scaffold_1
27,5440001,5455000,14999,False,54,scaffold_1
28,5483001,5511000,27999,False,54,scaffold_1
29,5535001,5570000,34999,False,54,scaffold_1
30,5849001,5911000,61999,False,54,scaffold_1
31,6108001,6153000,44999,False,54,scaffold_1
32,6154001,6379000,224999,False,54,scaffold_1
33,6384001,6535000,150999,False,54,scaffold_1
34,6542001,6569000,26999,False,54,scaffold_1
35,6836001,6878000,41999,False,54,scaffold_1
36,7037001,7247000,209999,False,54,scaffold_1
37,7248001,7589000,340999,False,54,scaffold_1
38,7590001,8656000,1065999,False,54,scaffold_1
39,8658001,9584000,925999,False,54,scaffold_1
40,9586001,10356000,769999,False,54,scaffold_1
41,10461001,10636000,174999,False,54,scaffold_1
42,10733001,10757000,23999,False,54,scaffold_1
43,10839001,10857000,17999,False,54,scaffold_1
44,11015001,11029000,13999,False,54,scaffold_1
45,11273001,11535000,261999,False,54,scaffold_1
46,11550001,11962000,411999,False,54,scaffold_1
47,12182001,12239000,56999,False,54,scaffold_1
48,12642001,12723000,80999,False,54,scaffold_1
49,12732001,12889000,156999,False,54,scaffold_1
50,12904001,12951000,46999,False,54,scaffold_1
51,12965001,13002000,36999,False,54,scaffold_1
52,13113001,13214000,100999,False,54,scaffold_1
53,13347001,13430000,82999,False,54,scaffold_1
54,13554001,13585000,30999,False,54,scaffold_1
55,13591001,13608000,16999,False,54,scaffold_1
56,13818001,13845000,26999,False,54,scaffold_1
57,13930001,13943000,12999,False,54,scaffold_1
58,13948001,13954000,5999,False,54,scaffold_1
59,13959001,13994000,34999,False,54,scaffold_1
60,14286001,14313000,26999,False,54,scaffold_1
0,1,48000,47999,True,54,scaffold_2
1,93001,159000,65999,False,54,scaffold_2
2,165001,177000,11999,False,54,scaffold_2
3,179001,186000,6999,False,54,scaffold_2
4,250001,288000,37999,False,54,scaffold_2
5,296001,318000,21999,False,54,scaffold_2
6,333001,376000,42999,False,54,scaffold_2
7,1528001,1547000,18999,False,54,scaffold_2
8,1694001,1713000,18999,False,54,scaffold_2
9,1877001,1899000,21999,False,54,scaffold_2
10,2315001,2334000,18999,False,54,scaffold_2
11,2336001,2391000,54999,False,54,scaffold_2
12,2397001,2560000,162999,False,54,scaffold_2
13,2561001,2609000,47999,False,54,scaffold_2
14,2658001,2688000,29999,False,54,scaffold_2
15,2693001,2747000,53999,False,54,scaffold_2
16,2767001,2776000,8999,False,54,scaffold_2
17,2777001,2788000,10999,False,54,scaffold_2
18,2804001,2856000,51999,False,54,scaffold_2
19,2868001,2910000,41999,False,54,scaffold_2
20,2974001,3012000,37999,False,54,scaffold_2
21,3027001,3044000,16999,False,54,scaffold_2
22,3367001,3414000,46999,False,54,scaffold_2
23,3450001,3466000,15999,False,54,scaffold_2
24,3528001,3548000,19999,False,54,scaffold_2
25,3669001,3693000,23999,False,54,scaffold_2
26,3754001,3784000,29999,False,54,scaffold_2
27,4243001,4262000,18999,False,54,scaffold_2
28,4343001,4409000,65999,False,54,scaffold_2
29,4426001,4460000,33999,False,54,scaffold_2
30,4520001,4655000,134999,False,54,scaffold_2
31,4783001,4790000,6999,False,54,scaffold_2
32,4793001,4807000,13999,False,54,scaffold_2
33,4916001,4959000,42999,False,54,scaffold_2
34,5021001,5104000,82999,False,54,scaffold_2
35,5285001,5314000,28999,False,54,scaffold_2
36,5344001,5394000,49999,False,54,scaffold_2
37,5458001,5481000,22999,False,54,scaffold_2
38,5483001,5558000,74999,False,54,scaffold_2
39,5658001,5705000,46999,False,54,scaffold_2
40,5719001,5761000,41999,False,54,scaffold_2
41,5840001,5887000,46999,False,54,scaffold_2
42,5917001,6058000,140999,False,54,scaffold_2
43,6261001,6330000,68999,False,54,scaffold_2
44,6331001,6351000,19999,False,54,scaffold_2
45,6394001,6449000,54999,False,54,scaffold_2
46,6576001,6629000,52999,False,54,scaffold_2
47,6698001,6726000,27999,False,54,scaffold_2
48,6802001,6902000,99999,False,54,scaffold_2
49,6946001,6979000,32999,False,54,scaffold_2
50,7018001,7038000,19999,False,54,scaffold_2
51,7063001,7097000,33999,False,54,scaffold_2
52,7354001,7477000,122999,False,54,scaffold_2
53,7491001,7522000,30999,False,54,scaffold_2
54,7548001,7561000,12999,False,54,scaffold_2
55,7563001,7707000,143999,False,54,scaffold_2
56,7786001,8313000,526999,False,54,scaffold_2
57,8331001,8333000,1999,False,54,scaffold_2
58,8346001,8494000,147999,False,54,scaffold_2
59,8495001,8564000,68999,False,54,scaffold_2
60,9029001,9046000,16999,False,54,scaffold_2
61,9156001,9166000,9999,False,54,scaffold_2
62,9348001,9382000,33999,False,54,scaffold_2
63,9600001,9635000,34999,False,54,scaffold_2
64,9673001,9709000,35999,False,54,scaffold_2
65,10691001,10736000,44999,False,54,scaffold_2
66,10991001,10993000,1999,False,54,scaffold_2
67,11395001,11428000,32999,False,54,scaffold_2
68,11520001,11786000,265999,False,54,scaffold_2
69,11797001,11802476,5475,True,54,scaffold_2
0,1,2000,1999,True,54,scaffold_3
1,3001,6000,2999,False,54,scaffold_3
2,218001,232000,13999,False,54,scaffold_3
3,528001,539000,10999,False,54,scaffold_3
4,618001,646000,27999,False,54,scaffold_3
5,796001,905000,108999,False,54,scaffold_3
6,2008001,2181000,172999,False,54,scaffold_3
7,2291001,2322000,30999,False,54,scaffold_3
8,2406001,2428000,21999,False,54,scaffold_3
9,2433001,2549000,115999,False,54,scaffold_3
10,2717001,2750000,32999,False,54,scaffold_3
11,3227001,3257000,29999,False,54,scaffold_3
12,3713001,3745000,31999,False,54,scaffold_3
13,3768001,3891000,122999,False,54,scaffold_3
14,4007001,4033000,25999,False,54,scaffold_3
15,4108001,4398000,289999,False,54,scaffold_3
16,4415001,4518000,102999,False,54,scaffold_3
17,4546001,4558000,11999,False,54,scaffold_3
18,4567001,4689000,121999,False,54,scaffold_3
19,4988001,5035000,46999,False,54,scaffold_3
20,5158001,5190000,31999,False,54,scaffold_3
21,5231001,5271000,39999,False,54,scaffold_3
22,5596001,5646000,49999,False,54,scaffold_3
23,5863001,5954000,90999,False,54,scaffold_3
24,5975001,6020000,44999,False,54,scaffold_3
25,6518001,6583000,64999,False,54,scaffold_3
26,6745001,6784000,38999,False,54,scaffold_3
27,6909001,6962000,52999,False,54,scaffold_3
28,6963001,7090000,126999,False,54,scaffold_3
29,7113001,7157000,43999,False,54,scaffold_3
30,7288001,7298000,9999,False,54,scaffold_3
31,7376001,7393000,16999,False,54,scaffold_3
32,7430001,7445000,14999,False,54,scaffold_3
33,7484001,7492000,7999,False,54,scaffold_3
34,7506001,7556000,49999,False,54,scaffold_3
35,7676001,7856000,179999,False,54,scaffold_3
36,8080001,8114000,33999,False,54,scaffold_3
37,8121001,8156000,34999,False,54,scaffold_3
38,8178001,8255000,76999,False,54,scaffold_3
39,8427001,8528000,100999,False,54,scaffold_3
40,8575001,8593000,17999,False,54,scaffold_3
41,9004001,9043000,38999,False,54,scaffold_3
42,9057001,9083000,25999,False,54,scaffold_3
43,9968001,9995000,26999,False,54,scaffold_3
44,10065001,10099000,33999,False,54,scaffold_3
45,10461001,10486000,24999,False,54,scaffold_3
46,10551001,10572000,20999,False,54,scaffold_3
47,10574001,11182071,608070,True,54,scaffold_3
0,11001,13000,1999,False,54,scaffold_4
1,17001,32000,14999,False,54,scaffold_4
2,48001,88000,39999,False,54,scaffold_4
3,120001,146000,25999,False,54,scaffold_4
4,147001,151000,3999,False,54,scaffold_4
5,155001,215000,59999,False,54,scaffold_4
6,217001,226000,8999,False,54,scaffold_4
7,227001,266000,38999,False,54,scaffold_4
8,283001,353000,69999,False,54,scaffold_4
9,355001,374000,18999,False,54,scaffold_4
10,375001,410000,34999,False,54,scaffold_4
11,412001,425000,12999,False,54,scaffold_4
12,429001,505000,75999,False,54,scaffold_4
13,541001,606000,64999,False,54,scaffold_4
14,608001,660000,51999,False,54,scaffold_4
15,672001,691000,18999,False,54,scaffold_4
16,694001,697000,2999,False,54,scaffold_4
17,701001,727000,25999,False,54,scaffold_4
18,1121001,1136000,14999,False,54,scaffold_4
19,1137001,1208000,70999,False,54,scaffold_4
20,1210001,1226000,15999,False,54,scaffold_4
21,1229001,1234000,4999,False,54,scaffold_4
22,1235001,1253000,17999,False,54,scaffold_4
23,1254001,1279000,24999,False,54,scaffold_4
24,1283001,1605000,321999,False,54,scaffold_4
25,1612001,2199000,586999,False,54,scaffold_4
26,2200001,2204000,3999,False,54,scaffold_4
27,2210001,2462000,251999,False,54,scaffold_4
28,2479001,2537000,57999,False,54,scaffold_4
29,2539001,2635000,95999,False,54,scaffold_4
30,2676001,2769000,92999,False,54,scaffold_4
31,2919001,2955000,35999,False,54,scaffold_4
32,3031001,3127000,95999,False,54,scaffold_4
33,3207001,3270000,62999,False,54,scaffold_4
34,3334001,3766000,431999,False,54,scaffold_4
35,4057001,4086000,28999,False,54,scaffold_4
36,4901001,5082000,180999,False,54,scaffold_4
37,5169001,5246000,76999,False,54,scaffold_4
38,5475001,5506000,30999,False,54,scaffold_4
39,5516001,5784000,267999,False,54,scaffold_4
40,5786001,5818000,31999,False,54,scaffold_4
41,6148001,6191000,42999,False,54,scaffold_4
42,6709001,6817000,107999,False,54,scaffold_4
43,6877001,6924000,46999,False,54,scaffold_4
44,6926001,6929000,2999,False,54,scaffold_4
45,6950001,6996000,45999,False,54,scaffold_4
46,7036001,7124000,87999,False,54,scaffold_4
47,7152001,7171000,18999,False,54,scaffold_4
48,7207001,7275000,67999,False,54,scaffold_4
49,7641001,7664000,22999,False,54,scaffold_4
50,8844001,9699000,854999,False,54,scaffold_4
51,9700001,9710000,9999,False,54,scaffold_4
52,9711001,9845951,134950,True,54,scaffold_4
0,318001,428000,109999,False,54,scaffold_5
1,454001,523000,68999,False,54,scaffold_5
2,669001,699000,29999,False,54,scaffold_5
3,932001,947000,14999,False,54,scaffold_5
4,1879001,1895000,15999,False,54,scaffold_5
5,2081001,2104000,22999,False,54,scaffold_5
6,2106001,2117000,10999,False,54,scaffold_5
7,2475001,2494000,18999,False,54,scaffold_5
8,2510001,2515000,4999,False,54,scaffold_5
9,2551001,2874000,322999,False,54,scaffold_5
10,3133001,3249000,115999,False,54,scaffold_5
11,3277001,3514000,236999,False,54,scaffold_5
12,3618001,3659000,40999,False,54,scaffold_5
13,3961001,4101000,139999,False,54,scaffold_5
14,4119001,4358000,238999,False,54,scaffold_5
15,4445001,4925000,479999,False,54,scaffold_5
16,4972001,5024000,51999,False,54,scaffold_5
17,5225001,5275000,49999,False,54,scaffold_5
18,5281001,5344000,62999,False,54,scaffold_5
19,6392001,6436000,43999,False,54,scaffold_5
20,6453001,6668000,214999,False,54,scaffold_5
21,6881001,6906000,24999,False,54,scaffold_5
22,7406001,7487000,80999,False,54,scaffold_5
23,7559001,7619000,59999,False,54,scaffold_5
24,7622001,7661000,38999,False,54,scaffold_5
25,8258001,8280000,21999,False,54,scaffold_5
26,8413001,8469000,55999,False,54,scaffold_5
27,8549001,8619000,69999,False,54,scaffold_5
28,8639001,8687000,47999,False,54,scaffold_5
29,8708001,9364176,656175,True,54,scaffold_5
0,64001,74000,9999,False,54,scaffold_6
1,86001,112000,25999,False,54,scaffold_6
2,160001,208000,47999,False,54,scaffold_6
3,239001,255000,15999,False,54,scaffold_6
4,257001,263000,5999,False,54,scaffold_6
5,264001,376000,111999,False,54,scaffold_6
6,589001,596000,6999,False,54,scaffold_6
7,1146001,1226000,79999,False,54,scaffold_6
8,1229001,1265000,35999,False,54,scaffold_6
9,1283001,1311000,27999,False,54,scaffold_6
10,1426001,1467000,40999,False,54,scaffold_6
11,1477001,1548000,70999,False,54,scaffold_6
12,1557001,1581000,23999,False,54,scaffold_6
13,1658001,1711000,52999,False,54,scaffold_6
14,1832001,1905000,72999,False,54,scaffold_6
15,2025001,2105000,79999,False,54,scaffold_6
16,2130001,2193000,62999,False,54,scaffold_6
17,2236001,2283000,46999,False,54,scaffold_6
18,2334001,2595000,260999,False,54,scaffold_6
19,2596001,2872000,275999,False,54,scaffold_6
20,2927001,3015000,87999,False,54,scaffold_6
21,3094001,3314000,219999,False,54,scaffold_6
22,3381001,3787000,405999,False,54,scaffold_6
23,3898001,3913000,14999,False,54,scaffold_6
24,4007001,4194000,186999,False,54,scaffold_6
25,4897001,4916000,18999,False,54,scaffold_6
26,5559001,5646000,86999,False,54,scaffold_6
27,5904001,5972000,67999,False,54,scaffold_6
28,6009001,6073000,63999,False,54,scaffold_6
29,6124001,6197000,72999,False,54,scaffold_6
30,6776001,6857000,80999,False,54,scaffold_6
31,6925001,6953000,27999,False,54,scaffold_6
32,6974001,6988000,13999,False,54,scaffold_6
33,7186001,7337000,150999,False,54,scaffold_6
34,7390001,7476000,85999,False,54,scaffold_6
35,7531001,8268281,737280,True,54,scaffold_6
0,1,8000,7999,True,54,scaffold_7
1,11001,31000,19999,False,54,scaffold_7
2,87001,120000,32999,False,54,scaffold_7
3,306001,508000,201999,False,54,scaffold_7
4,614001,675000,60999,False,54,scaffold_7
5,690001,736000,45999,False,54,scaffold_7
6,737001,754000,16999,False,54,scaffold_7
7,760001,829000,68999,False,54,scaffold_7
8,865001,981000,115999,False,54,scaffold_7
9,982001,1044000,61999,False,54,scaffold_7
10,1048001,1104000,55999,False,54,scaffold_7
11,1106001,1135000,28999,False,54,scaffold_7
12,1181001,1512000,330999,False,54,scaffold_7
13,1588001,1690000,101999,False,54,scaffold_7
14,1740001,1757000,16999,False,54,scaffold_7
15,1851001,1901000,49999,False,54,scaffold_7
16,1976001,2015000,38999,False,54,scaffold_7
17,3325001,3373000,47999,False,54,scaffold_7
18,3524001,3558000,33999,False,54,scaffold_7
19,3588001,3771000,182999,False,54,scaffold_7
20,4324001,4366000,41999,False,54,scaffold_7
21,4415001,4512000,96999,False,54,scaffold_7
22,4632001,4737000,104999,False,54,scaffold_7
23,4754001,4819000,64999,False,54,scaffold_7
24,4978001,5149000,170999,False,54,scaffold_7
25,5465001,5537000,71999,False,54,scaffold_7
26,6071001,6094000,22999,False,54,scaffold_7
27,6096001,6135000,38999,False,54,scaffold_7
28,6752001,6797000,44999,False,54,scaffold_7
29,6949001,7502216,553215,True,54,scaffold_7
0,30001,85000,54999,False,54,scaffold_8
1,729001,732000,2999,False,54,scaffold_8
2,1362001,1422000,59999,False,54,scaffold_8
3,2413001,2584000,170999,False,54,scaffold_8
4,2651001,2683000,31999,False,54,scaffold_8
5,2685001,2763000,77999,False,54,scaffold_8
6,2798001,2844000,45999,False,54,scaffold_8
7,2846001,2891000,44999,False,54,scaffold_8
8,3033001,3525000,491999,False,54,scaffold_8
9,3577001,3612000,34999,False,54,scaffold_8
10,3615001,3946000,330999,False,54,scaffold_8
11,4020001,4117000,96999,False,54,scaffold_8
12,4173001,4269000,95999,False,54,scaffold_8
13,4398001,4439000,40999,False,54,scaffold_8
14,5084001,5241000,156999,False,54,scaffold_8
15,5576001,5596000,19999,False,54,scaffold_8
16,5649001,5692000,42999,False,54,scaffold_8
17,5821001,5873000,51999,False,54,scaffold_8
18,5889001,5904000,14999,False,54,scaffold_8
19,6323001,6334544,11543,True,54,scaffold_8
0,1,22000,21999,True,54,scaffold_9
1,109001,117000,7999,False,54,scaffold_9
2,121001,139000,17999,False,54,scaffold_9
3,236001,243000,6999,False,54,scaffold_9
4,319001,411000,91999,False,54,scaffold_9
5,413001,434000,20999,False,54,scaffold_9
6,483001,531000,47999,False,54,scaffold_9
7,547001,564000,16999,False,54,scaffold_9
8,652001,665000,12999,False,54,scaffold_9
9,670001,697000,26999,False,54,scaffold_9
10,730001,741000,10999,False,54,scaffold_9
11,815001,847000,31999,False,54,scaffold_9
12,873001,986000,112999,False,54,scaffold_9
13,987001,995000,7999,False,54,scaffold_9
14,997001,1006000,8999,False,54,scaffold_9
15,1008001,1085000,76999,False,54,scaffold_9
16,1087001,1150000,62999,False,54,scaffold_9
17,1151001,1175000,23999,False,54,scaffold_9
18,1311001,1383000,71999,False,54,scaffold_9
19,1428001,1441000,12999,False,54,scaffold_9
20,1487001,1497000,9999,False,54,scaffold_9
21,1601001,1615000,13999,False,54,scaffold_9
22,1638001,1687000,48999,False,54,scaffold_9
23,1749001,1791000,41999,False,54,scaffold_9
24,1885001,1911000,25999,False,54,scaffold_9
25,1987001,2037000,49999,False,54,scaffold_9
26,2038001,2127000,88999,False,54,scaffold_9
27,2148001,2168000,19999,False,54,scaffold_9
28,2598001,2620000,21999,False,54,scaffold_9
29,2732001,3381000,648999,False,54,scaffold_9
30,3383001,5107000,1723999,False,54,scaffold_9
31,5112001,5114000,1999,False,54,scaffold_9
32,5116001,5238000,121999,False,54,scaffold_9
33,5239001,5298000,58999,False,54,scaffold_9
34,5299001,5491000,191999,False,54,scaffold_9
35,5493001,6331288,838287,True,54,scaffold_9
0,1,235000,234999,True,54,scaffold_10
1,258001,482000,223999,False,54,scaffold_10
2,483001,583000,99999,False,54,scaffold_10
3,596001,796000,199999,False,54,scaffold_10
4,811001,881000,69999,False,54,scaffold_10
5,884001,917000,32999,False,54,scaffold_10
6,923001,963000,39999,False,54,scaffold_10
7,1037001,1069000,31999,False,54,scaffold_10
8,1073001,1146000,72999,False,54,scaffold_10
9,1389001,1463000,73999,False,54,scaffold_10
10,1538001,1570000,31999,False,54,scaffold_10
11,1602001,1617000,14999,False,54,scaffold_10
12,2043001,2103000,59999,False,54,scaffold_10
13,2141001,2169000,27999,False,54,scaffold_10
14,2266001,2292000,25999,False,54,scaffold_10
15,2346001,2471000,124999,False,54,scaffold_10
16,2599001,2653000,53999,False,54,scaffold_10
17,3068001,3132000,63999,False,54,scaffold_10
18,3156001,3177000,20999,False,54,scaffold_10
19,4052001,4112000,59999,False,54,scaffold_10
20,4154001,4174000,19999,False,54,scaffold_10
21,4335001,4369000,33999,False,54,scaffold_10
22,4443001,4462000,18999,False,54,scaffold_10
23,4467001,4513000,45999,False,54,scaffold_10
24,4515001,4523000,7999,False,54,scaffold_10
25,4526001,4548000,21999,False,54,scaffold_10
26,4574001,4597000,22999,False,54,scaffold_10
27,4700001,4732000,31999,False,54,scaffold_10
28,4733001,4751000,17999,False,54,scaffold_10
29,4752001,4766000,13999,False,54,scaffold_10
30,4767001,4776000,8999,False,54,scaffold_10
31,4798001,4824000,25999,False,54,scaffold_10
32,4828001,4843000,14999,False,54,scaffold_10
33,4848001,4866973,18972,True,54,scaffold_10
0,10001,99000,88999,False,54,scaffold_11
1,101001,109000,7999,False,54,scaffold_11
2,132001,167000,34999,False,54,scaffold_11
3,169001,191000,21999,False,54,scaffold_11
4,204001,212000,7999,False,54,scaffold_11
5,213001,236000,22999,False,54,scaffold_11
6,240001,252000,11999,False,54,scaffold_11
7,290001,319000,28999,False,54,scaffold_11
8,419001,431000,11999,False,54,scaffold_11
9,639001,657000,17999,False,54,scaffold_11
10,781001,785000,3999,False,54,scaffold_11
11,1025001,1034000,8999,False,54,scaffold_11
12,1423001,1427000,3999,False,54,scaffold_11
13,1474001,1477000,2999,False,54,scaffold_11
14,1971001,2007000,35999,False,54,scaffold_11
15,2008001,2034000,25999,False,54,scaffold_11
16,2035001,2046000,10999,False,54,scaffold_11
17,2192001,2218000,25999,False,54,scaffold_11
18,2700001,2878000,177999,False,54,scaffold_11
19,2977001,3019000,41999,False,54,scaffold_11
20,3084001,3176000,91999,False,54,scaffold_11
21,3184001,3325000,140999,False,54,scaffold_11
22,3327001,3383000,55999,False,54,scaffold_11
23,3423001,3479000,55999,False,54,scaffold_11
24,3521001,3971000,449999,False,54,scaffold_11
25,3985001,4159000,173999,False,54,scaffold_11
26,4182001,4710000,527999,False,54,scaffold_11
27,4711001,4766820,55819,True,54,scaffold_11
0,1,1498000,1497999,True,54,scaffold_12
1,1720001,1747000,26999,False,54,scaffold_12
2,1788001,1806000,17999,False,54,scaffold_12
3,1903001,1951000,47999,False,54,scaffold_12
4,1972001,2005000,32999,False,54,scaffold_12
5,2067001,2102000,34999,False,54,scaffold_12
6,2129001,2161000,31999,False,54,scaffold_12
7,2340001,2371000,30999,False,54,scaffold_12
8,2458001,2479000,20999,False,54,scaffold_12
9,2481001,2486000,4999,False,54,scaffold_12
10,2571001,2618000,46999,False,54,scaffold_12
11,2659001,2682000,22999,False,54,scaffold_12
12,2685001,2699000,13999,False,54,scaffold_12
13,2747001,2747968,967,True,54,scaffold_12
0,1,340000,339999,True,55,scaffold_1
1,482001,498000,15999,False,55,scaffold_1
2,574001,643000,68999,False,55,scaffold_1
3,686001,743000,56999,False,55,scaffold_1
4,1281001,1292000,10999,False,55,scaffold_1
5,1814001,1899000,84999,False,55,scaffold_1
6,1954001,1964000,9999,False,55,scaffold_1
7,1965001,1984000,18999,False,55,scaffold_1
8,2449001,2517000,67999,False,55,scaffold_1
9,2729001,2746000,16999,False,55,scaffold_1
10,3180001,3208000,27999,False,55,scaffold_1
11,3715001,3734000,18999,False,55,scaffold_1
12,3916001,3941000,24999,False,55,scaffold_1
13,4064001,4111000,46999,False,55,scaffold_1
14,4315001,4354000,38999,False,55,scaffold_1
15,4928001,4985000,56999,False,55,scaffold_1
16,5481001,5511000,29999,False,55,scaffold_1
17,6108001,6153000,44999,False,55,scaffold_1
18,6228001,6381000,152999,False,55,scaffold_1
19,6384001,6507000,122999,False,55,scaffold_1
20,6545001,6554000,8999,False,55,scaffold_1
21,7038001,7247000,208999,False,55,scaffold_1
22,7248001,7583000,334999,False,55,scaffold_1
23,7590001,8477000,886999,False,55,scaffold_1
24,8478001,8640000,161999,False,55,scaffold_1
25,8644001,8656000,11999,False,55,scaffold_1
26,8658001,9584000,925999,False,55,scaffold_1
27,9586001,10355000,768999,False,55,scaffold_1
28,10461001,10626000,164999,False,55,scaffold_1
29,10808001,10811000,2999,False,55,scaffold_1
30,11351001,11508000,156999,False,55,scaffold_1
31,11614001,11951000,336999,False,55,scaffold_1
32,12184001,12203000,18999,False,55,scaffold_1
33,12652001,12721000,68999,False,55,scaffold_1
34,12777001,12888000,110999,False,55,scaffold_1
35,13113001,13157000,43999,False,55,scaffold_1
36,13178001,13211000,32999,False,55,scaffold_1
37,13347001,13404000,56999,False,55,scaffold_1
38,14605001,14611000,5999,False,55,scaffold_1
0,25001,48000,22999,False,55,scaffold_2
1,93001,159000,65999,False,55,scaffold_2
2,168001,177000,8999,False,55,scaffold_2
3,303001,318000,14999,False,55,scaffold_2
4,333001,374000,40999,False,55,scaffold_2
5,2336001,2358000,21999,False,55,scaffold_2
6,2405001,2415000,9999,False,55,scaffold_2
7,2416001,2424000,7999,False,55,scaffold_2
8,2441001,2553000,111999,False,55,scaffold_2
9,2660001,2689000,28999,False,55,scaffold_2
10,2693001,2742000,48999,False,55,scaffold_2
11,2976001,3021000,44999,False,55,scaffold_2
12,3174001,3186000,11999,False,55,scaffold_2
13,3454001,3463000,8999,False,55,scaffold_2
14,3754001,3784000,29999,False,55,scaffold_2
15,4385001,4409000,23999,False,55,scaffold_2
16,4429001,4456000,26999,False,55,scaffold_2
17,4520001,4557000,36999,False,55,scaffold_2
18,4592001,4654000,61999,False,55,scaffold_2
19,5022001,5031000,8999,False,55,scaffold_2
20,5033001,5063000,29999,False,55,scaffold_2
21,5491001,5511000,19999,False,55,scaffold_2
22,5672001,5704000,31999,False,55,scaffold_2
23,6261001,6330000,68999,False,55,scaffold_2
24,6331001,6342000,10999,False,55,scaffold_2
25,6429001,6448000,18999,False,55,scaffold_2
26,7439001,7472000,32999,False,55,scaffold_2
27,7563001,7697000,133999,False,55,scaffold_2
28,7786001,7897000,110999,False,55,scaffold_2
29,7934001,8160000,225999,False,55,scaffold_2
30,8261001,8294000,32999,False,55,scaffold_2
31,8335001,8345000,9999,False,55,scaffold_2
32,8346001,8393000,46999,False,55,scaffold_2
33,8509001,8557000,47999,False,55,scaffold_2
34,11520001,11785000,264999,False,55,scaffold_2
0,102001,104000,1999,False,55,scaffold_3
1,799001,900000,100999,False,55,scaffold_3
2,2085001,2108000,22999,False,55,scaffold_3
3,2291001,2321000,29999,False,55,scaffold_3
4,2494001,2533000,38999,False,55,scaffold_3
5,4150001,4385000,234999,False,55,scaffold_3
6,4418001,4518000,99999,False,55,scaffold_3
7,4652001,4684000,31999,False,55,scaffold_3
8,6911001,6962000,50999,False,55,scaffold_3
9,6979001,7047000,67999,False,55,scaffold_3
10,7538001,7556000,17999,False,55,scaffold_3
11,7692001,7727000,34999,False,55,scaffold_3
12,7824001,7838000,13999,False,55,scaffold_3
13,8175001,8253000,77999,False,55,scaffold_3
14,8462001,8527000,64999,False,55,scaffold_3
15,8575001,8594000,18999,False,55,scaffold_3
16,9968001,9995000,26999,False,55,scaffold_3
17,10461001,10483000,21999,False,55,scaffold_3
18,10587001,11165000,577999,False,55,scaffold_3
0,17001,32000,14999,False,55,scaffold_4
1,48001,88000,39999,False,55,scaffold_4
2,147001,151000,3999,False,55,scaffold_4
3,155001,216000,60999,False,55,scaffold_4
4,217001,226000,8999,False,55,scaffold_4
5,227001,266000,38999,False,55,scaffold_4
6,291001,310000,18999,False,55,scaffold_4
7,355001,374000,18999,False,55,scaffold_4
8,375001,380000,4999,False,55,scaffold_4
9,390001,410000,19999,False,55,scaffold_4
10,412001,425000,12999,False,55,scaffold_4
11,429001,505000,75999,False,55,scaffold_4
12,542001,606000,63999,False,55,scaffold_4
13,608001,661000,52999,False,55,scaffold_4
14,670001,691000,20999,False,55,scaffold_4
15,695001,697000,1999,False,55,scaffold_4
16,1120001,1136000,15999,False,55,scaffold_4
17,1137001,1178000,40999,False,55,scaffold_4
18,1199001,1208000,8999,False,55,scaffold_4
19,1235001,1253000,17999,False,55,scaffold_4
20,1270001,1279000,8999,False,55,scaffold_4
21,1283001,1315000,31999,False,55,scaffold_4
22,1372001,1591000,218999,False,55,scaffold_4
23,1729001,1957000,227999,False,55,scaffold_4
24,1958001,1988000,29999,False,55,scaffold_4
25,2027001,2099000,71999,False,55,scaffold_4
26,2247001,2268000,20999,False,55,scaffold_4
27,2269001,2339000,69999,False,55,scaffold_4
28,2398001,2461000,62999,False,55,scaffold_4
29,2480001,2567000,86999,False,55,scaffold_4
30,2599001,2635000,35999,False,55,scaffold_4
31,3336001,3632000,295999,False,55,scaffold_4
32,3676001,3760000,83999,False,55,scaffold_4
33,4941001,4985000,43999,False,55,scaffold_4
34,5476001,5506000,29999,False,55,scaffold_4
35,5515001,5620000,104999,False,55,scaffold_4
36,5669001,5784000,114999,False,55,scaffold_4
37,7036001,7062000,25999,False,55,scaffold_4
38,8846001,9699000,852999,False,55,scaffold_4
39,9700001,9845951,145950,True,55,scaffold_4
0,1,4000,3999,True,55,scaffold_5
1,189001,204000,14999,False,55,scaffold_5
2,318001,382000,63999,False,55,scaffold_5
3,463001,523000,59999,False,55,scaffold_5
4,668001,680000,11999,False,55,scaffold_5
5,933001,947000,13999,False,55,scaffold_5
6,2567001,2582000,14999,False,55,scaffold_5
7,2625001,2732000,106999,False,55,scaffold_5
8,2816001,2871000,54999,False,55,scaffold_5
9,3167001,3184000,16999,False,55,scaffold_5
10,3309001,3438000,128999,False,55,scaffold_5
11,3451001,3500000,48999,False,55,scaffold_5
12,3962001,4101000,138999,False,55,scaffold_5
13,4120001,4219000,98999,False,55,scaffold_5
14,4233001,4262000,28999,False,55,scaffold_5
15,4446001,4497000,50999,False,55,scaffold_5
16,4601001,4657000,55999,False,55,scaffold_5
17,4691001,4718000,26999,False,55,scaffold_5
18,4788001,4861000,72999,False,55,scaffold_5
19,4904001,4916000,11999,False,55,scaffold_5
20,5258001,5272000,13999,False,55,scaffold_5
21,5314001,5346000,31999,False,55,scaffold_5
22,6547001,6628000,80999,False,55,scaffold_5
23,8573001,8616000,42999,False,55,scaffold_5
24,8730001,9364176,634175,True,55,scaffold_5
0,79001,84000,4999,False,55,scaffold_6
1,86001,112000,25999,False,55,scaffold_6
2,241001,253000,11999,False,55,scaffold_6
3,267001,283000,15999,False,55,scaffold_6
4,543001,546000,2999,False,55,scaffold_6
5,1229001,1258000,28999,False,55,scaffold_6
6,1478001,1546000,67999,False,55,scaffold_6
7,1866001,1906000,39999,False,55,scaffold_6
8,2023001,2088000,64999,False,55,scaffold_6
9,2130001,2169000,38999,False,55,scaffold_6
10,2371001,2595000,223999,False,55,scaffold_6
11,2596001,2654000,57999,False,55,scaffold_6
12,2660001,2691000,30999,False,55,scaffold_6
13,2731001,2852000,120999,False,55,scaffold_6
14,2935001,3014000,78999,False,55,scaffold_6
15,3114001,3150000,35999,False,55,scaffold_6
16,3223001,3301000,77999,False,55,scaffold_6
17,3408001,3428000,19999,False,55,scaffold_6
18,3460001,3786000,325999,False,55,scaffold_6
19,3900001,3912000,11999,False,55,scaffold_6
20,4017001,4072000,54999,False,55,scaffold_6
21,4083001,4192000,108999,False,55,scaffold_6
22,6010001,6060000,49999,False,55,scaffold_6
23,7283001,7337000,53999,False,55,scaffold_6
24,7560001,7795000,234999,False,55,scaffold_6
25,7811001,8268281,457280,True,55,scaffold_6
0,1001,7000,5999,False,55,scaffold_7
1,13001,34000,20999,False,55,scaffold_7
2,323001,340000,16999,False,55,scaffold_7
3,342001,505000,162999,False,55,scaffold_7
4,554001,563000,8999,False,55,scaffold_7
5,706001,724000,17999,False,55,scaffold_7
6,725001,736000,10999,False,55,scaffold_7
7,764001,843000,78999,False,55,scaffold_7
8,859001,864000,4999,False,55,scaffold_7
9,964001,966000,1999,False,55,scaffold_7
10,968001,980000,11999,False,55,scaffold_7
11,982001,1044000,61999,False,55,scaffold_7
12,1048001,1090000,41999,False,55,scaffold_7
13,1203001,1512000,308999,False,55,scaffold_7
14,1588001,1689000,100999,False,55,scaffold_7
15,3326001,3369000,42999,False,55,scaffold_7
16,3537001,3550000,12999,False,55,scaffold_7
17,3596001,3650000,53999,False,55,scaffold_7
18,3719001,3765000,45999,False,55,scaffold_7
19,4416001,4517000,100999,False,55,scaffold_7
20,4658001,4682000,23999,False,55,scaffold_7
21,4979001,5064000,84999,False,55,scaffold_7
22,5073001,5114000,40999,False,55,scaffold_7
23,5484001,5515000,30999,False,55,scaffold_7
24,6955001,7270000,314999,False,55,scaffold_7
25,7271001,7502216,231215,True,55,scaffold_7
0,67001,85000,17999,False,55,scaffold_8
1,2445001,2469000,23999,False,55,scaffold_8
2,2492001,2513000,20999,False,55,scaffold_8
3,2536001,2551000,14999,False,55,scaffold_8
4,2662001,2683000,20999,False,55,scaffold_8
5,2745001,2756000,10999,False,55,scaffold_8
6,3060001,3525000,464999,False,55,scaffold_8
7,3584001,3612000,27999,False,55,scaffold_8
8,3615001,3913000,297999,False,55,scaffold_8
9,4066001,4098000,31999,False,55,scaffold_8
10,5182001,5241000,58999,False,55,scaffold_8
11,6332001,6334544,2543,True,55,scaffold_8
0,109001,117000,7999,False,55,scaffold_9
1,189001,194000,4999,False,55,scaffold_9
2,301001,315000,13999,False,55,scaffold_9
3,319001,334000,14999,False,55,scaffold_9
4,358001,411000,52999,False,55,scaffold_9
5,413001,434000,20999,False,55,scaffold_9
6,501001,531000,29999,False,55,scaffold_9
7,671001,696000,24999,False,55,scaffold_9
8,732001,742000,9999,False,55,scaffold_9
9,816001,842000,25999,False,55,scaffold_9
10,850001,854000,3999,False,55,scaffold_9
11,886001,986000,99999,False,55,scaffold_9
12,987001,995000,7999,False,55,scaffold_9
13,1001001,1007000,5999,False,55,scaffold_9
14,1009001,1031000,21999,False,55,scaffold_9
15,1035001,1085000,49999,False,55,scaffold_9
16,1087001,1150000,62999,False,55,scaffold_9
17,1151001,1164000,12999,False,55,scaffold_9
18,1313001,1377000,63999,False,55,scaffold_9
19,1769001,1789000,19999,False,55,scaffold_9
20,2601001,2616000,14999,False,55,scaffold_9
21,2745001,2752000,6999,False,55,scaffold_9
22,2783001,2802000,18999,False,55,scaffold_9
23,2874001,3381000,506999,False,55,scaffold_9
24,3383001,5107000,1723999,False,55,scaffold_9
25,5112001,5114000,1999,False,55,scaffold_9
26,5116001,5238000,121999,False,55,scaffold_9
27,5239001,5298000,58999,False,55,scaffold_9
28,5300001,5490000,189999,False,55,scaffold_9
29,5492001,6331288,839287,True,55,scaffold_9
0,1,199000,198999,True,55,scaffold_10
1,373001,405000,31999,False,55,scaffold_10
2,472001,482000,9999,False,55,scaffold_10
3,483001,580000,96999,False,55,scaffold_10
4,603001,749000,145999,False,55,scaffold_10
5,888001,917000,28999,False,55,scaffold_10
6,923001,962000,38999,False,55,scaffold_10
7,1073001,1105000,31999,False,55,scaffold_10
8,2346001,2367000,20999,False,55,scaffold_10
9,4054001,4088000,33999,False,55,scaffold_10
10,4154001,4174000,19999,False,55,scaffold_10
11,4443001,4462000,18999,False,55,scaffold_10
12,4467001,4476000,8999,False,55,scaffold_10
13,4503001,4513000,9999,False,55,scaffold_10
14,4515001,4523000,7999,False,55,scaffold_10
15,4526001,4548000,21999,False,55,scaffold_10
16,4575001,4596000,20999,False,55,scaffold_10
17,4680001,4688000,7999,False,55,scaffold_10
18,4734001,4766000,31999,False,55,scaffold_10
19,4768001,4776000,7999,False,55,scaffold_10
20,4798001,4824000,25999,False,55,scaffold_10
21,4827001,4843000,15999,False,55,scaffold_10
22,4848001,4861000,12999,False,55,scaffold_10
23,4865001,4866973,1972,True,55,scaffold_10
0,10001,34000,23999,False,55,scaffold_11
1,40001,93000,52999,False,55,scaffold_11
2,149001,167000,17999,False,55,scaffold_11
3,169001,189000,19999,False,55,scaffold_11
4,213001,235000,21999,False,55,scaffold_11
5,240001,248000,7999,False,55,scaffold_11
6,419001,431000,11999,False,55,scaffold_11
7,648001,656000,7999,False,55,scaffold_11
8,666001,669000,2999,False,55,scaffold_11
9,781001,785000,3999,False,55,scaffold_11
10,1028001,1034000,5999,False,55,scaffold_11
11,1423001,1426000,2999,False,55,scaffold_11
12,1474001,1477000,2999,False,55,scaffold_11
13,2701001,2774000,72999,False,55,scaffold_11
14,2781001,2873000,91999,False,55,scaffold_11
15,2983001,3011000,27999,False,55,scaffold_11
16,3212001,3255000,42999,False,55,scaffold_11
17,3331001,3383000,51999,False,55,scaffold_11
18,3702001,3926000,223999,False,55,scaffold_11
19,4319001,4710000,390999,False,55,scaffold_11
20,4713001,4766820,53819,True,55,scaffold_11
0,1,370000,369999,True,55,scaffold_12
1,474001,541000,66999,False,55,scaffold_12
2,581001,856000,274999,False,55,scaffold_12
3,865001,1356000,490999,False,55,scaffold_12
4,1720001,1733000,12999,False,55,scaffold_12
5,2559001,2570000,10999,False,55,scaffold_12
6,2571001,2616000,44999,False,55,scaffold_12
0,1,342000,341999,True,56,scaffold_1
1,482001,498000,15999,False,56,scaffold_1
2,571001,643000,71999,False,56,scaffold_1
3,686001,750000,63999,False,56,scaffold_1
4,1281001,1294000,12999,False,56,scaffold_1
5,1297001,1331000,33999,False,56,scaffold_1
6,1618001,1660000,41999,False,56,scaffold_1
7,1812001,1900000,87999,False,56,scaffold_1
8,1916001,1964000,47999,False,56,scaffold_1
9,1965001,1984000,18999,False,56,scaffold_1
10,1988001,1996000,7999,False,56,scaffold_1
11,2262001,2328000,65999,False,56,scaffold_1
12,2358001,2413000,54999,False,56,scaffold_1
13,2449001,2517000,67999,False,56,scaffold_1
14,2566001,2583000,16999,False,56,scaffold_1
15,2729001,2746000,16999,False,56,scaffold_1
16,2988001,3031000,42999,False,56,scaffold_1
17,3179001,3209000,29999,False,56,scaffold_1
18,3456001,3622000,165999,False,56,scaffold_1
19,3685001,3756000,70999,False,56,scaffold_1
20,3764001,3880000,115999,False,56,scaffold_1
21,3901001,3941000,39999,False,56,scaffold_1
22,3942001,4031000,88999,False,56,scaffold_1
23,4060001,4130000,69999,False,56,scaffold_1
24,4314001,4357000,42999,False,56,scaffold_1
25,4719001,4789000,69999,False,56,scaffold_1
26,4927001,5022000,94999,False,56,scaffold_1
27,5087001,5111000,23999,False,56,scaffold_1
28,5436001,5454000,17999,False,56,scaffold_1
29,5481001,5521000,39999,False,56,scaffold_1
30,5535001,5577000,41999,False,56,scaffold_1
31,5850001,5890000,39999,False,56,scaffold_1
32,6109001,6153000,43999,False,56,scaffold_1
33,6154001,6511000,356999,False,56,scaffold_1
34,6542001,6555000,12999,False,56,scaffold_1
35,6833001,6854000,20999,False,56,scaffold_1
36,7037001,7247000,209999,False,56,scaffold_1
37,7248001,7588000,339999,False,56,scaffold_1
38,7590001,8656000,1065999,False,56,scaffold_1
39,8658001,9584000,925999,False,56,scaffold_1
40,9586001,10370000,783999,False,56,scaffold_1
41,10450001,10640000,189999,False,56,scaffold_1
42,10659001,10763000,103999,False,56,scaffold_1
43,10832001,10857000,24999,False,56,scaffold_1
44,10916001,10967000,50999,False,56,scaffold_1
45,11015001,11030000,14999,False,56,scaffold_1
46,11207001,11230000,22999,False,56,scaffold_1
47,11264001,11964000,699999,False,56,scaffold_1
48,12184001,12238000,53999,False,56,scaffold_1
49,12429001,12450000,20999,False,56,scaffold_1
50,12555001,12569000,13999,False,56,scaffold_1
51,12652001,12722000,69999,False,56,scaffold_1
52,12733001,12758000,24999,False,56,scaffold_1
53,12775001,12891000,115999,False,56,scaffold_1
54,12919001,12930000,10999,False,56,scaffold_1
55,12932001,12939000,6999,False,56,scaffold_1
56,13113001,13215000,101999,False,56,scaffold_1
57,13345001,13442000,96999,False,56,scaffold_1
58,13517001,13589000,71999,False,56,scaffold_1
59,13666001,13709000,42999,False,56,scaffold_1
60,13797001,13845000,47999,False,56,scaffold_1
61,13846001,13927000,80999,False,56,scaffold_1
62,13959001,13993000,33999,False,56,scaffold_1
63,14289001,14309000,19999,False,56,scaffold_1
64,14603001,14612000,8999,False,56,scaffold_1
0,22001,48000,25999,False,56,scaffold_2
1,95001,159000,63999,False,56,scaffold_2
2,165001,177000,11999,False,56,scaffold_2
3,241001,288000,46999,False,56,scaffold_2
4,296001,318000,21999,False,56,scaffold_2
5,331001,374000,42999,False,56,scaffold_2
6,1354001,1401000,46999,False,56,scaffold_2
7,2085001,2114000,28999,False,56,scaffold_2
8,2336001,2387000,50999,False,56,scaffold_2
9,2397001,2424000,26999,False,56,scaffold_2
10,2437001,2639000,201999,False,56,scaffold_2
11,2645001,2689000,43999,False,56,scaffold_2
12,2693001,2746000,52999,False,56,scaffold_2
13,2766001,2788000,21999,False,56,scaffold_2
14,2818001,2855000,36999,False,56,scaffold_2
15,2868001,2911000,42999,False,56,scaffold_2
16,2976001,3021000,44999,False,56,scaffold_2
17,3022001,3047000,24999,False,56,scaffold_2
18,3174001,3187000,12999,False,56,scaffold_2
19,3334001,3343000,8999,False,56,scaffold_2
20,3363001,3390000,26999,False,56,scaffold_2
21,3454001,3464000,9999,False,56,scaffold_2
22,3754001,3789000,34999,False,56,scaffold_2
23,4243001,4278000,34999,False,56,scaffold_2
24,4370001,4409000,38999,False,56,scaffold_2
25,4426001,4457000,30999,False,56,scaffold_2
26,4520001,4759000,238999,False,56,scaffold_2
27,4793001,4804000,10999,False,56,scaffold_2
28,4917001,4960000,42999,False,56,scaffold_2
29,5021001,5104000,82999,False,56,scaffold_2
30,5286001,5312000,25999,False,56,scaffold_2
31,5357001,5395000,37999,False,56,scaffold_2
32,5414001,5557000,142999,False,56,scaffold_2
33,5616001,5762000,145999,False,56,scaffold_2
34,5821001,5887000,65999,False,56,scaffold_2
35,5915001,6053000,137999,False,56,scaffold_2
36,6233001,6351000,117999,False,56,scaffold_2
37,6405001,6452000,46999,False,56,scaffold_2
38,6580001,6628000,47999,False,56,scaffold_2
39,6809001,6890000,80999,False,56,scaffold_2
40,6947001,6978000,30999,False,56,scaffold_2
41,7016001,7038000,21999,False,56,scaffold_2
42,7060001,7118000,57999,False,56,scaffold_2
43,7188001,7220000,31999,False,56,scaffold_2
44,7400001,7473000,72999,False,56,scaffold_2
45,7491001,7518000,26999,False,56,scaffold_2
46,7549001,7561000,11999,False,56,scaffold_2
47,7563001,7698000,134999,False,56,scaffold_2
48,7785001,8313000,527999,False,56,scaffold_2
49,8340001,8345000,4999,False,56,scaffold_2
50,8346001,8455000,108999,False,56,scaffold_2
51,8507001,8563000,55999,False,56,scaffold_2
52,9140001,9167000,26999,False,56,scaffold_2
53,9320001,9382000,61999,False,56,scaffold_2
54,9601001,9633000,31999,False,56,scaffold_2
55,10773001,10813000,39999,False,56,scaffold_2
56,11366001,11384000,17999,False,56,scaffold_2
57,11395001,11424000,28999,False,56,scaffold_2
58,11519001,11786000,266999,False,56,scaffold_2
0,63001,83000,19999,False,56,scaffold_3
1,528001,539000,10999,False,56,scaffold_3
2,618001,646000,27999,False,56,scaffold_3
3,795001,900000,104999,False,56,scaffold_3
4,1906001,1974000,67999,False,56,scaffold_3
5,2008001,2108000,99999,False,56,scaffold_3
6,2135001,2147000,11999,False,56,scaffold_3
7,2161001,2180000,18999,False,56,scaffold_3
8,2265001,2322000,56999,False,56,scaffold_3
9,2408001,2428000,19999,False,56,scaffold_3
10,2434001,2533000,98999,False,56,scaffold_3
11,2622001,2683000,60999,False,56,scaffold_3
12,2716001,2736000,19999,False,56,scaffold_3
13,3112001,3125000,12999,False,56,scaffold_3
14,3129001,3139000,9999,False,56,scaffold_3
15,3620001,3643000,22999,False,56,scaffold_3
16,3768001,3891000,122999,False,56,scaffold_3
17,4098001,4403000,304999,False,56,scaffold_3
18,4409001,4518000,108999,False,56,scaffold_3
19,4547001,4559000,11999,False,56,scaffold_3
20,4583001,4687000,103999,False,56,scaffold_3
21,4998001,5033000,34999,False,56,scaffold_3
22,5159001,5210000,50999,False,56,scaffold_3
23,5488001,5508000,19999,False,56,scaffold_3
24,5589001,5665000,75999,False,56,scaffold_3
25,5808001,5953000,144999,False,56,scaffold_3
26,5989001,6020000,30999,False,56,scaffold_3
27,6741001,6808000,66999,False,56,scaffold_3
28,6848001,6962000,113999,False,56,scaffold_3
29,6979001,7098000,118999,False,56,scaffold_3
30,7255001,7317000,61999,False,56,scaffold_3
31,7432001,7445000,12999,False,56,scaffold_3
32,7449001,7458000,8999,False,56,scaffold_3
33,7518001,7557000,38999,False,56,scaffold_3
34,7675001,7857000,181999,False,56,scaffold_3
35,8052001,8106000,53999,False,56,scaffold_3
36,8175001,8253000,77999,False,56,scaffold_3
37,8398001,8527000,128999,False,56,scaffold_3
38,8575001,8593000,17999,False,56,scaffold_3
39,9000001,9082000,81999,False,56,scaffold_3
40,9224001,9248000,23999,False,56,scaffold_3
41,9645001,9685000,39999,False,56,scaffold_3
42,9968001,9996000,27999,False,56,scaffold_3
43,10461001,10483000,21999,False,56,scaffold_3
44,10587001,11182071,595070,True,56,scaffold_3
0,1,7000,6999,True,56,scaffold_4
1,11001,13000,1999,False,56,scaffold_4
2,14001,32000,17999,False,56,scaffold_4
3,49001,115000,65999,False,56,scaffold_4
4,155001,215000,59999,False,56,scaffold_4
5,217001,278000,60999,False,56,scaffold_4
6,289001,344000,54999,False,56,scaffold_4
7,345001,353000,7999,False,56,scaffold_4
8,355001,374000,18999,False,56,scaffold_4
9,375001,410000,34999,False,56,scaffold_4
10,412001,425000,12999,False,56,scaffold_4
11,429001,607000,177999,False,56,scaffold_4
12,608001,691000,82999,False,56,scaffold_4
13,1121001,1136000,14999,False,56,scaffold_4
14,1137001,1226000,88999,False,56,scaffold_4
15,1229001,1279000,49999,False,56,scaffold_4
16,1283001,1605000,321999,False,56,scaffold_4
17,1613001,2208000,594999,False,56,scaffold_4
18,2210001,2218000,7999,False,56,scaffold_4
19,2219001,2246000,26999,False,56,scaffold_4
20,2247001,2461000,213999,False,56,scaffold_4
21,2476001,2635000,158999,False,56,scaffold_4
22,2676001,2801000,124999,False,56,scaffold_4
23,2892001,2956000,63999,False,56,scaffold_4
24,3090001,3128000,37999,False,56,scaffold_4
25,3228001,3788000,559999,False,56,scaffold_4
26,4051001,4107000,55999,False,56,scaffold_4
27,4897001,5092000,194999,False,56,scaffold_4
28,5171001,5246000,74999,False,56,scaffold_4
29,5340001,5408000,67999,False,56,scaffold_4
30,5476001,5506000,29999,False,56,scaffold_4
31,5514001,5784000,269999,False,56,scaffold_4
32,5786001,5827000,40999,False,56,scaffold_4
33,6068001,6113000,44999,False,56,scaffold_4
34,6148001,6192000,43999,False,56,scaffold_4
35,6285001,6370000,84999,False,56,scaffold_4
36,6615001,6617000,1999,False,56,scaffold_4
37,6727001,6817000,89999,False,56,scaffold_4
38,6872001,6924000,51999,False,56,scaffold_4
39,6926001,6931000,4999,False,56,scaffold_4
40,6950001,7021000,70999,False,56,scaffold_4
41,7036001,7177000,140999,False,56,scaffold_4
42,7207001,7291000,83999,False,56,scaffold_4
43,7352001,7428000,75999,False,56,scaffold_4
44,7628001,7667000,38999,False,56,scaffold_4
45,8844001,9699000,854999,False,56,scaffold_4
46,9700001,9845951,145950,True,56,scaffold_4
0,141001,173000,31999,False,56,scaffold_5
1,318001,430000,111999,False,56,scaffold_5
2,452001,526000,73999,False,56,scaffold_5
3,668001,697000,28999,False,56,scaffold_5
4,933001,947000,13999,False,56,scaffold_5
5,1069001,1104000,34999,False,56,scaffold_5
6,1648001,1655000,6999,False,56,scaffold_5
7,2093001,2104000,10999,False,56,scaffold_5
8,2265001,2283000,17999,False,56,scaffold_5
9,2475001,2494000,18999,False,56,scaffold_5
10,2508001,2515000,6999,False,56,scaffold_5
11,2550001,2875000,324999,False,56,scaffold_5
12,3133001,3563000,429999,False,56,scaffold_5
13,3617001,3659000,41999,False,56,scaffold_5
14,3843001,3872000,28999,False,56,scaffold_5
15,3962001,4275000,312999,False,56,scaffold_5
16,4444001,4538000,93999,False,56,scaffold_5
17,4595001,4918000,322999,False,56,scaffold_5
18,5059001,5083000,23999,False,56,scaffold_5
19,5257001,5274000,16999,False,56,scaffold_5
20,5283001,5344000,60999,False,56,scaffold_5
21,5507001,5529000,21999,False,56,scaffold_5
22,5707001,5738000,30999,False,56,scaffold_5
23,6257001,6262000,4999,False,56,scaffold_5
24,6394001,6421000,26999,False,56,scaffold_5
25,6453001,6727000,273999,False,56,scaffold_5
26,6878001,6906000,27999,False,56,scaffold_5
27,7454001,7513000,58999,False,56,scaffold_5
28,7559001,7655000,95999,False,56,scaffold_5
29,7705001,7747000,41999,False,56,scaffold_5
30,8258001,8266000,7999,False,56,scaffold_5
31,8411001,8469000,57999,False,56,scaffold_5
32,8540001,8617000,76999,False,56,scaffold_5
33,8632001,8686000,53999,False,56,scaffold_5
34,8703001,9364176,661175,True,56,scaffold_5
0,77001,84000,6999,False,56,scaffold_6
1,86001,113000,26999,False,56,scaffold_6
2,149001,208000,58999,False,56,scaffold_6
3,239001,297000,57999,False,56,scaffold_6
4,352001,377000,24999,False,56,scaffold_6
5,786001,800000,13999,False,56,scaffold_6
6,1003001,1025000,21999,False,56,scaffold_6
7,1146001,1267000,120999,False,56,scaffold_6
8,1288001,1300000,11999,False,56,scaffold_6
9,1478001,1553000,74999,False,56,scaffold_6
10,1557001,1592000,34999,False,56,scaffold_6
11,1658001,1689000,30999,False,56,scaffold_6
12,1832001,1901000,68999,False,56,scaffold_6
13,2030001,2106000,75999,False,56,scaffold_6
14,2117001,2213000,95999,False,56,scaffold_6
15,2238001,2283000,44999,False,56,scaffold_6
16,2335001,2595000,259999,False,56,scaffold_6
17,2596001,2654000,57999,False,56,scaffold_6
18,2655001,2872000,216999,False,56,scaffold_6
19,2926001,3027000,100999,False,56,scaffold_6
20,3063001,3211000,147999,False,56,scaffold_6
21,3215001,3350000,134999,False,56,scaffold_6
22,3351001,3793000,441999,False,56,scaffold_6
23,3893001,3913000,19999,False,56,scaffold_6
24,3982001,4193000,210999,False,56,scaffold_6
25,4843001,4916000,72999,False,56,scaffold_6
26,4976001,4997000,20999,False,56,scaffold_6
27,5600001,5739000,138999,False,56,scaffold_6
28,6004001,6089000,84999,False,56,scaffold_6
29,6141001,6183000,41999,False,56,scaffold_6
30,6776001,6804000,27999,False,56,scaffold_6
31,6923001,6953000,29999,False,56,scaffold_6
32,7080001,7098000,17999,False,56,scaffold_6
33,7184001,7342000,157999,False,56,scaffold_6
34,7388001,7484000,95999,False,56,scaffold_6
35,7550001,8268281,718280,True,56,scaffold_6
0,13001,32000,18999,False,56,scaffold_7
1,87001,119000,31999,False,56,scaffold_7
2,157001,168000,10999,False,56,scaffold_7
3,323001,509000,185999,False,56,scaffold_7
4,571001,592000,20999,False,56,scaffold_7
5,646001,675000,28999,False,56,scaffold_7
6,689001,753000,63999,False,56,scaffold_7
7,763001,829000,65999,False,56,scaffold_7
8,859001,864000,4999,False,56,scaffold_7
9,865001,948000,82999,False,56,scaffold_7
10,949001,980000,30999,False,56,scaffold_7
11,982001,1044000,61999,False,56,scaffold_7
12,1048001,1136000,87999,False,56,scaffold_7
13,1168001,1460000,291999,False,56,scaffold_7
14,1461001,1517000,55999,False,56,scaffold_7
15,1578001,1695000,116999,False,56,scaffold_7
16,1727001,1781000,53999,False,56,scaffold_7
17,1821001,1893000,71999,False,56,scaffold_7
18,1983001,2024000,40999,False,56,scaffold_7
19,3301001,3371000,69999,False,56,scaffold_7
20,3521001,3562000,40999,False,56,scaffold_7
21,3591001,3766000,174999,False,56,scaffold_7
22,3910001,3931000,20999,False,56,scaffold_7
23,4326001,4361000,34999,False,56,scaffold_7
24,4415001,4516000,100999,False,56,scaffold_7
25,4551001,4580000,28999,False,56,scaffold_7
26,4658001,4745000,86999,False,56,scaffold_7
27,4748001,4861000,112999,False,56,scaffold_7
28,4978001,5168000,189999,False,56,scaffold_7
29,5459001,5537000,77999,False,56,scaffold_7
30,6167001,6235000,67999,False,56,scaffold_7
31,6765001,6782000,16999,False,56,scaffold_7
32,6953001,7270000,316999,False,56,scaffold_7
33,7271001,7502216,231215,True,56,scaffold_7
0,1,6000,5999,True,56,scaffold_8
1,32001,64000,31999,False,56,scaffold_8
2,66001,85000,18999,False,56,scaffold_8
3,1363001,1422000,58999,False,56,scaffold_8
4,1858001,1931000,72999,False,56,scaffold_8
5,2360001,2395000,34999,False,56,scaffold_8
6,2414001,2571000,156999,False,56,scaffold_8
7,2646001,2700000,53999,False,56,scaffold_8
8,2740001,2758000,17999,False,56,scaffold_8
9,2795001,2844000,48999,False,56,scaffold_8
10,2847001,2873000,25999,False,56,scaffold_8
11,3039001,3551000,511999,False,56,scaffold_8
12,3579001,3614000,34999,False,56,scaffold_8
13,3615001,3945000,329999,False,56,scaffold_8
14,4037001,4107000,69999,False,56,scaffold_8
15,4202001,4267000,64999,False,56,scaffold_8
16,4400001,4434000,33999,False,56,scaffold_8
17,4902001,4914000,11999,False,56,scaffold_8
18,5084001,5136000,51999,False,56,scaffold_8
19,5168001,5241000,72999,False,56,scaffold_8
20,5531001,5596000,64999,False,56,scaffold_8
21,5651001,5708000,56999,False,56,scaffold_8
22,5760001,5834000,73999,False,56,scaffold_8
23,5836001,5855000,18999,False,56,scaffold_8
24,5963001,5980000,16999,False,56,scaffold_8
25,6320001,6334544,14543,True,56,scaffold_8
0,1,21000,20999,True,56,scaffold_9
1,109001,117000,7999,False,56,scaffold_9
2,303001,315000,11999,False,56,scaffold_9
3,319001,411000,91999,False,56,scaffold_9
4,413001,435000,21999,False,56,scaffold_9
5,483001,531000,47999,False,56,scaffold_9
6,547001,563000,15999,False,56,scaffold_9
7,647001,665000,17999,False,56,scaffold_9
8,669001,696000,26999,False,56,scaffold_9
9,731001,742000,10999,False,56,scaffold_9
10,814001,843000,28999,False,56,scaffold_9
11,877001,986000,108999,False,56,scaffold_9
12,988001,996000,7999,False,56,scaffold_9
13,997001,1007000,9999,False,56,scaffold_9
14,1008001,1150000,141999,False,56,scaffold_9
15,1151001,1177000,25999,False,56,scaffold_9
16,1203001,1226000,22999,False,56,scaffold_9
17,1311001,1382000,70999,False,56,scaffold_9
18,1428001,1442000,13999,False,56,scaffold_9
19,1457001,1464000,6999,False,56,scaffold_9
20,1527001,1534000,6999,False,56,scaffold_9
21,1543001,1598000,54999,False,56,scaffold_9
22,1599001,1624000,24999,False,56,scaffold_9
23,1637001,1692000,54999,False,56,scaffold_9
24,1749001,1806000,56999,False,56,scaffold_9
25,1985001,2058000,72999,False,56,scaffold_9
26,2075001,2237000,161999,False,56,scaffold_9
27,2517001,2579000,61999,False,56,scaffold_9
28,2584001,2669000,84999,False,56,scaffold_9
29,2731001,3381000,649999,False,56,scaffold_9
30,3383001,5107000,1723999,False,56,scaffold_9
31,5112001,5238000,125999,False,56,scaffold_9
32,5239001,5298000,58999,False,56,scaffold_9
33,5299001,5490000,190999,False,56,scaffold_9
34,5493001,6331288,838287,True,56,scaffold_9
0,1,235000,234999,True,56,scaffold_10
1,257001,414000,156999,False,56,scaffold_10
2,415001,482000,66999,False,56,scaffold_10
3,483001,583000,99999,False,56,scaffold_10
4,596001,878000,281999,False,56,scaffold_10
5,888001,992000,103999,False,56,scaffold_10
6,1073001,1147000,73999,False,56,scaffold_10
7,1381001,1474000,92999,False,56,scaffold_10
8,1537001,1572000,34999,False,56,scaffold_10
9,1635001,1675000,39999,False,56,scaffold_10
10,2087001,2107000,19999,False,56,scaffold_10
11,2134001,2333000,198999,False,56,scaffold_10
12,2334001,2446000,111999,False,56,scaffold_10
13,2509001,2520000,10999,False,56,scaffold_10
14,2521001,2578000,56999,False,56,scaffold_10
15,2599001,2637000,37999,False,56,scaffold_10
16,2641001,2652000,10999,False,56,scaffold_10
17,2715001,2733000,17999,False,56,scaffold_10
18,2735001,2746000,10999,False,56,scaffold_10
19,2787001,2813000,25999,False,56,scaffold_10
20,2817001,2846000,28999,False,56,scaffold_10
21,3153001,3183000,29999,False,56,scaffold_10
22,3314001,3321000,6999,False,56,scaffold_10
23,3395001,3411000,15999,False,56,scaffold_10
24,4051001,4118000,66999,False,56,scaffold_10
25,4154001,4174000,19999,False,56,scaffold_10
26,4231001,4248000,16999,False,56,scaffold_10
27,4335001,4361000,25999,False,56,scaffold_10
28,4443001,4513000,69999,False,56,scaffold_10
29,4515001,4548000,32999,False,56,scaffold_10
30,4574001,4596000,21999,False,56,scaffold_10
31,4681001,4687000,5999,False,56,scaffold_10
32,4734001,4766000,31999,False,56,scaffold_10
33,4768001,4776000,7999,False,56,scaffold_10
34,4798001,4824000,25999,False,56,scaffold_10
35,4827001,4843000,15999,False,56,scaffold_10
36,4848001,4861000,12999,False,56,scaffold_10
37,4865001,4866973,1972,True,56,scaffold_10
0,11001,97000,85999,False,56,scaffold_11
1,132001,167000,34999,False,56,scaffold_11
2,169001,212000,42999,False,56,scaffold_11
3,213001,236000,22999,False,56,scaffold_11
4,240001,251000,10999,False,56,scaffold_11
5,288001,320000,31999,False,56,scaffold_11
6,420001,431000,10999,False,56,scaffold_11
7,637001,656000,18999,False,56,scaffold_11
8,1474001,1477000,2999,False,56,scaffold_11
9,1774001,1802000,27999,False,56,scaffold_11
10,1855001,1886000,30999,False,56,scaffold_11
11,1969001,1984000,14999,False,56,scaffold_11
12,1985001,1996000,10999,False,56,scaffold_11
13,2008001,2058000,49999,False,56,scaffold_11
14,2131001,2158000,26999,False,56,scaffold_11
15,2676001,2877000,200999,False,56,scaffold_11
16,2982001,3019000,36999,False,56,scaffold_11
17,3085001,3176000,90999,False,56,scaffold_11
18,3184001,3297000,112999,False,56,scaffold_11
19,3307001,3383000,75999,False,56,scaffold_11
20,3441001,3479000,37999,False,56,scaffold_11
21,3522001,3971000,448999,False,56,scaffold_11
22,4004001,4160000,155999,False,56,scaffold_11
23,4181001,4710000,528999,False,56,scaffold_11
24,4713001,4766820,53819,True,56,scaffold_11
0,1,1501000,1500999,True,56,scaffold_12
1,1717001,1746000,28999,False,56,scaffold_12
2,1787001,1811000,23999,False,56,scaffold_12
3,1882001,1951000,68999,False,56,scaffold_12
4,1979001,2005000,25999,False,56,scaffold_12
5,2007001,2015000,7999,False,56,scaffold_12
6,2016001,2104000,87999,False,56,scaffold_12
7,2135001,2180000,44999,False,56,scaffold_12
8,2340001,2378000,37999,False,56,scaffold_12
9,2571001,2618000,46999,False,56,scaffold_12
10,2685001,2708000,22999,False,56,scaffold_12
0,1,498000,497999,True,57,scaffold_1
1,571001,1000000,428999,False,57,scaffold_1
2,1060001,1101000,40999,False,57,scaffold_1
3,1148001,1296000,147999,False,57,scaffold_1
4,1297001,1368000,70999,False,57,scaffold_1
5,1607001,2101000,493999,False,57,scaffold_1
6,2135001,2627000,491999,False,57,scaffold_1
7,2638001,2696000,57999,False,57,scaffold_1
8,2715001,2746000,30999,False,57,scaffold_1
9,2893001,2928000,34999,False,57,scaffold_1
10,2958001,3094000,135999,False,57,scaffold_1
11,3099001,3241000,141999,False,57,scaffold_1
12,3243001,3414000,170999,False,57,scaffold_1
13,3419001,4300000,880999,False,57,scaffold_1
14,4301001,4322000,20999,False,57,scaffold_1
15,4323001,5224000,900999,False,57,scaffold_1
16,5267001,5334000,66999,False,57,scaffold_1
17,5343001,5521000,177999,False,57,scaffold_1
18,5522001,5693000,170999,False,57,scaffold_1
19,5848001,6101000,252999,False,57,scaffold_1
20,6108001,6569000,460999,False,57,scaffold_1
21,6637001,6658000,20999,False,57,scaffold_1
22,6681001,6862000,180999,False,57,scaffold_1
23,6864001,8656000,1791999,False,57,scaffold_1
24,8658001,9584000,925999,False,57,scaffold_1
25,9586001,10640000,1053999,False,57,scaffold_1
26,10654001,10792000,137999,False,57,scaffold_1
27,10832001,11079000,246999,False,57,scaffold_1
28,11080001,12249000,1168999,False,57,scaffold_1
29,12285001,13217000,931999,False,57,scaffold_1
30,13258001,13277000,18999,False,57,scaffold_1
31,13317001,13516000,198999,False,57,scaffold_1
32,13517001,13955000,437999,False,57,scaffold_1
33,13959001,14099000,139999,False,57,scaffold_1
34,14112001,14187000,74999,False,57,scaffold_1
35,14188001,14192000,3999,False,57,scaffold_1
36,14193001,14313000,119999,False,57,scaffold_1
37,14316001,14461000,144999,False,57,scaffold_1
38,14462001,14621000,158999,False,57,scaffold_1
39,14649001,14674000,24999,False,57,scaffold_1
40,14675001,14715000,39999,False,57,scaffold_1
41,14717001,14726000,8999,False,57,scaffold_1
42,14728001,14769000,40999,False,57,scaffold_1
43,14770001,14794116,24115,True,57,scaffold_1
0,1,48000,47999,True,57,scaffold_2
1,51001,56000,4999,False,57,scaffold_2
2,66001,161000,94999,False,57,scaffold_2
3,165001,177000,11999,False,57,scaffold_2
4,179001,288000,108999,False,57,scaffold_2
5,302001,318000,15999,False,57,scaffold_2
6,319001,409000,89999,False,57,scaffold_2
7,418001,449000,30999,False,57,scaffold_2
8,458001,633000,174999,False,57,scaffold_2
9,648001,739000,90999,False,57,scaffold_2
10,761001,822000,60999,False,57,scaffold_2
11,859001,1015000,155999,False,57,scaffold_2
12,1019001,2691000,1671999,False,57,scaffold_2
13,2693001,2749000,55999,False,57,scaffold_2
14,2761001,3105000,343999,False,57,scaffold_2
15,3140001,3160000,19999,False,57,scaffold_2
16,3161001,3282000,120999,False,57,scaffold_2
17,3286001,3439000,152999,False,57,scaffold_2
18,3447001,4194000,746999,False,57,scaffold_2
19,4196001,4790000,593999,False,57,scaffold_2
20,4793001,4815000,21999,False,57,scaffold_2
21,4839001,4998000,158999,False,57,scaffold_2
22,5007001,5105000,97999,False,57,scaffold_2
23,5115001,5234000,118999,False,57,scaffold_2
24,5248001,5779000,530999,False,57,scaffold_2
25,5814001,6490000,675999,False,57,scaffold_2
26,6500001,7244000,743999,False,57,scaffold_2
27,7346001,7530000,183999,False,57,scaffold_2
28,7545001,7562000,16999,False,57,scaffold_2
29,7563001,8326000,762999,False,57,scaffold_2
30,8346001,8494000,147999,False,57,scaffold_2
31,8495001,8591000,95999,False,57,scaffold_2
32,8612001,8697000,84999,False,57,scaffold_2
33,8799001,9095000,295999,False,57,scaffold_2
34,9117001,9508000,390999,False,57,scaffold_2
35,9532001,9906000,373999,False,57,scaffold_2
36,10187001,10246000,58999,False,57,scaffold_2
37,10297001,10434000,136999,False,57,scaffold_2
38,10436001,10766000,329999,False,57,scaffold_2
39,10769001,10962000,192999,False,57,scaffold_2
40,10991001,10993000,1999,False,57,scaffold_2
41,10994001,11802476,808475,True,57,scaffold_2
0,1,116000,115999,True,57,scaffold_3
1,117001,128000,10999,False,57,scaffold_3
2,130001,267000,136999,False,57,scaffold_3
3,270001,365000,94999,False,57,scaffold_3
4,369001,466000,96999,False,57,scaffold_3
5,527001,547000,19999,False,57,scaffold_3
6,575001,617000,41999,False,57,scaffold_3
7,618001,647000,28999,False,57,scaffold_3
8,649001,1034000,384999,False,57,scaffold_3
9,1063001,1097000,33999,False,57,scaffold_3
10,1098001,1162000,63999,False,57,scaffold_3
11,1163001,1384000,220999,False,57,scaffold_3
12,1397001,1582000,184999,False,57,scaffold_3
13,1584001,2428000,843999,False,57,scaffold_3
14,2432001,2560000,127999,False,57,scaffold_3
15,2561001,3062000,500999,False,57,scaffold_3
16,3064001,4404000,1339999,False,57,scaffold_3
17,4406001,5321000,914999,False,57,scaffold_3
18,5344001,6203000,858999,False,57,scaffold_3
19,6218001,6245000,26999,False,57,scaffold_3
20,6276001,6383000,106999,False,57,scaffold_3
21,6422001,6627000,204999,False,57,scaffold_3
22,6657001,6962000,304999,False,57,scaffold_3
23,6963001,7445000,481999,False,57,scaffold_3
24,7449001,8724000,1274999,False,57,scaffold_3
25,8756001,9721000,964999,False,57,scaffold_3
26,9723001,9996000,272999,False,57,scaffold_3
27,10040001,10149000,108999,False,57,scaffold_3
28,10172001,10344000,171999,False,57,scaffold_3
29,10355001,10389000,33999,False,57,scaffold_3
30,10416001,11182071,766070,True,57,scaffold_3
0,1,7000,6999,True,57,scaffold_4
1,9001,29000,19999,False,57,scaffold_4
2,48001,88000,39999,False,57,scaffold_4
3,91001,116000,24999,False,57,scaffold_4
4,119001,151000,31999,False,57,scaffold_4
5,154001,216000,61999,False,57,scaffold_4
6,217001,280000,62999,False,57,scaffold_4
7,283001,344000,60999,False,57,scaffold_4
8,345001,353000,7999,False,57,scaffold_4
9,355001,374000,18999,False,57,scaffold_4
10,375001,410000,34999,False,57,scaffold_4
11,411001,425000,13999,False,57,scaffold_4
12,426001,428000,1999,False,57,scaffold_4
13,429001,505000,75999,False,57,scaffold_4
14,507001,592000,84999,False,57,scaffold_4
15,593001,607000,13999,False,57,scaffold_4
16,608001,691000,82999,False,57,scaffold_4
17,701001,726000,24999,False,57,scaffold_4
18,820001,887000,66999,False,57,scaffold_4
19,889001,982000,92999,False,57,scaffold_4
20,1011001,1042000,30999,False,57,scaffold_4
21,1043001,1047000,3999,False,57,scaffold_4
22,1050001,1081000,30999,False,57,scaffold_4
23,1083001,1136000,52999,False,57,scaffold_4
24,1137001,1227000,89999,False,57,scaffold_4
25,1229001,1279000,49999,False,57,scaffold_4
26,1283001,1605000,321999,False,57,scaffold_4
27,1609001,2462000,852999,False,57,scaffold_4
28,2476001,4046000,1569999,False,57,scaffold_4
29,4047001,4197000,149999,False,57,scaffold_4
30,4198001,4377000,178999,False,57,scaffold_4
31,4659001,4749000,89999,False,57,scaffold_4
32,4833001,5506000,672999,False,57,scaffold_4
33,5516001,6612000,1095999,False,57,scaffold_4
34,6613001,6924000,310999,False,57,scaffold_4
35,6926001,7571000,644999,False,57,scaffold_4
36,7595001,7936000,340999,False,57,scaffold_4
37,7967001,8163000,195999,False,57,scaffold_4
38,8241001,8364000,122999,False,57,scaffold_4
39,8453001,8469000,15999,False,57,scaffold_4
40,8522001,8542000,19999,False,57,scaffold_4
41,8555001,8830000,274999,False,57,scaffold_4
42,8835001,9699000,863999,False,57,scaffold_4
43,9700001,9845951,145950,True,57,scaffold_4
0,49001,121000,71999,False,57,scaffold_5
1,129001,206000,76999,False,57,scaffold_5
2,216001,428000,211999,False,57,scaffold_5
3,442001,526000,83999,False,57,scaffold_5
4,542001,561000,18999,False,57,scaffold_5
5,563001,720000,156999,False,57,scaffold_5
6,795001,834000,38999,False,57,scaffold_5
7,836001,975000,138999,False,57,scaffold_5
8,1062001,1567000,504999,False,57,scaffold_5
9,1579001,1593000,13999,False,57,scaffold_5
10,1595001,1836000,240999,False,57,scaffold_5
11,1837001,1895000,57999,False,57,scaffold_5
12,1897001,1935000,37999,False,57,scaffold_5
13,1937001,2043000,105999,False,57,scaffold_5
14,2079001,2104000,24999,False,57,scaffold_5
15,2106001,2119000,12999,False,57,scaffold_5
16,2254001,3662000,1407999,False,57,scaffold_5
17,3713001,5568000,1854999,False,57,scaffold_5
18,5696001,5843000,146999,False,57,scaffold_5
19,5859001,5888000,28999,False,57,scaffold_5
20,6101001,6121000,19999,False,57,scaffold_5
21,6203001,6262000,58999,False,57,scaffold_5
22,6263001,6854000,590999,False,57,scaffold_5
23,6876001,6970000,93999,False,57,scaffold_5
24,7010001,7100000,89999,False,57,scaffold_5
25,7124001,7452000,327999,False,57,scaffold_5
26,7454001,7874000,419999,False,57,scaffold_5
27,8145001,8169000,23999,False,57,scaffold_5
28,8258001,8281000,22999,False,57,scaffold_5
29,8287001,8346000,58999,False,57,scaffold_5
30,8370001,8469000,98999,False,57,scaffold_5
31,8530001,9364176,834175,True,57,scaffold_5
0,1,39000,38999,True,57,scaffold_6
1,42001,75000,32999,False,57,scaffold_6
2,76001,85000,8999,False,57,scaffold_6
3,86001,121000,34999,False,57,scaffold_6
4,122001,581000,458999,False,57,scaffold_6
5,605001,810000,204999,False,57,scaffold_6
6,813001,830000,16999,False,57,scaffold_6
7,833001,4207000,3373999,False,57,scaffold_6
8,4208001,4233000,24999,False,57,scaffold_6
9,4246001,4562000,315999,False,57,scaffold_6
10,4567001,4919000,351999,False,57,scaffold_6
11,4924001,5006000,81999,False,57,scaffold_6
12,5016001,5052000,35999,False,57,scaffold_6
13,5122001,5184000,61999,False,57,scaffold_6
14,5233001,6889000,1655999,False,57,scaffold_6
15,6910001,7141000,230999,False,57,scaffold_6
16,7158001,8268281,1110280,True,57,scaffold_6
0,1,46000,45999,True,57,scaffold_7
1,50001,202000,151999,False,57,scaffold_7
2,269001,341000,71999,False,57,scaffold_7
3,342001,509000,166999,False,57,scaffold_7
4,571001,579000,7999,False,57,scaffold_7
5,580001,612000,31999,False,57,scaffold_7
6,614001,755000,140999,False,57,scaffold_7
7,760001,845000,84999,False,57,scaffold_7
8,865001,1044000,178999,False,57,scaffold_7
9,1048001,1151000,102999,False,57,scaffold_7
10,1160001,1577000,416999,False,57,scaffold_7
11,1578001,1782000,203999,False,57,scaffold_7
12,1783001,2083000,299999,False,57,scaffold_7
13,2127001,2178000,50999,False,57,scaffold_7
14,2180001,2221000,40999,False,57,scaffold_7
15,2222001,2291000,68999,False,57,scaffold_7
16,2366001,2410000,43999,False,57,scaffold_7
17,2427001,2759000,331999,False,57,scaffold_7
18,2760001,3406000,645999,False,57,scaffold_7
19,3440001,3985000,544999,False,57,scaffold_7
20,4014001,4117000,102999,False,57,scaffold_7
21,4202001,4220000,17999,False,57,scaffold_7
22,4290001,5206000,915999,False,57,scaffold_7
23,5260001,5345000,84999,False,57,scaffold_7
24,5398001,5665000,266999,False,57,scaffold_7
25,5666001,5688000,21999,False,57,scaffold_7
26,5717001,6522000,804999,False,57,scaffold_7
27,6533001,6925000,391999,False,57,scaffold_7
28,6944001,7502216,558215,True,57,scaffold_7
0,1,6000,5999,True,57,scaffold_8
1,30001,90000,59999,False,57,scaffold_8
2,229001,243000,13999,False,57,scaffold_8
3,438001,463000,24999,False,57,scaffold_8
4,494001,538000,43999,False,57,scaffold_8
5,541001,550000,8999,False,57,scaffold_8
6,592001,621000,28999,False,57,scaffold_8
7,688001,699000,10999,False,57,scaffold_8
8,766001,784000,17999,False,57,scaffold_8
9,976001,1108000,131999,False,57,scaffold_8
10,1109001,1232000,122999,False,57,scaffold_8
11,1233001,1266000,32999,False,57,scaffold_8
12,1303001,1447000,143999,False,57,scaffold_8
13,1480001,1718000,237999,False,57,scaffold_8
14,1734001,1765000,30999,False,57,scaffold_8
15,1803001,1985000,181999,False,57,scaffold_8
16,2001001,2844000,842999,False,57,scaffold_8
17,2846001,4968000,2121999,False,57,scaffold_8
18,4969001,5723000,753999,False,57,scaffold_8
19,5727001,6334544,607543,True,57,scaffold_8
0,1,36000,35999,True,57,scaffold_9
1,54001,106000,51999,False,57,scaffold_9
2,109001,170000,60999,False,57,scaffold_9
3,204001,228000,23999,False,57,scaffold_9
4,285001,411000,125999,False,57,scaffold_9
5,413001,435000,21999,False,57,scaffold_9
6,442001,531000,88999,False,57,scaffold_9
7,532001,665000,132999,False,57,scaffold_9
8,669001,847000,177999,False,57,scaffold_9
9,850001,986000,135999,False,57,scaffold_9
10,988001,1424000,435999,False,57,scaffold_9
11,1425001,1481000,55999,False,57,scaffold_9
12,1483001,1864000,380999,False,57,scaffold_9
13,1866001,3381000,1514999,False,57,scaffold_9
14,3383001,5111000,1727999,False,57,scaffold_9
15,5112001,5238000,125999,False,57,scaffold_9
16,5239001,5298000,58999,False,57,scaffold_9
17,5299001,6331288,1032287,True,57,scaffold_9
0,1,414000,413999,True,57,scaffold_10
1,415001,1069000,653999,False,57,scaffold_10
2,1071001,3218000,2146999,False,57,scaffold_10
3,3249001,3383000,133999,False,57,scaffold_10
4,3394001,3424000,29999,False,57,scaffold_10
5,3425001,3433000,7999,False,57,scaffold_10
6,3434001,3476000,41999,False,57,scaffold_10
7,3481001,3583000,101999,False,57,scaffold_10
8,3588001,3674000,85999,False,57,scaffold_10
9,3697001,3836000,138999,False,57,scaffold_10
10,3854001,3905000,50999,False,57,scaffold_10
11,4001001,4115000,113999,False,57,scaffold_10
12,4155001,4273000,117999,False,57,scaffold_10
13,4295001,4313000,17999,False,57,scaffold_10
14,4316001,4466000,149999,False,57,scaffold_10
15,4467001,4513000,45999,False,57,scaffold_10
16,4515001,4548000,32999,False,57,scaffold_10
17,4554001,4637000,82999,False,57,scaffold_10
18,4642001,4652000,9999,False,57,scaffold_10
19,4653001,4678000,24999,False,57,scaffold_10
20,4700001,4732000,31999,False,57,scaffold_10
21,4733001,4776000,42999,False,57,scaffold_10
22,4778001,4846000,67999,False,57,scaffold_10
23,4848001,4861000,12999,False,57,scaffold_10
24,4865001,4866973,1972,True,57,scaffold_10
0,1,109000,108999,True,57,scaffold_11
1,131001,167000,35999,False,57,scaffold_11
2,169001,235000,65999,False,57,scaffold_11
3,240001,252000,11999,False,57,scaffold_11
4,265001,320000,54999,False,57,scaffold_11
5,354001,416000,61999,False,57,scaffold_11
6,419001,431000,11999,False,57,scaffold_11
7,433001,455000,21999,False,57,scaffold_11
8,627001,658000,30999,False,57,scaffold_11
9,901001,943000,41999,False,57,scaffold_11
10,952001,1014000,61999,False,57,scaffold_11
11,1035001,1314000,278999,False,57,scaffold_11
12,1315001,1409000,93999,False,57,scaffold_11
13,1414001,1421000,6999,False,57,scaffold_11
14,1423001,1470000,46999,False,57,scaffold_11
15,1474001,1478000,3999,False,57,scaffold_11
16,1480001,1496000,15999,False,57,scaffold_11
17,1516001,1648000,131999,False,57,scaffold_11
18,1664001,1693000,28999,False,57,scaffold_11
19,1703001,2064000,360999,False,57,scaffold_11
20,2065001,2246000,180999,False,57,scaffold_11
21,2333001,2499000,165999,False,57,scaffold_11
22,2572001,3037000,464999,False,57,scaffold_11
23,3082001,4710000,1627999,False,57,scaffold_11
24,4711001,4766820,55819,True,57,scaffold_11
0,1,2383000,2382999,True,57,scaffold_12
1,2384001,2570000,185999,False,57,scaffold_12
2,2571001,2624000,52999,False,57,scaffold_12
3,2625001,2640000,14999,False,57,scaffold_12
4,2660001,2682000,21999,False,57,scaffold_12
5,2686001,2747968,61967,True,57,scaffold_12
0,1,331000,330999,True,58,scaffold_1
1,482001,498000,15999,False,58,scaffold_1
2,571001,643000,71999,False,58,scaffold_1
3,686001,743000,56999,False,58,scaffold_1
4,1281001,1292000,10999,False,58,scaffold_1
5,1954001,1964000,9999,False,58,scaffold_1
6,1965001,1984000,18999,False,58,scaffold_1
7,2449001,2516000,66999,False,58,scaffold_1
8,2729001,2746000,16999,False,58,scaffold_1
9,3181001,3208000,26999,False,58,scaffold_1
10,3715001,3732000,16999,False,58,scaffold_1
11,3916001,3941000,24999,False,58,scaffold_1
12,4063001,4111000,47999,False,58,scaffold_1
13,4322001,4354000,31999,False,58,scaffold_1
14,4929001,4959000,29999,False,58,scaffold_1
15,4970001,4983000,12999,False,58,scaffold_1
16,5484001,5511000,26999,False,58,scaffold_1
17,6108001,6153000,44999,False,58,scaffold_1
18,6228001,6318000,89999,False,58,scaffold_1
19,6321001,6381000,59999,False,58,scaffold_1
20,6384001,6507000,122999,False,58,scaffold_1
21,6545001,6554000,8999,False,58,scaffold_1
22,7038001,7247000,208999,False,58,scaffold_1
23,7248001,7588000,339999,False,58,scaffold_1
24,7590001,8477000,886999,False,58,scaffold_1
25,8478001,8656000,177999,False,58,scaffold_1
26,8658001,9584000,925999,False,58,scaffold_1
27,9586001,10354000,767999,False,58,scaffold_1
28,10461001,10616000,154999,False,58,scaffold_1
29,10808001,10811000,2999,False,58,scaffold_1
30,10839001,10857000,17999,False,58,scaffold_1
31,11351001,11503000,151999,False,58,scaffold_1
32,11643001,11951000,307999,False,58,scaffold_1
33,12184001,12204000,19999,False,58,scaffold_1
34,12666001,12722000,55999,False,58,scaffold_1
35,12778001,12888000,109999,False,58,scaffold_1
36,13115001,13134000,18999,False,58,scaffold_1
37,13181001,13211000,29999,False,58,scaffold_1
38,13347001,13377000,29999,False,58,scaffold_1
39,13900001,13903000,2999,False,58,scaffold_1
0,22001,48000,25999,False,58,scaffold_2
1,93001,159000,65999,False,58,scaffold_2
2,165001,177000,11999,False,58,scaffold_2
3,330001,374000,43999,False,58,scaffold_2
4,2336001,2358000,21999,False,58,scaffold_2
5,2406001,2423000,16999,False,58,scaffold_2
6,2438001,2553000,114999,False,58,scaffold_2
7,2660001,2689000,28999,False,58,scaffold_2
8,2694001,2741000,46999,False,58,scaffold_2
9,3454001,3463000,8999,False,58,scaffold_2
10,3766001,3782000,15999,False,58,scaffold_2
11,4386001,4409000,22999,False,58,scaffold_2
12,4427001,4457000,29999,False,58,scaffold_2
13,4522001,4554000,31999,False,58,scaffold_2
14,4606001,4656000,49999,False,58,scaffold_2
15,5022001,5031000,8999,False,58,scaffold_2
16,5033001,5061000,27999,False,58,scaffold_2
17,5491001,5512000,20999,False,58,scaffold_2
18,5672001,5704000,31999,False,58,scaffold_2
19,6261001,6330000,68999,False,58,scaffold_2
20,6331001,6350000,18999,False,58,scaffold_2
21,7018001,7038000,19999,False,58,scaffold_2
22,7439001,7472000,32999,False,58,scaffold_2
23,7563001,7697000,133999,False,58,scaffold_2
24,7786001,7890000,103999,False,58,scaffold_2
25,7934001,7966000,31999,False,58,scaffold_2
26,7984001,8088000,103999,False,58,scaffold_2
27,8341001,8345000,3999,False,58,scaffold_2
28,8346001,8389000,42999,False,58,scaffold_2
29,8509001,8562000,52999,False,58,scaffold_2
30,11367001,11371000,3999,False,58,scaffold_2
31,11520001,11786000,265999,False,58,scaffold_2
0,1,2000,1999,True,58,scaffold_3
1,51001,55000,3999,False,58,scaffold_3
2,799001,901000,101999,False,58,scaffold_3
3,960001,964000,3999,False,58,scaffold_3
4,2085001,2108000,22999,False,58,scaffold_3
5,2291001,2321000,29999,False,58,scaffold_3
6,2508001,2533000,24999,False,58,scaffold_3
7,4150001,4395000,244999,False,58,scaffold_3
8,4418001,4518000,99999,False,58,scaffold_3
9,4547001,4558000,10999,False,58,scaffold_3
10,4660001,4672000,11999,False,58,scaffold_3
11,6910001,6962000,51999,False,58,scaffold_3
12,6980001,7034000,53999,False,58,scaffold_3
13,7540001,7556000,15999,False,58,scaffold_3
14,7693001,7720000,26999,False,58,scaffold_3
15,7822001,7838000,15999,False,58,scaffold_3
16,8204001,8255000,50999,False,58,scaffold_3
17,8462001,8527000,64999,False,58,scaffold_3
18,8575001,8593000,17999,False,58,scaffold_3
19,9968001,9996000,27999,False,58,scaffold_3
20,10461001,10483000,21999,False,58,scaffold_3
21,10587001,11162000,574999,False,58,scaffold_3
0,17001,32000,14999,False,58,scaffold_4
1,48001,86000,37999,False,58,scaffold_4
2,147001,151000,3999,False,58,scaffold_4
3,155001,215000,59999,False,58,scaffold_4
4,218001,226000,7999,False,58,scaffold_4
5,227001,266000,38999,False,58,scaffold_4
6,291001,307000,15999,False,58,scaffold_4
7,355001,374000,18999,False,58,scaffold_4
8,375001,380000,4999,False,58,scaffold_4
9,411001,425000,13999,False,58,scaffold_4
10,429001,500000,70999,False,58,scaffold_4
11,545001,592000,46999,False,58,scaffold_4
12,593001,606000,12999,False,58,scaffold_4
13,608001,691000,82999,False,58,scaffold_4
14,1121001,1136000,14999,False,58,scaffold_4
15,1137001,1170000,32999,False,58,scaffold_4
16,1199001,1208000,8999,False,58,scaffold_4
17,1210001,1226000,15999,False,58,scaffold_4
18,1283001,1336000,52999,False,58,scaffold_4
19,1372001,1597000,224999,False,58,scaffold_4
20,1749001,1816000,66999,False,58,scaffold_4
21,1850001,1863000,12999,False,58,scaffold_4
22,1905001,1957000,51999,False,58,scaffold_4
23,1958001,1981000,22999,False,58,scaffold_4
24,2037001,2065000,27999,False,58,scaffold_4
25,2211001,2246000,34999,False,58,scaffold_4
26,2247001,2268000,20999,False,58,scaffold_4
27,2269001,2279000,9999,False,58,scaffold_4
28,2284001,2310000,25999,False,58,scaffold_4
29,2312001,2340000,27999,False,58,scaffold_4
30,2342001,2352000,9999,False,58,scaffold_4
31,2480001,2533000,52999,False,58,scaffold_4
32,3336001,3632000,295999,False,58,scaffold_4
33,3650001,3760000,109999,False,58,scaffold_4
34,4944001,4984000,39999,False,58,scaffold_4
35,5477001,5506000,28999,False,58,scaffold_4
36,5514001,5620000,105999,False,58,scaffold_4
37,5669001,5784000,114999,False,58,scaffold_4
38,6177001,6190000,12999,False,58,scaffold_4
39,6804001,6817000,12999,False,58,scaffold_4
40,7037001,7061000,23999,False,58,scaffold_4
41,8846001,9699000,852999,False,58,scaffold_4
42,9700001,9845951,145950,True,58,scaffold_4
0,318001,326000,7999,False,58,scaffold_5
1,327001,368000,40999,False,58,scaffold_5
2,469001,480000,10999,False,58,scaffold_5
3,498001,523000,24999,False,58,scaffold_5
4,933001,947000,13999,False,58,scaffold_5
5,2565001,2582000,16999,False,58,scaffold_5
6,2623001,2733000,109999,False,58,scaffold_5
7,2816001,2871000,54999,False,58,scaffold_5
8,3167001,3184000,16999,False,58,scaffold_5
9,3322001,3438000,115999,False,58,scaffold_5
10,3451001,3498000,46999,False,58,scaffold_5
11,3962001,4101000,138999,False,58,scaffold_5
12,4121001,4219000,97999,False,58,scaffold_5
13,4246001,4262000,15999,False,58,scaffold_5
14,4446001,4501000,54999,False,58,scaffold_5
15,4603001,4629000,25999,False,58,scaffold_5
16,4691001,4717000,25999,False,58,scaffold_5
17,4784001,4861000,76999,False,58,scaffold_5
18,4904001,4917000,12999,False,58,scaffold_5
19,5318001,5346000,27999,False,58,scaffold_5
20,7623001,7637000,13999,False,58,scaffold_5
21,8730001,9363000,632999,False,58,scaffold_5
22,9364001,9364176,175,True,58,scaffold_5
0,79001,112000,32999,False,58,scaffold_6
1,240001,254000,13999,False,58,scaffold_6
2,267001,283000,15999,False,58,scaffold_6
3,1479001,1546000,66999,False,58,scaffold_6
4,2030001,2086000,55999,False,58,scaffold_6
5,2130001,2193000,62999,False,58,scaffold_6
6,2371001,2595000,223999,False,58,scaffold_6
7,2596001,2653000,56999,False,58,scaffold_6
8,2657001,2691000,33999,False,58,scaffold_6
9,2731001,2852000,120999,False,58,scaffold_6
10,2933001,3014000,80999,False,58,scaffold_6
11,3115001,3149000,33999,False,58,scaffold_6
12,3224001,3301000,76999,False,58,scaffold_6
13,3408001,3427000,18999,False,58,scaffold_6
14,3461001,3766000,304999,False,58,scaffold_6
15,3899001,3913000,13999,False,58,scaffold_6
16,4018001,4046000,27999,False,58,scaffold_6
17,4085001,4193000,107999,False,58,scaffold_6
18,6011001,6060000,48999,False,58,scaffold_6
19,7282001,7337000,54999,False,58,scaffold_6
20,7560001,7673000,112999,False,58,scaffold_6
21,7690001,7795000,104999,False,58,scaffold_6
22,7811001,8268281,457280,True,58,scaffold_6
0,1,7000,6999,True,58,scaffold_7
1,13001,34000,20999,False,58,scaffold_7
2,323001,340000,16999,False,58,scaffold_7
3,342001,508000,165999,False,58,scaffold_7
4,554001,563000,8999,False,58,scaffold_7
5,571001,577000,5999,False,58,scaffold_7
6,706001,724000,17999,False,58,scaffold_7
7,725001,736000,10999,False,58,scaffold_7
8,764001,806000,41999,False,58,scaffold_7
9,859001,864000,4999,False,58,scaffold_7
10,982001,1044000,61999,False,58,scaffold_7
11,1191001,1512000,320999,False,58,scaffold_7
12,1588001,1690000,101999,False,58,scaffold_7
13,3326001,3369000,42999,False,58,scaffold_7
14,3595001,3649000,53999,False,58,scaffold_7
15,4415001,4517000,101999,False,58,scaffold_7
16,4658001,4682000,23999,False,58,scaffold_7
17,4979001,5030000,50999,False,58,scaffold_7
18,5076001,5113000,36999,False,58,scaffold_7
19,5486001,5515000,28999,False,58,scaffold_7
20,6955001,7502216,547215,True,58,scaffold_7
0,67001,85000,17999,False,58,scaffold_8
1,2661001,2683000,21999,False,58,scaffold_8
2,2745001,2756000,10999,False,58,scaffold_8
3,3060001,3524000,463999,False,58,scaffold_8
4,3584001,3612000,27999,False,58,scaffold_8
5,3615001,3913000,297999,False,58,scaffold_8
6,5201001,5239000,37999,False,58,scaffold_8
7,6324001,6334544,10543,True,58,scaffold_8
0,109001,117000,7999,False,58,scaffold_9
1,121001,138000,16999,False,58,scaffold_9
2,144001,148000,3999,False,58,scaffold_9
3,303001,315000,11999,False,58,scaffold_9
4,319001,332000,12999,False,58,scaffold_9
5,367001,411000,43999,False,58,scaffold_9
6,413001,434000,20999,False,58,scaffold_9
7,502001,531000,28999,False,58,scaffold_9
8,548001,563000,14999,False,58,scaffold_9
9,652001,665000,12999,False,58,scaffold_9
10,671001,696000,24999,False,58,scaffold_9
11,732001,742000,9999,False,58,scaffold_9
12,815001,842000,26999,False,58,scaffold_9
13,850001,862000,11999,False,58,scaffold_9
14,873001,986000,112999,False,58,scaffold_9
15,987001,995000,7999,False,58,scaffold_9
16,1001001,1007000,5999,False,58,scaffold_9
17,1010001,1031000,20999,False,58,scaffold_9
18,1035001,1085000,49999,False,58,scaffold_9
19,1087001,1150000,62999,False,58,scaffold_9
20,1151001,1164000,12999,False,58,scaffold_9
21,1312001,1377000,64999,False,58,scaffold_9
22,1767001,1790000,22999,False,58,scaffold_9
23,2601001,2616000,14999,False,58,scaffold_9
24,2872001,3381000,508999,False,58,scaffold_9
25,3383001,5040000,1656999,False,58,scaffold_9
26,5041001,5106000,64999,False,58,scaffold_9
27,5112001,5115000,2999,False,58,scaffold_9
28,5116001,5238000,121999,False,58,scaffold_9
29,5239001,5298000,58999,False,58,scaffold_9
30,5300001,5490000,189999,False,58,scaffold_9
31,5493001,6331288,838287,True,58,scaffold_9
0,1,197000,196999,True,58,scaffold_10
1,375001,414000,38999,False,58,scaffold_10
2,472001,482000,9999,False,58,scaffold_10
3,483001,576000,92999,False,58,scaffold_10
4,603001,749000,145999,False,58,scaffold_10
5,888001,916000,27999,False,58,scaffold_10
6,924001,962000,37999,False,58,scaffold_10
7,1087001,1105000,17999,False,58,scaffold_10
8,2346001,2365000,18999,False,58,scaffold_10
9,4052001,4085000,32999,False,58,scaffold_10
10,4154001,4174000,19999,False,58,scaffold_10
11,4443001,4462000,18999,False,58,scaffold_10
12,4467001,4476000,8999,False,58,scaffold_10
13,4506001,4513000,6999,False,58,scaffold_10
14,4515001,4523000,7999,False,58,scaffold_10
15,4526001,4548000,21999,False,58,scaffold_10
16,4577001,4594000,16999,False,58,scaffold_10
17,4681001,4688000,6999,False,58,scaffold_10
18,4734001,4766000,31999,False,58,scaffold_10
19,4769001,4776000,6999,False,58,scaffold_10
20,4798001,4824000,25999,False,58,scaffold_10
21,4827001,4843000,15999,False,58,scaffold_10
22,4848001,4861000,12999,False,58,scaffold_10
23,4865001,4866973,1972,True,58,scaffold_10
0,10001,93000,82999,False,58,scaffold_11
1,149001,167000,17999,False,58,scaffold_11
2,169001,191000,21999,False,58,scaffold_11
3,213001,236000,22999,False,58,scaffold_11
4,240001,248000,7999,False,58,scaffold_11
5,419001,431000,11999,False,58,scaffold_11
6,649001,656000,6999,False,58,scaffold_11
7,1025001,1034000,8999,False,58,scaffold_11
8,1305001,1307000,1999,False,58,scaffold_11
9,1423001,1426000,2999,False,58,scaffold_11
10,2701001,2874000,172999,False,58,scaffold_11
11,3217001,3254000,36999,False,58,scaffold_11
12,3331001,3380000,48999,False,58,scaffold_11
13,3702001,3926000,223999,False,58,scaffold_11
14,4321001,4710000,388999,False,58,scaffold_11
15,4713001,4766820,53819,True,58,scaffold_11
0,1,241000,240999,True,58,scaffold_12
1,250001,370000,119999,False,58,scaffold_12
2,474001,538000,63999,False,58,scaffold_12
3,582001,730000,147999,False,58,scaffold_12
4,739001,856000,116999,False,58,scaffold_12
5,866001,1356000,489999,False,58,scaffold_12
6,1720001,1733000,12999,False,58,scaffold_12
7,2571001,2616000,44999,False,58,scaffold_12
0,1,340000,339999,True,59,scaffold_1
1,482001,498000,15999,False,59,scaffold_1
2,574001,643000,68999,False,59,scaffold_1
3,686001,743000,56999,False,59,scaffold_1
4,1281001,1292000,10999,False,59,scaffold_1
5,1954001,1964000,9999,False,59,scaffold_1
6,1965001,1984000,18999,False,59,scaffold_1
7,2449001,2511000,61999,False,59,scaffold_1
8,2729001,2746000,16999,False,59,scaffold_1
9,3181001,3208000,26999,False,59,scaffold_1
10,3715001,3733000,17999,False,59,scaffold_1
11,3916001,3941000,24999,False,59,scaffold_1
12,4063001,4111000,47999,False,59,scaffold_1
13,4322001,4354000,31999,False,59,scaffold_1
14,4929001,4963000,33999,False,59,scaffold_1
15,4969001,4983000,13999,False,59,scaffold_1
16,5484001,5511000,26999,False,59,scaffold_1
17,6108001,6153000,44999,False,59,scaffold_1
18,6228001,6507000,278999,False,59,scaffold_1
19,6545001,6554000,8999,False,59,scaffold_1
20,7038001,7247000,208999,False,59,scaffold_1
21,7248001,7584000,335999,False,59,scaffold_1
22,7590001,8477000,886999,False,59,scaffold_1
23,8478001,8656000,177999,False,59,scaffold_1
24,8658001,9584000,925999,False,59,scaffold_1
25,9586001,10354000,767999,False,59,scaffold_1
26,10461001,10616000,154999,False,59,scaffold_1
27,10808001,10811000,2999,False,59,scaffold_1
28,10832001,10858000,25999,False,59,scaffold_1
29,11351001,11504000,152999,False,59,scaffold_1
30,11648001,11951000,302999,False,59,scaffold_1
31,12184001,12204000,19999,False,59,scaffold_1
32,12667001,12722000,54999,False,59,scaffold_1
33,12777001,12888000,110999,False,59,scaffold_1
34,13114001,13135000,20999,False,59,scaffold_1
35,13179001,13211000,31999,False,59,scaffold_1
36,13347001,13377000,29999,False,59,scaffold_1
37,13901001,13903000,1999,False,59,scaffold_1
38,14007001,14009000,1999,False,59,scaffold_1
0,22001,48000,25999,False,59,scaffold_2
1,93001,159000,65999,False,59,scaffold_2
2,168001,177000,8999,False,59,scaffold_2
3,303001,318000,14999,False,59,scaffold_2
4,330001,374000,43999,False,59,scaffold_2
5,2336001,2358000,21999,False,59,scaffold_2
6,2441001,2553000,111999,False,59,scaffold_2
7,2660001,2689000,28999,False,59,scaffold_2
8,2694001,2742000,47999,False,59,scaffold_2
9,2780001,2788000,7999,False,59,scaffold_2
10,2994001,3012000,17999,False,59,scaffold_2
11,3174001,3184000,9999,False,59,scaffold_2
12,3454001,3463000,8999,False,59,scaffold_2
13,3767001,3781000,13999,False,59,scaffold_2
14,4385001,4409000,23999,False,59,scaffold_2
15,4429001,4456000,26999,False,59,scaffold_2
16,4525001,4553000,27999,False,59,scaffold_2
17,4608001,4653000,44999,False,59,scaffold_2
18,5022001,5031000,8999,False,59,scaffold_2
19,5033001,5061000,27999,False,59,scaffold_2
20,5491001,5511000,19999,False,59,scaffold_2
21,5672001,5704000,31999,False,59,scaffold_2
22,6261001,6330000,68999,False,59,scaffold_2
23,6331001,6342000,10999,False,59,scaffold_2
24,7439001,7472000,32999,False,59,scaffold_2
25,7563001,7697000,133999,False,59,scaffold_2
26,7786001,7890000,103999,False,59,scaffold_2
27,7934001,7965000,30999,False,59,scaffold_2
28,7985001,8088000,102999,False,59,scaffold_2
29,8331001,8333000,1999,False,59,scaffold_2
30,8340001,8344000,3999,False,59,scaffold_2
31,8346001,8389000,42999,False,59,scaffold_2
32,8509001,8535000,25999,False,59,scaffold_2
33,11367001,11371000,3999,False,59,scaffold_2
34,11520001,11785000,264999,False,59,scaffold_2
0,1,2000,1999,True,59,scaffold_3
1,51001,55000,3999,False,59,scaffold_3
2,102001,104000,1999,False,59,scaffold_3
3,799001,900000,100999,False,59,scaffold_3
4,2085001,2108000,22999,False,59,scaffold_3
5,2291001,2321000,29999,False,59,scaffold_3
6,2491001,2533000,41999,False,59,scaffold_3
7,4150001,4383000,232999,False,59,scaffold_3
8,4418001,4518000,99999,False,59,scaffold_3
9,4547001,4558000,10999,False,59,scaffold_3
10,4654001,4678000,23999,False,59,scaffold_3
11,6911001,6962000,50999,False,59,scaffold_3
12,6980001,7046000,65999,False,59,scaffold_3
13,7540001,7556000,15999,False,59,scaffold_3
14,7693001,7720000,26999,False,59,scaffold_3
15,7824001,7838000,13999,False,59,scaffold_3
16,8208001,8255000,46999,False,59,scaffold_3
17,8462001,8527000,64999,False,59,scaffold_3
18,8575001,8594000,18999,False,59,scaffold_3
19,9968001,9996000,27999,False,59,scaffold_3
20,10461001,10483000,21999,False,59,scaffold_3
21,10587001,11165000,577999,False,59,scaffold_3
0,3001,7000,3999,False,59,scaffold_4
1,17001,32000,14999,False,59,scaffold_4
2,48001,88000,39999,False,59,scaffold_4
3,133001,146000,12999,False,59,scaffold_4
4,147001,151000,3999,False,59,scaffold_4
5,155001,160000,4999,False,59,scaffold_4
6,161001,215000,53999,False,59,scaffold_4
7,217001,226000,8999,False,59,scaffold_4
8,227001,266000,38999,False,59,scaffold_4
9,291001,308000,16999,False,59,scaffold_4
10,355001,374000,18999,False,59,scaffold_4
11,375001,380000,4999,False,59,scaffold_4
12,395001,410000,14999,False,59,scaffold_4
13,412001,425000,12999,False,59,scaffold_4
14,429001,498000,68999,False,59,scaffold_4
15,545001,606000,60999,False,59,scaffold_4
16,608001,661000,52999,False,59,scaffold_4
17,670001,691000,20999,False,59,scaffold_4
18,701001,714000,12999,False,59,scaffold_4
19,1121001,1136000,14999,False,59,scaffold_4
20,1138001,1178000,39999,False,59,scaffold_4
21,1199001,1208000,8999,False,59,scaffold_4
22,1210001,1226000,15999,False,59,scaffold_4
23,1229001,1231000,1999,False,59,scaffold_4
24,1235001,1246000,10999,False,59,scaffold_4
25,1248001,1253000,4999,False,59,scaffold_4
26,1254001,1262000,7999,False,59,scaffold_4
27,1265001,1279000,13999,False,59,scaffold_4
28,1283001,1314000,30999,False,59,scaffold_4
29,1372001,1591000,218999,False,59,scaffold_4
30,1749001,1817000,67999,False,59,scaffold_4
31,1905001,1957000,51999,False,59,scaffold_4
32,2247001,2279000,31999,False,59,scaffold_4
33,2284001,2340000,55999,False,59,scaffold_4
34,2480001,2549000,68999,False,59,scaffold_4
35,3335001,3632000,296999,False,59,scaffold_4
36,3676001,3759000,82999,False,59,scaffold_4
37,4944001,4984000,39999,False,59,scaffold_4
38,5477001,5506000,28999,False,59,scaffold_4
39,5514001,5620000,105999,False,59,scaffold_4
40,5669001,5784000,114999,False,59,scaffold_4
41,7037001,7062000,24999,False,59,scaffold_4
42,8849001,9699000,849999,False,59,scaffold_4
43,9700001,9845951,145950,True,59,scaffold_4
0,190001,204000,13999,False,59,scaffold_5
1,296001,299000,2999,False,59,scaffold_5
2,318001,326000,7999,False,59,scaffold_5
3,327001,368000,40999,False,59,scaffold_5
4,469001,480000,10999,False,59,scaffold_5
5,498001,523000,24999,False,59,scaffold_5
6,933001,947000,13999,False,59,scaffold_5
7,2565001,2581000,15999,False,59,scaffold_5
8,2625001,2732000,106999,False,59,scaffold_5
9,2816001,2871000,54999,False,59,scaffold_5
10,3167001,3184000,16999,False,59,scaffold_5
11,3322001,3438000,115999,False,59,scaffold_5
12,3451001,3497000,45999,False,59,scaffold_5
13,3962001,4101000,138999,False,59,scaffold_5
14,4121001,4142000,20999,False,59,scaffold_5
15,4155001,4219000,63999,False,59,scaffold_5
16,4246001,4262000,15999,False,59,scaffold_5
17,4446001,4483000,36999,False,59,scaffold_5
18,4601001,4644000,42999,False,59,scaffold_5
19,4691001,4717000,25999,False,59,scaffold_5
20,4789001,4861000,71999,False,59,scaffold_5
21,4904001,4916000,11999,False,59,scaffold_5
22,5318001,5346000,27999,False,59,scaffold_5
23,8730001,9363000,632999,False,59,scaffold_5
0,79001,112000,32999,False,59,scaffold_6
1,241001,253000,11999,False,59,scaffold_6
2,257001,262000,4999,False,59,scaffold_6
3,267001,278000,10999,False,59,scaffold_6
4,1229001,1256000,26999,False,59,scaffold_6
5,1479001,1546000,66999,False,59,scaffold_6
6,2023001,2086000,62999,False,59,scaffold_6
7,2130001,2168000,37999,False,59,scaffold_6
8,2371001,2595000,223999,False,59,scaffold_6
9,2596001,2653000,56999,False,59,scaffold_6
10,2660001,2691000,30999,False,59,scaffold_6
11,2731001,2851000,119999,False,59,scaffold_6
12,2933001,3014000,80999,False,59,scaffold_6
13,3115001,3149000,33999,False,59,scaffold_6
14,3224001,3301000,76999,False,59,scaffold_6
15,3407001,3428000,20999,False,59,scaffold_6
16,3462001,3766000,303999,False,59,scaffold_6
17,3901001,3912000,10999,False,59,scaffold_6
18,4019001,4040000,20999,False,59,scaffold_6
19,4086001,4193000,106999,False,59,scaffold_6
20,6011001,6060000,48999,False,59,scaffold_6
21,7283001,7336000,52999,False,59,scaffold_6
22,7560001,7795000,234999,False,59,scaffold_6
23,7811001,8268281,457280,True,59,scaffold_6
0,13001,31000,17999,False,59,scaffold_7
1,323001,340000,16999,False,59,scaffold_7
2,342001,508000,165999,False,59,scaffold_7
3,554001,563000,8999,False,59,scaffold_7
4,571001,577000,5999,False,59,scaffold_7
5,706001,736000,29999,False,59,scaffold_7
6,741001,753000,11999,False,59,scaffold_7
7,764001,809000,44999,False,59,scaffold_7
8,859001,864000,4999,False,59,scaffold_7
9,964001,966000,1999,False,59,scaffold_7
10,968001,979000,10999,False,59,scaffold_7
11,982001,1044000,61999,False,59,scaffold_7
12,1057001,1104000,46999,False,59,scaffold_7
13,1191001,1512000,320999,False,59,scaffold_7
14,1588001,1688000,99999,False,59,scaffold_7
15,3326001,3369000,42999,False,59,scaffold_7
16,3596001,3649000,52999,False,59,scaffold_7
17,4418001,4517000,98999,False,59,scaffold_7
18,4658001,4681000,22999,False,59,scaffold_7
19,4979001,5030000,50999,False,59,scaffold_7
20,5073001,5111000,37999,False,59,scaffold_7
21,6955001,7502216,547215,True,59,scaffold_7
0,67001,85000,17999,False,59,scaffold_8
1,2662001,2683000,20999,False,59,scaffold_8
2,2745001,2756000,10999,False,59,scaffold_8
3,3060001,3525000,464999,False,59,scaffold_8
4,3584001,3612000,27999,False,59,scaffold_8
5,3615001,3913000,297999,False,59,scaffold_8
6,5200001,5241000,40999,False,59,scaffold_8
7,6332001,6334544,2543,True,59,scaffold_8
0,109001,117000,7999,False,59,scaffold_9
1,303001,315000,11999,False,59,scaffold_9
2,319001,333000,13999,False,59,scaffold_9
3,367001,411000,43999,False,59,scaffold_9
4,413001,434000,20999,False,59,scaffold_9
5,501001,531000,29999,False,59,scaffold_9
6,652001,664000,11999,False,59,scaffold_9
7,671001,696000,24999,False,59,scaffold_9
8,732001,742000,9999,False,59,scaffold_9
9,815001,842000,26999,False,59,scaffold_9
10,886001,986000,99999,False,59,scaffold_9
11,988001,995000,6999,False,59,scaffold_9
12,1001001,1006000,4999,False,59,scaffold_9
13,1010001,1031000,20999,False,59,scaffold_9
14,1035001,1083000,47999,False,59,scaffold_9
15,1087001,1150000,62999,False,59,scaffold_9
16,1151001,1164000,12999,False,59,scaffold_9
17,1313001,1378000,64999,False,59,scaffold_9
18,1770001,1782000,11999,False,59,scaffold_9
19,2601001,2616000,14999,False,59,scaffold_9
20,2874001,3381000,506999,False,59,scaffold_9
21,3383001,5100000,1716999,False,59,scaffold_9
22,5101001,5107000,5999,False,59,scaffold_9
23,5112001,5115000,2999,False,59,scaffold_9
24,5116001,5237000,120999,False,59,scaffold_9
25,5239001,5298000,58999,False,59,scaffold_9
26,5300001,5491000,190999,False,59,scaffold_9
27,5493001,6331288,838287,True,59,scaffold_9
0,1,197000,196999,True,59,scaffold_10
1,375001,414000,38999,False,59,scaffold_10
2,472001,482000,9999,False,59,scaffold_10
3,508001,576000,67999,False,59,scaffold_10
4,603001,748000,144999,False,59,scaffold_10
5,888001,916000,27999,False,59,scaffold_10
6,924001,962000,37999,False,59,scaffold_10
7,1087001,1105000,17999,False,59,scaffold_10
8,2346001,2366000,19999,False,59,scaffold_10
9,4054001,4091000,36999,False,59,scaffold_10
10,4154001,4174000,19999,False,59,scaffold_10
11,4515001,4523000,7999,False,59,scaffold_10
12,4526001,4548000,21999,False,59,scaffold_10
13,4576001,4595000,18999,False,59,scaffold_10
14,4679001,4688000,8999,False,59,scaffold_10
15,4734001,4766000,31999,False,59,scaffold_10
16,4769001,4776000,6999,False,59,scaffold_10
17,4798001,4824000,25999,False,59,scaffold_10
18,4827001,4843000,15999,False,59,scaffold_10
19,4848001,4861000,12999,False,59,scaffold_10
20,4865001,4866973,1972,True,59,scaffold_10
0,10001,34000,23999,False,59,scaffold_11
1,40001,93000,52999,False,59,scaffold_11
2,149001,167000,17999,False,59,scaffold_11
3,169001,191000,21999,False,59,scaffold_11
4,213001,235000,21999,False,59,scaffold_11
5,240001,247000,6999,False,59,scaffold_11
6,419001,431000,11999,False,59,scaffold_11
7,648001,656000,7999,False,59,scaffold_11
8,1025001,1034000,8999,False,59,scaffold_11
9,1305001,1307000,1999,False,59,scaffold_11
10,2701001,2872000,170999,False,59,scaffold_11
11,3211001,3254000,42999,False,59,scaffold_11
12,3329001,3371000,41999,False,59,scaffold_11
13,3702001,3926000,223999,False,59,scaffold_11
14,4322001,4710000,387999,False,59,scaffold_11
15,4713001,4766820,53819,True,59,scaffold_11
0,1,240000,239999,True,59,scaffold_12
1,290001,369000,78999,False,59,scaffold_12
2,582001,730000,147999,False,59,scaffold_12
3,739001,856000,116999,False,59,scaffold_12
4,867001,1354000,486999,False,59,scaffold_12
5,1720001,1733000,12999,False,59,scaffold_12
6,2571001,2618000,46999,False,59,scaffold_12
7,2747001,2747968,967,True,59,scaffold_12
0,1,342000,341999,True,60,scaffold_1
1,482001,498000,15999,False,60,scaffold_1
2,574001,643000,68999,False,60,scaffold_1
3,686001,743000,56999,False,60,scaffold_1
4,1281001,1292000,10999,False,60,scaffold_1
5,1617001,1660000,42999,False,60,scaffold_1
6,1813001,1899000,85999,False,60,scaffold_1
7,1950001,1964000,13999,False,60,scaffold_1
8,1965001,1984000,18999,False,60,scaffold_1
9,1986001,1994000,7999,False,60,scaffold_1
10,2449001,2517000,67999,False,60,scaffold_1
11,2729001,2746000,16999,False,60,scaffold_1
12,3172001,3209000,36999,False,60,scaffold_1
13,3713001,3740000,26999,False,60,scaffold_1
14,3845001,3878000,32999,False,60,scaffold_1
15,3902001,3941000,38999,False,60,scaffold_1
16,3963001,4033000,69999,False,60,scaffold_1
17,4062001,4115000,52999,False,60,scaffold_1
18,4314001,4376000,61999,False,60,scaffold_1
19,4796001,4811000,14999,False,60,scaffold_1
20,4927001,5024000,96999,False,60,scaffold_1
21,5097001,5105000,7999,False,60,scaffold_1
22,5481001,5512000,30999,False,60,scaffold_1
23,5535001,5579000,43999,False,60,scaffold_1
24,5857001,5874000,16999,False,60,scaffold_1
25,6108001,6183000,74999,False,60,scaffold_1
26,6228001,6379000,150999,False,60,scaffold_1
27,6382001,6509000,126999,False,60,scaffold_1
28,6544001,6554000,9999,False,60,scaffold_1
29,7037001,7247000,209999,False,60,scaffold_1
30,7248001,7584000,335999,False,60,scaffold_1
31,7590001,8656000,1065999,False,60,scaffold_1
32,8658001,9584000,925999,False,60,scaffold_1
33,9586001,10363000,776999,False,60,scaffold_1
34,10461001,10638000,176999,False,60,scaffold_1
35,10736001,10755000,18999,False,60,scaffold_1
36,10839001,10857000,17999,False,60,scaffold_1
37,10920001,10940000,19999,False,60,scaffold_1
38,11283001,11509000,225999,False,60,scaffold_1
39,11551001,11951000,399999,False,60,scaffold_1
40,12184001,12205000,20999,False,60,scaffold_1
41,12652001,12723000,70999,False,60,scaffold_1
42,12775001,12889000,113999,False,60,scaffold_1
43,12916001,12949000,32999,False,60,scaffold_1
44,12965001,13002000,36999,False,60,scaffold_1
45,13112001,13211000,98999,False,60,scaffold_1
46,13347001,13431000,83999,False,60,scaffold_1
47,13559001,13589000,29999,False,60,scaffold_1
48,13818001,13845000,26999,False,60,scaffold_1
49,14290001,14307000,16999,False,60,scaffold_1
0,21001,48000,26999,False,60,scaffold_2
1,68001,91000,22999,False,60,scaffold_2
2,93001,159000,65999,False,60,scaffold_2
3,168001,177000,8999,False,60,scaffold_2
4,297001,318000,20999,False,60,scaffold_2
5,332001,374000,41999,False,60,scaffold_2
6,2085001,2107000,21999,False,60,scaffold_2
7,2337001,2358000,20999,False,60,scaffold_2
8,2404001,2554000,149999,False,60,scaffold_2
9,2645001,2689000,43999,False,60,scaffold_2
10,2694001,2745000,50999,False,60,scaffold_2
11,2770001,2788000,17999,False,60,scaffold_2
12,2868001,2901000,32999,False,60,scaffold_2
13,2972001,3012000,39999,False,60,scaffold_2
14,3368001,3388000,19999,False,60,scaffold_2
15,3450001,3479000,28999,False,60,scaffold_2
16,3678001,3691000,12999,False,60,scaffold_2
17,3754001,3787000,32999,False,60,scaffold_2
18,4243001,4254000,10999,False,60,scaffold_2
19,4382001,4409000,26999,False,60,scaffold_2
20,4426001,4457000,30999,False,60,scaffold_2
21,4521001,4669000,147999,False,60,scaffold_2
22,4780001,4790000,9999,False,60,scaffold_2
23,4793001,4809000,15999,False,60,scaffold_2
24,4917001,4961000,43999,False,60,scaffold_2
25,5021001,5104000,82999,False,60,scaffold_2
26,5371001,5395000,23999,False,60,scaffold_2
27,5455001,5481000,25999,False,60,scaffold_2
28,5491001,5519000,27999,False,60,scaffold_2
29,5667001,5759000,91999,False,60,scaffold_2
30,5840001,5888000,47999,False,60,scaffold_2
31,5915001,5958000,42999,False,60,scaffold_2
32,6011001,6021000,9999,False,60,scaffold_2
33,6259001,6449000,189999,False,60,scaffold_2
34,6580001,6628000,47999,False,60,scaffold_2
35,7005001,7038000,32999,False,60,scaffold_2
36,7050001,7097000,46999,False,60,scaffold_2
37,7439001,7472000,32999,False,60,scaffold_2
38,7491001,7518000,26999,False,60,scaffold_2
39,7549001,7561000,11999,False,60,scaffold_2
40,7563001,7697000,133999,False,60,scaffold_2
41,7786001,7916000,129999,False,60,scaffold_2
42,7934001,8161000,226999,False,60,scaffold_2
43,8261001,8313000,51999,False,60,scaffold_2
44,8331001,8333000,1999,False,60,scaffold_2
45,8340001,8345000,4999,False,60,scaffold_2
46,8346001,8455000,108999,False,60,scaffold_2
47,8508001,8562000,53999,False,60,scaffold_2
48,9139001,9170000,30999,False,60,scaffold_2
49,9348001,9382000,33999,False,60,scaffold_2
50,9602001,9628000,25999,False,60,scaffold_2
51,9674001,9696000,21999,False,60,scaffold_2
52,11366001,11375000,8999,False,60,scaffold_2
53,11520001,11785000,264999,False,60,scaffold_2
54,11797001,11802476,5475,True,60,scaffold_2
0,618001,646000,27999,False,60,scaffold_3
1,797001,900000,102999,False,60,scaffold_3
2,1937001,1979000,41999,False,60,scaffold_3
3,2040001,2071000,30999,False,60,scaffold_3
4,2075001,2108000,32999,False,60,scaffold_3
5,2109001,2116000,6999,False,60,scaffold_3
6,2291001,2321000,29999,False,60,scaffold_3
7,2485001,2533000,47999,False,60,scaffold_3
8,2717001,2735000,17999,False,60,scaffold_3
9,3769001,3821000,51999,False,60,scaffold_3
10,3822001,3894000,71999,False,60,scaffold_3
11,4007001,4032000,24999,False,60,scaffold_3
12,4070001,4403000,332999,False,60,scaffold_3
13,4413001,4518000,104999,False,60,scaffold_3
14,4546001,4558000,11999,False,60,scaffold_3
15,4645001,4686000,40999,False,60,scaffold_3
16,5175001,5191000,15999,False,60,scaffold_3
17,5494001,5509000,14999,False,60,scaffold_3
18,5879001,5904000,24999,False,60,scaffold_3
19,5990001,6020000,29999,False,60,scaffold_3
20,6742001,6784000,41999,False,60,scaffold_3
21,6910001,6962000,51999,False,60,scaffold_3
22,6963001,7098000,134999,False,60,scaffold_3
23,7336001,7362000,25999,False,60,scaffold_3
24,7384001,7396000,11999,False,60,scaffold_3
25,7431001,7445000,13999,False,60,scaffold_3
26,7449001,7458000,8999,False,60,scaffold_3
27,7506001,7557000,50999,False,60,scaffold_3
28,7679001,7853000,173999,False,60,scaffold_3
29,8044001,8109000,64999,False,60,scaffold_3
30,8175001,8253000,77999,False,60,scaffold_3
31,8462001,8527000,64999,False,60,scaffold_3
32,8574001,8594000,19999,False,60,scaffold_3
33,8757001,8770000,12999,False,60,scaffold_3
34,9006001,9081000,74999,False,60,scaffold_3
35,9968001,9995000,26999,False,60,scaffold_3
36,10461001,10481000,19999,False,60,scaffold_3
37,10580001,11182071,602070,True,60,scaffold_3
0,1,7000,6999,True,60,scaffold_4
1,10001,13000,2999,False,60,scaffold_4
2,14001,16000,1999,False,60,scaffold_4
3,17001,29000,11999,False,60,scaffold_4
4,48001,81000,32999,False,60,scaffold_4
5,102001,115000,12999,False,60,scaffold_4
6,120001,146000,25999,False,60,scaffold_4
7,147001,151000,3999,False,60,scaffold_4
8,155001,160000,4999,False,60,scaffold_4
9,161001,215000,53999,False,60,scaffold_4
10,217001,226000,8999,False,60,scaffold_4
11,227001,268000,40999,False,60,scaffold_4
12,290001,307000,16999,False,60,scaffold_4
13,318001,353000,34999,False,60,scaffold_4
14,355001,374000,18999,False,60,scaffold_4
15,375001,380000,4999,False,60,scaffold_4
16,394001,425000,30999,False,60,scaffold_4
17,429001,500000,70999,False,60,scaffold_4
18,539001,592000,52999,False,60,scaffold_4
19,593001,607000,13999,False,60,scaffold_4
20,608001,691000,82999,False,60,scaffold_4
21,1043001,1047000,3999,False,60,scaffold_4
22,1121001,1136000,14999,False,60,scaffold_4
23,1138001,1198000,59999,False,60,scaffold_4
24,1199001,1226000,26999,False,60,scaffold_4
25,1239001,1253000,13999,False,60,scaffold_4
26,1283001,1336000,52999,False,60,scaffold_4
27,1354001,1599000,244999,False,60,scaffold_4
28,1613001,1849000,235999,False,60,scaffold_4
29,1850001,2129000,278999,False,60,scaffold_4
30,2142001,2181000,38999,False,60,scaffold_4
31,2191001,2206000,14999,False,60,scaffold_4
32,2207001,2218000,10999,False,60,scaffold_4
33,2219001,2246000,26999,False,60,scaffold_4
34,2247001,2461000,213999,False,60,scaffold_4
35,2477001,2635000,157999,False,60,scaffold_4
36,2676001,2714000,37999,False,60,scaffold_4
37,2917001,2956000,38999,False,60,scaffold_4
38,3090001,3127000,36999,False,60,scaffold_4
39,3335001,3760000,424999,False,60,scaffold_4
40,4900001,5060000,159999,False,60,scaffold_4
41,5173001,5224000,50999,False,60,scaffold_4
42,5300001,5356000,55999,False,60,scaffold_4
43,5477001,5506000,28999,False,60,scaffold_4
44,5514001,5632000,117999,False,60,scaffold_4
45,5659001,5784000,124999,False,60,scaffold_4
46,5786001,5817000,30999,False,60,scaffold_4
47,6147001,6195000,47999,False,60,scaffold_4
48,6796001,6819000,22999,False,60,scaffold_4
49,6896001,6924000,27999,False,60,scaffold_4
50,6969001,6997000,27999,False,60,scaffold_4
51,7036001,7096000,59999,False,60,scaffold_4
52,7207001,7290000,82999,False,60,scaffold_4
53,7641001,7664000,22999,False,60,scaffold_4
54,8847001,9699000,851999,False,60,scaffold_4
55,9700001,9845951,145950,True,60,scaffold_4
0,142001,165000,22999,False,60,scaffold_5
1,318001,419000,100999,False,60,scaffold_5
2,461001,526000,64999,False,60,scaffold_5
3,671001,697000,25999,False,60,scaffold_5
4,933001,952000,18999,False,60,scaffold_5
5,1583001,1593000,9999,False,60,scaffold_5
6,2093001,2104000,10999,False,60,scaffold_5
7,2265001,2301000,35999,False,60,scaffold_5
8,2475001,2494000,18999,False,60,scaffold_5
9,2511001,2515000,3999,False,60,scaffold_5
10,2550001,2875000,324999,False,60,scaffold_5
11,3133001,3258000,124999,False,60,scaffold_5
12,3309001,3514000,204999,False,60,scaffold_5
13,3617001,3657000,39999,False,60,scaffold_5
14,3844001,3877000,32999,False,60,scaffold_5
15,3962001,4101000,138999,False,60,scaffold_5
16,4119001,4221000,101999,False,60,scaffold_5
17,4227001,4291000,63999,False,60,scaffold_5
18,4445001,4526000,80999,False,60,scaffold_5
19,4600001,4681000,80999,False,60,scaffold_5
20,4691001,4863000,171999,False,60,scaffold_5
21,4884001,4926000,41999,False,60,scaffold_5
22,4972001,4994000,21999,False,60,scaffold_5
23,5059001,5095000,35999,False,60,scaffold_5
24,5318001,5345000,26999,False,60,scaffold_5
25,6409001,6419000,9999,False,60,scaffold_5
26,6454001,6666000,211999,False,60,scaffold_5
27,6763001,6792000,28999,False,60,scaffold_5
28,6882001,6906000,23999,False,60,scaffold_5
29,7454001,7488000,33999,False,60,scaffold_5
30,7581001,7619000,37999,False,60,scaffold_5
31,7621001,7657000,35999,False,60,scaffold_5
32,8381001,8468000,86999,False,60,scaffold_5
33,8552001,8616000,63999,False,60,scaffold_5
34,8652001,8687000,34999,False,60,scaffold_5
35,8713001,9363000,649999,False,60,scaffold_5
36,9364001,9364176,175,True,60,scaffold_5
0,65001,74000,8999,False,60,scaffold_6
1,86001,121000,34999,False,60,scaffold_6
2,165001,195000,29999,False,60,scaffold_6
3,240001,254000,13999,False,60,scaffold_6
4,256001,262000,5999,False,60,scaffold_6
5,264001,337000,72999,False,60,scaffold_6
6,553001,568000,14999,False,60,scaffold_6
7,1147001,1226000,78999,False,60,scaffold_6
8,1228001,1258000,29999,False,60,scaffold_6
9,1284001,1309000,24999,False,60,scaffold_6
10,1478001,1546000,67999,False,60,scaffold_6
11,1563001,1594000,30999,False,60,scaffold_6
12,1868001,1906000,37999,False,60,scaffold_6
13,2029001,2105000,75999,False,60,scaffold_6
14,2130001,2196000,65999,False,60,scaffold_6
15,2237001,2266000,28999,False,60,scaffold_6
16,2336001,2872000,535999,False,60,scaffold_6
17,2936001,3015000,78999,False,60,scaffold_6
18,3113001,3179000,65999,False,60,scaffold_6
19,3223001,3318000,94999,False,60,scaffold_6
20,3398001,3806000,407999,False,60,scaffold_6
21,3883001,3913000,29999,False,60,scaffold_6
22,4018001,4195000,176999,False,60,scaffold_6
23,6003001,6078000,74999,False,60,scaffold_6
24,6124001,6190000,65999,False,60,scaffold_6
25,6783001,6805000,21999,False,60,scaffold_6
26,7186001,7247000,60999,False,60,scaffold_6
27,7256001,7339000,82999,False,60,scaffold_6
28,7389001,7436000,46999,False,60,scaffold_6
29,7550001,8268281,718280,True,60,scaffold_6
0,1,8000,7999,True,60,scaffold_7
1,13001,34000,20999,False,60,scaffold_7
2,303001,340000,36999,False,60,scaffold_7
3,342001,508000,165999,False,60,scaffold_7
4,626001,640000,13999,False,60,scaffold_7
5,656001,674000,17999,False,60,scaffold_7
6,689001,736000,46999,False,60,scaffold_7
7,741001,755000,13999,False,60,scaffold_7
8,764001,826000,61999,False,60,scaffold_7
9,859001,864000,4999,False,60,scaffold_7
10,868001,963000,94999,False,60,scaffold_7
11,964001,1044000,79999,False,60,scaffold_7
12,1048001,1104000,55999,False,60,scaffold_7
13,1106001,1134000,27999,False,60,scaffold_7
14,1191001,1261000,69999,False,60,scaffold_7
15,1262001,1460000,197999,False,60,scaffold_7
16,1461001,1512000,50999,False,60,scaffold_7
17,1588001,1693000,104999,False,60,scaffold_7
18,1851001,1886000,34999,False,60,scaffold_7
19,3296001,3370000,73999,False,60,scaffold_7
20,3518001,3767000,248999,False,60,scaffold_7
21,4029001,4049000,19999,False,60,scaffold_7
22,4415001,4518000,102999,False,60,scaffold_7
23,4658001,4737000,78999,False,60,scaffold_7
24,4773001,4830000,56999,False,60,scaffold_7
25,4978001,5161000,182999,False,60,scaffold_7
26,5468001,5538000,69999,False,60,scaffold_7
27,6754001,6788000,33999,False,60,scaffold_7
28,6954001,7270000,315999,False,60,scaffold_7
29,7271001,7502216,231215,True,60,scaffold_7
0,1,10000,9999,True,60,scaffold_8
1,32001,64000,31999,False,60,scaffold_8
2,67001,85000,17999,False,60,scaffold_8
3,728001,732000,3999,False,60,scaffold_8
4,1904001,1928000,23999,False,60,scaffold_8
5,2444001,2530000,85999,False,60,scaffold_8
6,2536001,2551000,14999,False,60,scaffold_8
7,2650001,2683000,32999,False,60,scaffold_8
8,2684001,2690000,5999,False,60,scaffold_8
9,2738001,2757000,18999,False,60,scaffold_8
10,2798001,2844000,45999,False,60,scaffold_8
11,2847001,2874000,26999,False,60,scaffold_8
12,3058001,3125000,66999,False,60,scaffold_8
13,3126001,3525000,398999,False,60,scaffold_8
14,3577001,3810000,232999,False,60,scaffold_8
15,3811001,3939000,127999,False,60,scaffold_8
16,4038001,4108000,69999,False,60,scaffold_8
17,4203001,4256000,52999,False,60,scaffold_8
18,4332001,4353000,20999,False,60,scaffold_8
19,4399001,4434000,34999,False,60,scaffold_8
20,5120001,5137000,16999,False,60,scaffold_8
21,5168001,5241000,72999,False,60,scaffold_8
22,5531001,5542000,10999,False,60,scaffold_8
23,5651001,5697000,45999,False,60,scaffold_8
24,5776001,5805000,28999,False,60,scaffold_8
25,6322001,6334544,12543,True,60,scaffold_8
0,1,22000,21999,True,60,scaffold_9
1,109001,117000,7999,False,60,scaffold_9
2,121001,140000,18999,False,60,scaffold_9
3,236001,243000,6999,False,60,scaffold_9
4,366001,411000,44999,False,60,scaffold_9
5,413001,434000,20999,False,60,scaffold_9
6,484001,531000,46999,False,60,scaffold_9
7,670001,696000,25999,False,60,scaffold_9
8,733001,741000,7999,False,60,scaffold_9
9,815001,845000,29999,False,60,scaffold_9
10,872001,986000,113999,False,60,scaffold_9
11,988001,995000,6999,False,60,scaffold_9
12,1001001,1007000,5999,False,60,scaffold_9
13,1010001,1031000,20999,False,60,scaffold_9
14,1037001,1085000,47999,False,60,scaffold_9
15,1087001,1150000,62999,False,60,scaffold_9
16,1151001,1168000,16999,False,60,scaffold_9
17,1312001,1378000,65999,False,60,scaffold_9
18,1427001,1440000,12999,False,60,scaffold_9
19,1457001,1465000,7999,False,60,scaffold_9
20,1487001,1499000,11999,False,60,scaffold_9
21,1600001,1621000,20999,False,60,scaffold_9
22,1749001,1805000,55999,False,60,scaffold_9
23,1893001,1934000,40999,False,60,scaffold_9
24,1970001,2056000,85999,False,60,scaffold_9
25,2076001,2105000,28999,False,60,scaffold_9
26,2138001,2171000,32999,False,60,scaffold_9
27,2174001,2198000,23999,False,60,scaffold_9
28,2593001,2616000,22999,False,60,scaffold_9
29,2737001,3381000,643999,False,60,scaffold_9
30,3383001,5107000,1723999,False,60,scaffold_9
31,5112001,5238000,125999,False,60,scaffold_9
32,5239001,5298000,58999,False,60,scaffold_9
33,5299001,5490000,190999,False,60,scaffold_9
34,5493001,6331288,838287,True,60,scaffold_9
0,1,414000,413999,True,60,scaffold_10
1,415001,482000,66999,False,60,scaffold_10
2,483001,582000,98999,False,60,scaffold_10
3,602001,798000,195999,False,60,scaffold_10
4,806001,877000,70999,False,60,scaffold_10
5,888001,963000,74999,False,60,scaffold_10
6,1073001,1145000,71999,False,60,scaffold_10
7,1404001,1464000,59999,False,60,scaffold_10
8,2079001,2103000,23999,False,60,scaffold_10
9,2140001,2167000,26999,False,60,scaffold_10
10,2266001,2300000,33999,False,60,scaffold_10
11,2346001,2391000,44999,False,60,scaffold_10
12,2600001,2653000,52999,False,60,scaffold_10
13,2674001,2700000,25999,False,60,scaffold_10
14,2733001,2813000,79999,False,60,scaffold_10
15,4053001,4091000,37999,False,60,scaffold_10
16,4154001,4174000,19999,False,60,scaffold_10
17,4443001,4462000,18999,False,60,scaffold_10
18,4467001,4513000,45999,False,60,scaffold_10
19,4515001,4523000,7999,False,60,scaffold_10
20,4526001,4548000,21999,False,60,scaffold_10
21,4574001,4597000,22999,False,60,scaffold_10
22,4734001,4766000,31999,False,60,scaffold_10
23,4769001,4776000,6999,False,60,scaffold_10
24,4798001,4824000,25999,False,60,scaffold_10
25,4827001,4843000,15999,False,60,scaffold_10
26,4848001,4861000,12999,False,60,scaffold_10
27,4865001,4866973,1972,True,60,scaffold_10
0,13001,99000,85999,False,60,scaffold_11
1,101001,109000,7999,False,60,scaffold_11
2,143001,168000,24999,False,60,scaffold_11
3,169001,212000,42999,False,60,scaffold_11
4,213001,235000,21999,False,60,scaffold_11
5,240001,252000,11999,False,60,scaffold_11
6,296001,320000,23999,False,60,scaffold_11
7,419001,431000,11999,False,60,scaffold_11
8,648001,656000,7999,False,60,scaffold_11
9,1025001,1034000,8999,False,60,scaffold_11
10,1403001,1409000,5999,False,60,scaffold_11
11,1423001,1426000,2999,False,60,scaffold_11
12,1474001,1477000,2999,False,60,scaffold_11
13,1872001,1883000,10999,False,60,scaffold_11
14,2677001,2877000,199999,False,60,scaffold_11
15,2952001,3018000,65999,False,60,scaffold_11
16,3083001,3175000,91999,False,60,scaffold_11
17,3185001,3293000,107999,False,60,scaffold_11
18,3329001,3384000,54999,False,60,scaffold_11
19,3445001,3478000,32999,False,60,scaffold_11
20,3521001,3657000,135999,False,60,scaffold_11
21,3702001,3933000,230999,False,60,scaffold_11
22,3986001,4159000,172999,False,60,scaffold_11
23,4181001,4710000,528999,False,60,scaffold_11
24,4712001,4766820,54819,True,60,scaffold_11
0,1,857000,856999,True,60,scaffold_12
1,864001,1498000,633999,False,60,scaffold_12
2,1720001,1733000,12999,False,60,scaffold_12
3,1970001,2000000,29999,False,60,scaffold_12
4,2050001,2096000,45999,False,60,scaffold_12
5,2137001,2165000,27999,False,60,scaffold_12
6,2571001,2610000,38999,False,60,scaffold_12
0,1,342000,341999,True,61,scaffold_1
1,482001,498000,15999,False,61,scaffold_1
2,570001,643000,72999,False,61,scaffold_1
3,686001,743000,56999,False,61,scaffold_1
4,1168001,1193000,24999,False,61,scaffold_1
5,1281001,1292000,10999,False,61,scaffold_1
6,1812001,1901000,88999,False,61,scaffold_1
7,1916001,1964000,47999,False,61,scaffold_1
8,1965001,1984000,18999,False,61,scaffold_1
9,1987001,2000000,12999,False,61,scaffold_1
10,2449001,2517000,67999,False,61,scaffold_1
11,2566001,2577000,10999,False,61,scaffold_1
12,2729001,2746000,16999,False,61,scaffold_1
13,2981001,3025000,43999,False,61,scaffold_1
14,3102001,3117000,14999,False,61,scaffold_1
15,3179001,3209000,29999,False,61,scaffold_1
16,3701001,3750000,48999,False,61,scaffold_1
17,3802001,3878000,75999,False,61,scaffold_1
18,3911001,3941000,29999,False,61,scaffold_1
19,3960001,4033000,72999,False,61,scaffold_1
20,4062001,4113000,50999,False,61,scaffold_1
21,4305001,4376000,70999,False,61,scaffold_1
22,4927001,5022000,94999,False,61,scaffold_1
23,5087001,5111000,23999,False,61,scaffold_1
24,5440001,5454000,13999,False,61,scaffold_1
25,5481001,5511000,29999,False,61,scaffold_1
26,5535001,5570000,34999,False,61,scaffold_1
27,5849001,5911000,61999,False,61,scaffold_1
28,6108001,6153000,44999,False,61,scaffold_1
29,6154001,6381000,226999,False,61,scaffold_1
30,6382001,6524000,141999,False,61,scaffold_1
31,6542001,6561000,18999,False,61,scaffold_1
32,7038001,7247000,208999,False,61,scaffold_1
33,7248001,7589000,340999,False,61,scaffold_1
34,7590001,8656000,1065999,False,61,scaffold_1
35,8658001,9584000,925999,False,61,scaffold_1
36,9586001,10369000,782999,False,61,scaffold_1
37,10451001,10639000,187999,False,61,scaffold_1
38,10662001,10698000,35999,False,61,scaffold_1
39,10734001,10755000,20999,False,61,scaffold_1
40,10837001,10857000,19999,False,61,scaffold_1
41,11312001,11509000,196999,False,61,scaffold_1
42,11558001,11962000,403999,False,61,scaffold_1
43,12183001,12238000,54999,False,61,scaffold_1
44,12638001,12723000,84999,False,61,scaffold_1
45,12733001,12755000,21999,False,61,scaffold_1
46,12775001,12890000,114999,False,61,scaffold_1
47,12967001,13002000,34999,False,61,scaffold_1
48,13101001,13212000,110999,False,61,scaffold_1
49,13345001,13431000,85999,False,61,scaffold_1
50,13481001,13494000,12999,False,61,scaffold_1
51,13799001,13845000,45999,False,61,scaffold_1
52,14055001,14079000,23999,False,61,scaffold_1
53,14287001,14314000,26999,False,61,scaffold_1
54,14345001,14353000,7999,False,61,scaffold_1
0,1,48000,47999,True,61,scaffold_2
1,95001,160000,64999,False,61,scaffold_2
2,165001,177000,11999,False,61,scaffold_2
3,256001,282000,25999,False,61,scaffold_2
4,297001,318000,20999,False,61,scaffold_2
5,332001,374000,41999,False,61,scaffold_2
6,733001,739000,5999,False,61,scaffold_2
7,2336001,2609000,272999,False,61,scaffold_2
8,2626001,2639000,12999,False,61,scaffold_2
9,2645001,2689000,43999,False,61,scaffold_2
10,2693001,2746000,52999,False,61,scaffold_2
11,2766001,2788000,21999,False,61,scaffold_2
12,2839001,2856000,16999,False,61,scaffold_2
13,2868001,2910000,41999,False,61,scaffold_2
14,2974001,3012000,37999,False,61,scaffold_2
15,3363001,3390000,26999,False,61,scaffold_2
16,3450001,3466000,15999,False,61,scaffold_2
17,3580001,3602000,21999,False,61,scaffold_2
18,3754001,3784000,29999,False,61,scaffold_2
19,4243001,4275000,31999,False,61,scaffold_2
20,4334001,4409000,74999,False,61,scaffold_2
21,4426001,4458000,31999,False,61,scaffold_2
22,4521001,4657000,135999,False,61,scaffold_2
23,4782001,4790000,7999,False,61,scaffold_2
24,4793001,4805000,11999,False,61,scaffold_2
25,4913001,4960000,46999,False,61,scaffold_2
26,5021001,5104000,82999,False,61,scaffold_2
27,5285001,5314000,28999,False,61,scaffold_2
28,5370001,5394000,23999,False,61,scaffold_2
29,5415001,5481000,65999,False,61,scaffold_2
30,5491001,5514000,22999,False,61,scaffold_2
31,5627001,5759000,131999,False,61,scaffold_2
32,5840001,5887000,46999,False,61,scaffold_2
33,5915001,6021000,105999,False,61,scaffold_2
34,6261001,6330000,68999,False,61,scaffold_2
35,6331001,6351000,19999,False,61,scaffold_2
36,6409001,6449000,39999,False,61,scaffold_2
37,6577001,6628000,50999,False,61,scaffold_2
38,7018001,7038000,19999,False,61,scaffold_2
39,7065001,7087000,21999,False,61,scaffold_2
40,7391001,7472000,80999,False,61,scaffold_2
41,7491001,7518000,26999,False,61,scaffold_2
42,7548001,7561000,12999,False,61,scaffold_2
43,7563001,7698000,134999,False,61,scaffold_2
44,7786001,7920000,133999,False,61,scaffold_2
45,7933001,8164000,230999,False,61,scaffold_2
46,8259001,8314000,54999,False,61,scaffold_2
47,8335001,8345000,9999,False,61,scaffold_2
48,8346001,8453000,106999,False,61,scaffold_2
49,8495001,8562000,66999,False,61,scaffold_2
50,9602001,9635000,32999,False,61,scaffold_2
51,9658001,9695000,36999,False,61,scaffold_2
52,10710001,10731000,20999,False,61,scaffold_2
53,11395001,11425000,29999,False,61,scaffold_2
54,11469001,11496000,26999,False,61,scaffold_2
55,11520001,11785000,264999,False,61,scaffold_2
0,1,2000,1999,True,61,scaffold_3
1,618001,646000,27999,False,61,scaffold_3
2,793001,905000,111999,False,61,scaffold_3
3,2009001,2107000,97999,False,61,scaffold_3
4,2291001,2322000,30999,False,61,scaffold_3
5,2433001,2532000,98999,False,61,scaffold_3
6,2716001,2736000,19999,False,61,scaffold_3
7,3109001,3143000,33999,False,61,scaffold_3
8,3768001,3821000,52999,False,61,scaffold_3
9,3822001,3892000,69999,False,61,scaffold_3
10,3910001,3921000,10999,False,61,scaffold_3
11,4102001,4398000,295999,False,61,scaffold_3
12,4416001,4518000,101999,False,61,scaffold_3
13,4547001,4558000,10999,False,61,scaffold_3
14,4641001,4690000,48999,False,61,scaffold_3
15,4988001,5029000,40999,False,61,scaffold_3
16,5158001,5196000,37999,False,61,scaffold_3
17,5236001,5272000,35999,False,61,scaffold_3
18,5495001,5505000,9999,False,61,scaffold_3
19,5930001,5944000,13999,False,61,scaffold_3
20,5990001,6019000,28999,False,61,scaffold_3
21,6742001,6783000,40999,False,61,scaffold_3
22,6847001,6962000,114999,False,61,scaffold_3
23,6963001,7096000,132999,False,61,scaffold_3
24,7112001,7157000,44999,False,61,scaffold_3
25,7334001,7398000,63999,False,61,scaffold_3
26,7449001,7458000,8999,False,61,scaffold_3
27,7522001,7557000,34999,False,61,scaffold_3
28,7677001,7857000,179999,False,61,scaffold_3
29,8030001,8107000,76999,False,61,scaffold_3
30,8136001,8154000,17999,False,61,scaffold_3
31,8175001,8253000,77999,False,61,scaffold_3
32,8429001,8447000,17999,False,61,scaffold_3
33,8462001,8528000,65999,False,61,scaffold_3
34,8575001,8593000,17999,False,61,scaffold_3
35,9019001,9032000,12999,False,61,scaffold_3
36,9059001,9075000,15999,False,61,scaffold_3
37,9968001,9995000,26999,False,61,scaffold_3
38,10550001,11182071,632070,True,61,scaffold_3
0,1,7000,6999,True,61,scaffold_4
1,11001,13000,1999,False,61,scaffold_4
2,17001,32000,14999,False,61,scaffold_4
3,48001,89000,40999,False,61,scaffold_4
4,91001,115000,23999,False,61,scaffold_4
5,120001,146000,25999,False,61,scaffold_4
6,147001,151000,3999,False,61,scaffold_4
7,155001,215000,59999,False,61,scaffold_4
8,217001,226000,8999,False,61,scaffold_4
9,227001,278000,50999,False,61,scaffold_4
10,283001,344000,60999,False,61,scaffold_4
11,345001,354000,8999,False,61,scaffold_4
12,355001,374000,18999,False,61,scaffold_4
13,375001,410000,34999,False,61,scaffold_4
14,412001,425000,12999,False,61,scaffold_4
15,429001,502000,72999,False,61,scaffold_4
16,539001,606000,66999,False,61,scaffold_4
17,608001,691000,82999,False,61,scaffold_4
18,704001,727000,22999,False,61,scaffold_4
19,1053001,1063000,9999,False,61,scaffold_4
20,1087001,1097000,9999,False,61,scaffold_4
21,1098001,1110000,11999,False,61,scaffold_4
22,1113001,1136000,22999,False,61,scaffold_4
23,1138001,1227000,88999,False,61,scaffold_4
24,1235001,1279000,43999,False,61,scaffold_4
25,1283001,1600000,316999,False,61,scaffold_4
26,1613001,2185000,571999,False,61,scaffold_4
27,2188001,2246000,57999,False,61,scaffold_4
28,2247001,2281000,33999,False,61,scaffold_4
29,2284001,2461000,176999,False,61,scaffold_4
30,2475001,2635000,159999,False,61,scaffold_4
31,2685001,2720000,34999,False,61,scaffold_4
32,2735001,2794000,58999,False,61,scaffold_4
33,3075001,3129000,53999,False,61,scaffold_4
34,3335001,3766000,430999,False,61,scaffold_4
35,4900001,5091000,190999,False,61,scaffold_4
36,5173001,5245000,71999,False,61,scaffold_4
37,5300001,5404000,103999,False,61,scaffold_4
38,5473001,5506000,32999,False,61,scaffold_4
39,5514001,5784000,269999,False,61,scaffold_4
40,5786001,5825000,38999,False,61,scaffold_4
41,6028001,6094000,65999,False,61,scaffold_4
42,6146001,6195000,48999,False,61,scaffold_4
43,6615001,6617000,1999,False,61,scaffold_4
44,6766001,6817000,50999,False,61,scaffold_4
45,6878001,6924000,45999,False,61,scaffold_4
46,7036001,7097000,60999,False,61,scaffold_4
47,7209001,7304000,94999,False,61,scaffold_4
48,7640001,7665000,24999,False,61,scaffold_4
49,7863001,7873000,9999,False,61,scaffold_4
50,8844001,9699000,854999,False,61,scaffold_4
51,9700001,9710000,9999,False,61,scaffold_4
52,9711001,9845951,134950,True,61,scaffold_4
0,1,16000,15999,True,61,scaffold_5
1,28001,31000,2999,False,61,scaffold_5
2,313001,428000,114999,False,61,scaffold_5
3,445001,526000,80999,False,61,scaffold_5
4,669001,697000,27999,False,61,scaffold_5
5,932001,947000,14999,False,61,scaffold_5
6,1064001,1068000,3999,False,61,scaffold_5
7,2477001,2493000,15999,False,61,scaffold_5
8,2552001,2754000,201999,False,61,scaffold_5
9,2765001,2873000,107999,False,61,scaffold_5
10,3132001,3188000,55999,False,61,scaffold_5
11,3278001,3522000,243999,False,61,scaffold_5
12,3532001,3563000,30999,False,61,scaffold_5
13,3616001,3659000,42999,False,61,scaffold_5
14,3962001,4101000,138999,False,61,scaffold_5
15,4120001,4220000,99999,False,61,scaffold_5
16,4232001,4272000,39999,False,61,scaffold_5
17,4345001,4360000,14999,False,61,scaffold_5
18,4446001,4526000,79999,False,61,scaffold_5
19,4600001,4751000,150999,False,61,scaffold_5
20,4752001,4921000,168999,False,61,scaffold_5
21,5055001,5083000,27999,False,61,scaffold_5
22,5259001,5274000,14999,False,61,scaffold_5
23,5287001,5312000,24999,False,61,scaffold_5
24,5314001,5346000,31999,False,61,scaffold_5
25,6392001,6441000,48999,False,61,scaffold_5
26,6451001,6669000,217999,False,61,scaffold_5
27,6699001,6719000,19999,False,61,scaffold_5
28,6888001,6906000,17999,False,61,scaffold_5
29,7457001,7487000,29999,False,61,scaffold_5
30,7558001,7619000,60999,False,61,scaffold_5
31,7620001,7663000,42999,False,61,scaffold_5
32,8258001,8280000,21999,False,61,scaffold_5
33,8416001,8465000,48999,False,61,scaffold_5
34,8551001,8617000,65999,False,61,scaffold_5
35,8654001,8687000,32999,False,61,scaffold_5
36,8703001,9364176,661175,True,61,scaffold_5
0,61001,75000,13999,False,61,scaffold_6
1,79001,85000,5999,False,61,scaffold_6
2,86001,125000,38999,False,61,scaffold_6
3,149001,208000,58999,False,61,scaffold_6
4,240001,297000,56999,False,61,scaffold_6
5,833001,842000,8999,False,61,scaffold_6
6,1233001,1260000,26999,False,61,scaffold_6
7,1285001,1308000,22999,False,61,scaffold_6
8,1478001,1552000,73999,False,61,scaffold_6
9,1557001,1595000,37999,False,61,scaffold_6
10,1658001,1671000,12999,False,61,scaffold_6
11,1827001,1905000,77999,False,61,scaffold_6
12,2026001,2104000,77999,False,61,scaffold_6
13,2129001,2196000,66999,False,61,scaffold_6
14,2236001,2283000,46999,False,61,scaffold_6
15,2345001,2595000,249999,False,61,scaffold_6
16,2596001,2872000,275999,False,61,scaffold_6
17,2934001,3016000,81999,False,61,scaffold_6
18,3081001,3178000,96999,False,61,scaffold_6
19,3222001,3345000,122999,False,61,scaffold_6
20,3392001,3788000,395999,False,61,scaffold_6
21,3882001,3913000,30999,False,61,scaffold_6
22,3966001,4071000,104999,False,61,scaffold_6
23,4080001,4195000,114999,False,61,scaffold_6
24,5699001,5742000,42999,False,61,scaffold_6
25,6004001,6082000,77999,False,61,scaffold_6
26,6155001,6193000,37999,False,61,scaffold_6
27,6773001,6804000,30999,False,61,scaffold_6
28,6812001,6858000,45999,False,61,scaffold_6
29,7186001,7349000,162999,False,61,scaffold_6
30,7389001,7447000,57999,False,61,scaffold_6
31,7455001,7476000,20999,False,61,scaffold_6
32,7550001,8268281,718280,True,61,scaffold_6
0,1,8000,7999,True,61,scaffold_7
1,10001,31000,20999,False,61,scaffold_7
2,306001,341000,34999,False,61,scaffold_7
3,342001,508000,165999,False,61,scaffold_7
4,571001,591000,19999,False,61,scaffold_7
5,622001,674000,51999,False,61,scaffold_7
6,706001,753000,46999,False,61,scaffold_7
7,764001,828000,63999,False,61,scaffold_7
8,859001,864000,4999,False,61,scaffold_7
9,867001,966000,98999,False,61,scaffold_7
10,967001,980000,12999,False,61,scaffold_7
11,982001,1044000,61999,False,61,scaffold_7
12,1048001,1146000,97999,False,61,scaffold_7
13,1194001,1460000,265999,False,61,scaffold_7
14,1461001,1512000,50999,False,61,scaffold_7
15,1588001,1695000,106999,False,61,scaffold_7
16,1725001,1767000,41999,False,61,scaffold_7
17,1860001,1901000,40999,False,61,scaffold_7
18,2417001,2419000,1999,False,61,scaffold_7
19,3296001,3371000,74999,False,61,scaffold_7
20,3517001,3768000,250999,False,61,scaffold_7
21,4342001,4361000,18999,False,61,scaffold_7
22,4415001,4512000,96999,False,61,scaffold_7
23,4550001,4580000,29999,False,61,scaffold_7
24,4635001,4737000,101999,False,61,scaffold_7
25,4772001,4821000,48999,False,61,scaffold_7
26,4977001,5149000,171999,False,61,scaffold_7
27,5457001,5536000,78999,False,61,scaffold_7
28,6167001,6235000,67999,False,61,scaffold_7
29,6764001,6794000,29999,False,61,scaffold_7
30,6953001,7502216,549215,True,61,scaffold_7
0,1,6000,5999,True,61,scaffold_8
1,66001,85000,18999,False,61,scaffold_8
2,1370001,1425000,54999,False,61,scaffold_8
3,2413001,2552000,138999,False,61,scaffold_8
4,2652001,2683000,30999,False,61,scaffold_8
5,2738001,2841000,102999,False,61,scaffold_8
6,3034001,3557000,522999,False,61,scaffold_8
7,3577001,3614000,36999,False,61,scaffold_8
8,3615001,3944000,328999,False,61,scaffold_8
9,4038001,4108000,69999,False,61,scaffold_8
10,4203001,4221000,17999,False,61,scaffold_8
11,4421001,4434000,12999,False,61,scaffold_8
12,4629001,4668000,38999,False,61,scaffold_8
13,5093001,5137000,43999,False,61,scaffold_8
14,5163001,5241000,77999,False,61,scaffold_8
15,5580001,5595000,14999,False,61,scaffold_8
16,5649001,5692000,42999,False,61,scaffold_8
17,5760001,5774000,13999,False,61,scaffold_8
18,5776001,5815000,38999,False,61,scaffold_8
19,6324001,6334544,10543,True,61,scaffold_8
0,1,22000,21999,True,61,scaffold_9
1,101001,107000,5999,False,61,scaffold_9
2,109001,117000,7999,False,61,scaffold_9
3,121001,137000,15999,False,61,scaffold_9
4,366001,411000,44999,False,61,scaffold_9
5,413001,435000,21999,False,61,scaffold_9
6,478001,531000,52999,False,61,scaffold_9
7,648001,659000,10999,False,61,scaffold_9
8,660001,665000,4999,False,61,scaffold_9
9,671001,710000,38999,False,61,scaffold_9
10,730001,741000,10999,False,61,scaffold_9
11,812001,842000,29999,False,61,scaffold_9
12,872001,986000,113999,False,61,scaffold_9
13,987001,995000,7999,False,61,scaffold_9
14,997001,1007000,9999,False,61,scaffold_9
15,1008001,1085000,76999,False,61,scaffold_9
16,1087001,1150000,62999,False,61,scaffold_9
17,1151001,1170000,18999,False,61,scaffold_9
18,1203001,1217000,13999,False,61,scaffold_9
19,1312001,1382000,69999,False,61,scaffold_9
20,1426001,1455000,28999,False,61,scaffold_9
21,1456001,1464000,7999,False,61,scaffold_9
22,1487001,1500000,12999,False,61,scaffold_9
23,1574001,1592000,17999,False,61,scaffold_9
24,1600001,1618000,17999,False,61,scaffold_9
25,1764001,1791000,26999,False,61,scaffold_9
26,1987001,2027000,39999,False,61,scaffold_9
27,2148001,2171000,22999,False,61,scaffold_9
28,2172001,2198000,25999,False,61,scaffold_9
29,2598001,2632000,33999,False,61,scaffold_9
30,2731001,3381000,649999,False,61,scaffold_9
31,3383001,5107000,1723999,False,61,scaffold_9
32,5112001,5115000,2999,False,61,scaffold_9
33,5116001,5238000,121999,False,61,scaffold_9
34,5239001,6331288,1092287,True,61,scaffold_9
0,1,236000,235999,True,61,scaffold_10
1,256001,482000,225999,False,61,scaffold_10
2,483001,580000,96999,False,61,scaffold_10
3,603001,876000,272999,False,61,scaffold_10
4,888001,986000,97999,False,61,scaffold_10
5,1061001,1069000,7999,False,61,scaffold_10
6,1072001,1146000,73999,False,61,scaffold_10
7,1402001,1473000,70999,False,61,scaffold_10
8,1496001,1523000,26999,False,61,scaffold_10
9,1539001,1624000,84999,False,61,scaffold_10
10,1806001,1817000,10999,False,61,scaffold_10
11,2087001,2109000,21999,False,61,scaffold_10
12,2131001,2168000,36999,False,61,scaffold_10
13,2273001,2290000,16999,False,61,scaffold_10
14,2339001,2461000,121999,False,61,scaffold_10
15,2558001,2574000,15999,False,61,scaffold_10
16,2600001,2652000,51999,False,61,scaffold_10
17,2674001,2694000,19999,False,61,scaffold_10
18,2937001,2953000,15999,False,61,scaffold_10
19,3154001,3183000,28999,False,61,scaffold_10
20,4001001,4011000,9999,False,61,scaffold_10
21,4052001,4091000,38999,False,61,scaffold_10
22,4154001,4174000,19999,False,61,scaffold_10
23,4443001,4466000,22999,False,61,scaffold_10
24,4467001,4513000,45999,False,61,scaffold_10
25,4515001,4523000,7999,False,61,scaffold_10
26,4526001,4548000,21999,False,61,scaffold_10
27,4565001,4597000,31999,False,61,scaffold_10
28,4716001,4732000,15999,False,61,scaffold_10
29,4735001,4776000,40999,False,61,scaffold_10
30,4798001,4826000,27999,False,61,scaffold_10
31,4828001,4843000,14999,False,61,scaffold_10
32,4848001,4863000,14999,False,61,scaffold_10
33,4865001,4866973,1972,True,61,scaffold_10
0,10001,93000,82999,False,61,scaffold_11
1,148001,167000,18999,False,61,scaffold_11
2,169001,212000,42999,False,61,scaffold_11
3,213001,236000,22999,False,61,scaffold_11
4,240001,249000,8999,False,61,scaffold_11
5,289001,320000,30999,False,61,scaffold_11
6,420001,431000,10999,False,61,scaffold_11
7,648001,656000,7999,False,61,scaffold_11
8,1403001,1409000,5999,False,61,scaffold_11
9,1966001,1984000,17999,False,61,scaffold_11
10,2027001,2044000,16999,False,61,scaffold_11
11,2131001,2140000,8999,False,61,scaffold_11
12,2701001,2878000,176999,False,61,scaffold_11
13,2983001,3019000,35999,False,61,scaffold_11
14,3083001,3161000,77999,False,61,scaffold_11
15,3185001,3383000,197999,False,61,scaffold_11
16,3433001,3481000,47999,False,61,scaffold_11
17,3499001,3933000,433999,False,61,scaffold_11
18,4004001,4159000,154999,False,61,scaffold_11
19,4189001,4710000,520999,False,61,scaffold_11
20,4713001,4766820,53819,True,61,scaffold_11
0,1,381000,380999,True,61,scaffold_12
1,404001,1500000,1095999,False,61,scaffold_12
2,1716001,1746000,29999,False,61,scaffold_12
3,1971001,2001000,29999,False,61,scaffold_12
4,2031001,2041000,9999,False,61,scaffold_12
5,2044001,2102000,57999,False,61,scaffold_12
6,2128001,2166000,37999,False,61,scaffold_12
7,2461001,2472000,10999,False,61,scaffold_12
8,2492001,2502000,9999,False,61,scaffold_12
9,2571001,2610000,38999,False,61,scaffold_12
10,2666001,2682000,15999,False,61,scaffold_12
11,2685001,2699000,13999,False,61,scaffold_12
12,2700001,2708000,7999,False,61,scaffold_12
13,2726001,2730000,3999,False,61,scaffold_12
0,1,342000,341999,True,62,scaffold_1
1,482001,498000,15999,False,62,scaffold_1
2,574001,643000,68999,False,62,scaffold_1
3,686001,743000,56999,False,62,scaffold_1
4,1281001,1292000,10999,False,62,scaffold_1
5,1821001,1899000,77999,False,62,scaffold_1
6,1954001,1964000,9999,False,62,scaffold_1
7,1965001,1984000,18999,False,62,scaffold_1
8,1987001,1993000,5999,False,62,scaffold_1
9,2449001,2517000,67999,False,62,scaffold_1
10,2729001,2746000,16999,False,62,scaffold_1
11,3181001,3208000,26999,False,62,scaffold_1
12,3715001,3735000,19999,False,62,scaffold_1
13,3916001,3941000,24999,False,62,scaffold_1
14,4003001,4027000,23999,False,62,scaffold_1
15,4060001,4111000,50999,False,62,scaffold_1
16,4322001,4354000,31999,False,62,scaffold_1
17,4926001,5021000,94999,False,62,scaffold_1
18,5481001,5512000,30999,False,62,scaffold_1
19,6108001,6153000,44999,False,62,scaffold_1
20,6228001,6382000,153999,False,62,scaffold_1
21,6384001,6509000,124999,False,62,scaffold_1
22,6544001,6554000,9999,False,62,scaffold_1
23,7038001,7247000,208999,False,62,scaffold_1
24,7248001,7583000,334999,False,62,scaffold_1
25,7590001,8656000,1065999,False,62,scaffold_1
26,8658001,9584000,925999,False,62,scaffold_1
27,9586001,10354000,767999,False,62,scaffold_1
28,10461001,10616000,154999,False,62,scaffold_1
29,10808001,10811000,2999,False,62,scaffold_1
30,10836001,10858000,21999,False,62,scaffold_1
31,11282001,11504000,221999,False,62,scaffold_1
32,11609001,11951000,341999,False,62,scaffold_1
33,12184001,12204000,19999,False,62,scaffold_1
34,12661001,12722000,60999,False,62,scaffold_1
35,12777001,12888000,110999,False,62,scaffold_1
36,13113001,13211000,97999,False,62,scaffold_1
37,13347001,13431000,83999,False,62,scaffold_1
38,14298001,14307000,8999,False,62,scaffold_1
0,22001,48000,25999,False,62,scaffold_2
1,93001,159000,65999,False,62,scaffold_2
2,168001,177000,8999,False,62,scaffold_2
3,302001,318000,15999,False,62,scaffold_2
4,330001,374000,43999,False,62,scaffold_2
5,2086001,2099000,12999,False,62,scaffold_2
6,2336001,2358000,21999,False,62,scaffold_2
7,2405001,2423000,17999,False,62,scaffold_2
8,2441001,2553000,111999,False,62,scaffold_2
9,2627001,2639000,11999,False,62,scaffold_2
10,2660001,2689000,28999,False,62,scaffold_2
11,2694001,2745000,50999,False,62,scaffold_2
12,2842001,2852000,9999,False,62,scaffold_2
13,2868001,2898000,29999,False,62,scaffold_2
14,3334001,3343000,8999,False,62,scaffold_2
15,3454001,3463000,8999,False,62,scaffold_2
16,3759001,3783000,23999,False,62,scaffold_2
17,4341001,4409000,67999,False,62,scaffold_2
18,4429001,4456000,26999,False,62,scaffold_2
19,4520001,4652000,131999,False,62,scaffold_2
20,5021001,5031000,9999,False,62,scaffold_2
21,5033001,5061000,27999,False,62,scaffold_2
22,5377001,5389000,11999,False,62,scaffold_2
23,5491001,5512000,20999,False,62,scaffold_2
24,5659001,5704000,44999,False,62,scaffold_2
25,5719001,5757000,37999,False,62,scaffold_2
26,6261001,6330000,68999,False,62,scaffold_2
27,6331001,6350000,18999,False,62,scaffold_2
28,6430001,6447000,16999,False,62,scaffold_2
29,7018001,7036000,17999,False,62,scaffold_2
30,7439001,7472000,32999,False,62,scaffold_2
31,7563001,7698000,134999,False,62,scaffold_2
32,7786001,7890000,103999,False,62,scaffold_2
33,7934001,8135000,200999,False,62,scaffold_2
34,8261001,8294000,32999,False,62,scaffold_2
35,8331001,8333000,1999,False,62,scaffold_2
36,8346001,8382000,35999,False,62,scaffold_2
37,8509001,8557000,47999,False,62,scaffold_2
38,11367001,11373000,5999,False,62,scaffold_2
39,11520001,11786000,265999,False,62,scaffold_2
0,1,2000,1999,True,62,scaffold_3
1,51001,55000,3999,False,62,scaffold_3
2,102001,104000,1999,False,62,scaffold_3
3,799001,900000,100999,False,62,scaffold_3
4,2084001,2108000,23999,False,62,scaffold_3
5,2291001,2334000,42999,False,62,scaffold_3
6,2487001,2533000,45999,False,62,scaffold_3
7,4108001,4385000,276999,False,62,scaffold_3
8,4418001,4518000,99999,False,62,scaffold_3
9,4547001,4558000,10999,False,62,scaffold_3
10,4654001,4678000,23999,False,62,scaffold_3
11,5990001,6022000,31999,False,62,scaffold_3
12,6907001,6962000,54999,False,62,scaffold_3
13,6963001,6972000,8999,False,62,scaffold_3
14,6979001,7089000,109999,False,62,scaffold_3
15,7146001,7157000,10999,False,62,scaffold_3
16,7339001,7354000,14999,False,62,scaffold_3
17,7371001,7396000,24999,False,62,scaffold_3
18,7522001,7556000,33999,False,62,scaffold_3
19,7692001,7798000,105999,False,62,scaffold_3
20,7822001,7852000,29999,False,62,scaffold_3
21,8175001,8253000,77999,False,62,scaffold_3
22,8462001,8527000,64999,False,62,scaffold_3
23,8575001,8594000,18999,False,62,scaffold_3
24,9968001,9996000,27999,False,62,scaffold_3
25,10461001,10483000,21999,False,62,scaffold_3
26,10587001,11165000,577999,False,62,scaffold_3
0,17001,32000,14999,False,62,scaffold_4
1,48001,88000,39999,False,62,scaffold_4
2,147001,151000,3999,False,62,scaffold_4
3,155001,160000,4999,False,62,scaffold_4
4,161001,215000,53999,False,62,scaffold_4
5,217001,226000,8999,False,62,scaffold_4
6,227001,266000,38999,False,62,scaffold_4
7,355001,374000,18999,False,62,scaffold_4
8,375001,380000,4999,False,62,scaffold_4
9,395001,410000,14999,False,62,scaffold_4
10,412001,425000,12999,False,62,scaffold_4
11,429001,498000,68999,False,62,scaffold_4
12,545001,592000,46999,False,62,scaffold_4
13,608001,691000,82999,False,62,scaffold_4
14,1121001,1136000,14999,False,62,scaffold_4
15,1137001,1198000,60999,False,62,scaffold_4
16,1199001,1208000,8999,False,62,scaffold_4
17,1210001,1226000,15999,False,62,scaffold_4
18,1265001,1279000,13999,False,62,scaffold_4
19,1283001,1336000,52999,False,62,scaffold_4
20,1372001,1596000,223999,False,62,scaffold_4
21,1613001,1957000,343999,False,62,scaffold_4
22,1958001,2002000,43999,False,62,scaffold_4
23,2032001,2117000,84999,False,62,scaffold_4
24,2162001,2185000,22999,False,62,scaffold_4
25,2248001,2268000,19999,False,62,scaffold_4
26,2269001,2279000,9999,False,62,scaffold_4
27,2284001,2310000,25999,False,62,scaffold_4
28,2312001,2340000,27999,False,62,scaffold_4
29,2342001,2386000,43999,False,62,scaffold_4
30,2394001,2442000,47999,False,62,scaffold_4
31,2477001,2635000,157999,False,62,scaffold_4
32,3336001,3633000,296999,False,62,scaffold_4
33,3649001,3766000,116999,False,62,scaffold_4
34,4942001,4984000,41999,False,62,scaffold_4
35,5474001,5506000,31999,False,62,scaffold_4
36,5514001,5620000,105999,False,62,scaffold_4
37,5661001,5784000,122999,False,62,scaffold_4
38,5786001,5818000,31999,False,62,scaffold_4
39,6146001,6193000,46999,False,62,scaffold_4
40,6769001,6817000,47999,False,62,scaffold_4
41,6902001,6924000,21999,False,62,scaffold_4
42,7036001,7062000,25999,False,62,scaffold_4
43,8846001,9699000,852999,False,62,scaffold_4
44,9700001,9845951,145950,True,62,scaffold_4
0,1,4000,3999,True,62,scaffold_5
1,194001,204000,9999,False,62,scaffold_5
2,296001,300000,3999,False,62,scaffold_5
3,318001,368000,49999,False,62,scaffold_5
4,463001,523000,59999,False,62,scaffold_5
5,933001,947000,13999,False,62,scaffold_5
6,2565001,2582000,16999,False,62,scaffold_5
7,2618001,2734000,115999,False,62,scaffold_5
8,2816001,2871000,54999,False,62,scaffold_5
9,3167001,3186000,18999,False,62,scaffold_5
10,3217001,3247000,29999,False,62,scaffold_5
11,3322001,3510000,187999,False,62,scaffold_5
12,3962001,4101000,138999,False,62,scaffold_5
13,4121001,4219000,97999,False,62,scaffold_5
14,4246001,4263000,16999,False,62,scaffold_5
15,4446001,4506000,59999,False,62,scaffold_5
16,4601001,4681000,79999,False,62,scaffold_5
17,4690001,4717000,26999,False,62,scaffold_5
18,4761001,4861000,99999,False,62,scaffold_5
19,4904001,4917000,12999,False,62,scaffold_5
20,5287001,5312000,24999,False,62,scaffold_5
21,5314001,5346000,31999,False,62,scaffold_5
22,6481001,6653000,171999,False,62,scaffold_5
23,7622001,7656000,33999,False,62,scaffold_5
24,8571001,8614000,42999,False,62,scaffold_5
25,8666001,8688000,21999,False,62,scaffold_5
26,8713001,9363000,649999,False,62,scaffold_5
0,79001,84000,4999,False,62,scaffold_6
1,86001,114000,27999,False,62,scaffold_6
2,240001,254000,13999,False,62,scaffold_6
3,1146001,1197000,50999,False,62,scaffold_6
4,1236001,1256000,19999,False,62,scaffold_6
5,1292001,1304000,11999,False,62,scaffold_6
6,1478001,1546000,67999,False,62,scaffold_6
7,2023001,2089000,65999,False,62,scaffold_6
8,2126001,2169000,42999,False,62,scaffold_6
9,2240001,2264000,23999,False,62,scaffold_6
10,2336001,2595000,258999,False,62,scaffold_6
11,2596001,2691000,94999,False,62,scaffold_6
12,2731001,2851000,119999,False,62,scaffold_6
13,2934001,3021000,86999,False,62,scaffold_6
14,3112001,3177000,64999,False,62,scaffold_6
15,3223001,3307000,83999,False,62,scaffold_6
16,3406001,3430000,23999,False,62,scaffold_6
17,3462001,3766000,303999,False,62,scaffold_6
18,3900001,3912000,11999,False,62,scaffold_6
19,4018001,4072000,53999,False,62,scaffold_6
20,4073001,4193000,119999,False,62,scaffold_6
21,6011001,6060000,48999,False,62,scaffold_6
22,7269001,7337000,67999,False,62,scaffold_6
23,7550001,7798000,247999,False,62,scaffold_6
24,7811001,8268281,457280,True,62,scaffold_6
0,13001,34000,20999,False,62,scaffold_7
1,323001,340000,16999,False,62,scaffold_7
2,342001,508000,165999,False,62,scaffold_7
3,554001,563000,8999,False,62,scaffold_7
4,571001,577000,5999,False,62,scaffold_7
5,706001,724000,17999,False,62,scaffold_7
6,725001,736000,10999,False,62,scaffold_7
7,741001,753000,11999,False,62,scaffold_7
8,764001,809000,44999,False,62,scaffold_7
9,859001,864000,4999,False,62,scaffold_7
10,964001,966000,1999,False,62,scaffold_7
11,968001,979000,10999,False,62,scaffold_7
12,982001,1044000,61999,False,62,scaffold_7
13,1191001,1512000,320999,False,62,scaffold_7
14,1588001,1688000,99999,False,62,scaffold_7
15,3325001,3369000,43999,False,62,scaffold_7
16,3595001,3649000,53999,False,62,scaffold_7
17,3720001,3765000,44999,False,62,scaffold_7
18,4416001,4517000,100999,False,62,scaffold_7
19,4658001,4683000,24999,False,62,scaffold_7
20,4687001,4733000,45999,False,62,scaffold_7
21,4978001,5149000,170999,False,62,scaffold_7
22,5481001,5536000,54999,False,62,scaffold_7
23,6954001,7270000,315999,False,62,scaffold_7
24,7271001,7502216,231215,True,62,scaffold_7
0,67001,85000,17999,False,62,scaffold_8
1,93001,101000,7999,False,62,scaffold_8
2,722001,724000,1999,False,62,scaffold_8
3,2444001,2525000,80999,False,62,scaffold_8
4,2652001,2683000,30999,False,62,scaffold_8
5,2742001,2758000,15999,False,62,scaffold_8
6,2798001,2844000,45999,False,62,scaffold_8
7,3059001,3525000,465999,False,62,scaffold_8
8,3584001,3612000,27999,False,62,scaffold_8
9,3615001,3913000,297999,False,62,scaffold_8
10,4039001,4104000,64999,False,62,scaffold_8
11,5083001,5136000,52999,False,62,scaffold_8
12,5200001,5241000,40999,False,62,scaffold_8
13,5678001,5693000,14999,False,62,scaffold_8
14,6324001,6334544,10543,True,62,scaffold_8
0,109001,117000,7999,False,62,scaffold_9
1,303001,315000,11999,False,62,scaffold_9
2,319001,332000,12999,False,62,scaffold_9
3,367001,411000,43999,False,62,scaffold_9
4,413001,434000,20999,False,62,scaffold_9
5,503001,531000,27999,False,62,scaffold_9
6,671001,697000,25999,False,62,scaffold_9
7,732001,742000,9999,False,62,scaffold_9
8,794001,801000,6999,False,62,scaffold_9
9,817001,843000,25999,False,62,scaffold_9
10,873001,986000,112999,False,62,scaffold_9
11,988001,995000,6999,False,62,scaffold_9
12,1001001,1007000,5999,False,62,scaffold_9
13,1009001,1085000,75999,False,62,scaffold_9
14,1087001,1150000,62999,False,62,scaffold_9
15,1151001,1160000,8999,False,62,scaffold_9
16,1313001,1377000,63999,False,62,scaffold_9
17,1760001,1791000,30999,False,62,scaffold_9
18,2147001,2171000,23999,False,62,scaffold_9
19,2598001,2616000,17999,False,62,scaffold_9
20,2782001,2803000,20999,False,62,scaffold_9
21,2870001,3381000,510999,False,62,scaffold_9
22,3383001,5100000,1716999,False,62,scaffold_9
23,5101001,5107000,5999,False,62,scaffold_9
24,5112001,5114000,1999,False,62,scaffold_9
25,5116001,5238000,121999,False,62,scaffold_9
26,5239001,5298000,58999,False,62,scaffold_9
27,5300001,6331288,1031287,True,62,scaffold_9
0,1,199000,198999,True,62,scaffold_10
1,259001,405000,145999,False,62,scaffold_10
2,462001,482000,19999,False,62,scaffold_10
3,483001,576000,92999,False,62,scaffold_10
4,603001,756000,152999,False,62,scaffold_10
5,783001,794000,10999,False,62,scaffold_10
6,888001,917000,28999,False,62,scaffold_10
7,923001,962000,38999,False,62,scaffold_10
8,1087001,1112000,24999,False,62,scaffold_10
9,2140001,2169000,28999,False,62,scaffold_10
10,2272001,2299000,26999,False,62,scaffold_10
11,2346001,2372000,25999,False,62,scaffold_10
12,4053001,4091000,37999,False,62,scaffold_10
13,4154001,4174000,19999,False,62,scaffold_10
14,4445001,4462000,16999,False,62,scaffold_10
15,4467001,4477000,9999,False,62,scaffold_10
16,4503001,4513000,9999,False,62,scaffold_10
17,4515001,4523000,7999,False,62,scaffold_10
18,4526001,4548000,21999,False,62,scaffold_10
19,4679001,4688000,8999,False,62,scaffold_10
20,4734001,4766000,31999,False,62,scaffold_10
21,4768001,4776000,7999,False,62,scaffold_10
22,4798001,4824000,25999,False,62,scaffold_10
23,4828001,4843000,14999,False,62,scaffold_10
24,4848001,4861000,12999,False,62,scaffold_10
25,4865001,4866973,1972,True,62,scaffold_10
0,10001,34000,23999,False,62,scaffold_11
1,40001,91000,50999,False,62,scaffold_11
2,149001,167000,17999,False,62,scaffold_11
3,169001,191000,21999,False,62,scaffold_11
4,210001,235000,24999,False,62,scaffold_11
5,240001,244000,3999,False,62,scaffold_11
6,419001,431000,11999,False,62,scaffold_11
7,648001,656000,7999,False,62,scaffold_11
8,1025001,1034000,8999,False,62,scaffold_11
9,1423001,1426000,2999,False,62,scaffold_11
10,1474001,1477000,2999,False,62,scaffold_11
11,2701001,2877000,175999,False,62,scaffold_11
12,3188001,3289000,100999,False,62,scaffold_11
13,3331001,3383000,51999,False,62,scaffold_11
14,3533001,3634000,100999,False,62,scaffold_11
15,3702001,3926000,223999,False,62,scaffold_11
16,4009001,4158000,148999,False,62,scaffold_11
17,4255001,4710000,454999,False,62,scaffold_11
18,4713001,4766820,53819,True,62,scaffold_11
0,1,369000,368999,True,62,scaffold_12
1,404001,544000,139999,False,62,scaffold_12
2,581001,856000,274999,False,62,scaffold_12
3,864001,1468000,603999,False,62,scaffold_12
4,1720001,1733000,12999,False,62,scaffold_12
5,2350001,2380000,29999,False,62,scaffold_12
6,2571001,2616000,44999,False,62,scaffold_12
7,2674001,2682000,7999,False,62,scaffold_12
8,2685001,2698000,12999,False,62,scaffold_12
0,1,342000,341999,True,63,scaffold_1
1,482001,498000,15999,False,63,scaffold_1
2,574001,643000,68999,False,63,scaffold_1
3,686001,749000,62999,False,63,scaffold_1
4,1281001,1292000,10999,False,63,scaffold_1
5,1827001,1898000,70999,False,63,scaffold_1
6,1954001,1964000,9999,False,63,scaffold_1
7,1965001,1984000,18999,False,63,scaffold_1
8,1987001,2002000,14999,False,63,scaffold_1
9,2449001,2517000,67999,False,63,scaffold_1
10,2727001,2746000,18999,False,63,scaffold_1
11,3181001,3208000,26999,False,63,scaffold_1
12,3448001,3479000,30999,False,63,scaffold_1
13,3712001,3734000,21999,False,63,scaffold_1
14,3916001,3941000,24999,False,63,scaffold_1
15,4062001,4112000,49999,False,63,scaffold_1
16,4322001,4354000,31999,False,63,scaffold_1
17,4928001,5018000,89999,False,63,scaffold_1
18,5481001,5511000,29999,False,63,scaffold_1
19,5535001,5570000,34999,False,63,scaffold_1
20,6108001,6153000,44999,False,63,scaffold_1
21,6204001,6507000,302999,False,63,scaffold_1
22,6545001,6554000,8999,False,63,scaffold_1
23,7041001,7247000,205999,False,63,scaffold_1
24,7248001,7588000,339999,False,63,scaffold_1
25,7590001,8656000,1065999,False,63,scaffold_1
26,8658001,9584000,925999,False,63,scaffold_1
27,9586001,10356000,769999,False,63,scaffold_1
28,10461001,10623000,161999,False,63,scaffold_1
29,10808001,10811000,2999,False,63,scaffold_1
30,10837001,10858000,20999,False,63,scaffold_1
31,11346001,11504000,157999,False,63,scaffold_1
32,11560001,11951000,390999,False,63,scaffold_1
33,12183001,12204000,20999,False,63,scaffold_1
34,12652001,12722000,69999,False,63,scaffold_1
35,12777001,12888000,110999,False,63,scaffold_1
36,12975001,13000000,24999,False,63,scaffold_1
37,13112001,13211000,98999,False,63,scaffold_1
38,13347001,13408000,60999,False,63,scaffold_1
39,14285001,14308000,22999,False,63,scaffold_1
0,22001,48000,25999,False,63,scaffold_2
1,93001,159000,65999,False,63,scaffold_2
2,168001,177000,8999,False,63,scaffold_2
3,302001,318000,15999,False,63,scaffold_2
4,333001,374000,40999,False,63,scaffold_2
5,2086001,2101000,14999,False,63,scaffold_2
6,2336001,2358000,21999,False,63,scaffold_2
7,2441001,2553000,111999,False,63,scaffold_2
8,2660001,2689000,28999,False,63,scaffold_2
9,2693001,2744000,50999,False,63,scaffold_2
10,2841001,2855000,13999,False,63,scaffold_2
11,2994001,3013000,18999,False,63,scaffold_2
12,3333001,3343000,9999,False,63,scaffold_2
13,3451001,3465000,13999,False,63,scaffold_2
14,3754001,3783000,28999,False,63,scaffold_2
15,4384001,4409000,24999,False,63,scaffold_2
16,4429001,4457000,27999,False,63,scaffold_2
17,4521001,4656000,134999,False,63,scaffold_2
18,4783001,4790000,6999,False,63,scaffold_2
19,4918001,4937000,18999,False,63,scaffold_2
20,5021001,5063000,41999,False,63,scaffold_2
21,5370001,5393000,22999,False,63,scaffold_2
22,5491001,5512000,20999,False,63,scaffold_2
23,5668001,5704000,35999,False,63,scaffold_2
24,5719001,5758000,38999,False,63,scaffold_2
25,5843001,5854000,10999,False,63,scaffold_2
26,5861001,5883000,21999,False,63,scaffold_2
27,6261001,6330000,68999,False,63,scaffold_2
28,6331001,6351000,19999,False,63,scaffold_2
29,6428001,6449000,20999,False,63,scaffold_2
30,6592001,6628000,35999,False,63,scaffold_2
31,7018001,7035000,16999,False,63,scaffold_2
32,7064001,7096000,31999,False,63,scaffold_2
33,7434001,7472000,37999,False,63,scaffold_2
34,7550001,7561000,10999,False,63,scaffold_2
35,7563001,7697000,133999,False,63,scaffold_2
36,7785001,7892000,106999,False,63,scaffold_2
37,7934001,8111000,176999,False,63,scaffold_2
38,8261001,8294000,32999,False,63,scaffold_2
39,8331001,8333000,1999,False,63,scaffold_2
40,8342001,8344000,1999,False,63,scaffold_2
41,8346001,8454000,107999,False,63,scaffold_2
42,8509001,8556000,46999,False,63,scaffold_2
43,11367001,11374000,6999,False,63,scaffold_2
44,11520001,11786000,265999,False,63,scaffold_2
0,43001,46000,2999,False,63,scaffold_3
1,51001,55000,3999,False,63,scaffold_3
2,102001,104000,1999,False,63,scaffold_3
3,798001,900000,101999,False,63,scaffold_3
4,2077001,2108000,30999,False,63,scaffold_3
5,2291001,2322000,30999,False,63,scaffold_3
6,2487001,2533000,45999,False,63,scaffold_3
7,3772001,3811000,38999,False,63,scaffold_3
8,3826001,3891000,64999,False,63,scaffold_3
9,4100001,4403000,302999,False,63,scaffold_3
10,4417001,4518000,100999,False,63,scaffold_3
11,4546001,4558000,11999,False,63,scaffold_3
12,4652001,4679000,26999,False,63,scaffold_3
13,5167001,5190000,22999,False,63,scaffold_3
14,5491001,5509000,17999,False,63,scaffold_3
15,5990001,6023000,32999,False,63,scaffold_3
16,6910001,6962000,51999,False,63,scaffold_3
17,6979001,7090000,110999,False,63,scaffold_3
18,7144001,7157000,12999,False,63,scaffold_3
19,7371001,7397000,25999,False,63,scaffold_3
20,7540001,7556000,15999,False,63,scaffold_3
21,7692001,7800000,107999,False,63,scaffold_3
22,7819001,7842000,22999,False,63,scaffold_3
23,8176001,8253000,76999,False,63,scaffold_3
24,8462001,8528000,65999,False,63,scaffold_3
25,8575001,8594000,18999,False,63,scaffold_3
26,9968001,9995000,26999,False,63,scaffold_3
27,10461001,10483000,21999,False,63,scaffold_3
28,10587001,11165000,577999,False,63,scaffold_3
0,11001,13000,1999,False,63,scaffold_4
1,17001,32000,14999,False,63,scaffold_4
2,49001,88000,38999,False,63,scaffold_4
3,155001,215000,59999,False,63,scaffold_4
4,217001,226000,8999,False,63,scaffold_4
5,227001,266000,38999,False,63,scaffold_4
6,291001,344000,52999,False,63,scaffold_4
7,355001,374000,18999,False,63,scaffold_4
8,375001,380000,4999,False,63,scaffold_4
9,412001,425000,12999,False,63,scaffold_4
10,429001,498000,68999,False,63,scaffold_4
11,542001,606000,63999,False,63,scaffold_4
12,608001,661000,52999,False,63,scaffold_4
13,670001,691000,20999,False,63,scaffold_4
14,695001,697000,1999,False,63,scaffold_4
15,701001,714000,12999,False,63,scaffold_4
16,1121001,1136000,14999,False,63,scaffold_4
17,1138001,1198000,59999,False,63,scaffold_4
18,1199001,1208000,8999,False,63,scaffold_4
19,1210001,1226000,15999,False,63,scaffold_4
20,1229001,1234000,4999,False,63,scaffold_4
21,1235001,1245000,9999,False,63,scaffold_4
22,1271001,1279000,7999,False,63,scaffold_4
23,1283001,1315000,31999,False,63,scaffold_4
24,1372001,1604000,231999,False,63,scaffold_4
25,1613001,2006000,392999,False,63,scaffold_4
26,2007001,2117000,109999,False,63,scaffold_4
27,2144001,2185000,40999,False,63,scaffold_4
28,2255001,2279000,23999,False,63,scaffold_4
29,2283001,2340000,56999,False,63,scaffold_4
30,2342001,2352000,9999,False,63,scaffold_4
31,2353001,2367000,13999,False,63,scaffold_4
32,2399001,2461000,61999,False,63,scaffold_4
33,2476001,2635000,158999,False,63,scaffold_4
34,3336001,3637000,300999,False,63,scaffold_4
35,3645001,3766000,120999,False,63,scaffold_4
36,4942001,4998000,55999,False,63,scaffold_4
37,5172001,5222000,49999,False,63,scaffold_4
38,5475001,5506000,30999,False,63,scaffold_4
39,5514001,5620000,105999,False,63,scaffold_4
40,5660001,5784000,123999,False,63,scaffold_4
41,5786001,5816000,29999,False,63,scaffold_4
42,6145001,6195000,49999,False,63,scaffold_4
43,6790001,6817000,26999,False,63,scaffold_4
44,6899001,6924000,24999,False,63,scaffold_4
45,7036001,7077000,40999,False,63,scaffold_4
46,8846001,9699000,852999,False,63,scaffold_4
47,9700001,9845951,145950,True,63,scaffold_4
0,1,4000,3999,True,63,scaffold_5
1,296001,300000,3999,False,63,scaffold_5
2,318001,326000,7999,False,63,scaffold_5
3,327001,368000,40999,False,63,scaffold_5
4,463001,523000,59999,False,63,scaffold_5
5,933001,947000,13999,False,63,scaffold_5
6,2562001,2741000,178999,False,63,scaffold_5
7,2816001,2874000,57999,False,63,scaffold_5
8,3133001,3185000,51999,False,63,scaffold_5
9,3220001,3248000,27999,False,63,scaffold_5
10,3322001,3511000,188999,False,63,scaffold_5
11,3962001,4101000,138999,False,63,scaffold_5
12,4121001,4219000,97999,False,63,scaffold_5
13,4244001,4273000,28999,False,63,scaffold_5
14,4446001,4506000,59999,False,63,scaffold_5
15,4601001,4663000,61999,False,63,scaffold_5
16,4691001,4861000,169999,False,63,scaffold_5
17,4904001,4917000,12999,False,63,scaffold_5
18,5260001,5273000,12999,False,63,scaffold_5
19,5317001,5346000,28999,False,63,scaffold_5
20,6500001,6652000,151999,False,63,scaffold_5
21,7454001,7483000,28999,False,63,scaffold_5
22,7580001,7619000,38999,False,63,scaffold_5
23,7621001,7657000,35999,False,63,scaffold_5
24,8571001,8616000,44999,False,63,scaffold_5
25,8666001,8689000,22999,False,63,scaffold_5
26,8730001,9363000,632999,False,63,scaffold_5
27,9364001,9364176,175,True,63,scaffold_5
0,79001,84000,4999,False,63,scaffold_6
1,86001,114000,27999,False,63,scaffold_6
2,239001,255000,15999,False,63,scaffold_6
3,1229001,1257000,27999,False,63,scaffold_6
4,1478001,1546000,67999,False,63,scaffold_6
5,1867001,1906000,38999,False,63,scaffold_6
6,2023001,2087000,63999,False,63,scaffold_6
7,2129001,2195000,65999,False,63,scaffold_6
8,2336001,2595000,258999,False,63,scaffold_6
9,2596001,2693000,96999,False,63,scaffold_6
10,2731001,2851000,119999,False,63,scaffold_6
11,2928001,3014000,85999,False,63,scaffold_6
12,3115001,3174000,58999,False,63,scaffold_6
13,3223001,3333000,109999,False,63,scaffold_6
14,3334001,3341000,6999,False,63,scaffold_6
15,3406001,3766000,359999,False,63,scaffold_6
16,3900001,3912000,11999,False,63,scaffold_6
17,4018001,4072000,53999,False,63,scaffold_6
18,4079001,4192000,112999,False,63,scaffold_6
19,6011001,6081000,69999,False,63,scaffold_6
20,7263001,7337000,73999,False,63,scaffold_6
21,7391001,7436000,44999,False,63,scaffold_6
22,7541001,8268281,727280,True,63,scaffold_6
0,1,8000,7999,True,63,scaffold_7
1,13001,31000,17999,False,63,scaffold_7
2,323001,340000,16999,False,63,scaffold_7
3,342001,508000,165999,False,63,scaffold_7
4,554001,563000,8999,False,63,scaffold_7
5,571001,577000,5999,False,63,scaffold_7
6,706001,736000,29999,False,63,scaffold_7
7,741001,753000,11999,False,63,scaffold_7
8,764001,829000,64999,False,63,scaffold_7
9,859001,864000,4999,False,63,scaffold_7
10,964001,966000,1999,False,63,scaffold_7
11,968001,980000,11999,False,63,scaffold_7
12,982001,1044000,61999,False,63,scaffold_7
13,1048001,1081000,32999,False,63,scaffold_7
14,1203001,1512000,308999,False,63,scaffold_7
15,1588001,1688000,99999,False,63,scaffold_7
16,3325001,3369000,43999,False,63,scaffold_7
17,3593001,3657000,63999,False,63,scaffold_7
18,4415001,4517000,101999,False,63,scaffold_7
19,4658001,4731000,72999,False,63,scaffold_7
20,4979001,5148000,168999,False,63,scaffold_7
21,5483001,5537000,53999,False,63,scaffold_7
22,6955001,7270000,314999,False,63,scaffold_7
23,7271001,7502216,231215,True,63,scaffold_7
0,66001,85000,18999,False,63,scaffold_8
1,93001,102000,8999,False,63,scaffold_8
2,2444001,2527000,82999,False,63,scaffold_8
3,2536001,2552000,15999,False,63,scaffold_8
4,2650001,2683000,32999,False,63,scaffold_8
5,2742001,2757000,14999,False,63,scaffold_8
6,2800001,2844000,43999,False,63,scaffold_8
7,3059001,3528000,468999,False,63,scaffold_8
8,3584001,3612000,27999,False,63,scaffold_8
9,3615001,3937000,321999,False,63,scaffold_8
10,4039001,4099000,59999,False,63,scaffold_8
11,4203001,4221000,17999,False,63,scaffold_8
12,5105001,5136000,30999,False,63,scaffold_8
13,5172001,5241000,68999,False,63,scaffold_8
14,5679001,5692000,12999,False,63,scaffold_8
15,6322001,6334544,12543,True,63,scaffold_8
0,1001,22000,20999,False,63,scaffold_9
1,109001,117000,7999,False,63,scaffold_9
2,189001,194000,4999,False,63,scaffold_9
3,304001,315000,10999,False,63,scaffold_9
4,319001,334000,14999,False,63,scaffold_9
5,366001,411000,44999,False,63,scaffold_9
6,413001,434000,20999,False,63,scaffold_9
7,502001,531000,28999,False,63,scaffold_9
8,652001,665000,12999,False,63,scaffold_9
9,671001,696000,24999,False,63,scaffold_9
10,733001,741000,7999,False,63,scaffold_9
11,817001,842000,24999,False,63,scaffold_9
12,873001,881000,7999,False,63,scaffold_9
13,883001,986000,102999,False,63,scaffold_9
14,987001,995000,7999,False,63,scaffold_9
15,1001001,1007000,5999,False,63,scaffold_9
16,1009001,1032000,22999,False,63,scaffold_9
17,1034001,1085000,50999,False,63,scaffold_9
18,1087001,1150000,62999,False,63,scaffold_9
19,1151001,1176000,24999,False,63,scaffold_9
20,1312001,1377000,64999,False,63,scaffold_9
21,1487001,1497000,9999,False,63,scaffold_9
22,1590001,1592000,1999,False,63,scaffold_9
23,1599001,1622000,22999,False,63,scaffold_9
24,1750001,1791000,40999,False,63,scaffold_9
25,2598001,2616000,17999,False,63,scaffold_9
26,2739001,2803000,63999,False,63,scaffold_9
27,2845001,3381000,535999,False,63,scaffold_9
28,3383001,5100000,1716999,False,63,scaffold_9
29,5101001,5107000,5999,False,63,scaffold_9
30,5112001,5238000,125999,False,63,scaffold_9
31,5239001,5298000,58999,False,63,scaffold_9
32,5299001,6331288,1032287,True,63,scaffold_9
0,1,232000,231999,True,63,scaffold_10
1,276001,405000,128999,False,63,scaffold_10
2,422001,482000,59999,False,63,scaffold_10
3,483001,576000,92999,False,63,scaffold_10
4,603001,754000,150999,False,63,scaffold_10
5,888001,921000,32999,False,63,scaffold_10
6,923001,962000,38999,False,63,scaffold_10
7,1073001,1112000,38999,False,63,scaffold_10
8,2089001,2103000,13999,False,63,scaffold_10
9,2140001,2170000,29999,False,63,scaffold_10
10,2346001,2396000,49999,False,63,scaffold_10
11,2701001,2708000,6999,False,63,scaffold_10
12,2714001,2733000,18999,False,63,scaffold_10
13,2735001,2745000,9999,False,63,scaffold_10
14,4054001,4092000,37999,False,63,scaffold_10
15,4154001,4174000,19999,False,63,scaffold_10
16,4443001,4462000,18999,False,63,scaffold_10
17,4467001,4476000,8999,False,63,scaffold_10
18,4506001,4513000,6999,False,63,scaffold_10
19,4515001,4523000,7999,False,63,scaffold_10
20,4526001,4548000,21999,False,63,scaffold_10
21,4575001,4596000,20999,False,63,scaffold_10
22,4679001,4688000,8999,False,63,scaffold_10
23,4716001,4720000,3999,False,63,scaffold_10
24,4727001,4732000,4999,False,63,scaffold_10
25,4734001,4766000,31999,False,63,scaffold_10
26,4769001,4776000,6999,False,63,scaffold_10
27,4798001,4824000,25999,False,63,scaffold_10
28,4827001,4843000,15999,False,63,scaffold_10
29,4848001,4861000,12999,False,63,scaffold_10
30,4865001,4866973,1972,True,63,scaffold_10
0,14001,34000,19999,False,63,scaffold_11
1,40001,93000,52999,False,63,scaffold_11
2,149001,167000,17999,False,63,scaffold_11
3,169001,191000,21999,False,63,scaffold_11
4,213001,235000,21999,False,63,scaffold_11
5,240001,248000,7999,False,63,scaffold_11
6,419001,431000,11999,False,63,scaffold_11
7,648001,656000,7999,False,63,scaffold_11
8,1423001,1426000,2999,False,63,scaffold_11
9,1474001,1477000,2999,False,63,scaffold_11
10,2701001,2876000,174999,False,63,scaffold_11
11,2983001,3011000,27999,False,63,scaffold_11
12,3095001,3130000,34999,False,63,scaffold_11
13,3188001,3288000,99999,False,63,scaffold_11
14,3331001,3383000,51999,False,63,scaffold_11
15,3434001,3477000,42999,False,63,scaffold_11
16,3521001,3597000,75999,False,63,scaffold_11
17,3702001,3933000,230999,False,63,scaffold_11
18,4005001,4156000,150999,False,63,scaffold_11
19,4189001,4211000,21999,False,63,scaffold_11
20,4259001,4710000,450999,False,63,scaffold_11
21,4713001,4766820,53819,True,63,scaffold_11
0,1,549000,548999,True,63,scaffold_12
1,579001,856000,276999,False,63,scaffold_12
2,865001,1450000,584999,False,63,scaffold_12
3,1719001,1733000,13999,False,63,scaffold_12
4,2044001,2087000,42999,False,63,scaffold_12
5,2088001,2103000,14999,False,63,scaffold_12
6,2137001,2166000,28999,False,63,scaffold_12
7,2571001,2610000,38999,False,63,scaffold_12
0,1,438000,437999,True,64,scaffold_1
1,482001,498000,15999,False,64,scaffold_1
2,570001,643000,72999,False,64,scaffold_1
3,686001,743000,56999,False,64,scaffold_1
4,1279001,1292000,12999,False,64,scaffold_1
5,1617001,1659000,41999,False,64,scaffold_1
6,1817001,1901000,83999,False,64,scaffold_1
7,1951001,1964000,12999,False,64,scaffold_1
8,1965001,1984000,18999,False,64,scaffold_1
9,1987001,2017000,29999,False,64,scaffold_1
10,2363001,2407000,43999,False,64,scaffold_1
11,2449001,2519000,69999,False,64,scaffold_1
12,2564001,2582000,17999,False,64,scaffold_1
13,2725001,2746000,20999,False,64,scaffold_1
14,3175001,3208000,32999,False,64,scaffold_1
15,3444001,3495000,50999,False,64,scaffold_1
16,3704001,3757000,52999,False,64,scaffold_1
17,3802001,3941000,138999,False,64,scaffold_1
18,3951001,4032000,80999,False,64,scaffold_1
19,4061001,4148000,86999,False,64,scaffold_1
20,4314001,4354000,39999,False,64,scaffold_1
21,4709001,4741000,31999,False,64,scaffold_1
22,4796001,4810000,13999,False,64,scaffold_1
23,4923001,5022000,98999,False,64,scaffold_1
24,5087001,5111000,23999,False,64,scaffold_1
25,5481001,5512000,30999,False,64,scaffold_1
26,5535001,5570000,34999,False,64,scaffold_1
27,5856001,5875000,18999,False,64,scaffold_1
28,6108001,6153000,44999,False,64,scaffold_1
29,6154001,6185000,30999,False,64,scaffold_1
30,6201001,6382000,180999,False,64,scaffold_1
31,6384001,6574000,189999,False,64,scaffold_1
32,6638001,6658000,19999,False,64,scaffold_1
33,7038001,7247000,208999,False,64,scaffold_1
34,7248001,7588000,339999,False,64,scaffold_1
35,7590001,8656000,1065999,False,64,scaffold_1
36,8658001,9584000,925999,False,64,scaffold_1
37,9586001,10356000,769999,False,64,scaffold_1
38,10460001,10638000,177999,False,64,scaffold_1
39,10667001,10678000,10999,False,64,scaffold_1
40,10739001,10763000,23999,False,64,scaffold_1
41,10833001,10857000,23999,False,64,scaffold_1
42,10920001,10940000,19999,False,64,scaffold_1
43,11015001,11037000,21999,False,64,scaffold_1
44,11276001,11506000,229999,False,64,scaffold_1
45,11557001,11963000,405999,False,64,scaffold_1
46,12182001,12206000,23999,False,64,scaffold_1
47,12651001,12930000,278999,False,64,scaffold_1
48,12966001,13001000,34999,False,64,scaffold_1
49,13099001,13216000,116999,False,64,scaffold_1
50,13346001,13447000,100999,False,64,scaffold_1
51,13958001,13966000,7999,False,64,scaffold_1
52,14285001,14307000,21999,False,64,scaffold_1
53,14471001,14479000,7999,False,64,scaffold_1
54,14648001,14663000,14999,False,64,scaffold_1
0,20001,48000,27999,False,64,scaffold_2
1,95001,159000,63999,False,64,scaffold_2
2,168001,176000,7999,False,64,scaffold_2
3,302001,318000,15999,False,64,scaffold_2
4,332001,374000,41999,False,64,scaffold_2
5,731001,739000,7999,False,64,scaffold_2
6,1525001,1556000,30999,False,64,scaffold_2
7,2086001,2102000,15999,False,64,scaffold_2
8,2302001,2334000,31999,False,64,scaffold_2
9,2336001,2636000,299999,False,64,scaffold_2
10,2645001,2689000,43999,False,64,scaffold_2
11,2694001,2748000,53999,False,64,scaffold_2
12,2766001,2776000,9999,False,64,scaffold_2
13,2777001,2788000,10999,False,64,scaffold_2
14,2796001,2855000,58999,False,64,scaffold_2
15,2879001,2904000,24999,False,64,scaffold_2
16,2993001,3012000,18999,False,64,scaffold_2
17,3022001,3046000,23999,False,64,scaffold_2
18,3335001,3342000,6999,False,64,scaffold_2
19,3360001,3388000,27999,False,64,scaffold_2
20,3450001,3477000,26999,False,64,scaffold_2
21,3530001,3548000,17999,False,64,scaffold_2
22,3755001,3783000,27999,False,64,scaffold_2
23,4243001,4322000,78999,False,64,scaffold_2
24,4334001,4409000,74999,False,64,scaffold_2
25,4426001,4458000,31999,False,64,scaffold_2
26,4514001,4790000,275999,False,64,scaffold_2
27,4793001,4808000,14999,False,64,scaffold_2
28,4908001,4959000,50999,False,64,scaffold_2
29,5013001,5031000,17999,False,64,scaffold_2
30,5033001,5104000,70999,False,64,scaffold_2
31,5256001,5314000,57999,False,64,scaffold_2
32,5369001,5564000,194999,False,64,scaffold_2
33,5609001,5761000,151999,False,64,scaffold_2
34,5840001,5891000,50999,False,64,scaffold_2
35,5910001,5989000,78999,False,64,scaffold_2
36,6029001,6053000,23999,False,64,scaffold_2
37,6125001,6136000,10999,False,64,scaffold_2
38,6244001,6351000,106999,False,64,scaffold_2
39,6370001,6449000,78999,False,64,scaffold_2
40,6592001,6628000,35999,False,64,scaffold_2
41,7001001,7038000,36999,False,64,scaffold_2
42,7049001,7097000,47999,False,64,scaffold_2
43,7110001,7120000,9999,False,64,scaffold_2
44,7331001,7473000,141999,False,64,scaffold_2
45,7491001,7518000,26999,False,64,scaffold_2
46,7549001,7561000,11999,False,64,scaffold_2
47,7563001,7916000,352999,False,64,scaffold_2
48,7934001,8168000,233999,False,64,scaffold_2
49,8260001,8320000,59999,False,64,scaffold_2
50,8331001,8333000,1999,False,64,scaffold_2
51,8334001,8344000,9999,False,64,scaffold_2
52,8346001,8453000,106999,False,64,scaffold_2
53,8495001,8564000,68999,False,64,scaffold_2
54,9154001,9174000,19999,False,64,scaffold_2
55,9243001,9382000,138999,False,64,scaffold_2
56,9431001,9457000,25999,False,64,scaffold_2
57,9599001,9622000,22999,False,64,scaffold_2
58,9869001,9896000,26999,False,64,scaffold_2
59,11367001,11381000,13999,False,64,scaffold_2
60,11469001,11502000,32999,False,64,scaffold_2
61,11520001,11789000,268999,False,64,scaffold_2
0,1,2000,1999,True,64,scaffold_3
1,3001,6000,2999,False,64,scaffold_3
2,51001,55000,3999,False,64,scaffold_3
3,618001,646000,27999,False,64,scaffold_3
4,798001,901000,102999,False,64,scaffold_3
5,2010001,2126000,115999,False,64,scaffold_3
6,2291001,2336000,44999,False,64,scaffold_3
7,2444001,2533000,88999,False,64,scaffold_3
8,2656001,2740000,83999,False,64,scaffold_3
9,3109001,3161000,51999,False,64,scaffold_3
10,3261001,3278000,16999,False,64,scaffold_3
11,3606001,3643000,36999,False,64,scaffold_3
12,3713001,3821000,107999,False,64,scaffold_3
13,3822001,3891000,68999,False,64,scaffold_3
14,3999001,4404000,404999,False,64,scaffold_3
15,4410001,4518000,107999,False,64,scaffold_3
16,4546001,4558000,11999,False,64,scaffold_3
17,4567001,4578000,10999,False,64,scaffold_3
18,4582001,4599000,16999,False,64,scaffold_3
19,4654001,4678000,23999,False,64,scaffold_3
20,5164001,5196000,31999,False,64,scaffold_3
21,5382001,5440000,57999,False,64,scaffold_3
22,5493001,5501000,7999,False,64,scaffold_3
23,5849001,5947000,97999,False,64,scaffold_3
24,5973001,6029000,55999,False,64,scaffold_3
25,6742001,6807000,64999,False,64,scaffold_3
26,6892001,7157000,264999,False,64,scaffold_3
27,7255001,7303000,47999,False,64,scaffold_3
28,7334001,7411000,76999,False,64,scaffold_3
29,7482001,7557000,74999,False,64,scaffold_3
30,7577001,7612000,34999,False,64,scaffold_3
31,7683001,7856000,172999,False,64,scaffold_3
32,7910001,7927000,16999,False,64,scaffold_3
33,8046001,8111000,64999,False,64,scaffold_3
34,8175001,8283000,107999,False,64,scaffold_3
35,8399001,8449000,49999,False,64,scaffold_3
36,8462001,8527000,64999,False,64,scaffold_3
37,8575001,8594000,18999,False,64,scaffold_3
38,8994001,9075000,80999,False,64,scaffold_3
39,9968001,9999000,30999,False,64,scaffold_3
40,10461001,10485000,23999,False,64,scaffold_3
41,10551001,10571000,19999,False,64,scaffold_3
42,10574001,11167000,592999,False,64,scaffold_3
0,17001,29000,11999,False,64,scaffold_4
1,30001,32000,1999,False,64,scaffold_4
2,48001,88000,39999,False,64,scaffold_4
3,155001,215000,59999,False,64,scaffold_4
4,217001,226000,8999,False,64,scaffold_4
5,227001,266000,38999,False,64,scaffold_4
6,355001,374000,18999,False,64,scaffold_4
7,375001,380000,4999,False,64,scaffold_4
8,393001,410000,16999,False,64,scaffold_4
9,411001,425000,13999,False,64,scaffold_4
10,429001,504000,74999,False,64,scaffold_4
11,540001,599000,58999,False,64,scaffold_4
12,600001,606000,5999,False,64,scaffold_4
13,608001,660000,51999,False,64,scaffold_4
14,670001,691000,20999,False,64,scaffold_4
15,695001,697000,1999,False,64,scaffold_4
16,701001,714000,12999,False,64,scaffold_4
17,1121001,1136000,14999,False,64,scaffold_4
18,1137001,1208000,70999,False,64,scaffold_4
19,1210001,1226000,15999,False,64,scaffold_4
20,1268001,1279000,10999,False,64,scaffold_4
21,1283001,1336000,52999,False,64,scaffold_4
22,1356001,1598000,241999,False,64,scaffold_4
23,1613001,2006000,392999,False,64,scaffold_4
24,2007001,2114000,106999,False,64,scaffold_4
25,2142001,2185000,42999,False,64,scaffold_4
26,2220001,2279000,58999,False,64,scaffold_4
27,2282001,2340000,57999,False,64,scaffold_4
28,2342001,2471000,128999,False,64,scaffold_4
29,2476001,2635000,158999,False,64,scaffold_4
30,2676001,2799000,122999,False,64,scaffold_4
31,2893001,2971000,77999,False,64,scaffold_4
32,3087001,3127000,39999,False,64,scaffold_4
33,3191001,3317000,125999,False,64,scaffold_4
34,3334001,3766000,431999,False,64,scaffold_4
35,4055001,4088000,32999,False,64,scaffold_4
36,4868001,4889000,20999,False,64,scaffold_4
37,4900001,5048000,147999,False,64,scaffold_4
38,5169001,5224000,54999,False,64,scaffold_4
39,5289001,5409000,119999,False,64,scaffold_4
40,5475001,5506000,30999,False,64,scaffold_4
41,5514001,5784000,269999,False,64,scaffold_4
42,5786001,5825000,38999,False,64,scaffold_4
43,5926001,5966000,39999,False,64,scaffold_4
44,6145001,6197000,51999,False,64,scaffold_4
45,6331001,6382000,50999,False,64,scaffold_4
46,6765001,6817000,51999,False,64,scaffold_4
47,6900001,6924000,23999,False,64,scaffold_4
48,6950001,6995000,44999,False,64,scaffold_4
49,7036001,7123000,86999,False,64,scaffold_4
50,7148001,7176000,27999,False,64,scaffold_4
51,7209001,7325000,115999,False,64,scaffold_4
52,7352001,7380000,27999,False,64,scaffold_4
53,7628001,7667000,38999,False,64,scaffold_4
54,7864001,7881000,16999,False,64,scaffold_4
55,8049001,8072000,22999,False,64,scaffold_4
56,8843001,9699000,855999,False,64,scaffold_4
57,9700001,9845951,145950,True,64,scaffold_4
0,1,4000,3999,True,64,scaffold_5
1,150001,175000,24999,False,64,scaffold_5
2,317001,326000,8999,False,64,scaffold_5
3,327001,413000,85999,False,64,scaffold_5
4,462001,524000,61999,False,64,scaffold_5
5,931001,947000,15999,False,64,scaffold_5
6,2255001,2283000,27999,False,64,scaffold_5
7,2475001,2493000,17999,False,64,scaffold_5
8,2516001,2527000,10999,False,64,scaffold_5
9,2552001,2896000,343999,False,64,scaffold_5
10,3091001,3519000,427999,False,64,scaffold_5
11,3616001,3659000,42999,False,64,scaffold_5
12,3962001,4101000,138999,False,64,scaffold_5
13,4116001,4363000,246999,False,64,scaffold_5
14,4445001,4551000,105999,False,64,scaffold_5
15,4600001,4862000,261999,False,64,scaffold_5
16,4883001,4920000,36999,False,64,scaffold_5
17,4955001,4990000,34999,False,64,scaffold_5
18,5217001,5275000,57999,False,64,scaffold_5
19,5286001,5346000,59999,False,64,scaffold_5
20,6407001,6437000,29999,False,64,scaffold_5
21,6457001,6672000,214999,False,64,scaffold_5
22,6887001,6906000,18999,False,64,scaffold_5
23,7059001,7095000,35999,False,64,scaffold_5
24,7097001,7100000,2999,False,64,scaffold_5
25,7170001,7185000,14999,False,64,scaffold_5
26,7454001,7513000,58999,False,64,scaffold_5
27,7546001,7619000,72999,False,64,scaffold_5
28,7621001,7747000,125999,False,64,scaffold_5
29,8258001,8280000,21999,False,64,scaffold_5
30,8571001,8616000,44999,False,64,scaffold_5
31,8659001,8687000,27999,False,64,scaffold_5
32,8702001,9363000,660999,False,64,scaffold_5
33,9364001,9364176,175,True,64,scaffold_5
0,65001,75000,9999,False,64,scaffold_6
1,79001,84000,4999,False,64,scaffold_6
2,86001,114000,27999,False,64,scaffold_6
3,164001,209000,44999,False,64,scaffold_6
4,240001,254000,13999,False,64,scaffold_6
5,267001,287000,19999,False,64,scaffold_6
6,1147001,1197000,49999,False,64,scaffold_6
7,1231001,1265000,33999,False,64,scaffold_6
8,1427001,1546000,118999,False,64,scaffold_6
9,1658001,1716000,57999,False,64,scaffold_6
10,1826001,1901000,74999,False,64,scaffold_6
11,2025001,2091000,65999,False,64,scaffold_6
12,2127001,2211000,83999,False,64,scaffold_6
13,2239001,2284000,44999,False,64,scaffold_6
14,2334001,2595000,260999,False,64,scaffold_6
15,2596001,2868000,271999,False,64,scaffold_6
16,2927001,3023000,95999,False,64,scaffold_6
17,3064001,3208000,143999,False,64,scaffold_6
18,3223001,3301000,77999,False,64,scaffold_6
19,3380001,3806000,425999,False,64,scaffold_6
20,3897001,3913000,15999,False,64,scaffold_6
21,3966001,4193000,226999,False,64,scaffold_6
22,4839001,4871000,31999,False,64,scaffold_6
23,4954001,4993000,38999,False,64,scaffold_6
24,5929001,5972000,42999,False,64,scaffold_6
25,6004001,6083000,78999,False,64,scaffold_6
26,6141001,6186000,44999,False,64,scaffold_6
27,6836001,6855000,18999,False,64,scaffold_6
28,7256001,7339000,82999,False,64,scaffold_6
29,7389001,7436000,46999,False,64,scaffold_6
30,7543001,8268281,725280,True,64,scaffold_6
0,1,8000,7999,True,64,scaffold_7
1,13001,34000,20999,False,64,scaffold_7
2,323001,341000,17999,False,64,scaffold_7
3,342001,505000,162999,False,64,scaffold_7
4,571001,577000,5999,False,64,scaffold_7
5,622001,642000,19999,False,64,scaffold_7
6,646001,674000,27999,False,64,scaffold_7
7,706001,736000,29999,False,64,scaffold_7
8,743001,753000,9999,False,64,scaffold_7
9,764001,803000,38999,False,64,scaffold_7
10,859001,864000,4999,False,64,scaffold_7
11,868001,872000,3999,False,64,scaffold_7
12,875001,945000,69999,False,64,scaffold_7
13,964001,966000,1999,False,64,scaffold_7
14,968001,981000,12999,False,64,scaffold_7
15,982001,1044000,61999,False,64,scaffold_7
16,1048001,1099000,50999,False,64,scaffold_7
17,1172001,1187000,14999,False,64,scaffold_7
18,1191001,1512000,320999,False,64,scaffold_7
19,1588001,1693000,104999,False,64,scaffold_7
20,3297001,3313000,15999,False,64,scaffold_7
21,3325001,3370000,44999,False,64,scaffold_7
22,3521001,3790000,268999,False,64,scaffold_7
23,4321001,4369000,47999,False,64,scaffold_7
24,4413001,4515000,101999,False,64,scaffold_7
25,4547001,4580000,32999,False,64,scaffold_7
26,4635001,4838000,202999,False,64,scaffold_7
27,4978001,5149000,170999,False,64,scaffold_7
28,5470001,5536000,65999,False,64,scaffold_7
29,6754001,6794000,39999,False,64,scaffold_7
30,6946001,7270000,323999,False,64,scaffold_7
31,7271001,7502216,231215,True,64,scaffold_7
0,66001,85000,18999,False,64,scaffold_8
1,1858001,1883000,24999,False,64,scaffold_8
2,2090001,2153000,62999,False,64,scaffold_8
3,2336001,2529000,192999,False,64,scaffold_8
4,2536001,2553000,16999,False,64,scaffold_8
5,2648001,2683000,34999,False,64,scaffold_8
6,2684001,2844000,159999,False,64,scaffold_8
7,2847001,2892000,44999,False,64,scaffold_8
8,3033001,3125000,91999,False,64,scaffold_8
9,3126001,3553000,426999,False,64,scaffold_8
10,3577001,3614000,36999,False,64,scaffold_8
11,3615001,4108000,492999,False,64,scaffold_8
12,4173001,4221000,47999,False,64,scaffold_8
13,4394001,4432000,37999,False,64,scaffold_8
14,4897001,4915000,17999,False,64,scaffold_8
15,5067001,5241000,173999,False,64,scaffold_8
16,5579001,5595000,15999,False,64,scaffold_8
17,5651001,5695000,43999,False,64,scaffold_8
18,6323001,6334544,11543,True,64,scaffold_8
0,109001,118000,8999,False,64,scaffold_9
1,121001,140000,18999,False,64,scaffold_9
2,319001,332000,12999,False,64,scaffold_9
3,366001,411000,44999,False,64,scaffold_9
4,413001,434000,20999,False,64,scaffold_9
5,484001,531000,46999,False,64,scaffold_9
6,652001,665000,12999,False,64,scaffold_9
7,670001,697000,26999,False,64,scaffold_9
8,732001,742000,9999,False,64,scaffold_9
9,815001,841000,25999,False,64,scaffold_9
10,886001,986000,99999,False,64,scaffold_9
11,987001,995000,7999,False,64,scaffold_9
12,1001001,1007000,5999,False,64,scaffold_9
13,1010001,1085000,74999,False,64,scaffold_9
14,1087001,1177000,89999,False,64,scaffold_9
15,1313001,1381000,67999,False,64,scaffold_9
16,1546001,1586000,39999,False,64,scaffold_9
17,1762001,1791000,28999,False,64,scaffold_9
18,1987001,2036000,48999,False,64,scaffold_9
19,2038001,2063000,24999,False,64,scaffold_9
20,2076001,2135000,58999,False,64,scaffold_9
21,2137001,2171000,33999,False,64,scaffold_9
22,2176001,2227000,50999,False,64,scaffold_9
23,2600001,2664000,63999,False,64,scaffold_9
24,2737001,2824000,86999,False,64,scaffold_9
25,2844001,3381000,536999,False,64,scaffold_9
26,3383001,5100000,1716999,False,64,scaffold_9
27,5101001,5107000,5999,False,64,scaffold_9
28,5112001,5115000,2999,False,64,scaffold_9
29,5116001,5298000,181999,False,64,scaffold_9
30,5300001,5490000,189999,False,64,scaffold_9
31,5493001,6331288,838287,True,64,scaffold_9
0,1,414000,413999,True,64,scaffold_10
1,415001,482000,66999,False,64,scaffold_10
2,483001,576000,92999,False,64,scaffold_10
3,603001,877000,273999,False,64,scaffold_10
4,888001,1069000,180999,False,64,scaffold_10
5,1073001,1148000,74999,False,64,scaffold_10
6,1306001,1336000,29999,False,64,scaffold_10
7,2140001,2173000,32999,False,64,scaffold_10
8,2274001,2297000,22999,False,64,scaffold_10
9,2346001,2396000,49999,False,64,scaffold_10
10,2672001,2694000,21999,False,64,scaffold_10
11,2702001,2708000,5999,False,64,scaffold_10
12,2735001,2748000,12999,False,64,scaffold_10
13,4002001,4010000,7999,False,64,scaffold_10
14,4052001,4086000,33999,False,64,scaffold_10
15,4154001,4174000,19999,False,64,scaffold_10
16,4335001,4364000,28999,False,64,scaffold_10
17,4443001,4462000,18999,False,64,scaffold_10
18,4467001,4477000,9999,False,64,scaffold_10
19,4478001,4491000,12999,False,64,scaffold_10
20,4493001,4502000,8999,False,64,scaffold_10
21,4503001,4513000,9999,False,64,scaffold_10
22,4515001,4523000,7999,False,64,scaffold_10
23,4526001,4548000,21999,False,64,scaffold_10
24,4565001,4596000,30999,False,64,scaffold_10
25,4679001,4688000,8999,False,64,scaffold_10
26,4734001,4776000,41999,False,64,scaffold_10
27,4791001,4824000,32999,False,64,scaffold_10
28,4828001,4843000,14999,False,64,scaffold_10
29,4848001,4861000,12999,False,64,scaffold_10
30,4865001,4866973,1972,True,64,scaffold_10
0,9001,90000,80999,False,64,scaffold_11
1,132001,167000,34999,False,64,scaffold_11
2,169001,192000,22999,False,64,scaffold_11
3,213001,235000,21999,False,64,scaffold_11
4,240001,248000,7999,False,64,scaffold_11
5,296001,313000,16999,False,64,scaffold_11
6,419001,431000,11999,False,64,scaffold_11
7,637001,656000,18999,False,64,scaffold_11
8,781001,785000,3999,False,64,scaffold_11
9,1025001,1034000,8999,False,64,scaffold_11
10,1423001,1427000,3999,False,64,scaffold_11
11,1474001,1477000,2999,False,64,scaffold_11
12,1721001,1736000,14999,False,64,scaffold_11
13,2701001,2873000,171999,False,64,scaffold_11
14,2953001,3019000,65999,False,64,scaffold_11
15,3090001,3175000,84999,False,64,scaffold_11
16,3186001,3297000,110999,False,64,scaffold_11
17,3299001,3383000,83999,False,64,scaffold_11
18,3449001,3479000,29999,False,64,scaffold_11
19,3520001,3654000,133999,False,64,scaffold_11
20,3702001,3928000,225999,False,64,scaffold_11
21,4004001,4159000,154999,False,64,scaffold_11
22,4189001,4710000,520999,False,64,scaffold_11
23,4713001,4766820,53819,True,64,scaffold_11
0,1,1494000,1493999,True,64,scaffold_12
1,1719001,1741000,21999,False,64,scaffold_12
2,2044001,2087000,42999,False,64,scaffold_12
3,2088001,2103000,14999,False,64,scaffold_12
4,2340001,2380000,39999,False,64,scaffold_12
5,2571001,2610000,38999,False,64,scaffold_12
0,1,342000,341999,True,65,scaffold_1
1,482001,498000,15999,False,65,scaffold_1
2,572001,643000,70999,False,65,scaffold_1
3,686001,748000,61999,False,65,scaffold_1
4,1279001,1294000,14999,False,65,scaffold_1
5,1615001,1660000,44999,False,65,scaffold_1
6,1813001,1898000,84999,False,65,scaffold_1
7,1951001,1984000,32999,False,65,scaffold_1
8,2449001,2517000,67999,False,65,scaffold_1
9,2729001,2746000,16999,False,65,scaffold_1
10,3173001,3209000,35999,False,65,scaffold_1
11,3710001,3740000,29999,False,65,scaffold_1
12,3915001,3941000,25999,False,65,scaffold_1
13,4003001,4029000,25999,False,65,scaffold_1
14,4061001,4112000,50999,False,65,scaffold_1
15,4311001,4355000,43999,False,65,scaffold_1
16,4796001,4812000,15999,False,65,scaffold_1
17,4928001,4997000,68999,False,65,scaffold_1
18,5096001,5104000,7999,False,65,scaffold_1
19,5481001,5511000,29999,False,65,scaffold_1
20,5535001,5573000,37999,False,65,scaffold_1
21,6108001,6153000,44999,False,65,scaffold_1
22,6154001,6185000,30999,False,65,scaffold_1
23,6202001,6380000,177999,False,65,scaffold_1
24,6384001,6507000,122999,False,65,scaffold_1
25,6543001,6557000,13999,False,65,scaffold_1
26,7038001,7247000,208999,False,65,scaffold_1
27,7248001,7584000,335999,False,65,scaffold_1
28,7590001,8656000,1065999,False,65,scaffold_1
29,8658001,9584000,925999,False,65,scaffold_1
30,9586001,10356000,769999,False,65,scaffold_1
31,10460001,10638000,177999,False,65,scaffold_1
32,10808001,10811000,2999,False,65,scaffold_1
33,10832001,10857000,24999,False,65,scaffold_1
34,11276001,11510000,233999,False,65,scaffold_1
35,11609001,11957000,347999,False,65,scaffold_1
36,12184001,12205000,20999,False,65,scaffold_1
37,12653001,12723000,69999,False,65,scaffold_1
38,12775001,12888000,112999,False,65,scaffold_1
39,12968001,13002000,33999,False,65,scaffold_1
40,13099001,13212000,112999,False,65,scaffold_1
41,13346001,13421000,74999,False,65,scaffold_1
42,13564001,13582000,17999,False,65,scaffold_1
43,14285001,14309000,23999,False,65,scaffold_1
0,22001,48000,25999,False,65,scaffold_2
1,95001,159000,63999,False,65,scaffold_2
2,165001,177000,11999,False,65,scaffold_2
3,296001,318000,21999,False,65,scaffold_2
4,332001,374000,41999,False,65,scaffold_2
5,2336001,2358000,21999,False,65,scaffold_2
6,2399001,2424000,24999,False,65,scaffold_2
7,2441001,2553000,111999,False,65,scaffold_2
8,2626001,2639000,12999,False,65,scaffold_2
9,2660001,2689000,28999,False,65,scaffold_2
10,2693001,2746000,52999,False,65,scaffold_2
11,2766001,2788000,21999,False,65,scaffold_2
12,2840001,2854000,13999,False,65,scaffold_2
13,2868001,2910000,41999,False,65,scaffold_2
14,2990001,3013000,22999,False,65,scaffold_2
15,3362001,3389000,26999,False,65,scaffold_2
16,3450001,3486000,35999,False,65,scaffold_2
17,3659001,3692000,32999,False,65,scaffold_2
18,3754001,3783000,28999,False,65,scaffold_2
19,4243001,4276000,32999,False,65,scaffold_2
20,4385001,4409000,23999,False,65,scaffold_2
21,4426001,4458000,31999,False,65,scaffold_2
22,4520001,4658000,137999,False,65,scaffold_2
23,4918001,4949000,30999,False,65,scaffold_2
24,5021001,5065000,43999,False,65,scaffold_2
25,5456001,5519000,62999,False,65,scaffold_2
26,5658001,5756000,97999,False,65,scaffold_2
27,5840001,5887000,46999,False,65,scaffold_2
28,5915001,5958000,42999,False,65,scaffold_2
29,6249001,6330000,80999,False,65,scaffold_2
30,6331001,6351000,19999,False,65,scaffold_2
31,6410001,6449000,38999,False,65,scaffold_2
32,6593001,6628000,34999,False,65,scaffold_2
33,7006001,7037000,30999,False,65,scaffold_2
34,7063001,7097000,33999,False,65,scaffold_2
35,7439001,7473000,33999,False,65,scaffold_2
36,7495001,7498000,2999,False,65,scaffold_2
37,7549001,7561000,11999,False,65,scaffold_2
38,7563001,7699000,135999,False,65,scaffold_2
39,7786001,7897000,110999,False,65,scaffold_2
40,7934001,8163000,228999,False,65,scaffold_2
41,8260001,8297000,36999,False,65,scaffold_2
42,8340001,8345000,4999,False,65,scaffold_2
43,8346001,8453000,106999,False,65,scaffold_2
44,8507001,8562000,54999,False,65,scaffold_2
45,9140001,9169000,28999,False,65,scaffold_2
46,9348001,9382000,33999,False,65,scaffold_2
47,9602001,9635000,32999,False,65,scaffold_2
48,10710001,10730000,19999,False,65,scaffold_2
49,11366001,11374000,7999,False,65,scaffold_2
50,11520001,11786000,265999,False,65,scaffold_2
51,11797001,11802476,5475,True,65,scaffold_2
0,10001,18000,7999,False,65,scaffold_3
1,618001,646000,27999,False,65,scaffold_3
2,796001,901000,104999,False,65,scaffold_3
3,2015001,2108000,92999,False,65,scaffold_3
4,2109001,2116000,6999,False,65,scaffold_3
5,2291001,2340000,48999,False,65,scaffold_3
6,2486001,2533000,46999,False,65,scaffold_3
7,2717001,2731000,13999,False,65,scaffold_3
8,3768001,3891000,122999,False,65,scaffold_3
9,4105001,4403000,297999,False,65,scaffold_3
10,4415001,4518000,102999,False,65,scaffold_3
11,4547001,4558000,10999,False,65,scaffold_3
12,4637001,4686000,48999,False,65,scaffold_3
13,5239001,5271000,31999,False,65,scaffold_3
14,5882001,5908000,25999,False,65,scaffold_3
15,5974001,6020000,45999,False,65,scaffold_3
16,6909001,6962000,52999,False,65,scaffold_3
17,6963001,7089000,125999,False,65,scaffold_3
18,7280001,7300000,19999,False,65,scaffold_3
19,7449001,7460000,10999,False,65,scaffold_3
20,7519001,7556000,36999,False,65,scaffold_3
21,7676001,7841000,164999,False,65,scaffold_3
22,8121001,8154000,32999,False,65,scaffold_3
23,8175001,8247000,71999,False,65,scaffold_3
24,8428001,8447000,18999,False,65,scaffold_3
25,8462001,8527000,64999,False,65,scaffold_3
26,8575001,8594000,18999,False,65,scaffold_3
27,9967001,9996000,28999,False,65,scaffold_3
28,10587001,11182071,595070,True,65,scaffold_3
0,48001,89000,40999,False,65,scaffold_4
1,101001,115000,13999,False,65,scaffold_4
2,147001,151000,3999,False,65,scaffold_4
3,155001,160000,4999,False,65,scaffold_4
4,161001,197000,35999,False,65,scaffold_4
5,200001,215000,14999,False,65,scaffold_4
6,217001,226000,8999,False,65,scaffold_4
7,227001,241000,13999,False,65,scaffold_4
8,242001,266000,23999,False,65,scaffold_4
9,292001,353000,60999,False,65,scaffold_4
10,355001,374000,18999,False,65,scaffold_4
11,375001,380000,4999,False,65,scaffold_4
12,383001,410000,26999,False,65,scaffold_4
13,412001,425000,12999,False,65,scaffold_4
14,429001,530000,100999,False,65,scaffold_4
15,541001,606000,64999,False,65,scaffold_4
16,608001,661000,52999,False,65,scaffold_4
17,672001,691000,18999,False,65,scaffold_4
18,695001,697000,1999,False,65,scaffold_4
19,700001,716000,15999,False,65,scaffold_4
20,1043001,1047000,3999,False,65,scaffold_4
21,1113001,1136000,22999,False,65,scaffold_4
22,1138001,1198000,59999,False,65,scaffold_4
23,1199001,1226000,26999,False,65,scaffold_4
24,1236001,1253000,16999,False,65,scaffold_4
25,1254001,1261000,6999,False,65,scaffold_4
26,1265001,1279000,13999,False,65,scaffold_4
27,1283001,1337000,53999,False,65,scaffold_4
28,1355001,1598000,242999,False,65,scaffold_4
29,1613001,2114000,500999,False,65,scaffold_4
30,2210001,2218000,7999,False,65,scaffold_4
31,2219001,2461000,241999,False,65,scaffold_4
32,2477001,2635000,157999,False,65,scaffold_4
33,2736001,2794000,57999,False,65,scaffold_4
34,3335001,3634000,298999,False,65,scaffold_4
35,3645001,3766000,120999,False,65,scaffold_4
36,4057001,4071000,13999,False,65,scaffold_4
37,4908001,4985000,76999,False,65,scaffold_4
38,5168001,5243000,74999,False,65,scaffold_4
39,5477001,5506000,28999,False,65,scaffold_4
40,5514001,5620000,105999,False,65,scaffold_4
41,5655001,5784000,128999,False,65,scaffold_4
42,5786001,5817000,30999,False,65,scaffold_4
43,6145001,6195000,49999,False,65,scaffold_4
44,6902001,6924000,21999,False,65,scaffold_4
45,6970001,6995000,24999,False,65,scaffold_4
46,7036001,7096000,59999,False,65,scaffold_4
47,7209001,7304000,94999,False,65,scaffold_4
48,7629001,7665000,35999,False,65,scaffold_4
49,8844001,9699000,854999,False,65,scaffold_4
50,9700001,9845951,145950,True,65,scaffold_4
0,1,4000,3999,True,65,scaffold_5
1,28001,31000,2999,False,65,scaffold_5
2,189001,207000,17999,False,65,scaffold_5
3,318001,386000,67999,False,65,scaffold_5
4,463001,525000,61999,False,65,scaffold_5
5,669001,697000,27999,False,65,scaffold_5
6,932001,947000,14999,False,65,scaffold_5
7,2552001,2592000,39999,False,65,scaffold_5
8,2613001,2738000,124999,False,65,scaffold_5
9,2812001,2873000,60999,False,65,scaffold_5
10,3135001,3249000,113999,False,65,scaffold_5
11,3300001,3509000,208999,False,65,scaffold_5
12,3622001,3642000,19999,False,65,scaffold_5
13,3962001,4101000,138999,False,65,scaffold_5
14,4121001,4222000,100999,False,65,scaffold_5
15,4232001,4272000,39999,False,65,scaffold_5
16,4443001,4506000,62999,False,65,scaffold_5
17,4600001,4663000,62999,False,65,scaffold_5
18,4691001,4751000,59999,False,65,scaffold_5
19,4759001,4924000,164999,False,65,scaffold_5
20,5250001,5273000,22999,False,65,scaffold_5
21,5286001,5312000,25999,False,65,scaffold_5
22,5314001,5345000,30999,False,65,scaffold_5
23,6393001,6420000,26999,False,65,scaffold_5
24,6456001,6666000,209999,False,65,scaffold_5
25,6880001,6906000,25999,False,65,scaffold_5
26,7454001,7484000,29999,False,65,scaffold_5
27,7552001,7619000,66999,False,65,scaffold_5
28,7622001,7653000,30999,False,65,scaffold_5
29,8417001,8463000,45999,False,65,scaffold_5
30,8572001,8616000,43999,False,65,scaffold_5
31,8659001,8686000,26999,False,65,scaffold_5
32,8714001,9364176,650175,True,65,scaffold_5
0,63001,75000,11999,False,65,scaffold_6
1,78001,84000,5999,False,65,scaffold_6
2,86001,116000,29999,False,65,scaffold_6
3,239001,255000,15999,False,65,scaffold_6
4,256001,283000,26999,False,65,scaffold_6
5,1235001,1258000,22999,False,65,scaffold_6
6,1479001,1547000,67999,False,65,scaffold_6
7,1867001,1906000,38999,False,65,scaffold_6
8,2025001,2104000,78999,False,65,scaffold_6
9,2129001,2182000,52999,False,65,scaffold_6
10,2239001,2265000,25999,False,65,scaffold_6
11,2336001,2595000,258999,False,65,scaffold_6
12,2596001,2654000,57999,False,65,scaffold_6
13,2655001,2872000,216999,False,65,scaffold_6
14,2936001,3014000,77999,False,65,scaffold_6
15,3112001,3174000,61999,False,65,scaffold_6
16,3222001,3366000,143999,False,65,scaffold_6
17,3405001,3788000,382999,False,65,scaffold_6
18,3900001,3913000,12999,False,65,scaffold_6
19,4012001,4195000,182999,False,65,scaffold_6
20,6010001,6064000,53999,False,65,scaffold_6
21,6152001,6179000,26999,False,65,scaffold_6
22,6784001,6804000,19999,False,65,scaffold_6
23,7262001,7338000,75999,False,65,scaffold_6
24,7388001,7475000,86999,False,65,scaffold_6
25,7550001,7798000,247999,False,65,scaffold_6
26,7811001,8268281,457280,True,65,scaffold_6
0,1,8000,7999,True,65,scaffold_7
1,11001,31000,19999,False,65,scaffold_7
2,177001,184000,6999,False,65,scaffold_7
3,311001,341000,29999,False,65,scaffold_7
4,342001,508000,165999,False,65,scaffold_7
5,571001,577000,5999,False,65,scaffold_7
6,580001,591000,10999,False,65,scaffold_7
7,623001,641000,17999,False,65,scaffold_7
8,654001,673000,18999,False,65,scaffold_7
9,706001,736000,29999,False,65,scaffold_7
10,764001,826000,61999,False,65,scaffold_7
11,858001,864000,5999,False,65,scaffold_7
12,868001,963000,94999,False,65,scaffold_7
13,968001,980000,11999,False,65,scaffold_7
14,982001,1044000,61999,False,65,scaffold_7
15,1048001,1101000,52999,False,65,scaffold_7
16,1169001,1187000,17999,False,65,scaffold_7
17,1191001,1512000,320999,False,65,scaffold_7
18,1588001,1689000,100999,False,65,scaffold_7
19,1769001,1782000,12999,False,65,scaffold_7
20,2932001,2959000,26999,False,65,scaffold_7
21,3296001,3370000,73999,False,65,scaffold_7
22,3518001,3550000,31999,False,65,scaffold_7
23,3595001,3651000,55999,False,65,scaffold_7
24,3717001,3767000,49999,False,65,scaffold_7
25,4415001,4517000,101999,False,65,scaffold_7
26,4551001,4581000,29999,False,65,scaffold_7
27,4658001,4736000,77999,False,65,scaffold_7
28,4777001,4819000,41999,False,65,scaffold_7
29,4978001,5149000,170999,False,65,scaffold_7
30,5483001,5536000,52999,False,65,scaffold_7
31,6754001,6796000,41999,False,65,scaffold_7
32,6955001,7270000,314999,False,65,scaffold_7
33,7271001,7502216,231215,True,65,scaffold_7
0,66001,85000,18999,False,65,scaffold_8
1,99001,103000,3999,False,65,scaffold_8
2,2444001,2552000,107999,False,65,scaffold_8
3,2654001,2683000,28999,False,65,scaffold_8
4,2740001,2757000,16999,False,65,scaffold_8
5,2781001,2844000,62999,False,65,scaffold_8
6,3057001,3526000,468999,False,65,scaffold_8
7,3577001,3612000,34999,False,65,scaffold_8
8,3615001,3939000,323999,False,65,scaffold_8
9,4039001,4108000,68999,False,65,scaffold_8
10,4400001,4434000,33999,False,65,scaffold_8
11,4815001,4846000,30999,False,65,scaffold_8
12,5084001,5137000,52999,False,65,scaffold_8
13,5164001,5241000,76999,False,65,scaffold_8
14,6320001,6334544,14543,True,65,scaffold_8
0,1,22000,21999,True,65,scaffold_9
1,109001,117000,7999,False,65,scaffold_9
2,188001,194000,5999,False,65,scaffold_9
3,366001,411000,44999,False,65,scaffold_9
4,413001,434000,20999,False,65,scaffold_9
5,484001,531000,46999,False,65,scaffold_9
6,652001,665000,12999,False,65,scaffold_9
7,671001,697000,25999,False,65,scaffold_9
8,730001,741000,10999,False,65,scaffold_9
9,815001,842000,26999,False,65,scaffold_9
10,877001,986000,108999,False,65,scaffold_9
11,987001,1007000,19999,False,65,scaffold_9
12,1008001,1085000,76999,False,65,scaffold_9
13,1087001,1160000,72999,False,65,scaffold_9
14,1311001,1382000,70999,False,65,scaffold_9
15,1487001,1500000,12999,False,65,scaffold_9
16,1749001,1791000,41999,False,65,scaffold_9
17,1987001,2063000,75999,False,65,scaffold_9
18,2076001,2105000,28999,False,65,scaffold_9
19,2148001,2171000,22999,False,65,scaffold_9
20,2598001,2616000,17999,False,65,scaffold_9
21,2737001,3381000,643999,False,65,scaffold_9
22,3383001,5107000,1723999,False,65,scaffold_9
23,5112001,5114000,1999,False,65,scaffold_9
24,5116001,5238000,121999,False,65,scaffold_9
25,5239001,5298000,58999,False,65,scaffold_9
26,5299001,5491000,191999,False,65,scaffold_9
27,5492001,6331288,839287,True,65,scaffold_9
0,1,234000,233999,True,65,scaffold_10
1,261001,414000,152999,False,65,scaffold_10
2,415001,482000,66999,False,65,scaffold_10
3,483001,576000,92999,False,65,scaffold_10
4,600001,797000,196999,False,65,scaffold_10
5,812001,876000,63999,False,65,scaffold_10
6,888001,917000,28999,False,65,scaffold_10
7,923001,963000,39999,False,65,scaffold_10
8,1073001,1145000,71999,False,65,scaffold_10
9,1405001,1470000,64999,False,65,scaffold_10
10,2089001,2102000,12999,False,65,scaffold_10
11,2140001,2169000,28999,False,65,scaffold_10
12,2266001,2299000,32999,False,65,scaffold_10
13,2346001,2425000,78999,False,65,scaffold_10
14,2560001,2580000,19999,False,65,scaffold_10
15,2687001,2700000,12999,False,65,scaffold_10
16,3590001,3595000,4999,False,65,scaffold_10
17,4051001,4091000,39999,False,65,scaffold_10
18,4154001,4174000,19999,False,65,scaffold_10
19,4443001,4461000,17999,False,65,scaffold_10
20,4515001,4523000,7999,False,65,scaffold_10
21,4526001,4548000,21999,False,65,scaffold_10
22,4554001,4562000,7999,False,65,scaffold_10
23,4565001,4596000,30999,False,65,scaffold_10
24,4679001,4688000,8999,False,65,scaffold_10
25,4734001,4751000,16999,False,65,scaffold_10
26,4752001,4766000,13999,False,65,scaffold_10
27,4768001,4776000,7999,False,65,scaffold_10
28,4798001,4824000,25999,False,65,scaffold_10
29,4828001,4846000,17999,False,65,scaffold_10
30,4848001,4861000,12999,False,65,scaffold_10
31,4865001,4866973,1972,True,65,scaffold_10
0,14001,99000,84999,False,65,scaffold_11
1,149001,167000,17999,False,65,scaffold_11
2,169001,192000,22999,False,65,scaffold_11
3,214001,235000,20999,False,65,scaffold_11
4,240001,248000,7999,False,65,scaffold_11
5,291001,320000,28999,False,65,scaffold_11
6,419001,431000,11999,False,65,scaffold_11
7,648001,656000,7999,False,65,scaffold_11
8,1025001,1034000,8999,False,65,scaffold_11
9,1403001,1409000,5999,False,65,scaffold_11
10,1423001,1426000,2999,False,65,scaffold_11
11,1474001,1477000,2999,False,65,scaffold_11
12,2701001,2875000,173999,False,65,scaffold_11
13,2978001,3019000,40999,False,65,scaffold_11
14,3083001,3293000,209999,False,65,scaffold_11
15,3328001,3383000,54999,False,65,scaffold_11
16,3449001,3477000,27999,False,65,scaffold_11
17,3525001,3653000,127999,False,65,scaffold_11
18,3702001,3933000,230999,False,65,scaffold_11
19,4001001,4159000,157999,False,65,scaffold_11
20,4255001,4710000,454999,False,65,scaffold_11
21,4713001,4766820,53819,True,65,scaffold_11
0,1,550000,549999,True,65,scaffold_12
1,579001,1469000,889999,False,65,scaffold_12
2,1717001,1733000,15999,False,65,scaffold_12
3,2044001,2103000,58999,False,65,scaffold_12
4,2135001,2179000,43999,False,65,scaffold_12
5,2571001,2620000,48999,False,65,scaffold_12
0,1,340000,339999,True,66,scaffold_1
1,482001,498000,15999,False,66,scaffold_1
2,572001,643000,70999,False,66,scaffold_1
3,686001,759000,72999,False,66,scaffold_1
4,1836001,1842000,5999,False,66,scaffold_1
5,1849001,1898000,48999,False,66,scaffold_1
6,1954001,1964000,9999,False,66,scaffold_1
7,1965001,1984000,18999,False,66,scaffold_1
8,2449001,2519000,69999,False,66,scaffold_1
9,2726001,2746000,19999,False,66,scaffold_1
10,3172001,3209000,36999,False,66,scaffold_1
11,3579001,3617000,37999,False,66,scaffold_1
12,3715001,3741000,25999,False,66,scaffold_1
13,3923001,3934000,10999,False,66,scaffold_1
14,4061001,4112000,50999,False,66,scaffold_1
15,4314001,4354000,39999,False,66,scaffold_1
16,4927001,5025000,97999,False,66,scaffold_1
17,5481001,5511000,29999,False,66,scaffold_1
18,5536001,5578000,41999,False,66,scaffold_1
19,6108001,6153000,44999,False,66,scaffold_1
20,6154001,6176000,21999,False,66,scaffold_1
21,6228001,6381000,152999,False,66,scaffold_1
22,6384001,6509000,124999,False,66,scaffold_1
23,6544001,6554000,9999,False,66,scaffold_1
24,7038001,7247000,208999,False,66,scaffold_1
25,7248001,7588000,339999,False,66,scaffold_1
26,7590001,8477000,886999,False,66,scaffold_1
27,8478001,8640000,161999,False,66,scaffold_1
28,8644001,8656000,11999,False,66,scaffold_1
29,8658001,9584000,925999,False,66,scaffold_1
30,9586001,10357000,770999,False,66,scaffold_1
31,10460001,10639000,178999,False,66,scaffold_1
32,10838001,10857000,18999,False,66,scaffold_1
33,11344001,11510000,165999,False,66,scaffold_1
34,11560001,11579000,18999,False,66,scaffold_1
35,11614001,11962000,347999,False,66,scaffold_1
36,12184001,12204000,19999,False,66,scaffold_1
37,12661001,12722000,60999,False,66,scaffold_1
38,12775001,12888000,112999,False,66,scaffold_1
39,12974001,13000000,25999,False,66,scaffold_1
40,13113001,13212000,98999,False,66,scaffold_1
41,13347001,13405000,57999,False,66,scaffold_1
42,14285001,14309000,23999,False,66,scaffold_1
43,14560001,14562000,1999,False,66,scaffold_1
44,14595001,14598000,2999,False,66,scaffold_1
45,14605001,14610000,4999,False,66,scaffold_1
0,22001,48000,25999,False,66,scaffold_2
1,93001,159000,65999,False,66,scaffold_2
2,313001,318000,4999,False,66,scaffold_2
3,331001,374000,42999,False,66,scaffold_2
4,2336001,2391000,54999,False,66,scaffold_2
5,2395001,2424000,28999,False,66,scaffold_2
6,2441001,2553000,111999,False,66,scaffold_2
7,2660001,2689000,28999,False,66,scaffold_2
8,2694001,2745000,50999,False,66,scaffold_2
9,2766001,2788000,21999,False,66,scaffold_2
10,2868001,2898000,29999,False,66,scaffold_2
11,3450001,3465000,14999,False,66,scaffold_2
12,3758001,3782000,23999,False,66,scaffold_2
13,4345001,4365000,19999,False,66,scaffold_2
14,4382001,4409000,26999,False,66,scaffold_2
15,4426001,4457000,30999,False,66,scaffold_2
16,4518001,4656000,137999,False,66,scaffold_2
17,4783001,4790000,6999,False,66,scaffold_2
18,4919001,4936000,16999,False,66,scaffold_2
19,5020001,5063000,42999,False,66,scaffold_2
20,5080001,5104000,23999,False,66,scaffold_2
21,5491001,5511000,19999,False,66,scaffold_2
22,5658001,5704000,45999,False,66,scaffold_2
23,5719001,5757000,37999,False,66,scaffold_2
24,6261001,6330000,68999,False,66,scaffold_2
25,6331001,6350000,18999,False,66,scaffold_2
26,6427001,6452000,24999,False,66,scaffold_2
27,6592001,6628000,35999,False,66,scaffold_2
28,7439001,7472000,32999,False,66,scaffold_2
29,7563001,7697000,133999,False,66,scaffold_2
30,7783001,7891000,107999,False,66,scaffold_2
31,7934001,8161000,226999,False,66,scaffold_2
32,8265001,8313000,47999,False,66,scaffold_2
33,8331001,8333000,1999,False,66,scaffold_2
34,8340001,8344000,3999,False,66,scaffold_2
35,8346001,8453000,106999,False,66,scaffold_2
36,8508001,8562000,53999,False,66,scaffold_2
37,9159001,9167000,7999,False,66,scaffold_2
38,11366001,11376000,9999,False,66,scaffold_2
39,11520001,11786000,265999,False,66,scaffold_2
0,1,2000,1999,True,66,scaffold_3
1,51001,54000,2999,False,66,scaffold_3
2,203001,207000,3999,False,66,scaffold_3
3,618001,646000,27999,False,66,scaffold_3
4,797001,900000,102999,False,66,scaffold_3
5,2010001,2108000,97999,False,66,scaffold_3
6,2110001,2115000,4999,False,66,scaffold_3
7,2291001,2321000,29999,False,66,scaffold_3
8,2487001,2533000,45999,False,66,scaffold_3
9,3770001,3820000,49999,False,66,scaffold_3
10,3823001,3892000,68999,False,66,scaffold_3
11,4098001,4403000,304999,False,66,scaffold_3
12,4410001,4518000,107999,False,66,scaffold_3
13,4546001,4558000,11999,False,66,scaffold_3
14,4652001,4679000,26999,False,66,scaffold_3
15,5976001,6023000,46999,False,66,scaffold_3
16,6910001,6962000,51999,False,66,scaffold_3
17,6963001,7080000,116999,False,66,scaffold_3
18,7255001,7301000,45999,False,66,scaffold_3
19,7337001,7362000,24999,False,66,scaffold_3
20,7506001,7556000,49999,False,66,scaffold_3
21,7692001,7853000,160999,False,66,scaffold_3
22,8087001,8116000,28999,False,66,scaffold_3
23,8176001,8256000,79999,False,66,scaffold_3
24,8424001,8449000,24999,False,66,scaffold_3
25,8462001,8527000,64999,False,66,scaffold_3
26,8575001,8594000,18999,False,66,scaffold_3
27,9006001,9041000,34999,False,66,scaffold_3
28,9968001,9996000,27999,False,66,scaffold_3
29,10461001,10484000,22999,False,66,scaffold_3
30,10587001,11162000,574999,False,66,scaffold_3
0,11001,13000,1999,False,66,scaffold_4
1,17001,32000,14999,False,66,scaffold_4
2,48001,81000,32999,False,66,scaffold_4
3,155001,215000,59999,False,66,scaffold_4
4,218001,226000,7999,False,66,scaffold_4
5,227001,241000,13999,False,66,scaffold_4
6,242001,267000,24999,False,66,scaffold_4
7,291001,310000,18999,False,66,scaffold_4
8,313001,344000,30999,False,66,scaffold_4
9,355001,374000,18999,False,66,scaffold_4
10,375001,380000,4999,False,66,scaffold_4
11,412001,425000,12999,False,66,scaffold_4
12,429001,504000,74999,False,66,scaffold_4
13,545001,592000,46999,False,66,scaffold_4
14,593001,599000,5999,False,66,scaffold_4
15,600001,606000,5999,False,66,scaffold_4
16,608001,691000,82999,False,66,scaffold_4
17,701001,715000,13999,False,66,scaffold_4
18,1120001,1136000,15999,False,66,scaffold_4
19,1137001,1186000,48999,False,66,scaffold_4
20,1199001,1208000,8999,False,66,scaffold_4
21,1210001,1226000,15999,False,66,scaffold_4
22,1235001,1253000,17999,False,66,scaffold_4
23,1254001,1262000,7999,False,66,scaffold_4
24,1265001,1279000,13999,False,66,scaffold_4
25,1283001,1336000,52999,False,66,scaffold_4
26,1372001,1595000,222999,False,66,scaffold_4
27,1613001,1896000,282999,False,66,scaffold_4
28,1904001,2006000,101999,False,66,scaffold_4
29,2007001,2069000,61999,False,66,scaffold_4
30,2071001,2117000,45999,False,66,scaffold_4
31,2284001,2310000,25999,False,66,scaffold_4
32,2312001,2340000,27999,False,66,scaffold_4
33,2342001,2386000,43999,False,66,scaffold_4
34,2427001,2461000,33999,False,66,scaffold_4
35,2476001,2635000,158999,False,66,scaffold_4
36,3090001,3126000,35999,False,66,scaffold_4
37,3336001,3761000,424999,False,66,scaffold_4
38,4901001,5047000,145999,False,66,scaffold_4
39,5173001,5223000,49999,False,66,scaffold_4
40,5476001,5506000,29999,False,66,scaffold_4
41,5514001,5620000,105999,False,66,scaffold_4
42,5659001,5784000,124999,False,66,scaffold_4
43,5786001,5825000,38999,False,66,scaffold_4
44,6148001,6191000,42999,False,66,scaffold_4
45,6796001,6817000,20999,False,66,scaffold_4
46,6892001,6924000,31999,False,66,scaffold_4
47,6950001,6995000,44999,False,66,scaffold_4
48,7036001,7062000,25999,False,66,scaffold_4
49,7229001,7288000,58999,False,66,scaffold_4
50,7639001,7665000,25999,False,66,scaffold_4
51,8846001,9699000,852999,False,66,scaffold_4
52,9700001,9845951,145950,True,66,scaffold_4
0,178001,180000,1999,False,66,scaffold_5
1,190001,204000,13999,False,66,scaffold_5
2,318001,368000,49999,False,66,scaffold_5
3,462001,523000,60999,False,66,scaffold_5
4,933001,947000,13999,False,66,scaffold_5
5,2511001,2515000,3999,False,66,scaffold_5
6,2565001,2745000,179999,False,66,scaffold_5
7,2766001,2875000,108999,False,66,scaffold_5
8,3133001,3259000,125999,False,66,scaffold_5
9,3322001,3509000,186999,False,66,scaffold_5
10,3620001,3657000,36999,False,66,scaffold_5
11,3962001,4101000,138999,False,66,scaffold_5
12,4120001,4221000,100999,False,66,scaffold_5
13,4232001,4286000,53999,False,66,scaffold_5
14,4445001,4506000,60999,False,66,scaffold_5
15,4603001,4861000,257999,False,66,scaffold_5
16,4892001,4917000,24999,False,66,scaffold_5
17,5249001,5274000,24999,False,66,scaffold_5
18,5318001,5346000,27999,False,66,scaffold_5
19,6408001,6420000,11999,False,66,scaffold_5
20,6481001,6651000,169999,False,66,scaffold_5
21,7454001,7483000,28999,False,66,scaffold_5
22,7559001,7619000,59999,False,66,scaffold_5
23,7621001,7661000,39999,False,66,scaffold_5
24,8571001,8615000,43999,False,66,scaffold_5
25,8670001,8689000,18999,False,66,scaffold_5
26,8713001,9364176,651175,True,66,scaffold_5
0,79001,84000,4999,False,66,scaffold_6
1,86001,113000,26999,False,66,scaffold_6
2,239001,253000,13999,False,66,scaffold_6
3,1239001,1255000,15999,False,66,scaffold_6
4,1479001,1546000,66999,False,66,scaffold_6
5,1866001,1906000,39999,False,66,scaffold_6
6,2023001,2088000,64999,False,66,scaffold_6
7,2129001,2179000,49999,False,66,scaffold_6
8,2243001,2264000,20999,False,66,scaffold_6
9,2336001,2595000,258999,False,66,scaffold_6
10,2596001,2654000,57999,False,66,scaffold_6
11,2655001,2691000,35999,False,66,scaffold_6
12,2712001,2852000,139999,False,66,scaffold_6
13,2933001,3016000,82999,False,66,scaffold_6
14,3111001,3174000,62999,False,66,scaffold_6
15,3222001,3316000,93999,False,66,scaffold_6
16,3407001,3795000,387999,False,66,scaffold_6
17,3898001,3913000,14999,False,66,scaffold_6
18,4018001,4072000,53999,False,66,scaffold_6
19,4080001,4193000,112999,False,66,scaffold_6
20,6010001,6084000,73999,False,66,scaffold_6
21,7263001,7337000,73999,False,66,scaffold_6
22,7390001,7436000,45999,False,66,scaffold_6
23,7549001,8268281,719280,True,66,scaffold_6
0,13001,31000,17999,False,66,scaffold_7
1,323001,340000,16999,False,66,scaffold_7
2,342001,508000,165999,False,66,scaffold_7
3,554001,563000,8999,False,66,scaffold_7
4,571001,577000,5999,False,66,scaffold_7
5,706001,724000,17999,False,66,scaffold_7
6,725001,736000,10999,False,66,scaffold_7
7,764001,821000,56999,False,66,scaffold_7
8,859001,864000,4999,False,66,scaffold_7
9,982001,1044000,61999,False,66,scaffold_7
10,1191001,1459000,267999,False,66,scaffold_7
11,1461001,1512000,50999,False,66,scaffold_7
12,1588001,1689000,100999,False,66,scaffold_7
13,3325001,3369000,43999,False,66,scaffold_7
14,3593001,3767000,173999,False,66,scaffold_7
15,4415001,4517000,101999,False,66,scaffold_7
16,4658001,4734000,75999,False,66,scaffold_7
17,4979001,5149000,169999,False,66,scaffold_7
18,5482001,5536000,53999,False,66,scaffold_7
19,6954001,7270000,315999,False,66,scaffold_7
20,7271001,7502216,231215,True,66,scaffold_7
0,1,6000,5999,True,66,scaffold_8
1,67001,85000,17999,False,66,scaffold_8
2,2444001,2529000,84999,False,66,scaffold_8
3,2537001,2549000,11999,False,66,scaffold_8
4,2656001,2682000,25999,False,66,scaffold_8
5,2742001,2757000,14999,False,66,scaffold_8
6,2798001,2844000,45999,False,66,scaffold_8
7,3060001,3525000,464999,False,66,scaffold_8
8,3587001,3612000,24999,False,66,scaffold_8
9,3615001,3939000,323999,False,66,scaffold_8
10,4038001,4100000,61999,False,66,scaffold_8
11,5094001,5136000,41999,False,66,scaffold_8
12,5163001,5242000,78999,False,66,scaffold_8
13,6327001,6334544,7543,True,66,scaffold_8
0,121001,134000,12999,False,66,scaffold_9
1,189001,194000,4999,False,66,scaffold_9
2,299001,315000,15999,False,66,scaffold_9
3,319001,332000,12999,False,66,scaffold_9
4,367001,411000,43999,False,66,scaffold_9
5,413001,434000,20999,False,66,scaffold_9
6,502001,531000,28999,False,66,scaffold_9
7,655001,659000,3999,False,66,scaffold_9
8,660001,665000,4999,False,66,scaffold_9
9,671001,696000,24999,False,66,scaffold_9
10,732001,742000,9999,False,66,scaffold_9
11,794001,803000,8999,False,66,scaffold_9
12,817001,841000,23999,False,66,scaffold_9
13,850001,862000,11999,False,66,scaffold_9
14,872001,986000,113999,False,66,scaffold_9
15,988001,995000,6999,False,66,scaffold_9
16,1001001,1007000,5999,False,66,scaffold_9
17,1010001,1031000,20999,False,66,scaffold_9
18,1036001,1085000,48999,False,66,scaffold_9
19,1087001,1150000,62999,False,66,scaffold_9
20,1151001,1160000,8999,False,66,scaffold_9
21,1312001,1380000,67999,False,66,scaffold_9
22,1600001,1620000,19999,False,66,scaffold_9
23,1754001,1811000,56999,False,66,scaffold_9
24,2598001,2616000,17999,False,66,scaffold_9
25,2737001,2803000,65999,False,66,scaffold_9
26,2872001,3137000,264999,False,66,scaffold_9
27,3138001,3381000,242999,False,66,scaffold_9
28,3383001,5107000,1723999,False,66,scaffold_9
29,5112001,5115000,2999,False,66,scaffold_9
30,5116001,5238000,121999,False,66,scaffold_9
31,5239001,5298000,58999,False,66,scaffold_9
32,5299001,5491000,191999,False,66,scaffold_9
33,5493001,6331288,838287,True,66,scaffold_9
0,1,235000,234999,True,66,scaffold_10
1,282001,414000,131999,False,66,scaffold_10
2,415001,482000,66999,False,66,scaffold_10
3,483001,582000,98999,False,66,scaffold_10
4,603001,755000,151999,False,66,scaffold_10
5,888001,916000,27999,False,66,scaffold_10
6,924001,963000,38999,False,66,scaffold_10
7,1073001,1112000,38999,False,66,scaffold_10
8,2090001,2103000,12999,False,66,scaffold_10
9,2140001,2171000,30999,False,66,scaffold_10
10,2346001,2402000,55999,False,66,scaffold_10
11,4053001,4091000,37999,False,66,scaffold_10
12,4154001,4174000,19999,False,66,scaffold_10
13,4443001,4462000,18999,False,66,scaffold_10
14,4503001,4513000,9999,False,66,scaffold_10
15,4527001,4548000,20999,False,66,scaffold_10
16,4576001,4595000,18999,False,66,scaffold_10
17,4679001,4688000,8999,False,66,scaffold_10
18,4734001,4766000,31999,False,66,scaffold_10
19,4768001,4776000,7999,False,66,scaffold_10
20,4798001,4824000,25999,False,66,scaffold_10
21,4827001,4843000,15999,False,66,scaffold_10
22,4848001,4861000,12999,False,66,scaffold_10
23,4865001,4866973,1972,True,66,scaffold_10
0,10001,34000,23999,False,66,scaffold_11
1,40001,91000,50999,False,66,scaffold_11
2,149001,167000,17999,False,66,scaffold_11
3,169001,191000,21999,False,66,scaffold_11
4,213001,235000,21999,False,66,scaffold_11
5,419001,431000,11999,False,66,scaffold_11
6,648001,656000,7999,False,66,scaffold_11
7,1025001,1034000,8999,False,66,scaffold_11
8,1423001,1426000,2999,False,66,scaffold_11
9,2701001,2874000,172999,False,66,scaffold_11
10,2983001,3019000,35999,False,66,scaffold_11
11,3086001,3144000,57999,False,66,scaffold_11
12,3188001,3291000,102999,False,66,scaffold_11
13,3331001,3384000,52999,False,66,scaffold_11
14,3560001,3651000,90999,False,66,scaffold_11
15,3702001,3933000,230999,False,66,scaffold_11
16,4009001,4159000,149999,False,66,scaffold_11
17,4226001,4710000,483999,False,66,scaffold_11
18,4713001,4766820,53819,True,66,scaffold_11
0,1,538000,537999,True,66,scaffold_12
1,579001,1469000,889999,False,66,scaffold_12
2,1720001,1733000,12999,False,66,scaffold_12
3,2137001,2162000,24999,False,66,scaffold_12
4,2350001,2362000,11999,False,66,scaffold_12
5,2571001,2616000,44999,False,66,scaffold_12
0,1,332000,331999,True,67,scaffold_1
1,482001,498000,15999,False,67,scaffold_1
2,571001,643000,71999,False,67,scaffold_1
3,686001,743000,56999,False,67,scaffold_1
4,1954001,1984000,29999,False,67,scaffold_1
5,2449001,2513000,63999,False,67,scaffold_1
6,2729001,2746000,16999,False,67,scaffold_1
7,3181001,3208000,26999,False,67,scaffold_1
8,3715001,3733000,17999,False,67,scaffold_1
9,3922001,3941000,18999,False,67,scaffold_1
10,4063001,4111000,47999,False,67,scaffold_1
11,4315001,4354000,38999,False,67,scaffold_1
12,4928001,4997000,68999,False,67,scaffold_1
13,5484001,5511000,26999,False,67,scaffold_1
14,5538001,5569000,30999,False,67,scaffold_1
15,6108001,6153000,44999,False,67,scaffold_1
16,6164001,6176000,11999,False,67,scaffold_1
17,6228001,6507000,278999,False,67,scaffold_1
18,6545001,6554000,8999,False,67,scaffold_1
19,7038001,7247000,208999,False,67,scaffold_1
20,7248001,7583000,334999,False,67,scaffold_1
21,7590001,8656000,1065999,False,67,scaffold_1
22,8658001,9584000,925999,False,67,scaffold_1
23,9586001,10354000,767999,False,67,scaffold_1
24,10461001,10618000,156999,False,67,scaffold_1
25,10808001,10811000,2999,False,67,scaffold_1
26,10832001,10858000,25999,False,67,scaffold_1
27,11346001,11504000,157999,False,67,scaffold_1
28,11614001,11951000,336999,False,67,scaffold_1
29,12184001,12204000,19999,False,67,scaffold_1
30,12666001,12722000,55999,False,67,scaffold_1
31,12777001,12888000,110999,False,67,scaffold_1
32,12982001,12995000,12999,False,67,scaffold_1
33,13113001,13157000,43999,False,67,scaffold_1
34,13178001,13211000,32999,False,67,scaffold_1
35,13347001,13403000,55999,False,67,scaffold_1
36,14399001,14402000,2999,False,67,scaffold_1
37,14560001,14562000,1999,False,67,scaffold_1
0,22001,48000,25999,False,67,scaffold_2
1,117001,159000,41999,False,67,scaffold_2
2,168001,177000,8999,False,67,scaffold_2
3,297001,318000,20999,False,67,scaffold_2
4,332001,374000,41999,False,67,scaffold_2
5,1336001,1342000,5999,False,67,scaffold_2
6,2336001,2358000,21999,False,67,scaffold_2
7,2400001,2424000,23999,False,67,scaffold_2
8,2441001,2553000,111999,False,67,scaffold_2
9,2627001,2639000,11999,False,67,scaffold_2
10,2660001,2689000,28999,False,67,scaffold_2
11,2694001,2742000,47999,False,67,scaffold_2
12,2777001,2788000,10999,False,67,scaffold_2
13,3454001,3463000,8999,False,67,scaffold_2
14,4386001,4409000,22999,False,67,scaffold_2
15,4427001,4457000,29999,False,67,scaffold_2
16,4521001,4554000,32999,False,67,scaffold_2
17,4611001,4649000,37999,False,67,scaffold_2
18,5022001,5031000,8999,False,67,scaffold_2
19,5033001,5063000,29999,False,67,scaffold_2
20,5491001,5512000,20999,False,67,scaffold_2
21,5672001,5704000,31999,False,67,scaffold_2
22,6261001,6330000,68999,False,67,scaffold_2
23,6331001,6350000,18999,False,67,scaffold_2
24,7439001,7472000,32999,False,67,scaffold_2
25,7563001,7697000,133999,False,67,scaffold_2
26,7786001,7890000,103999,False,67,scaffold_2
27,7934001,7965000,30999,False,67,scaffold_2
28,7985001,8089000,103999,False,67,scaffold_2
29,8346001,8389000,42999,False,67,scaffold_2
30,8418001,8453000,34999,False,67,scaffold_2
31,8509001,8536000,26999,False,67,scaffold_2
32,11367001,11371000,3999,False,67,scaffold_2
33,11520001,11785000,264999,False,67,scaffold_2
0,1,2000,1999,True,67,scaffold_3
1,51001,55000,3999,False,67,scaffold_3
2,800001,901000,100999,False,67,scaffold_3
3,2085001,2108000,22999,False,67,scaffold_3
4,2291001,2321000,29999,False,67,scaffold_3
5,2493001,2531000,37999,False,67,scaffold_3
6,4149001,4403000,253999,False,67,scaffold_3
7,4416001,4518000,101999,False,67,scaffold_3
8,4547001,4558000,10999,False,67,scaffold_3
9,4652001,4680000,27999,False,67,scaffold_3
10,6911001,6962000,50999,False,67,scaffold_3
11,6980001,7034000,53999,False,67,scaffold_3
12,7449001,7458000,8999,False,67,scaffold_3
13,7535001,7556000,20999,False,67,scaffold_3
14,7692001,7723000,30999,False,67,scaffold_3
15,7822001,7840000,17999,False,67,scaffold_3
16,8205001,8255000,49999,False,67,scaffold_3
17,8462001,8527000,64999,False,67,scaffold_3
18,8575001,8594000,18999,False,67,scaffold_3
19,9968001,9996000,27999,False,67,scaffold_3
20,10461001,10483000,21999,False,67,scaffold_3
21,10587001,11167000,579999,False,67,scaffold_3
0,17001,32000,14999,False,67,scaffold_4
1,49001,88000,38999,False,67,scaffold_4
2,121001,146000,24999,False,67,scaffold_4
3,147001,151000,3999,False,67,scaffold_4
4,155001,160000,4999,False,67,scaffold_4
5,161001,215000,53999,False,67,scaffold_4
6,217001,226000,8999,False,67,scaffold_4
7,227001,266000,38999,False,67,scaffold_4
8,291001,308000,16999,False,67,scaffold_4
9,355001,374000,18999,False,67,scaffold_4
10,375001,380000,4999,False,67,scaffold_4
11,395001,410000,14999,False,67,scaffold_4
12,412001,425000,12999,False,67,scaffold_4
13,429001,498000,68999,False,67,scaffold_4
14,548001,590000,41999,False,67,scaffold_4
15,608001,691000,82999,False,67,scaffold_4
16,701001,713000,11999,False,67,scaffold_4
17,1121001,1136000,14999,False,67,scaffold_4
18,1137001,1198000,60999,False,67,scaffold_4
19,1199001,1208000,8999,False,67,scaffold_4
20,1210001,1226000,15999,False,67,scaffold_4
21,1254001,1262000,7999,False,67,scaffold_4
22,1265001,1279000,13999,False,67,scaffold_4
23,1283001,1336000,52999,False,67,scaffold_4
24,1372001,1591000,218999,False,67,scaffold_4
25,1613001,1694000,80999,False,67,scaffold_4
26,1749001,1817000,67999,False,67,scaffold_4
27,1827001,1849000,21999,False,67,scaffold_4
28,1850001,1867000,16999,False,67,scaffold_4
29,1904001,1999000,94999,False,67,scaffold_4
30,2036001,2064000,27999,False,67,scaffold_4
31,2269001,2279000,9999,False,67,scaffold_4
32,2284001,2310000,25999,False,67,scaffold_4
33,2312001,2340000,27999,False,67,scaffold_4
34,2476001,2581000,104999,False,67,scaffold_4
35,2599001,2635000,35999,False,67,scaffold_4
36,3336001,3632000,295999,False,67,scaffold_4
37,3676001,3760000,83999,False,67,scaffold_4
38,4944001,4984000,39999,False,67,scaffold_4
39,5477001,5506000,28999,False,67,scaffold_4
40,5514001,5620000,105999,False,67,scaffold_4
41,5667001,5784000,116999,False,67,scaffold_4
42,6159001,6168000,8999,False,67,scaffold_4
43,6177001,6190000,12999,False,67,scaffold_4
44,6804001,6817000,12999,False,67,scaffold_4
45,6908001,6924000,15999,False,67,scaffold_4
46,7037001,7062000,24999,False,67,scaffold_4
47,7985001,7995000,9999,False,67,scaffold_4
48,8849001,9699000,849999,False,67,scaffold_4
49,9700001,9845951,145950,True,67,scaffold_4
0,318001,383000,64999,False,67,scaffold_5
1,469001,477000,7999,False,67,scaffold_5
2,499001,523000,23999,False,67,scaffold_5
3,933001,947000,13999,False,67,scaffold_5
4,2564001,2584000,19999,False,67,scaffold_5
5,2625001,2733000,107999,False,67,scaffold_5
6,2816001,2870000,53999,False,67,scaffold_5
7,3136001,3185000,48999,False,67,scaffold_5
8,3322001,3438000,115999,False,67,scaffold_5
9,3451001,3496000,44999,False,67,scaffold_5
10,3962001,4101000,138999,False,67,scaffold_5
11,4121001,4219000,97999,False,67,scaffold_5
12,4246001,4263000,16999,False,67,scaffold_5
13,4445001,4485000,39999,False,67,scaffold_5
14,4601001,4661000,59999,False,67,scaffold_5
15,4691001,4717000,25999,False,67,scaffold_5
16,4785001,4861000,75999,False,67,scaffold_5
17,5318001,5346000,27999,False,67,scaffold_5
18,6411001,6418000,6999,False,67,scaffold_5
19,7623001,7636000,12999,False,67,scaffold_5
20,8730001,9363000,632999,False,67,scaffold_5
0,79001,84000,4999,False,67,scaffold_6
1,86001,112000,25999,False,67,scaffold_6
2,240001,253000,12999,False,67,scaffold_6
3,257001,262000,4999,False,67,scaffold_6
4,1246001,1255000,8999,False,67,scaffold_6
5,1479001,1546000,66999,False,67,scaffold_6
6,2023001,2087000,63999,False,67,scaffold_6
7,2130001,2169000,38999,False,67,scaffold_6
8,2369001,2595000,225999,False,67,scaffold_6
9,2596001,2653000,56999,False,67,scaffold_6
10,2661001,2691000,29999,False,67,scaffold_6
11,2732001,2872000,139999,False,67,scaffold_6
12,2934001,3014000,79999,False,67,scaffold_6
13,3115001,3150000,34999,False,67,scaffold_6
14,3224001,3301000,76999,False,67,scaffold_6
15,3410001,3427000,16999,False,67,scaffold_6
16,3462001,3765000,302999,False,67,scaffold_6
17,3899001,3913000,13999,False,67,scaffold_6
18,4018001,4065000,46999,False,67,scaffold_6
19,4086001,4193000,106999,False,67,scaffold_6
20,6011001,6069000,57999,False,67,scaffold_6
21,7264001,7336000,71999,False,67,scaffold_6
22,7560001,7793000,232999,False,67,scaffold_6
23,7811001,8268281,457280,True,67,scaffold_6
0,13001,31000,17999,False,67,scaffold_7
1,169001,171000,1999,False,67,scaffold_7
2,323001,340000,16999,False,67,scaffold_7
3,342001,508000,165999,False,67,scaffold_7
4,554001,563000,8999,False,67,scaffold_7
5,571001,577000,5999,False,67,scaffold_7
6,706001,736000,29999,False,67,scaffold_7
7,764001,809000,44999,False,67,scaffold_7
8,811001,813000,1999,False,67,scaffold_7
9,859001,864000,4999,False,67,scaffold_7
10,865001,872000,6999,False,67,scaffold_7
11,876001,885000,8999,False,67,scaffold_7
12,952001,963000,10999,False,67,scaffold_7
13,964001,966000,1999,False,67,scaffold_7
14,968001,980000,11999,False,67,scaffold_7
15,982001,1044000,61999,False,67,scaffold_7
16,1048001,1104000,55999,False,67,scaffold_7
17,1191001,1512000,320999,False,67,scaffold_7
18,1588001,1688000,99999,False,67,scaffold_7
19,3330001,3369000,38999,False,67,scaffold_7
20,3595001,3649000,53999,False,67,scaffold_7
21,4415001,4517000,101999,False,67,scaffold_7
22,4658001,4681000,22999,False,67,scaffold_7
23,4979001,5021000,41999,False,67,scaffold_7
24,5077001,5114000,36999,False,67,scaffold_7
25,6954001,7270000,315999,False,67,scaffold_7
26,7271001,7502216,231215,True,67,scaffold_7
0,67001,85000,17999,False,67,scaffold_8
1,93001,101000,7999,False,67,scaffold_8
2,2492001,2521000,28999,False,67,scaffold_8
3,2662001,2683000,20999,False,67,scaffold_8
4,2745001,2756000,10999,False,67,scaffold_8
5,3060001,3525000,464999,False,67,scaffold_8
6,3581001,3612000,30999,False,67,scaffold_8
7,3615001,3913000,297999,False,67,scaffold_8
8,5200001,5241000,40999,False,67,scaffold_8
9,6331001,6334544,3543,True,67,scaffold_8
0,1001,16000,14999,False,67,scaffold_9
1,109001,117000,7999,False,67,scaffold_9
2,121001,138000,16999,False,67,scaffold_9
3,367001,411000,43999,False,67,scaffold_9
4,413001,434000,20999,False,67,scaffold_9
5,501001,531000,29999,False,67,scaffold_9
6,548001,563000,14999,False,67,scaffold_9
7,671001,696000,24999,False,67,scaffold_9
8,731001,742000,10999,False,67,scaffold_9
9,815001,843000,27999,False,67,scaffold_9
10,850001,862000,11999,False,67,scaffold_9
11,886001,986000,99999,False,67,scaffold_9
12,987001,995000,7999,False,67,scaffold_9
13,1001001,1007000,5999,False,67,scaffold_9
14,1010001,1031000,20999,False,67,scaffold_9
15,1035001,1085000,49999,False,67,scaffold_9
16,1087001,1165000,77999,False,67,scaffold_9
17,1312001,1377000,64999,False,67,scaffold_9
18,1770001,1787000,16999,False,67,scaffold_9
19,2601001,2616000,14999,False,67,scaffold_9
20,2874001,3381000,506999,False,67,scaffold_9
21,3383001,5107000,1723999,False,67,scaffold_9
22,5112001,5238000,125999,False,67,scaffold_9
23,5239001,5298000,58999,False,67,scaffold_9
24,5300001,5490000,189999,False,67,scaffold_9
25,5493001,6331288,838287,True,67,scaffold_9
0,1,136000,135999,True,67,scaffold_10
1,137001,198000,60999,False,67,scaffold_10
2,374001,405000,30999,False,67,scaffold_10
3,472001,482000,9999,False,67,scaffold_10
4,483001,496000,12999,False,67,scaffold_10
5,506001,580000,73999,False,67,scaffold_10
6,603001,749000,145999,False,67,scaffold_10
7,888001,921000,32999,False,67,scaffold_10
8,923001,962000,38999,False,67,scaffold_10
9,1087001,1105000,17999,False,67,scaffold_10
10,2346001,2366000,19999,False,67,scaffold_10
11,3264001,3268000,3999,False,67,scaffold_10
12,4053001,4091000,37999,False,67,scaffold_10
13,4154001,4174000,19999,False,67,scaffold_10
14,4506001,4513000,6999,False,67,scaffold_10
15,4515001,4523000,7999,False,67,scaffold_10
16,4526001,4548000,21999,False,67,scaffold_10
17,4574001,4597000,22999,False,67,scaffold_10
18,4679001,4688000,8999,False,67,scaffold_10
19,4734001,4766000,31999,False,67,scaffold_10
20,4768001,4776000,7999,False,67,scaffold_10
21,4798001,4824000,25999,False,67,scaffold_10
22,4828001,4843000,14999,False,67,scaffold_10
23,4848001,4861000,12999,False,67,scaffold_10
24,4865001,4866973,1972,True,67,scaffold_10
0,10001,93000,82999,False,67,scaffold_11
1,149001,167000,17999,False,67,scaffold_11
2,169001,191000,21999,False,67,scaffold_11
3,213001,236000,22999,False,67,scaffold_11
4,240001,248000,7999,False,67,scaffold_11
5,419001,431000,11999,False,67,scaffold_11
6,648001,656000,7999,False,67,scaffold_11
7,666001,669000,2999,False,67,scaffold_11
8,1025001,1034000,8999,False,67,scaffold_11
9,1423001,1426000,2999,False,67,scaffold_11
10,2701001,2872000,170999,False,67,scaffold_11
11,3212001,3283000,70999,False,67,scaffold_11
12,3331001,3383000,51999,False,67,scaffold_11
13,3702001,3926000,223999,False,67,scaffold_11
14,4318001,4710000,391999,False,67,scaffold_11
15,4713001,4766820,53819,True,67,scaffold_11
0,1,369000,368999,True,67,scaffold_12
1,474001,537000,62999,False,67,scaffold_12
2,582001,730000,147999,False,67,scaffold_12
3,739001,855000,115999,False,67,scaffold_12
4,865001,1425000,559999,False,67,scaffold_12
5,1721001,1732000,10999,False,67,scaffold_12
6,2571001,2610000,38999,False,67,scaffold_12
0,1,341000,340999,True,68,scaffold_1
1,482001,498000,15999,False,68,scaffold_1
2,571001,643000,71999,False,68,scaffold_1
3,686001,749000,62999,False,68,scaffold_1
4,1280001,1294000,13999,False,68,scaffold_1
5,1630001,1660000,29999,False,68,scaffold_1
6,1814001,1898000,83999,False,68,scaffold_1
7,1954001,1964000,9999,False,68,scaffold_1
8,1965001,1984000,18999,False,68,scaffold_1
9,2359001,2387000,27999,False,68,scaffold_1
10,2449001,2518000,68999,False,68,scaffold_1
11,2729001,2746000,16999,False,68,scaffold_1
12,3180001,3208000,27999,False,68,scaffold_1
13,3714001,3738000,23999,False,68,scaffold_1
14,3902001,3941000,38999,False,68,scaffold_1
15,3989001,4027000,37999,False,68,scaffold_1
16,4062001,4112000,49999,False,68,scaffold_1
17,4314001,4355000,40999,False,68,scaffold_1
18,4796001,4813000,16999,False,68,scaffold_1
19,4928001,5022000,93999,False,68,scaffold_1
20,5483001,5512000,28999,False,68,scaffold_1
21,5535001,5573000,37999,False,68,scaffold_1
22,5853001,5875000,21999,False,68,scaffold_1
23,6108001,6153000,44999,False,68,scaffold_1
24,6154001,6176000,21999,False,68,scaffold_1
25,6228001,6535000,306999,False,68,scaffold_1
26,6542001,6559000,16999,False,68,scaffold_1
27,7037001,7247000,209999,False,68,scaffold_1
28,7248001,7588000,339999,False,68,scaffold_1
29,7590001,8477000,886999,False,68,scaffold_1
30,8478001,8656000,177999,False,68,scaffold_1
31,8658001,9584000,925999,False,68,scaffold_1
32,9586001,10363000,776999,False,68,scaffold_1
33,10460001,10637000,176999,False,68,scaffold_1
34,10730001,10763000,32999,False,68,scaffold_1
35,10836001,10858000,21999,False,68,scaffold_1
36,11344001,11509000,164999,False,68,scaffold_1
37,11591001,11951000,359999,False,68,scaffold_1
38,12184001,12204000,19999,False,68,scaffold_1
39,12650001,12722000,71999,False,68,scaffold_1
40,12782001,12889000,106999,False,68,scaffold_1
41,12900001,12949000,48999,False,68,scaffold_1
42,13113001,13211000,97999,False,68,scaffold_1
43,13347001,13429000,81999,False,68,scaffold_1
44,13561001,13583000,21999,False,68,scaffold_1
45,14093001,14095000,1999,False,68,scaffold_1
46,14285001,14313000,27999,False,68,scaffold_1
47,14649001,14663000,13999,False,68,scaffold_1
0,22001,48000,25999,False,68,scaffold_2
1,93001,159000,65999,False,68,scaffold_2
2,165001,177000,11999,False,68,scaffold_2
3,297001,318000,20999,False,68,scaffold_2
4,333001,374000,40999,False,68,scaffold_2
5,2336001,2358000,21999,False,68,scaffold_2
6,2398001,2603000,204999,False,68,scaffold_2
7,2660001,2689000,28999,False,68,scaffold_2
8,2694001,2745000,50999,False,68,scaffold_2
9,2766001,2776000,9999,False,68,scaffold_2
10,2777001,2788000,10999,False,68,scaffold_2
11,2868001,2899000,30999,False,68,scaffold_2
12,2974001,3021000,46999,False,68,scaffold_2
13,3174001,3186000,11999,False,68,scaffold_2
14,3367001,3390000,22999,False,68,scaffold_2
15,3450001,3466000,15999,False,68,scaffold_2
16,3754001,3783000,28999,False,68,scaffold_2
17,4243001,4277000,33999,False,68,scaffold_2
18,4382001,4409000,26999,False,68,scaffold_2
19,4426001,4458000,31999,False,68,scaffold_2
20,4521001,4656000,134999,False,68,scaffold_2
21,4917001,4962000,44999,False,68,scaffold_2
22,5021001,5104000,82999,False,68,scaffold_2
23,5362001,5392000,29999,False,68,scaffold_2
24,5416001,5481000,64999,False,68,scaffold_2
25,5491001,5520000,28999,False,68,scaffold_2
26,5672001,5705000,32999,False,68,scaffold_2
27,5842001,5883000,40999,False,68,scaffold_2
28,6261001,6342000,80999,False,68,scaffold_2
29,6428001,6449000,20999,False,68,scaffold_2
30,6590001,6628000,37999,False,68,scaffold_2
31,7018001,7037000,18999,False,68,scaffold_2
32,7439001,7472000,32999,False,68,scaffold_2
33,7563001,7698000,134999,False,68,scaffold_2
34,7786001,7916000,129999,False,68,scaffold_2
35,7928001,8218000,289999,False,68,scaffold_2
36,8260001,8313000,52999,False,68,scaffold_2
37,8331001,8333000,1999,False,68,scaffold_2
38,8346001,8453000,106999,False,68,scaffold_2
39,8509001,8562000,52999,False,68,scaffold_2
40,9140001,9167000,26999,False,68,scaffold_2
41,11367001,11376000,8999,False,68,scaffold_2
42,11395001,11427000,31999,False,68,scaffold_2
43,11520001,11786000,265999,False,68,scaffold_2
0,1,2000,1999,True,68,scaffold_3
1,528001,539000,10999,False,68,scaffold_3
2,571001,574000,2999,False,68,scaffold_3
3,618001,646000,27999,False,68,scaffold_3
4,798001,904000,105999,False,68,scaffold_3
5,2084001,2108000,23999,False,68,scaffold_3
6,2291001,2335000,43999,False,68,scaffold_3
7,2433001,2533000,99999,False,68,scaffold_3
8,3261001,3273000,11999,False,68,scaffold_3
9,3768001,3821000,52999,False,68,scaffold_3
10,3822001,3859000,36999,False,68,scaffold_3
11,4108001,4397000,288999,False,68,scaffold_3
12,4418001,4517000,98999,False,68,scaffold_3
13,4547001,4558000,10999,False,68,scaffold_3
14,4645001,4682000,36999,False,68,scaffold_3
15,5990001,6020000,29999,False,68,scaffold_3
16,6741001,6780000,38999,False,68,scaffold_3
17,6910001,6962000,51999,False,68,scaffold_3
18,6963001,7088000,124999,False,68,scaffold_3
19,7522001,7556000,33999,False,68,scaffold_3
20,7680001,7798000,117999,False,68,scaffold_3
21,7822001,7841000,18999,False,68,scaffold_3
22,8186001,8253000,66999,False,68,scaffold_3
23,8428001,8527000,98999,False,68,scaffold_3
24,8575001,8596000,20999,False,68,scaffold_3
25,9968001,9995000,26999,False,68,scaffold_3
26,10461001,10484000,22999,False,68,scaffold_3
27,10588001,11168000,579999,False,68,scaffold_3
0,11001,13000,1999,False,68,scaffold_4
1,17001,32000,14999,False,68,scaffold_4
2,49001,88000,38999,False,68,scaffold_4
3,141001,146000,4999,False,68,scaffold_4
4,147001,151000,3999,False,68,scaffold_4
5,155001,160000,4999,False,68,scaffold_4
6,161001,215000,53999,False,68,scaffold_4
7,217001,226000,8999,False,68,scaffold_4
8,227001,266000,38999,False,68,scaffold_4
9,290001,308000,17999,False,68,scaffold_4
10,355001,374000,18999,False,68,scaffold_4
11,375001,380000,4999,False,68,scaffold_4
12,389001,410000,20999,False,68,scaffold_4
13,412001,425000,12999,False,68,scaffold_4
14,429001,505000,75999,False,68,scaffold_4
15,541001,606000,64999,False,68,scaffold_4
16,608001,660000,51999,False,68,scaffold_4
17,672001,691000,18999,False,68,scaffold_4
18,695001,697000,1999,False,68,scaffold_4
19,701001,716000,14999,False,68,scaffold_4
20,1073001,1081000,7999,False,68,scaffold_4
21,1113001,1136000,22999,False,68,scaffold_4
22,1137001,1226000,88999,False,68,scaffold_4
23,1254001,1279000,24999,False,68,scaffold_4
24,1283001,1598000,314999,False,68,scaffold_4
25,1613001,2065000,451999,False,68,scaffold_4
26,2077001,2114000,36999,False,68,scaffold_4
27,2144001,2206000,61999,False,68,scaffold_4
28,2211001,2246000,34999,False,68,scaffold_4
29,2247001,2268000,20999,False,68,scaffold_4
30,2269001,2281000,11999,False,68,scaffold_4
31,2282001,2461000,178999,False,68,scaffold_4
32,2476001,2581000,104999,False,68,scaffold_4
33,2598001,2635000,36999,False,68,scaffold_4
34,3086001,3126000,39999,False,68,scaffold_4
35,3337001,3760000,422999,False,68,scaffold_4
36,4905001,5001000,95999,False,68,scaffold_4
37,5027001,5048000,20999,False,68,scaffold_4
38,5174001,5205000,30999,False,68,scaffold_4
39,5473001,5506000,32999,False,68,scaffold_4
40,5514001,5631000,116999,False,68,scaffold_4
41,5657001,5784000,126999,False,68,scaffold_4
42,6062001,6112000,49999,False,68,scaffold_4
43,6146001,6195000,48999,False,68,scaffold_4
44,6898001,6924000,25999,False,68,scaffold_4
45,7036001,7070000,33999,False,68,scaffold_4
46,7152001,7176000,23999,False,68,scaffold_4
47,7225001,7269000,43999,False,68,scaffold_4
48,7641001,7662000,20999,False,68,scaffold_4
49,7986001,7997000,10999,False,68,scaffold_4
50,8846001,9699000,852999,False,68,scaffold_4
51,9700001,9845951,145950,True,68,scaffold_4
0,318001,386000,67999,False,68,scaffold_5
1,463001,526000,62999,False,68,scaffold_5
2,933001,947000,13999,False,68,scaffold_5
3,1657001,1661000,3999,False,68,scaffold_5
4,2552001,2735000,182999,False,68,scaffold_5
5,2816001,2875000,58999,False,68,scaffold_5
6,3123001,3185000,61999,False,68,scaffold_5
7,3322001,3440000,117999,False,68,scaffold_5
8,3443001,3513000,69999,False,68,scaffold_5
9,3963001,4101000,137999,False,68,scaffold_5
10,4121001,4272000,150999,False,68,scaffold_5
11,4445001,4507000,61999,False,68,scaffold_5
12,4601001,4751000,149999,False,68,scaffold_5
13,4759001,4857000,97999,False,68,scaffold_5
14,4893001,4921000,27999,False,68,scaffold_5
15,5287001,5312000,24999,False,68,scaffold_5
16,5314001,5344000,29999,False,68,scaffold_5
17,6410001,6418000,7999,False,68,scaffold_5
18,6479001,6653000,173999,False,68,scaffold_5
19,7097001,7100000,2999,False,68,scaffold_5
20,7454001,7481000,26999,False,68,scaffold_5
21,7572001,7609000,36999,False,68,scaffold_5
22,7622001,7637000,14999,False,68,scaffold_5
23,8571001,8617000,45999,False,68,scaffold_5
24,8666001,8689000,22999,False,68,scaffold_5
25,8713001,9364176,651175,True,68,scaffold_5
0,78001,114000,35999,False,68,scaffold_6
1,163001,208000,44999,False,68,scaffold_6
2,239001,253000,13999,False,68,scaffold_6
3,264001,287000,22999,False,68,scaffold_6
4,1236001,1258000,21999,False,68,scaffold_6
5,1284001,1311000,26999,False,68,scaffold_6
6,1478001,1579000,100999,False,68,scaffold_6
7,1867001,1902000,34999,False,68,scaffold_6
8,2030001,2099000,68999,False,68,scaffold_6
9,2130001,2190000,59999,False,68,scaffold_6
10,2348001,2595000,246999,False,68,scaffold_6
11,2596001,2653000,56999,False,68,scaffold_6
12,2655001,2872000,216999,False,68,scaffold_6
13,2927001,3015000,87999,False,68,scaffold_6
14,3111001,3176000,64999,False,68,scaffold_6
15,3224001,3363000,138999,False,68,scaffold_6
16,3400001,3432000,31999,False,68,scaffold_6
17,3452001,3785000,332999,False,68,scaffold_6
18,3901001,3911000,9999,False,68,scaffold_6
19,4016001,4072000,55999,False,68,scaffold_6
20,4073001,4194000,120999,False,68,scaffold_6
21,6008001,6078000,69999,False,68,scaffold_6
22,7221001,7248000,26999,False,68,scaffold_6
23,7264001,7337000,72999,False,68,scaffold_6
24,7389001,7481000,91999,False,68,scaffold_6
25,7557001,8268281,711280,True,68,scaffold_6
0,13001,34000,20999,False,68,scaffold_7
1,323001,340000,16999,False,68,scaffold_7
2,342001,508000,165999,False,68,scaffold_7
3,571001,575000,3999,False,68,scaffold_7
4,706001,753000,46999,False,68,scaffold_7
5,764001,809000,44999,False,68,scaffold_7
6,811001,843000,31999,False,68,scaffold_7
7,859001,864000,4999,False,68,scaffold_7
8,868001,872000,3999,False,68,scaffold_7
9,874001,948000,73999,False,68,scaffold_7
10,950001,963000,12999,False,68,scaffold_7
11,964001,966000,1999,False,68,scaffold_7
12,968001,979000,10999,False,68,scaffold_7
13,982001,1044000,61999,False,68,scaffold_7
14,1048001,1100000,51999,False,68,scaffold_7
15,1190001,1512000,321999,False,68,scaffold_7
16,1588001,1689000,100999,False,68,scaffold_7
17,1764001,1782000,17999,False,68,scaffold_7
18,3325001,3369000,43999,False,68,scaffold_7
19,3524001,3550000,25999,False,68,scaffold_7
20,3595001,3766000,170999,False,68,scaffold_7
21,4324001,4361000,36999,False,68,scaffold_7
22,4415001,4518000,102999,False,68,scaffold_7
23,4658001,4735000,76999,False,68,scaffold_7
24,4978001,5150000,171999,False,68,scaffold_7
25,5482001,5533000,50999,False,68,scaffold_7
26,6953001,7270000,316999,False,68,scaffold_7
27,7271001,7502216,231215,True,68,scaffold_7
0,66001,85000,18999,False,68,scaffold_8
1,722001,725000,2999,False,68,scaffold_8
2,2444001,2529000,84999,False,68,scaffold_8
3,2536001,2550000,13999,False,68,scaffold_8
4,2650001,2683000,32999,False,68,scaffold_8
5,2740001,2757000,16999,False,68,scaffold_8
6,2798001,2844000,45999,False,68,scaffold_8
7,3032001,3525000,492999,False,68,scaffold_8
8,3579001,3612000,32999,False,68,scaffold_8
9,3615001,3914000,298999,False,68,scaffold_8
10,4040001,4108000,67999,False,68,scaffold_8
11,4204001,4254000,49999,False,68,scaffold_8
12,5170001,5240000,69999,False,68,scaffold_8
13,5657001,5692000,34999,False,68,scaffold_8
14,6320001,6334544,14543,True,68,scaffold_8
0,109001,118000,8999,False,68,scaffold_9
1,121001,135000,13999,False,68,scaffold_9
2,300001,316000,15999,False,68,scaffold_9
3,319001,330000,10999,False,68,scaffold_9
4,366001,404000,37999,False,68,scaffold_9
5,413001,434000,20999,False,68,scaffold_9
6,484001,531000,46999,False,68,scaffold_9
7,671001,696000,24999,False,68,scaffold_9
8,730001,742000,11999,False,68,scaffold_9
9,815001,842000,26999,False,68,scaffold_9
10,886001,986000,99999,False,68,scaffold_9
11,987001,995000,7999,False,68,scaffold_9
12,1001001,1007000,5999,False,68,scaffold_9
13,1009001,1032000,22999,False,68,scaffold_9
14,1035001,1085000,49999,False,68,scaffold_9
15,1087001,1150000,62999,False,68,scaffold_9
16,1151001,1165000,13999,False,68,scaffold_9
17,1312001,1378000,65999,False,68,scaffold_9
18,1767001,1811000,43999,False,68,scaffold_9
19,1986001,2029000,42999,False,68,scaffold_9
20,2601001,2616000,14999,False,68,scaffold_9
21,2737001,2803000,65999,False,68,scaffold_9
22,2845001,3381000,535999,False,68,scaffold_9
23,3383001,5099000,1715999,False,68,scaffold_9
24,5101001,5107000,5999,False,68,scaffold_9
25,5112001,5115000,2999,False,68,scaffold_9
26,5116001,5237000,120999,False,68,scaffold_9
27,5239001,5298000,58999,False,68,scaffold_9
28,5300001,5490000,189999,False,68,scaffold_9
29,5492001,6331288,839287,True,68,scaffold_9
0,1,200000,199999,True,68,scaffold_10
1,259001,406000,146999,False,68,scaffold_10
2,453001,482000,28999,False,68,scaffold_10
3,483001,582000,98999,False,68,scaffold_10
4,602001,796000,193999,False,68,scaffold_10
5,888001,916000,27999,False,68,scaffold_10
6,924001,962000,37999,False,68,scaffold_10
7,1088001,1112000,23999,False,68,scaffold_10
8,2092001,2102000,9999,False,68,scaffold_10
9,2131001,2167000,35999,False,68,scaffold_10
10,2274001,2290000,15999,False,68,scaffold_10
11,2342001,2368000,25999,False,68,scaffold_10
12,4053001,4093000,39999,False,68,scaffold_10
13,4142001,4149000,6999,False,68,scaffold_10
14,4154001,4174000,19999,False,68,scaffold_10
15,4443001,4462000,18999,False,68,scaffold_10
16,4467001,4477000,9999,False,68,scaffold_10
17,4503001,4513000,9999,False,68,scaffold_10
18,4515001,4523000,7999,False,68,scaffold_10
19,4526001,4548000,21999,False,68,scaffold_10
20,4574001,4596000,21999,False,68,scaffold_10
21,4735001,4766000,30999,False,68,scaffold_10
22,4768001,4776000,7999,False,68,scaffold_10
23,4798001,4824000,25999,False,68,scaffold_10
24,4828001,4845000,16999,False,68,scaffold_10
25,4848001,4861000,12999,False,68,scaffold_10
26,4865001,4866973,1972,True,68,scaffold_10
0,10001,99000,88999,False,68,scaffold_11
1,149001,167000,17999,False,68,scaffold_11
2,169001,194000,24999,False,68,scaffold_11
3,203001,235000,31999,False,68,scaffold_11
4,240001,252000,11999,False,68,scaffold_11
5,296001,314000,17999,False,68,scaffold_11
6,419001,431000,11999,False,68,scaffold_11
7,637001,656000,18999,False,68,scaffold_11
8,781001,785000,3999,False,68,scaffold_11
9,883001,886000,2999,False,68,scaffold_11
10,1025001,1034000,8999,False,68,scaffold_11
11,1474001,1477000,2999,False,68,scaffold_11
12,2076001,2078000,1999,False,68,scaffold_11
13,2700001,2873000,172999,False,68,scaffold_11
14,2983001,3011000,27999,False,68,scaffold_11
15,3096001,3134000,37999,False,68,scaffold_11
16,3188001,3296000,107999,False,68,scaffold_11
17,3331001,3383000,51999,False,68,scaffold_11
18,3672001,3929000,256999,False,68,scaffold_11
19,4006001,4070000,63999,False,68,scaffold_11
20,4134001,4156000,21999,False,68,scaffold_11
21,4260001,4710000,449999,False,68,scaffold_11
22,4713001,4766820,53819,True,68,scaffold_11
0,1,1486000,1485999,True,68,scaffold_12
1,1719001,1733000,13999,False,68,scaffold_12
2,2069001,2083000,13999,False,68,scaffold_12
3,2571001,2612000,40999,False,68,scaffold_12
4,2673001,2682000,8999,False,68,scaffold_12
0,1,342000,341999,True,69,scaffold_1
1,482001,498000,15999,False,69,scaffold_1
2,572001,643000,70999,False,69,scaffold_1
3,686001,750000,63999,False,69,scaffold_1
4,1281001,1292000,10999,False,69,scaffold_1
5,1814001,1898000,83999,False,69,scaffold_1
6,1952001,1964000,11999,False,69,scaffold_1
7,1965001,1984000,18999,False,69,scaffold_1
8,2449001,2520000,70999,False,69,scaffold_1
9,2729001,2746000,16999,False,69,scaffold_1
10,3175001,3209000,33999,False,69,scaffold_1
11,3714001,3734000,19999,False,69,scaffold_1
12,3915001,3941000,25999,False,69,scaffold_1
13,4004001,4026000,21999,False,69,scaffold_1
14,4062001,4112000,49999,False,69,scaffold_1
15,4323001,4355000,31999,False,69,scaffold_1
16,4796001,4810000,13999,False,69,scaffold_1
17,4928001,5022000,93999,False,69,scaffold_1
18,5483001,5511000,27999,False,69,scaffold_1
19,5537001,5569000,31999,False,69,scaffold_1
20,6108001,6153000,44999,False,69,scaffold_1
21,6154001,6176000,21999,False,69,scaffold_1
22,6220001,6380000,159999,False,69,scaffold_1
23,6384001,6509000,124999,False,69,scaffold_1
24,6542001,6567000,24999,False,69,scaffold_1
25,7038001,7247000,208999,False,69,scaffold_1
26,7248001,7583000,334999,False,69,scaffold_1
27,7590001,8477000,886999,False,69,scaffold_1
28,8478001,8656000,177999,False,69,scaffold_1
29,8658001,9584000,925999,False,69,scaffold_1
30,9586001,10356000,769999,False,69,scaffold_1
31,10460001,10639000,178999,False,69,scaffold_1
32,10808001,10811000,2999,False,69,scaffold_1
33,10832001,10857000,24999,False,69,scaffold_1
34,11346001,11504000,157999,False,69,scaffold_1
35,11609001,11954000,344999,False,69,scaffold_1
36,12184001,12204000,19999,False,69,scaffold_1
37,12664001,12722000,57999,False,69,scaffold_1
38,12777001,12888000,110999,False,69,scaffold_1
39,13113001,13211000,97999,False,69,scaffold_1
40,13347001,13382000,34999,False,69,scaffold_1
41,13393001,13403000,9999,False,69,scaffold_1
42,14007001,14009000,1999,False,69,scaffold_1
43,14285001,14309000,23999,False,69,scaffold_1
44,14471001,14479000,7999,False,69,scaffold_1
0,20001,48000,27999,False,69,scaffold_2
1,95001,159000,63999,False,69,scaffold_2
2,168001,177000,8999,False,69,scaffold_2
3,297001,318000,20999,False,69,scaffold_2
4,332001,374000,41999,False,69,scaffold_2
5,2336001,2358000,21999,False,69,scaffold_2
6,2398001,2424000,25999,False,69,scaffold_2
7,2441001,2553000,111999,False,69,scaffold_2
8,2645001,2689000,43999,False,69,scaffold_2
9,2694001,2744000,49999,False,69,scaffold_2
10,2868001,2898000,29999,False,69,scaffold_2
11,2993001,3013000,19999,False,69,scaffold_2
12,3450001,3467000,16999,False,69,scaffold_2
13,3766001,3782000,15999,False,69,scaffold_2
14,4383001,4409000,25999,False,69,scaffold_2
15,4426001,4457000,30999,False,69,scaffold_2
16,4521001,4554000,32999,False,69,scaffold_2
17,4593001,4658000,64999,False,69,scaffold_2
18,4918001,4937000,18999,False,69,scaffold_2
19,5021001,5061000,39999,False,69,scaffold_2
20,5460001,5471000,10999,False,69,scaffold_2
21,5491001,5511000,19999,False,69,scaffold_2
22,5663001,5704000,40999,False,69,scaffold_2
23,5719001,5758000,38999,False,69,scaffold_2
24,6261001,6330000,68999,False,69,scaffold_2
25,6331001,6350000,18999,False,69,scaffold_2
26,6404001,6449000,44999,False,69,scaffold_2
27,6610001,6627000,16999,False,69,scaffold_2
28,7019001,7036000,16999,False,69,scaffold_2
29,7439001,7472000,32999,False,69,scaffold_2
30,7563001,7697000,133999,False,69,scaffold_2
31,7786001,7890000,103999,False,69,scaffold_2
32,7934001,8115000,180999,False,69,scaffold_2
33,8268001,8293000,24999,False,69,scaffold_2
34,8331001,8333000,1999,False,69,scaffold_2
35,8346001,8391000,44999,False,69,scaffold_2
36,8437001,8449000,11999,False,69,scaffold_2
37,8509001,8559000,49999,False,69,scaffold_2
38,11366001,11375000,8999,False,69,scaffold_2
39,11520001,11785000,264999,False,69,scaffold_2
0,1,2000,1999,True,69,scaffold_3
1,51001,55000,3999,False,69,scaffold_3
2,800001,900000,99999,False,69,scaffold_3
3,2061001,2108000,46999,False,69,scaffold_3
4,2291001,2321000,29999,False,69,scaffold_3
5,2487001,2533000,45999,False,69,scaffold_3
6,3826001,3874000,47999,False,69,scaffold_3
7,4108001,4403000,294999,False,69,scaffold_3
8,4410001,4518000,107999,False,69,scaffold_3
9,4546001,4558000,11999,False,69,scaffold_3
10,4643001,4680000,36999,False,69,scaffold_3
11,5493001,5509000,15999,False,69,scaffold_3
12,5990001,6009000,18999,False,69,scaffold_3
13,6760001,6782000,21999,False,69,scaffold_3
14,6910001,6962000,51999,False,69,scaffold_3
15,6963001,6968000,4999,False,69,scaffold_3
16,6979001,7087000,107999,False,69,scaffold_3
17,7483001,7491000,7999,False,69,scaffold_3
18,7523001,7556000,32999,False,69,scaffold_3
19,7692001,7798000,105999,False,69,scaffold_3
20,7819001,7852000,32999,False,69,scaffold_3
21,8176001,8253000,76999,False,69,scaffold_3
22,8462001,8527000,64999,False,69,scaffold_3
23,8575001,8594000,18999,False,69,scaffold_3
24,9968001,9996000,27999,False,69,scaffold_3
25,10461001,10484000,22999,False,69,scaffold_3
26,10587001,11165000,577999,False,69,scaffold_3
0,17001,32000,14999,False,69,scaffold_4
1,48001,88000,39999,False,69,scaffold_4
2,155001,160000,4999,False,69,scaffold_4
3,161001,215000,53999,False,69,scaffold_4
4,217001,226000,8999,False,69,scaffold_4
5,227001,266000,38999,False,69,scaffold_4
6,318001,344000,25999,False,69,scaffold_4
7,355001,374000,18999,False,69,scaffold_4
8,375001,380000,4999,False,69,scaffold_4
9,390001,410000,19999,False,69,scaffold_4
10,412001,425000,12999,False,69,scaffold_4
11,429001,504000,74999,False,69,scaffold_4
12,545001,592000,46999,False,69,scaffold_4
13,593001,606000,12999,False,69,scaffold_4
14,608001,691000,82999,False,69,scaffold_4
15,1121001,1136000,14999,False,69,scaffold_4
16,1137001,1198000,60999,False,69,scaffold_4
17,1199001,1208000,8999,False,69,scaffold_4
18,1209001,1226000,16999,False,69,scaffold_4
19,1229001,1231000,1999,False,69,scaffold_4
20,1235001,1253000,17999,False,69,scaffold_4
21,1254001,1262000,7999,False,69,scaffold_4
22,1265001,1279000,13999,False,69,scaffold_4
23,1283001,1320000,36999,False,69,scaffold_4
24,1362001,1597000,234999,False,69,scaffold_4
25,1613001,1709000,95999,False,69,scaffold_4
26,1731001,1849000,117999,False,69,scaffold_4
27,1850001,1957000,106999,False,69,scaffold_4
28,1958001,2006000,47999,False,69,scaffold_4
29,2016001,2065000,48999,False,69,scaffold_4
30,2071001,2117000,45999,False,69,scaffold_4
31,2211001,2218000,6999,False,69,scaffold_4
32,2219001,2246000,26999,False,69,scaffold_4
33,2284001,2310000,25999,False,69,scaffold_4
34,2312001,2339000,26999,False,69,scaffold_4
35,2397001,2460000,62999,False,69,scaffold_4
36,2476001,2635000,158999,False,69,scaffold_4
37,3336001,3633000,296999,False,69,scaffold_4
38,3646001,3761000,114999,False,69,scaffold_4
39,4901001,4999000,97999,False,69,scaffold_4
40,5173001,5207000,33999,False,69,scaffold_4
41,5477001,5506000,28999,False,69,scaffold_4
42,5514001,5620000,105999,False,69,scaffold_4
43,5657001,5784000,126999,False,69,scaffold_4
44,5785001,5817000,31999,False,69,scaffold_4
45,6145001,6193000,47999,False,69,scaffold_4
46,6904001,6924000,19999,False,69,scaffold_4
47,6974001,6993000,18999,False,69,scaffold_4
48,7036001,7062000,25999,False,69,scaffold_4
49,8846001,9699000,852999,False,69,scaffold_4
50,9700001,9845951,145950,True,69,scaffold_4
0,1,4000,3999,True,69,scaffold_5
1,178001,180000,1999,False,69,scaffold_5
2,189001,204000,14999,False,69,scaffold_5
3,318001,383000,64999,False,69,scaffold_5
4,469001,479000,9999,False,69,scaffold_5
5,506001,523000,16999,False,69,scaffold_5
6,933001,947000,13999,False,69,scaffold_5
7,2562001,2583000,20999,False,69,scaffold_5
8,2618001,2738000,119999,False,69,scaffold_5
9,2816001,2871000,54999,False,69,scaffold_5
10,3133001,3185000,51999,False,69,scaffold_5
11,3219001,3247000,27999,False,69,scaffold_5
12,3300001,3438000,137999,False,69,scaffold_5
13,3451001,3512000,60999,False,69,scaffold_5
14,3618001,3657000,38999,False,69,scaffold_5
15,3962001,4101000,138999,False,69,scaffold_5
16,4120001,4219000,98999,False,69,scaffold_5
17,4246001,4265000,18999,False,69,scaffold_5
18,4446001,4505000,58999,False,69,scaffold_5
19,4601001,4682000,80999,False,69,scaffold_5
20,4688001,4730000,41999,False,69,scaffold_5
21,4764001,4861000,96999,False,69,scaffold_5
22,4892001,4921000,28999,False,69,scaffold_5
23,5285001,5312000,26999,False,69,scaffold_5
24,5314001,5346000,31999,False,69,scaffold_5
25,6505001,6627000,121999,False,69,scaffold_5
26,7373001,7386000,12999,False,69,scaffold_5
27,7561001,7619000,57999,False,69,scaffold_5
28,7621001,7657000,35999,False,69,scaffold_5
29,8580001,8593000,12999,False,69,scaffold_5
30,8670001,8689000,18999,False,69,scaffold_5
31,8730001,9363000,632999,False,69,scaffold_5
0,79001,112000,32999,False,69,scaffold_6
1,240001,254000,13999,False,69,scaffold_6
2,257001,262000,4999,False,69,scaffold_6
3,367001,376000,8999,False,69,scaffold_6
4,1235001,1257000,21999,False,69,scaffold_6
5,1478001,1548000,69999,False,69,scaffold_6
6,1873001,1896000,22999,False,69,scaffold_6
7,2023001,2087000,63999,False,69,scaffold_6
8,2130001,2186000,55999,False,69,scaffold_6
9,2345001,2595000,249999,False,69,scaffold_6
10,2596001,2654000,57999,False,69,scaffold_6
11,2655001,2852000,196999,False,69,scaffold_6
12,2933001,3015000,81999,False,69,scaffold_6
13,3115001,3149000,33999,False,69,scaffold_6
14,3224001,3314000,89999,False,69,scaffold_6
15,3404001,3429000,24999,False,69,scaffold_6
16,3461001,3766000,304999,False,69,scaffold_6
17,3901001,3912000,10999,False,69,scaffold_6
18,4018001,4066000,47999,False,69,scaffold_6
19,4081001,4195000,113999,False,69,scaffold_6
20,6010001,6064000,53999,False,69,scaffold_6
21,7263001,7337000,73999,False,69,scaffold_6
22,7556001,8268281,712280,True,69,scaffold_6
0,14001,34000,19999,False,69,scaffold_7
1,323001,340000,16999,False,69,scaffold_7
2,342001,508000,165999,False,69,scaffold_7
3,554001,563000,8999,False,69,scaffold_7
4,571001,577000,5999,False,69,scaffold_7
5,706001,724000,17999,False,69,scaffold_7
6,725001,736000,10999,False,69,scaffold_7
7,764001,829000,64999,False,69,scaffold_7
8,859001,864000,4999,False,69,scaffold_7
9,951001,963000,11999,False,69,scaffold_7
10,964001,966000,1999,False,69,scaffold_7
11,968001,979000,10999,False,69,scaffold_7
12,982001,1044000,61999,False,69,scaffold_7
13,1048001,1098000,49999,False,69,scaffold_7
14,1138001,1147000,8999,False,69,scaffold_7
15,1191001,1459000,267999,False,69,scaffold_7
16,1461001,1512000,50999,False,69,scaffold_7
17,1588001,1689000,100999,False,69,scaffold_7
18,3325001,3370000,44999,False,69,scaffold_7
19,3595001,3766000,170999,False,69,scaffold_7
20,4416001,4535000,118999,False,69,scaffold_7
21,4658001,4735000,76999,False,69,scaffold_7
22,4979001,5149000,169999,False,69,scaffold_7
23,5472001,5536000,63999,False,69,scaffold_7
24,5609001,5627000,17999,False,69,scaffold_7
25,6955001,7502216,547215,True,69,scaffold_7
0,67001,85000,17999,False,69,scaffold_8
1,93001,101000,7999,False,69,scaffold_8
2,722001,724000,1999,False,69,scaffold_8
3,2444001,2470000,25999,False,69,scaffold_8
4,2491001,2530000,38999,False,69,scaffold_8
5,2537001,2548000,10999,False,69,scaffold_8
6,2652001,2683000,30999,False,69,scaffold_8
7,2745001,2756000,10999,False,69,scaffold_8
8,2799001,2844000,44999,False,69,scaffold_8
9,3058001,3525000,466999,False,69,scaffold_8
10,3584001,3612000,27999,False,69,scaffold_8
11,3615001,3913000,297999,False,69,scaffold_8
12,4039001,4095000,55999,False,69,scaffold_8
13,5096001,5136000,39999,False,69,scaffold_8
14,5198001,5241000,42999,False,69,scaffold_8
15,6326001,6334544,8543,True,69,scaffold_8
0,109001,117000,7999,False,69,scaffold_9
1,121001,135000,13999,False,69,scaffold_9
2,303001,315000,11999,False,69,scaffold_9
3,319001,334000,14999,False,69,scaffold_9
4,367001,404000,36999,False,69,scaffold_9
5,413001,434000,20999,False,69,scaffold_9
6,503001,531000,27999,False,69,scaffold_9
7,670001,696000,25999,False,69,scaffold_9
8,732001,742000,9999,False,69,scaffold_9
9,794001,803000,8999,False,69,scaffold_9
10,815001,842000,26999,False,69,scaffold_9
11,873001,986000,112999,False,69,scaffold_9
12,987001,995000,7999,False,69,scaffold_9
13,1001001,1007000,5999,False,69,scaffold_9
14,1009001,1031000,21999,False,69,scaffold_9
15,1035001,1085000,49999,False,69,scaffold_9
16,1087001,1150000,62999,False,69,scaffold_9
17,1151001,1175000,23999,False,69,scaffold_9
18,1313001,1377000,63999,False,69,scaffold_9
19,1487001,1499000,11999,False,69,scaffold_9
20,1766001,1791000,24999,False,69,scaffold_9
21,2148001,2171000,22999,False,69,scaffold_9
22,2601001,2616000,14999,False,69,scaffold_9
23,2739001,2757000,17999,False,69,scaffold_9
24,2770001,2808000,37999,False,69,scaffold_9
25,2872001,3381000,508999,False,69,scaffold_9
26,3383001,5107000,1723999,False,69,scaffold_9
27,5112001,5114000,1999,False,69,scaffold_9
28,5116001,5238000,121999,False,69,scaffold_9
29,5239001,5298000,58999,False,69,scaffold_9
30,5300001,5490000,189999,False,69,scaffold_9
31,5493001,6331288,838287,True,69,scaffold_9
0,1,233000,232999,True,69,scaffold_10
1,278001,406000,127999,False,69,scaffold_10
2,426001,482000,55999,False,69,scaffold_10
3,483001,582000,98999,False,69,scaffold_10
4,603001,756000,152999,False,69,scaffold_10
5,888001,962000,73999,False,69,scaffold_10
6,1073001,1111000,37999,False,69,scaffold_10
7,2346001,2367000,20999,False,69,scaffold_10
8,4054001,4091000,36999,False,69,scaffold_10
9,4154001,4174000,19999,False,69,scaffold_10
10,4444001,4458000,13999,False,69,scaffold_10
11,4503001,4513000,9999,False,69,scaffold_10
12,4515001,4523000,7999,False,69,scaffold_10
13,4526001,4548000,21999,False,69,scaffold_10
14,4575001,4596000,20999,False,69,scaffold_10
15,4681001,4688000,6999,False,69,scaffold_10
16,4734001,4766000,31999,False,69,scaffold_10
17,4769001,4776000,6999,False,69,scaffold_10
18,4798001,4824000,25999,False,69,scaffold_10
19,4828001,4843000,14999,False,69,scaffold_10
20,4848001,4861000,12999,False,69,scaffold_10
21,4865001,4866973,1972,True,69,scaffold_10
0,10001,34000,23999,False,69,scaffold_11
1,40001,93000,52999,False,69,scaffold_11
2,149001,167000,17999,False,69,scaffold_11
3,169001,191000,21999,False,69,scaffold_11
4,213001,235000,21999,False,69,scaffold_11
5,240001,248000,7999,False,69,scaffold_11
6,419001,431000,11999,False,69,scaffold_11
7,648001,656000,7999,False,69,scaffold_11
8,949001,951000,1999,False,69,scaffold_11
9,1025001,1034000,8999,False,69,scaffold_11
10,1423001,1426000,2999,False,69,scaffold_11
11,1474001,1477000,2999,False,69,scaffold_11
12,2701001,2877000,175999,False,69,scaffold_11
13,2983001,3015000,31999,False,69,scaffold_11
14,3188001,3262000,73999,False,69,scaffold_11
15,3328001,3383000,54999,False,69,scaffold_11
16,3550001,3577000,26999,False,69,scaffold_11
17,3702001,3926000,223999,False,69,scaffold_11
18,4134001,4159000,24999,False,69,scaffold_11
19,4189001,4247000,57999,False,69,scaffold_11
20,4301001,4710000,408999,False,69,scaffold_11
21,4713001,4766820,53819,True,69,scaffold_11
0,1,370000,369999,True,69,scaffold_12
1,404001,538000,133999,False,69,scaffold_12
2,581001,1450000,868999,False,69,scaffold_12
3,1720001,1733000,12999,False,69,scaffold_12
4,2072001,2087000,14999,False,69,scaffold_12
5,2571001,2617000,45999,False,69,scaffold_12
6,2685001,2699000,13999,False,69,scaffold_12
7,2747001,2747968,967,True,69,scaffold_12
0,1,342000,341999,True,70,scaffold_1
1,482001,499000,16999,False,70,scaffold_1
2,571001,643000,71999,False,70,scaffold_1
3,686001,743000,56999,False,70,scaffold_1
4,1281001,1292000,10999,False,70,scaffold_1
5,1615001,1660000,44999,False,70,scaffold_1
6,1814001,1898000,83999,False,70,scaffold_1
7,1954001,1964000,9999,False,70,scaffold_1
8,1965001,1984000,18999,False,70,scaffold_1
9,1988001,1993000,4999,False,70,scaffold_1
10,2449001,2517000,67999,False,70,scaffold_1
11,2729001,2746000,16999,False,70,scaffold_1
12,3173001,3210000,36999,False,70,scaffold_1
13,3712001,3736000,23999,False,70,scaffold_1
14,3910001,3941000,30999,False,70,scaffold_1
15,4060001,4112000,51999,False,70,scaffold_1
16,4314001,4354000,39999,False,70,scaffold_1
17,4928001,4999000,70999,False,70,scaffold_1
18,5481001,5511000,29999,False,70,scaffold_1
19,5535001,5570000,34999,False,70,scaffold_1
20,6108001,6176000,67999,False,70,scaffold_1
21,6228001,6381000,152999,False,70,scaffold_1
22,6384001,6509000,124999,False,70,scaffold_1
23,6543001,6567000,23999,False,70,scaffold_1
24,7038001,7247000,208999,False,70,scaffold_1
25,7248001,7589000,340999,False,70,scaffold_1
26,7590001,8477000,886999,False,70,scaffold_1
27,8478001,8656000,177999,False,70,scaffold_1
28,8658001,9584000,925999,False,70,scaffold_1
29,9586001,10356000,769999,False,70,scaffold_1
30,10461001,10636000,174999,False,70,scaffold_1
31,10808001,10811000,2999,False,70,scaffold_1
32,10840001,10856000,15999,False,70,scaffold_1
33,11351001,11504000,152999,False,70,scaffold_1
34,11558001,11575000,16999,False,70,scaffold_1
35,11614001,11951000,336999,False,70,scaffold_1
36,12184001,12204000,19999,False,70,scaffold_1
37,12658001,12722000,63999,False,70,scaffold_1
38,12777001,12888000,110999,False,70,scaffold_1
39,13113001,13211000,97999,False,70,scaffold_1
40,13347001,13404000,56999,False,70,scaffold_1
41,14007001,14009000,1999,False,70,scaffold_1
42,14200001,14204000,3999,False,70,scaffold_1
43,14286001,14308000,21999,False,70,scaffold_1
0,7001,40000,32999,False,70,scaffold_2
1,42001,48000,5999,False,70,scaffold_2
2,117001,159000,41999,False,70,scaffold_2
3,168001,177000,8999,False,70,scaffold_2
4,296001,318000,21999,False,70,scaffold_2
5,332001,374000,41999,False,70,scaffold_2
6,2336001,2358000,21999,False,70,scaffold_2
7,2405001,2609000,203999,False,70,scaffold_2
8,2660001,2689000,28999,False,70,scaffold_2
9,2694001,2745000,50999,False,70,scaffold_2
10,2844001,2852000,7999,False,70,scaffold_2
11,2878001,2902000,23999,False,70,scaffold_2
12,2989001,3021000,31999,False,70,scaffold_2
13,3451001,3466000,14999,False,70,scaffold_2
14,3754001,3783000,28999,False,70,scaffold_2
15,4335001,4366000,30999,False,70,scaffold_2
16,4382001,4409000,26999,False,70,scaffold_2
17,4426001,4457000,30999,False,70,scaffold_2
18,4520001,4657000,136999,False,70,scaffold_2
19,4781001,4790000,8999,False,70,scaffold_2
20,4793001,4798000,4999,False,70,scaffold_2
21,4918001,4956000,37999,False,70,scaffold_2
22,5020001,5061000,40999,False,70,scaffold_2
23,5290001,5300000,9999,False,70,scaffold_2
24,5370001,5392000,21999,False,70,scaffold_2
25,5444001,5515000,70999,False,70,scaffold_2
26,5659001,5704000,44999,False,70,scaffold_2
27,5718001,5757000,38999,False,70,scaffold_2
28,5840001,5887000,46999,False,70,scaffold_2
29,6261001,6330000,68999,False,70,scaffold_2
30,6331001,6350000,18999,False,70,scaffold_2
31,6411001,6449000,37999,False,70,scaffold_2
32,6591001,6628000,36999,False,70,scaffold_2
33,7019001,7038000,18999,False,70,scaffold_2
34,7134001,7221000,86999,False,70,scaffold_2
35,7351001,7472000,120999,False,70,scaffold_2
36,7550001,7561000,10999,False,70,scaffold_2
37,7563001,7698000,134999,False,70,scaffold_2
38,7786001,7920000,133999,False,70,scaffold_2
39,7928001,7967000,38999,False,70,scaffold_2
40,7983001,8174000,190999,False,70,scaffold_2
41,8261001,8297000,35999,False,70,scaffold_2
42,8331001,8333000,1999,False,70,scaffold_2
43,8342001,8344000,1999,False,70,scaffold_2
44,8346001,8454000,107999,False,70,scaffold_2
45,8509001,8562000,52999,False,70,scaffold_2
46,9602001,9624000,21999,False,70,scaffold_2
47,9927001,9944000,16999,False,70,scaffold_2
48,11520001,11786000,265999,False,70,scaffold_2
0,1,2000,1999,True,70,scaffold_3
1,51001,55000,3999,False,70,scaffold_3
2,618001,646000,27999,False,70,scaffold_3
3,799001,901000,101999,False,70,scaffold_3
4,2027001,2108000,80999,False,70,scaffold_3
5,2291001,2322000,30999,False,70,scaffold_3
6,2486001,2533000,46999,False,70,scaffold_3
7,3768001,3821000,52999,False,70,scaffold_3
8,3822001,3894000,71999,False,70,scaffold_3
9,4104001,4403000,298999,False,70,scaffold_3
10,4410001,4521000,110999,False,70,scaffold_3
11,4546001,4558000,11999,False,70,scaffold_3
12,4567001,4578000,10999,False,70,scaffold_3
13,4582001,4598000,15999,False,70,scaffold_3
14,4648001,4681000,32999,False,70,scaffold_3
15,6759001,6785000,25999,False,70,scaffold_3
16,6910001,6962000,51999,False,70,scaffold_3
17,6963001,7097000,133999,False,70,scaffold_3
18,7508001,7556000,47999,False,70,scaffold_3
19,7692001,7857000,164999,False,70,scaffold_3
20,8177001,8253000,75999,False,70,scaffold_3
21,8462001,8527000,64999,False,70,scaffold_3
22,8575001,8594000,18999,False,70,scaffold_3
23,9968001,9996000,27999,False,70,scaffold_3
24,10461001,10484000,22999,False,70,scaffold_3
25,10552001,10571000,18999,False,70,scaffold_3
26,10575001,11165000,589999,False,70,scaffold_3
0,17001,29000,11999,False,70,scaffold_4
1,30001,32000,1999,False,70,scaffold_4
2,48001,88000,39999,False,70,scaffold_4
3,129001,151000,21999,False,70,scaffold_4
4,155001,215000,59999,False,70,scaffold_4
5,217001,226000,8999,False,70,scaffold_4
6,227001,266000,38999,False,70,scaffold_4
7,294001,310000,15999,False,70,scaffold_4
8,313001,344000,30999,False,70,scaffold_4
9,355001,374000,18999,False,70,scaffold_4
10,375001,380000,4999,False,70,scaffold_4
11,389001,410000,20999,False,70,scaffold_4
12,412001,425000,12999,False,70,scaffold_4
13,429001,502000,72999,False,70,scaffold_4
14,544001,606000,61999,False,70,scaffold_4
15,608001,691000,82999,False,70,scaffold_4
16,701001,714000,12999,False,70,scaffold_4
17,735001,741000,5999,False,70,scaffold_4
18,1113001,1136000,22999,False,70,scaffold_4
19,1137001,1179000,41999,False,70,scaffold_4
20,1199001,1208000,8999,False,70,scaffold_4
21,1210001,1226000,15999,False,70,scaffold_4
22,1235001,1246000,10999,False,70,scaffold_4
23,1248001,1253000,4999,False,70,scaffold_4
24,1254001,1262000,7999,False,70,scaffold_4
25,1265001,1279000,13999,False,70,scaffold_4
26,1283001,1336000,52999,False,70,scaffold_4
27,1371001,1605000,233999,False,70,scaffold_4
28,1613001,1869000,255999,False,70,scaffold_4
29,1904001,2066000,161999,False,70,scaffold_4
30,2073001,2117000,43999,False,70,scaffold_4
31,2211001,2218000,6999,False,70,scaffold_4
32,2219001,2229000,9999,False,70,scaffold_4
33,2251001,2280000,28999,False,70,scaffold_4
34,2284001,2340000,55999,False,70,scaffold_4
35,2342001,2352000,9999,False,70,scaffold_4
36,2398001,2445000,46999,False,70,scaffold_4
37,2447001,2461000,13999,False,70,scaffold_4
38,2476001,2635000,158999,False,70,scaffold_4
39,3336001,3760000,423999,False,70,scaffold_4
40,4908001,5061000,152999,False,70,scaffold_4
41,5174001,5208000,33999,False,70,scaffold_4
42,5476001,5506000,29999,False,70,scaffold_4
43,5515001,5630000,114999,False,70,scaffold_4
44,5655001,5784000,128999,False,70,scaffold_4
45,5786001,5818000,31999,False,70,scaffold_4
46,6145001,6196000,50999,False,70,scaffold_4
47,6797001,6817000,19999,False,70,scaffold_4
48,6902001,6924000,21999,False,70,scaffold_4
49,6969001,6995000,25999,False,70,scaffold_4
50,7036001,7079000,42999,False,70,scaffold_4
51,8843001,9699000,855999,False,70,scaffold_4
52,9700001,9845951,145950,True,70,scaffold_4
0,1,4000,3999,True,70,scaffold_5
1,327001,401000,73999,False,70,scaffold_5
2,402001,415000,12999,False,70,scaffold_5
3,462001,523000,60999,False,70,scaffold_5
4,669001,679000,9999,False,70,scaffold_5
5,933001,947000,13999,False,70,scaffold_5
6,1062001,1068000,5999,False,70,scaffold_5
7,2562001,2734000,171999,False,70,scaffold_5
8,2813001,2871000,57999,False,70,scaffold_5
9,3133001,3185000,51999,False,70,scaffold_5
10,3217001,3252000,34999,False,70,scaffold_5
11,3309001,3503000,193999,False,70,scaffold_5
12,3621001,3657000,35999,False,70,scaffold_5
13,3962001,4101000,138999,False,70,scaffold_5
14,4121001,4221000,99999,False,70,scaffold_5
15,4232001,4271000,38999,False,70,scaffold_5
16,4446001,4505000,58999,False,70,scaffold_5
17,4600001,4681000,80999,False,70,scaffold_5
18,4690001,4862000,171999,False,70,scaffold_5
19,4892001,4918000,25999,False,70,scaffold_5
20,5318001,5346000,27999,False,70,scaffold_5
21,6407001,6420000,12999,False,70,scaffold_5
22,6509001,6630000,120999,False,70,scaffold_5
23,7373001,7387000,13999,False,70,scaffold_5
24,7454001,7483000,28999,False,70,scaffold_5
25,7547001,7617000,69999,False,70,scaffold_5
26,7621001,7648000,26999,False,70,scaffold_5
27,8573001,8615000,41999,False,70,scaffold_5
28,8674001,8689000,14999,False,70,scaffold_5
29,8730001,9363000,632999,False,70,scaffold_5
30,9364001,9364176,175,True,70,scaffold_5
0,79001,84000,4999,False,70,scaffold_6
1,86001,114000,27999,False,70,scaffold_6
2,172001,197000,24999,False,70,scaffold_6
3,239001,253000,13999,False,70,scaffold_6
4,555001,568000,12999,False,70,scaffold_6
5,569001,574000,4999,False,70,scaffold_6
6,1229001,1264000,34999,False,70,scaffold_6
7,1479001,1546000,66999,False,70,scaffold_6
8,2023001,2085000,61999,False,70,scaffold_6
9,2129001,2196000,66999,False,70,scaffold_6
10,2242001,2281000,38999,False,70,scaffold_6
11,2336001,2595000,258999,False,70,scaffold_6
12,2596001,2653000,56999,False,70,scaffold_6
13,2660001,2851000,190999,False,70,scaffold_6
14,2934001,3026000,91999,False,70,scaffold_6
15,3103001,3174000,70999,False,70,scaffold_6
16,3222001,3301000,78999,False,70,scaffold_6
17,3399001,3429000,29999,False,70,scaffold_6
18,3454001,3806000,351999,False,70,scaffold_6
19,3899001,3913000,13999,False,70,scaffold_6
20,4017001,4072000,54999,False,70,scaffold_6
21,4073001,4193000,119999,False,70,scaffold_6
22,6004001,6078000,73999,False,70,scaffold_6
23,7263001,7342000,78999,False,70,scaffold_6
24,7389001,7436000,46999,False,70,scaffold_6
25,7549001,8268281,719280,True,70,scaffold_6
0,1,9000,8999,True,70,scaffold_7
1,13001,34000,20999,False,70,scaffold_7
2,323001,340000,16999,False,70,scaffold_7
3,342001,508000,165999,False,70,scaffold_7
4,571001,577000,5999,False,70,scaffold_7
5,706001,736000,29999,False,70,scaffold_7
6,764001,829000,64999,False,70,scaffold_7
7,830001,843000,12999,False,70,scaffold_7
8,859001,864000,4999,False,70,scaffold_7
9,865001,872000,6999,False,70,scaffold_7
10,875001,929000,53999,False,70,scaffold_7
11,964001,966000,1999,False,70,scaffold_7
12,982001,1044000,61999,False,70,scaffold_7
13,1048001,1101000,52999,False,70,scaffold_7
14,1203001,1512000,308999,False,70,scaffold_7
15,1588001,1695000,106999,False,70,scaffold_7
16,3325001,3370000,44999,False,70,scaffold_7
17,3524001,3789000,264999,False,70,scaffold_7
18,4415001,4535000,119999,False,70,scaffold_7
19,4631001,4737000,105999,False,70,scaffold_7
20,4979001,5149000,169999,False,70,scaffold_7
21,5483001,5516000,32999,False,70,scaffold_7
22,5520001,5534000,13999,False,70,scaffold_7
23,5609001,5627000,17999,False,70,scaffold_7
24,5666001,5674000,7999,False,70,scaffold_7
25,6954001,7270000,315999,False,70,scaffold_7
26,7271001,7502216,231215,True,70,scaffold_7
0,66001,85000,18999,False,70,scaffold_8
1,2414001,2531000,116999,False,70,scaffold_8
2,2536001,2552000,15999,False,70,scaffold_8
3,2652001,2683000,30999,False,70,scaffold_8
4,2746001,2756000,9999,False,70,scaffold_8
5,2798001,2844000,45999,False,70,scaffold_8
6,3059001,3125000,65999,False,70,scaffold_8
7,3126001,3549000,422999,False,70,scaffold_8
8,3580001,3612000,31999,False,70,scaffold_8
9,3615001,3946000,330999,False,70,scaffold_8
10,4036001,4102000,65999,False,70,scaffold_8
11,4206001,4220000,13999,False,70,scaffold_8
12,4400001,4430000,29999,False,70,scaffold_8
13,5093001,5137000,43999,False,70,scaffold_8
14,5197001,5241000,43999,False,70,scaffold_8
15,6323001,6334544,11543,True,70,scaffold_8
0,109001,118000,8999,False,70,scaffold_9
1,121001,134000,12999,False,70,scaffold_9
2,303001,316000,12999,False,70,scaffold_9
3,319001,336000,16999,False,70,scaffold_9
4,366001,411000,44999,False,70,scaffold_9
5,413001,434000,20999,False,70,scaffold_9
6,501001,531000,29999,False,70,scaffold_9
7,670001,697000,26999,False,70,scaffold_9
8,732001,742000,9999,False,70,scaffold_9
9,793001,803000,9999,False,70,scaffold_9
10,815001,843000,27999,False,70,scaffold_9
11,850001,862000,11999,False,70,scaffold_9
12,886001,986000,99999,False,70,scaffold_9
13,987001,995000,7999,False,70,scaffold_9
14,1001001,1007000,5999,False,70,scaffold_9
15,1010001,1032000,21999,False,70,scaffold_9
16,1035001,1085000,49999,False,70,scaffold_9
17,1087001,1150000,62999,False,70,scaffold_9
18,1151001,1164000,12999,False,70,scaffold_9
19,1312001,1378000,65999,False,70,scaffold_9
20,1487001,1500000,12999,False,70,scaffold_9
21,1600001,1610000,9999,False,70,scaffold_9
22,1749001,1791000,41999,False,70,scaffold_9
23,2599001,2616000,16999,False,70,scaffold_9
24,2737001,2821000,83999,False,70,scaffold_9
25,2845001,3381000,535999,False,70,scaffold_9
26,3383001,5107000,1723999,False,70,scaffold_9
27,5112001,5237000,124999,False,70,scaffold_9
28,5239001,5298000,58999,False,70,scaffold_9
29,5300001,5491000,190999,False,70,scaffold_9
30,5492001,6331288,839287,True,70,scaffold_9
0,1,235000,234999,True,70,scaffold_10
1,278001,414000,135999,False,70,scaffold_10
2,415001,482000,66999,False,70,scaffold_10
3,483001,583000,99999,False,70,scaffold_10
4,603001,758000,154999,False,70,scaffold_10
5,783001,794000,10999,False,70,scaffold_10
6,888001,917000,28999,False,70,scaffold_10
7,923001,963000,39999,False,70,scaffold_10
8,1073001,1147000,73999,False,70,scaffold_10
9,2140001,2168000,27999,False,70,scaffold_10
10,2346001,2368000,21999,False,70,scaffold_10
11,4053001,4093000,39999,False,70,scaffold_10
12,4154001,4175000,20999,False,70,scaffold_10
13,4443001,4462000,18999,False,70,scaffold_10
14,4467001,4502000,34999,False,70,scaffold_10
15,4503001,4513000,9999,False,70,scaffold_10
16,4515001,4523000,7999,False,70,scaffold_10
17,4526001,4548000,21999,False,70,scaffold_10
18,4575001,4596000,20999,False,70,scaffold_10
19,4679001,4688000,8999,False,70,scaffold_10
20,4727001,4732000,4999,False,70,scaffold_10
21,4734001,4766000,31999,False,70,scaffold_10
22,4769001,4776000,6999,False,70,scaffold_10
23,4798001,4824000,25999,False,70,scaffold_10
24,4828001,4843000,14999,False,70,scaffold_10
25,4848001,4861000,12999,False,70,scaffold_10
26,4865001,4866973,1972,True,70,scaffold_10
0,10001,91000,80999,False,70,scaffold_11
1,149001,167000,17999,False,70,scaffold_11
2,169001,191000,21999,False,70,scaffold_11
3,213001,235000,21999,False,70,scaffold_11
4,240001,246000,5999,False,70,scaffold_11
5,296001,320000,23999,False,70,scaffold_11
6,419001,431000,11999,False,70,scaffold_11
7,648001,656000,7999,False,70,scaffold_11
8,775001,777000,1999,False,70,scaffold_11
9,1025001,1034000,8999,False,70,scaffold_11
10,1403001,1409000,5999,False,70,scaffold_11
11,1423001,1426000,2999,False,70,scaffold_11
12,2065001,2068000,2999,False,70,scaffold_11
13,2701001,2877000,175999,False,70,scaffold_11
14,2987001,3010000,22999,False,70,scaffold_11
15,3091001,3159000,67999,False,70,scaffold_11
16,3188001,3293000,104999,False,70,scaffold_11
17,3327001,3383000,55999,False,70,scaffold_11
18,3554001,3651000,96999,False,70,scaffold_11
19,3702001,3934000,231999,False,70,scaffold_11
20,4010001,4159000,148999,False,70,scaffold_11
21,4296001,4710000,413999,False,70,scaffold_11
22,4713001,4766820,53819,True,70,scaffold_11
0,1,371000,370999,True,70,scaffold_12
1,403001,551000,147999,False,70,scaffold_12
2,572001,856000,283999,False,70,scaffold_12
3,865001,1430000,564999,False,70,scaffold_12
4,1720001,1733000,12999,False,70,scaffold_12
5,2571001,2619000,47999,False,70,scaffold_12
6,2700001,2707000,6999,False,70,scaffold_12
0,1,342000,341999,True,71,scaffold_1
1,482001,498000,15999,False,71,scaffold_1
2,572001,643000,70999,False,71,scaffold_1
3,686001,748000,61999,False,71,scaffold_1
4,1281001,1292000,10999,False,71,scaffold_1
5,1814001,1898000,83999,False,71,scaffold_1
6,1954001,1964000,9999,False,71,scaffold_1
7,1965001,1984000,18999,False,71,scaffold_1
8,2449001,2517000,67999,False,71,scaffold_1
9,2729001,2746000,16999,False,71,scaffold_1
10,3175001,3208000,32999,False,71,scaffold_1
11,3715001,3734000,18999,False,71,scaffold_1
12,3916001,3941000,24999,False,71,scaffold_1
13,4003001,4027000,23999,False,71,scaffold_1
14,4061001,4112000,50999,False,71,scaffold_1
15,4323001,4354000,30999,False,71,scaffold_1
16,4928001,5005000,76999,False,71,scaffold_1
17,5483001,5521000,37999,False,71,scaffold_1
18,5535001,5570000,34999,False,71,scaffold_1
19,6108001,6153000,44999,False,71,scaffold_1
20,6154001,6177000,22999,False,71,scaffold_1
21,6205001,6379000,173999,False,71,scaffold_1
22,6384001,6507000,122999,False,71,scaffold_1
23,6544001,6554000,9999,False,71,scaffold_1
24,7038001,7247000,208999,False,71,scaffold_1
25,7248001,7588000,339999,False,71,scaffold_1
26,7590001,8656000,1065999,False,71,scaffold_1
27,8658001,9584000,925999,False,71,scaffold_1
28,9586001,10355000,768999,False,71,scaffold_1
29,10461001,10636000,174999,False,71,scaffold_1
30,10808001,10811000,2999,False,71,scaffold_1
31,10835001,10858000,22999,False,71,scaffold_1
32,11277001,11307000,29999,False,71,scaffold_1
33,11345001,11504000,158999,False,71,scaffold_1
34,11607001,11951000,343999,False,71,scaffold_1
35,12184001,12204000,19999,False,71,scaffold_1
36,12652001,12722000,69999,False,71,scaffold_1
37,12777001,12888000,110999,False,71,scaffold_1
38,13113001,13211000,97999,False,71,scaffold_1
39,13347001,13405000,57999,False,71,scaffold_1
40,14471001,14479000,7999,False,71,scaffold_1
0,22001,48000,25999,False,71,scaffold_2
1,95001,159000,63999,False,71,scaffold_2
2,168001,177000,8999,False,71,scaffold_2
3,303001,318000,14999,False,71,scaffold_2
4,331001,374000,42999,False,71,scaffold_2
5,2336001,2358000,21999,False,71,scaffold_2
6,2404001,2424000,19999,False,71,scaffold_2
7,2438001,2554000,115999,False,71,scaffold_2
8,2661001,2689000,27999,False,71,scaffold_2
9,2694001,2742000,47999,False,71,scaffold_2
10,2868001,2899000,30999,False,71,scaffold_2
11,2993001,3012000,18999,False,71,scaffold_2
12,3174001,3186000,11999,False,71,scaffold_2
13,3454001,3464000,9999,False,71,scaffold_2
14,3759001,3783000,23999,False,71,scaffold_2
15,4382001,4409000,26999,False,71,scaffold_2
16,4429001,4456000,26999,False,71,scaffold_2
17,4520001,4656000,135999,False,71,scaffold_2
18,4784001,4790000,5999,False,71,scaffold_2
19,4918001,4940000,21999,False,71,scaffold_2
20,5022001,5061000,38999,False,71,scaffold_2
21,5375001,5392000,16999,False,71,scaffold_2
22,5491001,5511000,19999,False,71,scaffold_2
23,5668001,5704000,35999,False,71,scaffold_2
24,5719001,5753000,33999,False,71,scaffold_2
25,5918001,5952000,33999,False,71,scaffold_2
26,6261001,6351000,89999,False,71,scaffold_2
27,6427001,6449000,21999,False,71,scaffold_2
28,7018001,7037000,18999,False,71,scaffold_2
29,7439001,7472000,32999,False,71,scaffold_2
30,7563001,7697000,133999,False,71,scaffold_2
31,7786001,7898000,111999,False,71,scaffold_2
32,7934001,8161000,226999,False,71,scaffold_2
33,8261001,8297000,35999,False,71,scaffold_2
34,8331001,8333000,1999,False,71,scaffold_2
35,8342001,8344000,1999,False,71,scaffold_2
36,8346001,8389000,42999,False,71,scaffold_2
37,8437001,8452000,14999,False,71,scaffold_2
38,8509001,8562000,52999,False,71,scaffold_2
39,11366001,11378000,11999,False,71,scaffold_2
40,11520001,11785000,264999,False,71,scaffold_2
0,1,2000,1999,True,71,scaffold_3
1,102001,104000,1999,False,71,scaffold_3
2,799001,901000,101999,False,71,scaffold_3
3,2076001,2108000,31999,False,71,scaffold_3
4,2291001,2321000,29999,False,71,scaffold_3
5,2487001,2533000,45999,False,71,scaffold_3
6,3826001,3890000,63999,False,71,scaffold_3
7,4108001,4403000,294999,False,71,scaffold_3
8,4410001,4519000,108999,False,71,scaffold_3
9,4547001,4558000,10999,False,71,scaffold_3
10,4652001,4674000,21999,False,71,scaffold_3
11,5495001,5506000,10999,False,71,scaffold_3
12,5990001,6019000,28999,False,71,scaffold_3
13,6909001,6962000,52999,False,71,scaffold_3
14,6979001,7097000,117999,False,71,scaffold_3
15,7336001,7397000,60999,False,71,scaffold_3
16,7540001,7556000,15999,False,71,scaffold_3
17,7692001,7838000,145999,False,71,scaffold_3
18,8176001,8255000,78999,False,71,scaffold_3
19,8462001,8527000,64999,False,71,scaffold_3
20,8575001,8594000,18999,False,71,scaffold_3
21,9968001,9995000,26999,False,71,scaffold_3
22,10461001,10484000,22999,False,71,scaffold_3
23,10587001,11164000,576999,False,71,scaffold_3
0,17001,32000,14999,False,71,scaffold_4
1,48001,88000,39999,False,71,scaffold_4
2,130001,146000,15999,False,71,scaffold_4
3,147001,151000,3999,False,71,scaffold_4
4,155001,215000,59999,False,71,scaffold_4
5,217001,226000,8999,False,71,scaffold_4
6,227001,266000,38999,False,71,scaffold_4
7,291001,311000,19999,False,71,scaffold_4
8,355001,374000,18999,False,71,scaffold_4
9,375001,380000,4999,False,71,scaffold_4
10,394001,410000,15999,False,71,scaffold_4
11,412001,425000,12999,False,71,scaffold_4
12,429001,498000,68999,False,71,scaffold_4
13,545001,592000,46999,False,71,scaffold_4
14,593001,606000,12999,False,71,scaffold_4
15,608001,691000,82999,False,71,scaffold_4
16,701001,711000,9999,False,71,scaffold_4
17,1121001,1136000,14999,False,71,scaffold_4
18,1137001,1198000,60999,False,71,scaffold_4
19,1199001,1226000,26999,False,71,scaffold_4
20,1235001,1253000,17999,False,71,scaffold_4
21,1254001,1262000,7999,False,71,scaffold_4
22,1265001,1279000,13999,False,71,scaffold_4
23,1283001,1317000,33999,False,71,scaffold_4
24,1373001,1599000,225999,False,71,scaffold_4
25,1613001,2065000,451999,False,71,scaffold_4
26,2073001,2097000,23999,False,71,scaffold_4
27,2272001,2279000,6999,False,71,scaffold_4
28,2284001,2340000,55999,False,71,scaffold_4
29,2476001,2545000,68999,False,71,scaffold_4
30,2546001,2575000,28999,False,71,scaffold_4
31,2599001,2635000,35999,False,71,scaffold_4
32,3336001,3761000,424999,False,71,scaffold_4
33,4942001,5047000,104999,False,71,scaffold_4
34,5475001,5506000,30999,False,71,scaffold_4
35,5514001,5620000,105999,False,71,scaffold_4
36,5660001,5784000,123999,False,71,scaffold_4
37,5786001,5816000,29999,False,71,scaffold_4
38,6145001,6191000,45999,False,71,scaffold_4
39,6798001,6817000,18999,False,71,scaffold_4
40,6907001,6924000,16999,False,71,scaffold_4
41,7036001,7062000,25999,False,71,scaffold_4
42,8846001,9699000,852999,False,71,scaffold_4
43,9700001,9845951,145950,True,71,scaffold_4
0,296001,300000,3999,False,71,scaffold_5
1,318001,326000,7999,False,71,scaffold_5
2,327001,368000,40999,False,71,scaffold_5
3,463001,523000,59999,False,71,scaffold_5
4,836001,842000,5999,False,71,scaffold_5
5,933001,947000,13999,False,71,scaffold_5
6,2559001,2582000,22999,False,71,scaffold_5
7,2618001,2738000,119999,False,71,scaffold_5
8,2813001,2871000,57999,False,71,scaffold_5
9,3134001,3185000,50999,False,71,scaffold_5
10,3217001,3248000,30999,False,71,scaffold_5
11,3322001,3494000,171999,False,71,scaffold_5
12,3962001,4101000,138999,False,71,scaffold_5
13,4121001,4219000,97999,False,71,scaffold_5
14,4246001,4270000,23999,False,71,scaffold_5
15,4446001,4498000,51999,False,71,scaffold_5
16,4602001,4681000,78999,False,71,scaffold_5
17,4690001,4718000,27999,False,71,scaffold_5
18,4761001,4861000,99999,False,71,scaffold_5
19,4892001,4921000,28999,False,71,scaffold_5
20,5318001,5346000,27999,False,71,scaffold_5
21,6411001,6418000,6999,False,71,scaffold_5
22,6507001,6631000,123999,False,71,scaffold_5
23,7454001,7483000,28999,False,71,scaffold_5
24,7579001,7609000,29999,False,71,scaffold_5
25,7622001,7655000,32999,False,71,scaffold_5
26,8670001,8689000,18999,False,71,scaffold_5
27,8730001,9363000,632999,False,71,scaffold_5
28,9364001,9364176,175,True,71,scaffold_5
0,79001,113000,33999,False,71,scaffold_6
1,239001,253000,13999,False,71,scaffold_6
2,1236001,1263000,26999,False,71,scaffold_6
3,1478001,1547000,68999,False,71,scaffold_6
4,2023001,2087000,63999,False,71,scaffold_6
5,2130001,2169000,38999,False,71,scaffold_6
6,2363001,2595000,231999,False,71,scaffold_6
7,2596001,2653000,56999,False,71,scaffold_6
8,2661001,2691000,29999,False,71,scaffold_6
9,2731001,2851000,119999,False,71,scaffold_6
10,2933001,3016000,82999,False,71,scaffold_6
11,3112001,3174000,61999,False,71,scaffold_6
12,3223001,3311000,87999,False,71,scaffold_6
13,3408001,3428000,19999,False,71,scaffold_6
14,3460001,3766000,305999,False,71,scaffold_6
15,3899001,3913000,13999,False,71,scaffold_6
16,4018001,4066000,47999,False,71,scaffold_6
17,4080001,4193000,112999,False,71,scaffold_6
18,6011001,6062000,50999,False,71,scaffold_6
19,7269001,7337000,67999,False,71,scaffold_6
20,7393001,7433000,39999,False,71,scaffold_6
21,7550001,7798000,247999,False,71,scaffold_6
22,7811001,8268281,457280,True,71,scaffold_6
0,1,7000,6999,True,71,scaffold_7
1,13001,31000,17999,False,71,scaffold_7
2,323001,340000,16999,False,71,scaffold_7
3,342001,508000,165999,False,71,scaffold_7
4,554001,563000,8999,False,71,scaffold_7
5,571001,577000,5999,False,71,scaffold_7
6,706001,736000,29999,False,71,scaffold_7
7,764001,809000,44999,False,71,scaffold_7
8,859001,864000,4999,False,71,scaffold_7
9,964001,980000,15999,False,71,scaffold_7
10,982001,1044000,61999,False,71,scaffold_7
11,1048001,1104000,55999,False,71,scaffold_7
12,1191001,1459000,267999,False,71,scaffold_7
13,1461001,1512000,50999,False,71,scaffold_7
14,1588001,1688000,99999,False,71,scaffold_7
15,3326001,3369000,42999,False,71,scaffold_7
16,3593001,3766000,172999,False,71,scaffold_7
17,4415001,4517000,101999,False,71,scaffold_7
18,4658001,4733000,74999,False,71,scaffold_7
19,4979001,5030000,50999,False,71,scaffold_7
20,5074001,5149000,74999,False,71,scaffold_7
21,5499001,5514000,14999,False,71,scaffold_7
22,6954001,7270000,315999,False,71,scaffold_7
23,7271001,7502216,231215,True,71,scaffold_7
0,1,6000,5999,True,71,scaffold_8
1,67001,85000,17999,False,71,scaffold_8
2,2444001,2469000,24999,False,71,scaffold_8
3,2492001,2528000,35999,False,71,scaffold_8
4,2652001,2683000,30999,False,71,scaffold_8
5,2740001,2757000,16999,False,71,scaffold_8
6,2798001,2844000,45999,False,71,scaffold_8
7,3059001,3125000,65999,False,71,scaffold_8
8,3126001,3525000,398999,False,71,scaffold_8
9,3584001,3612000,27999,False,71,scaffold_8
10,3615001,3938000,322999,False,71,scaffold_8
11,4039001,4099000,59999,False,71,scaffold_8
12,5125001,5135000,9999,False,71,scaffold_8
13,5173001,5241000,67999,False,71,scaffold_8
14,6320001,6334544,14543,True,71,scaffold_8
0,109001,117000,7999,False,71,scaffold_9
1,121001,134000,12999,False,71,scaffold_9
2,189001,194000,4999,False,71,scaffold_9
3,319001,333000,13999,False,71,scaffold_9
4,367001,404000,36999,False,71,scaffold_9
5,413001,434000,20999,False,71,scaffold_9
6,503001,531000,27999,False,71,scaffold_9
7,660001,665000,4999,False,71,scaffold_9
8,670001,697000,26999,False,71,scaffold_9
9,732001,742000,9999,False,71,scaffold_9
10,816001,843000,26999,False,71,scaffold_9
11,850001,862000,11999,False,71,scaffold_9
12,885001,986000,100999,False,71,scaffold_9
13,988001,995000,6999,False,71,scaffold_9
14,1001001,1007000,5999,False,71,scaffold_9
15,1009001,1031000,21999,False,71,scaffold_9
16,1035001,1085000,49999,False,71,scaffold_9
17,1087001,1150000,62999,False,71,scaffold_9
18,1151001,1175000,23999,False,71,scaffold_9
19,1313001,1377000,63999,False,71,scaffold_9
20,1600001,1615000,14999,False,71,scaffold_9
21,1770001,1788000,17999,False,71,scaffold_9
22,2598001,2616000,17999,False,71,scaffold_9
23,2737001,2823000,85999,False,71,scaffold_9
24,2870001,3381000,510999,False,71,scaffold_9
25,3383001,5107000,1723999,False,71,scaffold_9
26,5112001,5115000,2999,False,71,scaffold_9
27,5116001,5238000,121999,False,71,scaffold_9
28,5239001,5298000,58999,False,71,scaffold_9
29,5300001,5490000,189999,False,71,scaffold_9
30,5493001,6331288,838287,True,71,scaffold_9
0,1,236000,235999,True,71,scaffold_10
1,282001,406000,123999,False,71,scaffold_10
2,459001,482000,22999,False,71,scaffold_10
3,483001,580000,96999,False,71,scaffold_10
4,603001,794000,190999,False,71,scaffold_10
5,888001,921000,32999,False,71,scaffold_10
6,923001,963000,39999,False,71,scaffold_10
7,1057001,1069000,11999,False,71,scaffold_10
8,1073001,1144000,70999,False,71,scaffold_10
9,2145001,2166000,20999,False,71,scaffold_10
10,2346001,2382000,35999,False,71,scaffold_10
11,2702001,2708000,5999,False,71,scaffold_10
12,2735001,2745000,9999,False,71,scaffold_10
13,4053001,4091000,37999,False,71,scaffold_10
14,4154001,4174000,19999,False,71,scaffold_10
15,4445001,4462000,16999,False,71,scaffold_10
16,4467001,4477000,9999,False,71,scaffold_10
17,4478001,4513000,34999,False,71,scaffold_10
18,4515001,4523000,7999,False,71,scaffold_10
19,4526001,4548000,21999,False,71,scaffold_10
20,4576001,4596000,19999,False,71,scaffold_10
21,4679001,4688000,8999,False,71,scaffold_10
22,4735001,4766000,30999,False,71,scaffold_10
23,4767001,4776000,8999,False,71,scaffold_10
24,4798001,4824000,25999,False,71,scaffold_10
25,4828001,4843000,14999,False,71,scaffold_10
26,4848001,4861000,12999,False,71,scaffold_10
27,4865001,4866973,1972,True,71,scaffold_10
0,10001,93000,82999,False,71,scaffold_11
1,149001,167000,17999,False,71,scaffold_11
2,169001,191000,21999,False,71,scaffold_11
3,214001,235000,20999,False,71,scaffold_11
4,419001,431000,11999,False,71,scaffold_11
5,648001,656000,7999,False,71,scaffold_11
6,1025001,1034000,8999,False,71,scaffold_11
7,1423001,1426000,2999,False,71,scaffold_11
8,1474001,1477000,2999,False,71,scaffold_11
9,2701001,2874000,172999,False,71,scaffold_11
10,2982001,3011000,28999,False,71,scaffold_11
11,3188001,3291000,102999,False,71,scaffold_11
12,3331001,3383000,51999,False,71,scaffold_11
13,3554001,3613000,58999,False,71,scaffold_11
14,3702001,3930000,227999,False,71,scaffold_11
15,4005001,4159000,153999,False,71,scaffold_11
16,4237001,4710000,472999,False,71,scaffold_11
17,4713001,4766820,53819,True,71,scaffold_11
0,1,386000,385999,True,71,scaffold_12
1,402001,857000,454999,False,71,scaffold_12
2,864001,1446000,581999,False,71,scaffold_12
3,1720001,1733000,12999,False,71,scaffold_12
4,2571001,2609000,37999,False,71,scaffold_12
5,2673001,2682000,8999,False,71,scaffold_12
6,2685001,2698000,12999,False,71,scaffold_12
0,1,342000,341999,True,72,scaffold_1
1,482001,498000,15999,False,72,scaffold_1
2,574001,643000,68999,False,72,scaffold_1
3,686001,713000,26999,False,72,scaffold_1
4,1281001,1292000,10999,False,72,scaffold_1
5,1952001,1964000,11999,False,72,scaffold_1
6,1965001,1984000,18999,False,72,scaffold_1
7,2449001,2511000,61999,False,72,scaffold_1
8,2729001,2746000,16999,False,72,scaffold_1
9,3181001,3208000,26999,False,72,scaffold_1
10,3715001,3733000,17999,False,72,scaffold_1
11,3923001,3941000,17999,False,72,scaffold_1
12,4063001,4111000,47999,False,72,scaffold_1
13,4322001,4354000,31999,False,72,scaffold_1
14,4929001,4963000,33999,False,72,scaffold_1
15,4969001,4983000,13999,False,72,scaffold_1
16,5483001,5511000,27999,False,72,scaffold_1
17,6108001,6153000,44999,False,72,scaffold_1
18,6228001,6507000,278999,False,72,scaffold_1
19,6545001,6554000,8999,False,72,scaffold_1
20,7038001,7247000,208999,False,72,scaffold_1
21,7248001,7583000,334999,False,72,scaffold_1
22,7590001,8477000,886999,False,72,scaffold_1
23,8478001,8656000,177999,False,72,scaffold_1
24,8658001,9584000,925999,False,72,scaffold_1
25,9586001,10354000,767999,False,72,scaffold_1
26,10461001,10630000,168999,False,72,scaffold_1
27,10808001,10811000,2999,False,72,scaffold_1
28,10836001,10858000,21999,False,72,scaffold_1
29,11351001,11504000,152999,False,72,scaffold_1
30,11648001,11951000,302999,False,72,scaffold_1
31,12184001,12204000,19999,False,72,scaffold_1
32,12667001,12722000,54999,False,72,scaffold_1
33,12777001,12888000,110999,False,72,scaffold_1
34,13115001,13134000,18999,False,72,scaffold_1
35,13180001,13211000,30999,False,72,scaffold_1
36,13347001,13378000,30999,False,72,scaffold_1
37,14298001,14306000,7999,False,72,scaffold_1
0,22001,48000,25999,False,72,scaffold_2
1,93001,159000,65999,False,72,scaffold_2
2,174001,176000,1999,False,72,scaffold_2
3,331001,374000,42999,False,72,scaffold_2
4,2336001,2358000,21999,False,72,scaffold_2
5,2406001,2423000,16999,False,72,scaffold_2
6,2441001,2553000,111999,False,72,scaffold_2
7,2627001,2639000,11999,False,72,scaffold_2
8,2660001,2689000,28999,False,72,scaffold_2
9,2694001,2742000,47999,False,72,scaffold_2
10,2993001,3021000,27999,False,72,scaffold_2
11,3454001,3463000,8999,False,72,scaffold_2
12,3766001,3782000,15999,False,72,scaffold_2
13,4385001,4409000,23999,False,72,scaffold_2
14,4429001,4456000,26999,False,72,scaffold_2
15,4525001,4553000,27999,False,72,scaffold_2
16,4607001,4653000,45999,False,72,scaffold_2
17,5022001,5031000,8999,False,72,scaffold_2
18,5033001,5061000,27999,False,72,scaffold_2
19,5491001,5511000,19999,False,72,scaffold_2
20,5672001,5704000,31999,False,72,scaffold_2
21,6261001,6330000,68999,False,72,scaffold_2
22,6331001,6342000,10999,False,72,scaffold_2
23,7439001,7472000,32999,False,72,scaffold_2
24,7563001,7697000,133999,False,72,scaffold_2
25,7786001,7890000,103999,False,72,scaffold_2
26,7934001,7969000,34999,False,72,scaffold_2
27,7982001,8088000,105999,False,72,scaffold_2
28,8331001,8333000,1999,False,72,scaffold_2
29,8343001,8344000,999,False,72,scaffold_2
30,8346001,8389000,42999,False,72,scaffold_2
31,8437001,8453000,15999,False,72,scaffold_2
32,8509001,8535000,25999,False,72,scaffold_2
33,11367001,11374000,6999,False,72,scaffold_2
34,11520001,11786000,265999,False,72,scaffold_2
0,1,2000,1999,True,72,scaffold_3
1,51001,55000,3999,False,72,scaffold_3
2,102001,104000,1999,False,72,scaffold_3
3,799001,900000,100999,False,72,scaffold_3
4,2085001,2108000,22999,False,72,scaffold_3
5,2291001,2321000,29999,False,72,scaffold_3
6,2510001,2533000,22999,False,72,scaffold_3
7,3831001,3841000,9999,False,72,scaffold_3
8,4150001,4383000,232999,False,72,scaffold_3
9,4418001,4518000,99999,False,72,scaffold_3
10,4547001,4558000,10999,False,72,scaffold_3
11,4654001,4673000,18999,False,72,scaffold_3
12,5578001,5581000,2999,False,72,scaffold_3
13,6911001,6962000,50999,False,72,scaffold_3
14,6980001,7075000,94999,False,72,scaffold_3
15,7538001,7556000,17999,False,72,scaffold_3
16,7694001,7724000,29999,False,72,scaffold_3
17,7822001,7838000,15999,False,72,scaffold_3
18,8205001,8253000,47999,False,72,scaffold_3
19,8462001,8527000,64999,False,72,scaffold_3
20,8575001,8593000,17999,False,72,scaffold_3
21,9968001,9995000,26999,False,72,scaffold_3
22,10461001,10484000,22999,False,72,scaffold_3
23,10587001,11165000,577999,False,72,scaffold_3
0,48001,88000,39999,False,72,scaffold_4
1,134001,146000,11999,False,72,scaffold_4
2,147001,151000,3999,False,72,scaffold_4
3,155001,160000,4999,False,72,scaffold_4
4,161001,215000,53999,False,72,scaffold_4
5,217001,226000,8999,False,72,scaffold_4
6,227001,266000,38999,False,72,scaffold_4
7,290001,307000,16999,False,72,scaffold_4
8,313001,344000,30999,False,72,scaffold_4
9,355001,374000,18999,False,72,scaffold_4
10,375001,380000,4999,False,72,scaffold_4
11,413001,425000,11999,False,72,scaffold_4
12,429001,498000,68999,False,72,scaffold_4
13,545001,592000,46999,False,72,scaffold_4
14,593001,606000,12999,False,72,scaffold_4
15,608001,691000,82999,False,72,scaffold_4
16,701001,714000,12999,False,72,scaffold_4
17,1121001,1136000,14999,False,72,scaffold_4
18,1137001,1179000,41999,False,72,scaffold_4
19,1199001,1208000,8999,False,72,scaffold_4
20,1254001,1262000,7999,False,72,scaffold_4
21,1265001,1279000,13999,False,72,scaffold_4
22,1283001,1337000,53999,False,72,scaffold_4
23,1372001,1591000,218999,False,72,scaffold_4
24,1749001,1817000,67999,False,72,scaffold_4
25,1904001,1957000,52999,False,72,scaffold_4
26,2036001,2068000,31999,False,72,scaffold_4
27,2073001,2088000,14999,False,72,scaffold_4
28,2211001,2218000,6999,False,72,scaffold_4
29,2269001,2279000,9999,False,72,scaffold_4
30,2284001,2310000,25999,False,72,scaffold_4
31,2312001,2340000,27999,False,72,scaffold_4
32,2476001,2533000,56999,False,72,scaffold_4
33,3335001,3632000,296999,False,72,scaffold_4
34,3676001,3759000,82999,False,72,scaffold_4
35,4054001,4071000,16999,False,72,scaffold_4
36,4944001,4984000,39999,False,72,scaffold_4
37,5477001,5506000,28999,False,72,scaffold_4
38,5515001,5620000,104999,False,72,scaffold_4
39,5665001,5784000,118999,False,72,scaffold_4
40,6811001,6817000,5999,False,72,scaffold_4
41,7037001,7062000,24999,False,72,scaffold_4
42,8846001,9699000,852999,False,72,scaffold_4
43,9700001,9845951,145950,True,72,scaffold_4
0,1,4000,3999,True,72,scaffold_5
1,192001,204000,11999,False,72,scaffold_5
2,318001,326000,7999,False,72,scaffold_5
3,327001,368000,40999,False,72,scaffold_5
4,469001,480000,10999,False,72,scaffold_5
5,498001,523000,24999,False,72,scaffold_5
6,669001,695000,25999,False,72,scaffold_5
7,933001,947000,13999,False,72,scaffold_5
8,2565001,2582000,16999,False,72,scaffold_5
9,2625001,2732000,106999,False,72,scaffold_5
10,2816001,2871000,54999,False,72,scaffold_5
11,3137001,3185000,47999,False,72,scaffold_5
12,3322001,3438000,115999,False,72,scaffold_5
13,3451001,3497000,45999,False,72,scaffold_5
14,3962001,4101000,138999,False,72,scaffold_5
15,4121001,4142000,20999,False,72,scaffold_5
16,4155001,4219000,63999,False,72,scaffold_5
17,4246001,4262000,15999,False,72,scaffold_5
18,4446001,4497000,50999,False,72,scaffold_5
19,4603001,4649000,45999,False,72,scaffold_5
20,4691001,4717000,25999,False,72,scaffold_5
21,4789001,4861000,71999,False,72,scaffold_5
22,4904001,4917000,12999,False,72,scaffold_5
23,5288001,5312000,23999,False,72,scaffold_5
24,5314001,5346000,31999,False,72,scaffold_5
25,7581001,7609000,27999,False,72,scaffold_5
26,7622001,7641000,18999,False,72,scaffold_5
27,8730001,9363000,632999,False,72,scaffold_5
0,79001,85000,5999,False,72,scaffold_6
1,86001,112000,25999,False,72,scaffold_6
2,240001,253000,12999,False,72,scaffold_6
3,267001,283000,15999,False,72,scaffold_6
4,1238001,1255000,16999,False,72,scaffold_6
5,1479001,1546000,66999,False,72,scaffold_6
6,2026001,2087000,60999,False,72,scaffold_6
7,2130001,2179000,48999,False,72,scaffold_6
8,2371001,2595000,223999,False,72,scaffold_6
9,2596001,2653000,56999,False,72,scaffold_6
10,2657001,2691000,33999,False,72,scaffold_6
11,2731001,2852000,120999,False,72,scaffold_6
12,2933001,3014000,80999,False,72,scaffold_6
13,3115001,3149000,33999,False,72,scaffold_6
14,3224001,3301000,76999,False,72,scaffold_6
15,3411001,3427000,15999,False,72,scaffold_6
16,3462001,3783000,320999,False,72,scaffold_6
17,3901001,3912000,10999,False,72,scaffold_6
18,4019001,4045000,25999,False,72,scaffold_6
19,4082001,4193000,110999,False,72,scaffold_6
20,6011001,6060000,48999,False,72,scaffold_6
21,7282001,7337000,54999,False,72,scaffold_6
22,7560001,7795000,234999,False,72,scaffold_6
23,7811001,8268281,457280,True,72,scaffold_6
0,1,7000,6999,True,72,scaffold_7
1,13001,31000,17999,False,72,scaffold_7
2,323001,340000,16999,False,72,scaffold_7
3,342001,508000,165999,False,72,scaffold_7
4,554001,563000,8999,False,72,scaffold_7
5,706001,736000,29999,False,72,scaffold_7
6,741001,753000,11999,False,72,scaffold_7
7,764001,809000,44999,False,72,scaffold_7
8,859001,864000,4999,False,72,scaffold_7
9,982001,1044000,61999,False,72,scaffold_7
10,1204001,1460000,255999,False,72,scaffold_7
11,1461001,1512000,50999,False,72,scaffold_7
12,1588001,1688000,99999,False,72,scaffold_7
13,3326001,3369000,42999,False,72,scaffold_7
14,3595001,3649000,53999,False,72,scaffold_7
15,4416001,4517000,100999,False,72,scaffold_7
16,4658001,4681000,22999,False,72,scaffold_7
17,4979001,5030000,50999,False,72,scaffold_7
18,5075001,5112000,36999,False,72,scaffold_7
19,6954001,7270000,315999,False,72,scaffold_7
20,7271001,7502216,231215,True,72,scaffold_7
0,2001,6000,3999,False,72,scaffold_8
1,66001,85000,18999,False,72,scaffold_8
2,93001,101000,7999,False,72,scaffold_8
3,2449001,2469000,19999,False,72,scaffold_8
4,2493001,2511000,17999,False,72,scaffold_8
5,2658001,2683000,24999,False,72,scaffold_8
6,2745001,2756000,10999,False,72,scaffold_8
7,2827001,2844000,16999,False,72,scaffold_8
8,3060001,3125000,64999,False,72,scaffold_8
9,3126001,3525000,398999,False,72,scaffold_8
10,3584001,3612000,27999,False,72,scaffold_8
11,3615001,3913000,297999,False,72,scaffold_8
12,5200001,5241000,40999,False,72,scaffold_8
13,6330001,6334544,4543,True,72,scaffold_8
0,109001,117000,7999,False,72,scaffold_9
1,303001,315000,11999,False,72,scaffold_9
2,319001,333000,13999,False,72,scaffold_9
3,367001,411000,43999,False,72,scaffold_9
4,413001,434000,20999,False,72,scaffold_9
5,502001,531000,28999,False,72,scaffold_9
6,671001,696000,24999,False,72,scaffold_9
7,732001,742000,9999,False,72,scaffold_9
8,794001,803000,8999,False,72,scaffold_9
9,815001,841000,25999,False,72,scaffold_9
10,850001,862000,11999,False,72,scaffold_9
11,886001,986000,99999,False,72,scaffold_9
12,988001,995000,6999,False,72,scaffold_9
13,1001001,1007000,5999,False,72,scaffold_9
14,1010001,1031000,20999,False,72,scaffold_9
15,1035001,1085000,49999,False,72,scaffold_9
16,1087001,1150000,62999,False,72,scaffold_9
17,1151001,1164000,12999,False,72,scaffold_9
18,1312001,1377000,64999,False,72,scaffold_9
19,1770001,1783000,12999,False,72,scaffold_9
20,2601001,2616000,14999,False,72,scaffold_9
21,2874001,3381000,506999,False,72,scaffold_9
22,3383001,5106000,1722999,False,72,scaffold_9
23,5112001,5114000,1999,False,72,scaffold_9
24,5116001,5238000,121999,False,72,scaffold_9
25,5239001,5298000,58999,False,72,scaffold_9
26,5300001,5490000,189999,False,72,scaffold_9
27,5493001,6331288,838287,True,72,scaffold_9
0,1,198000,197999,True,72,scaffold_10
1,375001,405000,29999,False,72,scaffold_10
2,472001,482000,9999,False,72,scaffold_10
3,483001,499000,15999,False,72,scaffold_10
4,506001,582000,75999,False,72,scaffold_10
5,603001,749000,145999,False,72,scaffold_10
6,888001,917000,28999,False,72,scaffold_10
7,923001,962000,38999,False,72,scaffold_10
8,1088001,1105000,16999,False,72,scaffold_10
9,2346001,2366000,19999,False,72,scaffold_10
10,4054001,4091000,36999,False,72,scaffold_10
11,4154001,4174000,19999,False,72,scaffold_10
12,4445001,4462000,16999,False,72,scaffold_10
13,4467001,4477000,9999,False,72,scaffold_10
14,4506001,4513000,6999,False,72,scaffold_10
15,4527001,4548000,20999,False,72,scaffold_10
16,4576001,4596000,19999,False,72,scaffold_10
17,4681001,4688000,6999,False,72,scaffold_10
18,4734001,4766000,31999,False,72,scaffold_10
19,4769001,4776000,6999,False,72,scaffold_10
20,4798001,4824000,25999,False,72,scaffold_10
21,4828001,4843000,14999,False,72,scaffold_10
22,4848001,4861000,12999,False,72,scaffold_10
23,4865001,4866973,1972,True,72,scaffold_10
0,10001,91000,80999,False,72,scaffold_11
1,149001,167000,17999,False,72,scaffold_11
2,169001,191000,21999,False,72,scaffold_11
3,213001,235000,21999,False,72,scaffold_11
4,240001,248000,7999,False,72,scaffold_11
5,419001,431000,11999,False,72,scaffold_11
6,648001,656000,7999,False,72,scaffold_11
7,1025001,1034000,8999,False,72,scaffold_11
8,1423001,1426000,2999,False,72,scaffold_11
9,2701001,2872000,170999,False,72,scaffold_11
10,3188001,3254000,65999,False,72,scaffold_11
11,3329001,3372000,42999,False,72,scaffold_11
12,3702001,3927000,224999,False,72,scaffold_11
13,4322001,4710000,387999,False,72,scaffold_11
14,4713001,4766820,53819,True,72,scaffold_11
0,1,241000,240999,True,72,scaffold_12
1,250001,369000,118999,False,72,scaffold_12
2,474001,536000,61999,False,72,scaffold_12
3,582001,730000,147999,False,72,scaffold_12
4,739001,856000,116999,False,72,scaffold_12
5,865001,1354000,488999,False,72,scaffold_12
6,1720001,1733000,12999,False,72,scaffold_12
7,2571001,2617000,45999,False,72,scaffold_12
0,1,342000,341999,True,73,scaffold_1
1,482001,498000,15999,False,73,scaffold_1
2,571001,643000,71999,False,73,scaffold_1
3,686001,759000,72999,False,73,scaffold_1
4,763001,769000,5999,False,73,scaffold_1
5,1280001,1292000,11999,False,73,scaffold_1
6,1615001,1660000,44999,False,73,scaffold_1
7,1814001,1898000,83999,False,73,scaffold_1
8,1951001,1964000,12999,False,73,scaffold_1
9,1965001,1984000,18999,False,73,scaffold_1
10,1988001,1992000,3999,False,73,scaffold_1
11,2449001,2517000,67999,False,73,scaffold_1
12,2727001,2746000,18999,False,73,scaffold_1
13,3179001,3209000,29999,False,73,scaffold_1
14,3714001,3734000,19999,False,73,scaffold_1
15,3848001,3878000,29999,False,73,scaffold_1
16,3902001,3941000,38999,False,73,scaffold_1
17,4060001,4112000,51999,False,73,scaffold_1
18,4314001,4355000,40999,False,73,scaffold_1
19,4926001,4997000,70999,False,73,scaffold_1
20,5481001,5511000,29999,False,73,scaffold_1
21,5535001,5570000,34999,False,73,scaffold_1
22,5858001,5871000,12999,False,73,scaffold_1
23,6108001,6153000,44999,False,73,scaffold_1
24,6154001,6177000,22999,False,73,scaffold_1
25,6228001,6381000,152999,False,73,scaffold_1
26,6383001,6509000,125999,False,73,scaffold_1
27,6544001,6555000,10999,False,73,scaffold_1
28,7038001,7247000,208999,False,73,scaffold_1
29,7248001,7589000,340999,False,73,scaffold_1
30,7590001,8477000,886999,False,73,scaffold_1
31,8478001,8656000,177999,False,73,scaffold_1
32,8658001,9584000,925999,False,73,scaffold_1
33,9586001,10356000,769999,False,73,scaffold_1
34,10461001,10632000,170999,False,73,scaffold_1
35,10808001,10811000,2999,False,73,scaffold_1
36,10840001,10856000,15999,False,73,scaffold_1
37,10922001,10939000,16999,False,73,scaffold_1
38,11278001,11509000,230999,False,73,scaffold_1
39,11609001,11962000,352999,False,73,scaffold_1
40,12184001,12204000,19999,False,73,scaffold_1
41,12652001,12722000,69999,False,73,scaffold_1
42,12777001,12888000,110999,False,73,scaffold_1
43,13113001,13216000,102999,False,73,scaffold_1
44,13347001,13432000,84999,False,73,scaffold_1
45,14298001,14308000,9999,False,73,scaffold_1
0,20001,48000,27999,False,73,scaffold_2
1,93001,159000,65999,False,73,scaffold_2
2,168001,177000,8999,False,73,scaffold_2
3,313001,318000,4999,False,73,scaffold_2
4,332001,374000,41999,False,73,scaffold_2
5,2336001,2358000,21999,False,73,scaffold_2
6,2439001,2608000,168999,False,73,scaffold_2
7,2627001,2639000,11999,False,73,scaffold_2
8,2660001,2689000,28999,False,73,scaffold_2
9,2694001,2742000,47999,False,73,scaffold_2
10,2766001,2788000,21999,False,73,scaffold_2
11,2843001,2852000,8999,False,73,scaffold_2
12,2877001,2900000,22999,False,73,scaffold_2
13,2993001,3021000,27999,False,73,scaffold_2
14,3452001,3464000,11999,False,73,scaffold_2
15,3756001,3784000,27999,False,73,scaffold_2
16,4381001,4409000,27999,False,73,scaffold_2
17,4426001,4457000,30999,False,73,scaffold_2
18,4519001,4658000,138999,False,73,scaffold_2
19,4918001,4954000,35999,False,73,scaffold_2
20,5022001,5031000,8999,False,73,scaffold_2
21,5033001,5063000,29999,False,73,scaffold_2
22,5080001,5104000,23999,False,73,scaffold_2
23,5370001,5393000,22999,False,73,scaffold_2
24,5491001,5514000,22999,False,73,scaffold_2
25,5658001,5757000,98999,False,73,scaffold_2
26,5840001,5887000,46999,False,73,scaffold_2
27,5920001,5928000,7999,False,73,scaffold_2
28,6261001,6350000,88999,False,73,scaffold_2
29,6388001,6449000,60999,False,73,scaffold_2
30,7005001,7038000,32999,False,73,scaffold_2
31,7049001,7097000,47999,False,73,scaffold_2
32,7428001,7473000,44999,False,73,scaffold_2
33,7550001,7561000,10999,False,73,scaffold_2
34,7563001,7697000,133999,False,73,scaffold_2
35,7786001,7889000,102999,False,73,scaffold_2
36,7934001,8162000,227999,False,73,scaffold_2
37,8261001,8294000,32999,False,73,scaffold_2
38,8331001,8333000,1999,False,73,scaffold_2
39,8346001,8453000,106999,False,73,scaffold_2
40,8509001,8563000,53999,False,73,scaffold_2
41,11520001,11786000,265999,False,73,scaffold_2
0,51001,55000,3999,False,73,scaffold_3
1,799001,900000,100999,False,73,scaffold_3
2,2040001,2108000,67999,False,73,scaffold_3
3,2110001,2116000,5999,False,73,scaffold_3
4,2290001,2321000,30999,False,73,scaffold_3
5,2487001,2533000,45999,False,73,scaffold_3
6,2648001,2682000,33999,False,73,scaffold_3
7,2718001,2729000,10999,False,73,scaffold_3
8,3768001,3821000,52999,False,73,scaffold_3
9,3822001,3891000,68999,False,73,scaffold_3
10,4108001,4403000,294999,False,73,scaffold_3
11,4416001,4518000,101999,False,73,scaffold_3
12,4547001,4558000,10999,False,73,scaffold_3
13,4652001,4685000,32999,False,73,scaffold_3
14,5159001,5192000,32999,False,73,scaffold_3
15,5240001,5271000,30999,False,73,scaffold_3
16,5988001,6023000,34999,False,73,scaffold_3
17,6907001,6962000,54999,False,73,scaffold_3
18,6963001,7089000,125999,False,73,scaffold_3
19,7522001,7556000,33999,False,73,scaffold_3
20,7690001,7839000,148999,False,73,scaffold_3
21,8176001,8253000,76999,False,73,scaffold_3
22,8434001,8446000,11999,False,73,scaffold_3
23,8452001,8527000,74999,False,73,scaffold_3
24,8575001,8594000,18999,False,73,scaffold_3
25,9968001,9996000,27999,False,73,scaffold_3
26,10461001,10484000,22999,False,73,scaffold_3
27,10587001,11163000,575999,False,73,scaffold_3
0,17001,32000,14999,False,73,scaffold_4
1,48001,88000,39999,False,73,scaffold_4
2,120001,131000,10999,False,73,scaffold_4
3,132001,146000,13999,False,73,scaffold_4
4,147001,151000,3999,False,73,scaffold_4
5,155001,215000,59999,False,73,scaffold_4
6,217001,226000,8999,False,73,scaffold_4
7,227001,266000,38999,False,73,scaffold_4
8,355001,374000,18999,False,73,scaffold_4
9,375001,380000,4999,False,73,scaffold_4
10,412001,425000,12999,False,73,scaffold_4
11,429001,498000,68999,False,73,scaffold_4
12,542001,592000,49999,False,73,scaffold_4
13,608001,691000,82999,False,73,scaffold_4
14,695001,697000,1999,False,73,scaffold_4
15,701001,727000,25999,False,73,scaffold_4
16,1121001,1136000,14999,False,73,scaffold_4
17,1137001,1198000,60999,False,73,scaffold_4
18,1199001,1208000,8999,False,73,scaffold_4
19,1210001,1226000,15999,False,73,scaffold_4
20,1235001,1247000,11999,False,73,scaffold_4
21,1248001,1253000,4999,False,73,scaffold_4
22,1254001,1262000,7999,False,73,scaffold_4
23,1265001,1279000,13999,False,73,scaffold_4
24,1283001,1336000,52999,False,73,scaffold_4
25,1361001,1595000,233999,False,73,scaffold_4
26,1613001,1849000,235999,False,73,scaffold_4
27,1850001,2099000,248999,False,73,scaffold_4
28,2188001,2206000,17999,False,73,scaffold_4
29,2211001,2218000,6999,False,73,scaffold_4
30,2219001,2279000,59999,False,73,scaffold_4
31,2284001,2339000,54999,False,73,scaffold_4
32,2432001,2461000,28999,False,73,scaffold_4
33,2476001,2635000,158999,False,73,scaffold_4
34,3091001,3127000,35999,False,73,scaffold_4
35,3335001,3766000,430999,False,73,scaffold_4
36,4057001,4070000,12999,False,73,scaffold_4
37,4901001,5048000,146999,False,73,scaffold_4
38,5173001,5207000,33999,False,73,scaffold_4
39,5475001,5506000,30999,False,73,scaffold_4
40,5514001,5632000,117999,False,73,scaffold_4
41,5659001,5784000,124999,False,73,scaffold_4
42,5786001,5818000,31999,False,73,scaffold_4
43,6145001,6195000,49999,False,73,scaffold_4
44,6796001,6817000,20999,False,73,scaffold_4
45,6902001,6924000,21999,False,73,scaffold_4
46,7036001,7076000,39999,False,73,scaffold_4
47,7228001,7290000,61999,False,73,scaffold_4
48,8846001,9699000,852999,False,73,scaffold_4
49,9700001,9845951,145950,True,73,scaffold_4
0,1,4000,3999,True,73,scaffold_5
1,296001,300000,3999,False,73,scaffold_5
2,320001,326000,5999,False,73,scaffold_5
3,327001,369000,41999,False,73,scaffold_5
4,463001,524000,60999,False,73,scaffold_5
5,933001,947000,13999,False,73,scaffold_5
6,2475001,2493000,17999,False,73,scaffold_5
7,2563001,2581000,17999,False,73,scaffold_5
8,2619001,2875000,255999,False,73,scaffold_5
9,3132001,3269000,136999,False,73,scaffold_5
10,3278001,3438000,159999,False,73,scaffold_5
11,3450001,3513000,62999,False,73,scaffold_5
12,3622001,3658000,35999,False,73,scaffold_5
13,3962001,4101000,138999,False,73,scaffold_5
14,4120001,4221000,100999,False,73,scaffold_5
15,4232001,4272000,39999,False,73,scaffold_5
16,4446001,4526000,79999,False,73,scaffold_5
17,4601001,4861000,259999,False,73,scaffold_5
18,4883001,4919000,35999,False,73,scaffold_5
19,5287001,5312000,24999,False,73,scaffold_5
20,5314001,5345000,30999,False,73,scaffold_5
21,5721001,5738000,16999,False,73,scaffold_5
22,6412001,6417000,4999,False,73,scaffold_5
23,6480001,6653000,172999,False,73,scaffold_5
24,7097001,7100000,2999,False,73,scaffold_5
25,7373001,7386000,12999,False,73,scaffold_5
26,7454001,7486000,31999,False,73,scaffold_5
27,7580001,7656000,75999,False,73,scaffold_5
28,8666001,8689000,22999,False,73,scaffold_5
29,8713001,9363000,649999,False,73,scaffold_5
0,79001,84000,4999,False,73,scaffold_6
1,86001,112000,25999,False,73,scaffold_6
2,239001,254000,14999,False,73,scaffold_6
3,257001,262000,4999,False,73,scaffold_6
4,267001,287000,19999,False,73,scaffold_6
5,1146001,1197000,50999,False,73,scaffold_6
6,1238001,1256000,17999,False,73,scaffold_6
7,1284001,1314000,29999,False,73,scaffold_6
8,1477001,1546000,68999,False,73,scaffold_6
9,2023001,2088000,64999,False,73,scaffold_6
10,2129001,2179000,49999,False,73,scaffold_6
11,2348001,2595000,246999,False,73,scaffold_6
12,2596001,2654000,57999,False,73,scaffold_6
13,2657001,2691000,33999,False,73,scaffold_6
14,2711001,2872000,160999,False,73,scaffold_6
15,2934001,3015000,80999,False,73,scaffold_6
16,3112001,3191000,78999,False,73,scaffold_6
17,3223001,3303000,79999,False,73,scaffold_6
18,3407001,3767000,359999,False,73,scaffold_6
19,3900001,3913000,12999,False,73,scaffold_6
20,4018001,4072000,53999,False,73,scaffold_6
21,4080001,4195000,114999,False,73,scaffold_6
22,6010001,6060000,49999,False,73,scaffold_6
23,6151001,6190000,38999,False,73,scaffold_6
24,7223001,7246000,22999,False,73,scaffold_6
25,7282001,7337000,54999,False,73,scaffold_6
26,7389001,7443000,53999,False,73,scaffold_6
27,7453001,7476000,22999,False,73,scaffold_6
28,7541001,8268281,727280,True,73,scaffold_6
0,1,8000,7999,True,73,scaffold_7
1,13001,31000,17999,False,73,scaffold_7
2,323001,340000,16999,False,73,scaffold_7
3,342001,508000,165999,False,73,scaffold_7
4,554001,563000,8999,False,73,scaffold_7
5,571001,577000,5999,False,73,scaffold_7
6,706001,736000,29999,False,73,scaffold_7
7,764001,827000,62999,False,73,scaffold_7
8,859001,864000,4999,False,73,scaffold_7
9,877001,885000,7999,False,73,scaffold_7
10,964001,966000,1999,False,73,scaffold_7
11,968001,980000,11999,False,73,scaffold_7
12,982001,1044000,61999,False,73,scaffold_7
13,1048001,1078000,29999,False,73,scaffold_7
14,1191001,1459000,267999,False,73,scaffold_7
15,1461001,1512000,50999,False,73,scaffold_7
16,1588001,1692000,103999,False,73,scaffold_7
17,3297001,3370000,72999,False,73,scaffold_7
18,3593001,3767000,173999,False,73,scaffold_7
19,4415001,4535000,119999,False,73,scaffold_7
20,4640001,4652000,11999,False,73,scaffold_7
21,4656001,4734000,77999,False,73,scaffold_7
22,4978001,5149000,170999,False,73,scaffold_7
23,5483001,5536000,52999,False,73,scaffold_7
24,5609001,5647000,37999,False,73,scaffold_7
25,6949001,7270000,320999,False,73,scaffold_7
26,7271001,7502216,231215,True,73,scaffold_7
0,1001,6000,4999,False,73,scaffold_8
1,67001,85000,17999,False,73,scaffold_8
2,2424001,2529000,104999,False,73,scaffold_8
3,2536001,2552000,15999,False,73,scaffold_8
4,2652001,2683000,30999,False,73,scaffold_8
5,2722001,2757000,34999,False,73,scaffold_8
6,2798001,2844000,45999,False,73,scaffold_8
7,3033001,3125000,91999,False,73,scaffold_8
8,3126001,3525000,398999,False,73,scaffold_8
9,3584001,3612000,27999,False,73,scaffold_8
10,3615001,3935000,319999,False,73,scaffold_8
11,4038001,4105000,66999,False,73,scaffold_8
12,4203001,4221000,17999,False,73,scaffold_8
13,5083001,5137000,53999,False,73,scaffold_8
14,5198001,5241000,42999,False,73,scaffold_8
15,6322001,6334544,12543,True,73,scaffold_8
0,109001,118000,8999,False,73,scaffold_9
1,189001,194000,4999,False,73,scaffold_9
2,303001,315000,11999,False,73,scaffold_9
3,319001,332000,12999,False,73,scaffold_9
4,366001,404000,37999,False,73,scaffold_9
5,413001,434000,20999,False,73,scaffold_9
6,504001,531000,26999,False,73,scaffold_9
7,652001,665000,12999,False,73,scaffold_9
8,671001,696000,24999,False,73,scaffold_9
9,731001,742000,10999,False,73,scaffold_9
10,794001,803000,8999,False,73,scaffold_9
11,815001,843000,27999,False,73,scaffold_9
12,850001,862000,11999,False,73,scaffold_9
13,886001,986000,99999,False,73,scaffold_9
14,987001,995000,7999,False,73,scaffold_9
15,1001001,1007000,5999,False,73,scaffold_9
16,1009001,1031000,21999,False,73,scaffold_9
17,1035001,1085000,49999,False,73,scaffold_9
18,1087001,1150000,62999,False,73,scaffold_9
19,1151001,1176000,24999,False,73,scaffold_9
20,1313001,1377000,63999,False,73,scaffold_9
21,1486001,1499000,12999,False,73,scaffold_9
22,1767001,1790000,22999,False,73,scaffold_9
23,2000001,2028000,27999,False,73,scaffold_9
24,2147001,2171000,23999,False,73,scaffold_9
25,2595001,2616000,20999,False,73,scaffold_9
26,2737001,2803000,65999,False,73,scaffold_9
27,2870001,3381000,510999,False,73,scaffold_9
28,3383001,5107000,1723999,False,73,scaffold_9
29,5112001,5114000,1999,False,73,scaffold_9
30,5116001,5238000,121999,False,73,scaffold_9
31,5239001,5298000,58999,False,73,scaffold_9
32,5300001,5491000,190999,False,73,scaffold_9
33,5493001,6331288,838287,True,73,scaffold_9
0,1,136000,135999,True,73,scaffold_10
1,137001,236000,98999,False,73,scaffold_10
2,259001,414000,154999,False,73,scaffold_10
3,415001,482000,66999,False,73,scaffold_10
4,483001,582000,98999,False,73,scaffold_10
5,603001,756000,152999,False,73,scaffold_10
6,785001,793000,7999,False,73,scaffold_10
7,888001,962000,73999,False,73,scaffold_10
8,1058001,1069000,10999,False,73,scaffold_10
9,1084001,1145000,60999,False,73,scaffold_10
10,2138001,2170000,31999,False,73,scaffold_10
11,2269001,2301000,31999,False,73,scaffold_10
12,2346001,2389000,42999,False,73,scaffold_10
13,4053001,4093000,39999,False,73,scaffold_10
14,4154001,4174000,19999,False,73,scaffold_10
15,4443001,4462000,18999,False,73,scaffold_10
16,4467001,4476000,8999,False,73,scaffold_10
17,4506001,4513000,6999,False,73,scaffold_10
18,4527001,4548000,20999,False,73,scaffold_10
19,4574001,4596000,21999,False,73,scaffold_10
20,4681001,4688000,6999,False,73,scaffold_10
21,4734001,4766000,31999,False,73,scaffold_10
22,4769001,4776000,6999,False,73,scaffold_10
23,4798001,4824000,25999,False,73,scaffold_10
24,4828001,4843000,14999,False,73,scaffold_10
25,4848001,4861000,12999,False,73,scaffold_10
26,4865001,4866973,1972,True,73,scaffold_10
0,10001,93000,82999,False,73,scaffold_11
1,149001,167000,17999,False,73,scaffold_11
2,169001,190000,20999,False,73,scaffold_11
3,213001,235000,21999,False,73,scaffold_11
4,240001,251000,10999,False,73,scaffold_11
5,419001,431000,11999,False,73,scaffold_11
6,648001,656000,7999,False,73,scaffold_11
7,1025001,1034000,8999,False,73,scaffold_11
8,1403001,1409000,5999,False,73,scaffold_11
9,1474001,1477000,2999,False,73,scaffold_11
10,2700001,2875000,174999,False,73,scaffold_11
11,2983001,3018000,34999,False,73,scaffold_11
12,3083001,3165000,81999,False,73,scaffold_11
13,3197001,3293000,95999,False,73,scaffold_11
14,3329001,3383000,53999,False,73,scaffold_11
15,3547001,3651000,103999,False,73,scaffold_11
16,3702001,3927000,224999,False,73,scaffold_11
17,3997001,4159000,161999,False,73,scaffold_11
18,4183001,4710000,526999,False,73,scaffold_11
19,4713001,4766820,53819,True,73,scaffold_11
0,1,386000,385999,True,73,scaffold_12
1,404001,1446000,1041999,False,73,scaffold_12
2,1718001,1733000,14999,False,73,scaffold_12
3,2007001,2015000,7999,False,73,scaffold_12
4,2571001,2612000,40999,False,73,scaffold_12
5,2685001,2699000,13999,False,73,scaffold_12
0,1,342000,341999,True,74,scaffold_1
1,482001,498000,15999,False,74,scaffold_1
2,571001,643000,71999,False,74,scaffold_1
3,686001,743000,56999,False,74,scaffold_1
4,1281001,1292000,10999,False,74,scaffold_1
5,1817001,1898000,80999,False,74,scaffold_1
6,1954001,1964000,9999,False,74,scaffold_1
7,1965001,1984000,18999,False,74,scaffold_1
8,1988001,1993000,4999,False,74,scaffold_1
9,2449001,2517000,67999,False,74,scaffold_1
10,2729001,2746000,16999,False,74,scaffold_1
11,3181001,3208000,26999,False,74,scaffold_1
12,3715001,3734000,18999,False,74,scaffold_1
13,3915001,3941000,25999,False,74,scaffold_1
14,4062001,4111000,48999,False,74,scaffold_1
15,4322001,4354000,31999,False,74,scaffold_1
16,4927001,5009000,81999,False,74,scaffold_1
17,5095001,5112000,16999,False,74,scaffold_1
18,5481001,5511000,29999,False,74,scaffold_1
19,5537001,5571000,33999,False,74,scaffold_1
20,6108001,6153000,44999,False,74,scaffold_1
21,6228001,6379000,150999,False,74,scaffold_1
22,6384001,6507000,122999,False,74,scaffold_1
23,6544001,6555000,10999,False,74,scaffold_1
24,7038001,7247000,208999,False,74,scaffold_1
25,7248001,7589000,340999,False,74,scaffold_1
26,7590001,8477000,886999,False,74,scaffold_1
27,8478001,8656000,177999,False,74,scaffold_1
28,8658001,9584000,925999,False,74,scaffold_1
29,9586001,10356000,769999,False,74,scaffold_1
30,10461001,10632000,170999,False,74,scaffold_1
31,10808001,10811000,2999,False,74,scaffold_1
32,10836001,10858000,21999,False,74,scaffold_1
33,11352001,11504000,151999,False,74,scaffold_1
34,11608001,11951000,342999,False,74,scaffold_1
35,12184001,12204000,19999,False,74,scaffold_1
36,12652001,12722000,69999,False,74,scaffold_1
37,12777001,12888000,110999,False,74,scaffold_1
38,13113001,13216000,102999,False,74,scaffold_1
39,13347001,13405000,57999,False,74,scaffold_1
40,14289001,14307000,17999,False,74,scaffold_1
41,14455001,14457000,1999,False,74,scaffold_1
0,21001,48000,26999,False,74,scaffold_2
1,93001,159000,65999,False,74,scaffold_2
2,168001,177000,8999,False,74,scaffold_2
3,302001,318000,15999,False,74,scaffold_2
4,333001,374000,40999,False,74,scaffold_2
5,2336001,2358000,21999,False,74,scaffold_2
6,2405001,2423000,17999,False,74,scaffold_2
7,2441001,2598000,156999,False,74,scaffold_2
8,2660001,2689000,28999,False,74,scaffold_2
9,2694001,2743000,48999,False,74,scaffold_2
10,2868001,2899000,30999,False,74,scaffold_2
11,2994001,3012000,17999,False,74,scaffold_2
12,3336001,3342000,5999,False,74,scaffold_2
13,3454001,3463000,8999,False,74,scaffold_2
14,3754001,3783000,28999,False,74,scaffold_2
15,4385001,4409000,23999,False,74,scaffold_2
16,4429001,4456000,26999,False,74,scaffold_2
17,4519001,4654000,134999,False,74,scaffold_2
18,4787001,4790000,2999,False,74,scaffold_2
19,4918001,4937000,18999,False,74,scaffold_2
20,5021001,5061000,39999,False,74,scaffold_2
21,5491001,5512000,20999,False,74,scaffold_2
22,5658001,5704000,45999,False,74,scaffold_2
23,5719001,5753000,33999,False,74,scaffold_2
24,5841001,5887000,45999,False,74,scaffold_2
25,6261001,6330000,68999,False,74,scaffold_2
26,6331001,6350000,18999,False,74,scaffold_2
27,6430001,6448000,17999,False,74,scaffold_2
28,7006001,7037000,30999,False,74,scaffold_2
29,7439001,7472000,32999,False,74,scaffold_2
30,7563001,7697000,133999,False,74,scaffold_2
31,7786001,7890000,103999,False,74,scaffold_2
32,7933001,8161000,227999,False,74,scaffold_2
33,8265001,8297000,31999,False,74,scaffold_2
34,8331001,8333000,1999,False,74,scaffold_2
35,8340001,8344000,3999,False,74,scaffold_2
36,8346001,8453000,106999,False,74,scaffold_2
37,8509001,8560000,50999,False,74,scaffold_2
38,11520001,11786000,265999,False,74,scaffold_2
0,1,2000,1999,True,74,scaffold_3
1,51001,55000,3999,False,74,scaffold_3
2,102001,104000,1999,False,74,scaffold_3
3,800001,900000,99999,False,74,scaffold_3
4,2084001,2108000,23999,False,74,scaffold_3
5,2291001,2321000,29999,False,74,scaffold_3
6,2487001,2533000,45999,False,74,scaffold_3
7,3826001,3890000,63999,False,74,scaffold_3
8,4105001,4403000,297999,False,74,scaffold_3
9,4410001,4518000,107999,False,74,scaffold_3
10,4547001,4558000,10999,False,74,scaffold_3
11,4654001,4678000,23999,False,74,scaffold_3
12,5174001,5189000,14999,False,74,scaffold_3
13,5493001,5509000,15999,False,74,scaffold_3
14,5990001,6020000,29999,False,74,scaffold_3
15,6908001,6962000,53999,False,74,scaffold_3
16,6963001,6968000,4999,False,74,scaffold_3
17,6979001,7088000,108999,False,74,scaffold_3
18,7522001,7556000,33999,False,74,scaffold_3
19,7692001,7797000,104999,False,74,scaffold_3
20,7820001,7847000,26999,False,74,scaffold_3
21,8176001,8253000,76999,False,74,scaffold_3
22,8462001,8527000,64999,False,74,scaffold_3
23,8575001,8594000,18999,False,74,scaffold_3
24,9968001,9996000,27999,False,74,scaffold_3
25,10461001,10483000,21999,False,74,scaffold_3
26,10587001,11163000,575999,False,74,scaffold_3
0,49001,88000,38999,False,74,scaffold_4
1,133001,146000,12999,False,74,scaffold_4
2,147001,151000,3999,False,74,scaffold_4
3,155001,215000,59999,False,74,scaffold_4
4,217001,226000,8999,False,74,scaffold_4
5,227001,266000,38999,False,74,scaffold_4
6,318001,344000,25999,False,74,scaffold_4
7,355001,374000,18999,False,74,scaffold_4
8,412001,425000,12999,False,74,scaffold_4
9,429001,498000,68999,False,74,scaffold_4
10,544001,606000,61999,False,74,scaffold_4
11,608001,661000,52999,False,74,scaffold_4
12,670001,691000,20999,False,74,scaffold_4
13,701001,714000,12999,False,74,scaffold_4
14,1120001,1136000,15999,False,74,scaffold_4
15,1138001,1198000,59999,False,74,scaffold_4
16,1199001,1226000,26999,False,74,scaffold_4
17,1235001,1246000,10999,False,74,scaffold_4
18,1254001,1262000,7999,False,74,scaffold_4
19,1265001,1279000,13999,False,74,scaffold_4
20,1283001,1319000,35999,False,74,scaffold_4
21,1372001,1598000,225999,False,74,scaffold_4
22,1613001,1957000,343999,False,74,scaffold_4
23,1958001,2069000,110999,False,74,scaffold_4
24,2071001,2114000,42999,False,74,scaffold_4
25,2162001,2185000,22999,False,74,scaffold_4
26,2211001,2246000,34999,False,74,scaffold_4
27,2247001,2268000,20999,False,74,scaffold_4
28,2269001,2279000,9999,False,74,scaffold_4
29,2284001,2340000,55999,False,74,scaffold_4
30,2429001,2461000,31999,False,74,scaffold_4
31,2476001,2545000,68999,False,74,scaffold_4
32,2598001,2635000,36999,False,74,scaffold_4
33,2676001,2715000,38999,False,74,scaffold_4
34,3336001,3633000,296999,False,74,scaffold_4
35,3650001,3760000,109999,False,74,scaffold_4
36,4941001,4985000,43999,False,74,scaffold_4
37,5172001,5208000,35999,False,74,scaffold_4
38,5476001,5506000,29999,False,74,scaffold_4
39,5514001,5620000,105999,False,74,scaffold_4
40,5665001,5784000,118999,False,74,scaffold_4
41,5786001,5819000,32999,False,74,scaffold_4
42,6145001,6193000,47999,False,74,scaffold_4
43,6800001,6817000,16999,False,74,scaffold_4
44,6902001,6924000,21999,False,74,scaffold_4
45,6951001,6995000,43999,False,74,scaffold_4
46,7037001,7062000,24999,False,74,scaffold_4
47,8848001,9699000,850999,False,74,scaffold_4
48,9700001,9766000,65999,False,74,scaffold_4
49,9767001,9845951,78950,True,74,scaffold_4
0,178001,180000,1999,False,74,scaffold_5
1,318001,368000,49999,False,74,scaffold_5
2,463001,523000,59999,False,74,scaffold_5
3,933001,947000,13999,False,74,scaffold_5
4,2564001,2581000,16999,False,74,scaffold_5
5,2625001,2736000,110999,False,74,scaffold_5
6,2816001,2871000,54999,False,74,scaffold_5
7,3134001,3185000,50999,False,74,scaffold_5
8,3227001,3236000,8999,False,74,scaffold_5
9,3322001,3498000,175999,False,74,scaffold_5
10,3962001,4101000,138999,False,74,scaffold_5
11,4119001,4219000,99999,False,74,scaffold_5
12,4246001,4263000,16999,False,74,scaffold_5
13,4446001,4492000,45999,False,74,scaffold_5
14,4600001,4680000,79999,False,74,scaffold_5
15,4691001,4717000,25999,False,74,scaffold_5
16,4761001,4861000,99999,False,74,scaffold_5
17,4899001,4918000,18999,False,74,scaffold_5
18,5285001,5312000,26999,False,74,scaffold_5
19,5314001,5346000,31999,False,74,scaffold_5
20,6406001,6420000,13999,False,74,scaffold_5
21,6504001,6566000,61999,False,74,scaffold_5
22,7372001,7386000,13999,False,74,scaffold_5
23,7454001,7483000,28999,False,74,scaffold_5
24,7581001,7609000,27999,False,74,scaffold_5
25,7621001,7654000,32999,False,74,scaffold_5
26,8666001,8689000,22999,False,74,scaffold_5
27,8714001,9364176,650175,True,74,scaffold_5
0,79001,85000,5999,False,74,scaffold_6
1,86001,112000,25999,False,74,scaffold_6
2,239001,254000,14999,False,74,scaffold_6
3,256001,262000,5999,False,74,scaffold_6
4,1238001,1256000,17999,False,74,scaffold_6
5,1479001,1546000,66999,False,74,scaffold_6
6,1844001,1905000,60999,False,74,scaffold_6
7,2023001,2086000,62999,False,74,scaffold_6
8,2130001,2180000,49999,False,74,scaffold_6
9,2337001,2595000,257999,False,74,scaffold_6
10,2596001,2653000,56999,False,74,scaffold_6
11,2655001,2691000,35999,False,74,scaffold_6
12,2713001,2851000,137999,False,74,scaffold_6
13,2934001,3014000,79999,False,74,scaffold_6
14,3109001,3191000,81999,False,74,scaffold_6
15,3223001,3315000,91999,False,74,scaffold_6
16,3407001,3428000,20999,False,74,scaffold_6
17,3461001,3766000,304999,False,74,scaffold_6
18,3901001,3912000,10999,False,74,scaffold_6
19,4018001,4072000,53999,False,74,scaffold_6
20,4073001,4193000,119999,False,74,scaffold_6
21,6010001,6062000,51999,False,74,scaffold_6
22,7264001,7337000,72999,False,74,scaffold_6
23,7389001,7434000,44999,False,74,scaffold_6
24,7556001,7798000,241999,False,74,scaffold_6
25,7811001,8268281,457280,True,74,scaffold_6
0,1,7000,6999,True,74,scaffold_7
1,13001,31000,17999,False,74,scaffold_7
2,323001,340000,16999,False,74,scaffold_7
3,342001,508000,165999,False,74,scaffold_7
4,554001,563000,8999,False,74,scaffold_7
5,571001,577000,5999,False,74,scaffold_7
6,706001,736000,29999,False,74,scaffold_7
7,741001,753000,11999,False,74,scaffold_7
8,764001,826000,61999,False,74,scaffold_7
9,859001,864000,4999,False,74,scaffold_7
10,982001,1044000,61999,False,74,scaffold_7
11,1048001,1104000,55999,False,74,scaffold_7
12,1191001,1201000,9999,False,74,scaffold_7
13,1203001,1512000,308999,False,74,scaffold_7
14,1588001,1695000,106999,False,74,scaffold_7
15,1772001,1782000,9999,False,74,scaffold_7
16,3325001,3369000,43999,False,74,scaffold_7
17,3536001,3548000,11999,False,74,scaffold_7
18,3595001,3652000,56999,False,74,scaffold_7
19,3719001,3765000,45999,False,74,scaffold_7
20,4415001,4535000,119999,False,74,scaffold_7
21,4658001,4734000,75999,False,74,scaffold_7
22,4979001,5115000,135999,False,74,scaffold_7
23,5484001,5536000,51999,False,74,scaffold_7
24,5609001,5644000,34999,False,74,scaffold_7
25,6953001,7270000,316999,False,74,scaffold_7
26,7271001,7502216,231215,True,74,scaffold_7
0,66001,85000,18999,False,74,scaffold_8
1,93001,101000,7999,False,74,scaffold_8
2,2444001,2470000,25999,False,74,scaffold_8
3,2492001,2513000,20999,False,74,scaffold_8
4,2653001,2683000,29999,False,74,scaffold_8
5,2723001,2761000,37999,False,74,scaffold_8
6,2812001,2844000,31999,False,74,scaffold_8
7,3059001,3125000,65999,False,74,scaffold_8
8,3126001,3525000,398999,False,74,scaffold_8
9,3584001,3612000,27999,False,74,scaffold_8
10,3615001,3913000,297999,False,74,scaffold_8
11,5095001,5136000,40999,False,74,scaffold_8
12,5184001,5241000,56999,False,74,scaffold_8
13,6322001,6334544,12543,True,74,scaffold_8
0,1001,20000,18999,False,74,scaffold_9
1,109001,117000,7999,False,74,scaffold_9
2,299001,315000,15999,False,74,scaffold_9
3,319001,332000,12999,False,74,scaffold_9
4,367001,411000,43999,False,74,scaffold_9
5,413001,435000,21999,False,74,scaffold_9
6,502001,531000,28999,False,74,scaffold_9
7,671001,696000,24999,False,74,scaffold_9
8,732001,742000,9999,False,74,scaffold_9
9,793001,803000,9999,False,74,scaffold_9
10,816001,842000,25999,False,74,scaffold_9
11,850001,862000,11999,False,74,scaffold_9
12,873001,986000,112999,False,74,scaffold_9
13,987001,995000,7999,False,74,scaffold_9
14,1001001,1007000,5999,False,74,scaffold_9
15,1009001,1031000,21999,False,74,scaffold_9
16,1037001,1085000,47999,False,74,scaffold_9
17,1087001,1150000,62999,False,74,scaffold_9
18,1151001,1164000,12999,False,74,scaffold_9
19,1313001,1383000,69999,False,74,scaffold_9
20,1600001,1616000,15999,False,74,scaffold_9
21,1750001,1791000,40999,False,74,scaffold_9
22,1987001,2052000,64999,False,74,scaffold_9
23,2148001,2168000,19999,False,74,scaffold_9
24,2598001,2616000,17999,False,74,scaffold_9
25,2739001,2759000,19999,False,74,scaffold_9
26,2768001,2803000,34999,False,74,scaffold_9
27,2870001,3381000,510999,False,74,scaffold_9
28,3383001,5099000,1715999,False,74,scaffold_9
29,5101001,5106000,4999,False,74,scaffold_9
30,5112001,5114000,1999,False,74,scaffold_9
31,5116001,5238000,121999,False,74,scaffold_9
32,5239001,5298000,58999,False,74,scaffold_9
33,5300001,5491000,190999,False,74,scaffold_9
34,5493001,6331288,838287,True,74,scaffold_9
0,1,235000,234999,True,74,scaffold_10
1,259001,405000,145999,False,74,scaffold_10
2,472001,482000,9999,False,74,scaffold_10
3,483001,576000,92999,False,74,scaffold_10
4,603001,752000,148999,False,74,scaffold_10
5,888001,921000,32999,False,74,scaffold_10
6,923001,963000,39999,False,74,scaffold_10
7,1087001,1113000,25999,False,74,scaffold_10
8,2140001,2176000,35999,False,74,scaffold_10
9,2268001,2297000,28999,False,74,scaffold_10
10,2346001,2389000,42999,False,74,scaffold_10
11,2736001,2745000,8999,False,74,scaffold_10
12,4053001,4091000,37999,False,74,scaffold_10
13,4154001,4174000,19999,False,74,scaffold_10
14,4446001,4462000,15999,False,74,scaffold_10
15,4467001,4477000,9999,False,74,scaffold_10
16,4506001,4513000,6999,False,74,scaffold_10
17,4527001,4548000,20999,False,74,scaffold_10
18,4576001,4596000,19999,False,74,scaffold_10
19,4679001,4688000,8999,False,74,scaffold_10
20,4734001,4766000,31999,False,74,scaffold_10
21,4798001,4824000,25999,False,74,scaffold_10
22,4828001,4843000,14999,False,74,scaffold_10
23,4848001,4861000,12999,False,74,scaffold_10
24,4865001,4866973,1972,True,74,scaffold_10
0,11001,93000,81999,False,74,scaffold_11
1,149001,167000,17999,False,74,scaffold_11
2,169001,191000,21999,False,74,scaffold_11
3,213001,235000,21999,False,74,scaffold_11
4,240001,247000,6999,False,74,scaffold_11
5,419001,431000,11999,False,74,scaffold_11
6,648001,656000,7999,False,74,scaffold_11
7,1025001,1034000,8999,False,74,scaffold_11
8,1423001,1427000,3999,False,74,scaffold_11
9,2701001,2875000,173999,False,74,scaffold_11
10,3188001,3262000,73999,False,74,scaffold_11
11,3331001,3383000,51999,False,74,scaffold_11
12,3556001,3578000,21999,False,74,scaffold_11
13,3702001,3929000,226999,False,74,scaffold_11
14,4009001,4159000,149999,False,74,scaffold_11
15,4255001,4710000,454999,False,74,scaffold_11
16,4713001,4766820,53819,True,74,scaffold_11
0,1,370000,369999,True,74,scaffold_12
1,474001,856000,381999,False,74,scaffold_12
2,865001,1448000,582999,False,74,scaffold_12
3,1720001,1733000,12999,False,74,scaffold_12
4,2043001,2087000,43999,False,74,scaffold_12
5,2088001,2103000,14999,False,74,scaffold_12
6,2136001,2161000,24999,False,74,scaffold_12
7,2571001,2617000,45999,False,74,scaffold_12
8,2685001,2699000,13999,False,74,scaffold_12
0,1,342000,341999,True,75,scaffold_1
1,482001,498000,15999,False,75,scaffold_1
2,572001,643000,70999,False,75,scaffold_1
3,686001,759000,72999,False,75,scaffold_1
4,1281001,1292000,10999,False,75,scaffold_1
5,1617001,1660000,42999,False,75,scaffold_1
6,1817001,1898000,80999,False,75,scaffold_1
7,1950001,1964000,13999,False,75,scaffold_1
8,1965001,1984000,18999,False,75,scaffold_1
9,2449001,2517000,67999,False,75,scaffold_1
10,2729001,2746000,16999,False,75,scaffold_1
11,2999001,3014000,14999,False,75,scaffold_1
12,3180001,3208000,27999,False,75,scaffold_1
13,3714001,3734000,19999,False,75,scaffold_1
14,3901001,3941000,39999,False,75,scaffold_1
15,3960001,4029000,68999,False,75,scaffold_1
16,4062001,4112000,49999,False,75,scaffold_1
17,4314001,4354000,39999,False,75,scaffold_1
18,4796001,4809000,12999,False,75,scaffold_1
19,4928001,5024000,95999,False,75,scaffold_1
20,5087001,5114000,26999,False,75,scaffold_1
21,5437001,5451000,13999,False,75,scaffold_1
22,5481001,5521000,39999,False,75,scaffold_1
23,5535001,5573000,37999,False,75,scaffold_1
24,5853001,5875000,21999,False,75,scaffold_1
25,6108001,6153000,44999,False,75,scaffold_1
26,6154001,6177000,22999,False,75,scaffold_1
27,6228001,6379000,150999,False,75,scaffold_1
28,6384001,6507000,122999,False,75,scaffold_1
29,6543001,6562000,18999,False,75,scaffold_1
30,7038001,7247000,208999,False,75,scaffold_1
31,7248001,7584000,335999,False,75,scaffold_1
32,7590001,8477000,886999,False,75,scaffold_1
33,8478001,8656000,177999,False,75,scaffold_1
34,8658001,9584000,925999,False,75,scaffold_1
35,9586001,10361000,774999,False,75,scaffold_1
36,10460001,10638000,177999,False,75,scaffold_1
37,10720001,10761000,40999,False,75,scaffold_1
38,10835001,10857000,21999,False,75,scaffold_1
39,10920001,10954000,33999,False,75,scaffold_1
40,11280001,11510000,229999,False,75,scaffold_1
41,11561001,11963000,401999,False,75,scaffold_1
42,12184001,12205000,20999,False,75,scaffold_1
43,12652001,12722000,69999,False,75,scaffold_1
44,12776001,12888000,111999,False,75,scaffold_1
45,12965001,13002000,36999,False,75,scaffold_1
46,13113001,13216000,102999,False,75,scaffold_1
47,13347001,13405000,57999,False,75,scaffold_1
48,13561001,13584000,22999,False,75,scaffold_1
49,13815001,13845000,29999,False,75,scaffold_1
50,13959001,13977000,17999,False,75,scaffold_1
51,14288001,14313000,24999,False,75,scaffold_1
52,14648001,14663000,14999,False,75,scaffold_1
0,22001,48000,25999,False,75,scaffold_2
1,95001,159000,63999,False,75,scaffold_2
2,165001,177000,11999,False,75,scaffold_2
3,253001,290000,36999,False,75,scaffold_2
4,296001,318000,21999,False,75,scaffold_2
5,332001,374000,41999,False,75,scaffold_2
6,1527001,1547000,19999,False,75,scaffold_2
7,2086001,2107000,20999,False,75,scaffold_2
8,2336001,2358000,21999,False,75,scaffold_2
9,2399001,2415000,15999,False,75,scaffold_2
10,2416001,2424000,7999,False,75,scaffold_2
11,2440001,2555000,114999,False,75,scaffold_2
12,2654001,2689000,34999,False,75,scaffold_2
13,2693001,2746000,52999,False,75,scaffold_2
14,2838001,2856000,17999,False,75,scaffold_2
15,2868001,2910000,41999,False,75,scaffold_2
16,2975001,3012000,36999,False,75,scaffold_2
17,3333001,3344000,10999,False,75,scaffold_2
18,3450001,3466000,15999,False,75,scaffold_2
19,3756001,3784000,27999,False,75,scaffold_2
20,4382001,4409000,26999,False,75,scaffold_2
21,4426001,4458000,31999,False,75,scaffold_2
22,4519001,4656000,136999,False,75,scaffold_2
23,4918001,4960000,41999,False,75,scaffold_2
24,5021001,5068000,46999,False,75,scaffold_2
25,5079001,5104000,24999,False,75,scaffold_2
26,5285001,5314000,28999,False,75,scaffold_2
27,5460001,5463000,2999,False,75,scaffold_2
28,5491001,5513000,21999,False,75,scaffold_2
29,5627001,5759000,131999,False,75,scaffold_2
30,5840001,5887000,46999,False,75,scaffold_2
31,6261001,6330000,68999,False,75,scaffold_2
32,6331001,6351000,19999,False,75,scaffold_2
33,6411001,6449000,37999,False,75,scaffold_2
34,6593001,6628000,34999,False,75,scaffold_2
35,7005001,7038000,32999,False,75,scaffold_2
36,7063001,7096000,32999,False,75,scaffold_2
37,7387001,7473000,85999,False,75,scaffold_2
38,7491001,7513000,21999,False,75,scaffold_2
39,7550001,7561000,10999,False,75,scaffold_2
40,7563001,7697000,133999,False,75,scaffold_2
41,7780001,7917000,136999,False,75,scaffold_2
42,7934001,8161000,226999,False,75,scaffold_2
43,8246001,8296000,49999,False,75,scaffold_2
44,8331001,8333000,1999,False,75,scaffold_2
45,8334001,8345000,10999,False,75,scaffold_2
46,8346001,8453000,106999,False,75,scaffold_2
47,8509001,8562000,52999,False,75,scaffold_2
48,9011001,9047000,35999,False,75,scaffold_2
49,9140001,9168000,27999,False,75,scaffold_2
50,9367001,9381000,13999,False,75,scaffold_2
51,9601001,9624000,22999,False,75,scaffold_2
52,11520001,11786000,265999,False,75,scaffold_2
0,1,2000,1999,True,75,scaffold_3
1,618001,646000,27999,False,75,scaffold_3
2,795001,901000,105999,False,75,scaffold_3
3,2041001,2108000,66999,False,75,scaffold_3
4,2109001,2115000,5999,False,75,scaffold_3
5,2288001,2321000,32999,False,75,scaffold_3
6,2487001,2531000,43999,False,75,scaffold_3
7,2561001,2573000,11999,False,75,scaffold_3
8,2650001,2667000,16999,False,75,scaffold_3
9,2717001,2736000,18999,False,75,scaffold_3
10,3768001,3891000,122999,False,75,scaffold_3
11,4108001,4398000,289999,False,75,scaffold_3
12,4418001,4518000,99999,False,75,scaffold_3
13,4547001,4558000,10999,False,75,scaffold_3
14,4639001,4689000,49999,False,75,scaffold_3
15,5863001,5908000,44999,False,75,scaffold_3
16,5927001,5943000,15999,False,75,scaffold_3
17,5975001,6020000,44999,False,75,scaffold_3
18,6743001,6782000,38999,False,75,scaffold_3
19,6909001,7098000,188999,False,75,scaffold_3
20,7430001,7445000,14999,False,75,scaffold_3
21,7449001,7458000,8999,False,75,scaffold_3
22,7521001,7556000,34999,False,75,scaffold_3
23,7682001,7855000,172999,False,75,scaffold_3
24,8050001,8116000,65999,False,75,scaffold_3
25,8176001,8255000,78999,False,75,scaffold_3
26,8427001,8527000,99999,False,75,scaffold_3
27,8575001,8594000,18999,False,75,scaffold_3
28,9058001,9073000,14999,False,75,scaffold_3
29,9968001,9996000,27999,False,75,scaffold_3
30,10553001,10570000,16999,False,75,scaffold_3
31,10587001,11182071,595070,True,75,scaffold_3
0,11001,13000,1999,False,75,scaffold_4
1,14001,32000,17999,False,75,scaffold_4
2,48001,88000,39999,False,75,scaffold_4
3,121001,146000,24999,False,75,scaffold_4
4,147001,151000,3999,False,75,scaffold_4
5,155001,160000,4999,False,75,scaffold_4
6,161001,215000,53999,False,75,scaffold_4
7,217001,226000,8999,False,75,scaffold_4
8,227001,266000,38999,False,75,scaffold_4
9,283001,309000,25999,False,75,scaffold_4
10,318001,344000,25999,False,75,scaffold_4
11,345001,353000,7999,False,75,scaffold_4
12,355001,374000,18999,False,75,scaffold_4
13,389001,410000,20999,False,75,scaffold_4
14,412001,425000,12999,False,75,scaffold_4
15,429001,502000,72999,False,75,scaffold_4
16,542001,599000,56999,False,75,scaffold_4
17,600001,606000,5999,False,75,scaffold_4
18,608001,691000,82999,False,75,scaffold_4
19,695001,697000,1999,False,75,scaffold_4
20,701001,727000,25999,False,75,scaffold_4
21,1113001,1198000,84999,False,75,scaffold_4
22,1199001,1208000,8999,False,75,scaffold_4
23,1210001,1226000,15999,False,75,scaffold_4
24,1235001,1253000,17999,False,75,scaffold_4
25,1269001,1279000,9999,False,75,scaffold_4
26,1283001,1597000,313999,False,75,scaffold_4
27,1613001,2117000,503999,False,75,scaffold_4
28,2119001,2199000,79999,False,75,scaffold_4
29,2200001,2205000,4999,False,75,scaffold_4
30,2210001,2246000,35999,False,75,scaffold_4
31,2247001,2280000,32999,False,75,scaffold_4
32,2282001,2461000,178999,False,75,scaffold_4
33,2480001,2635000,154999,False,75,scaffold_4
34,2676001,2720000,43999,False,75,scaffold_4
35,2932001,2955000,22999,False,75,scaffold_4
36,3091001,3127000,35999,False,75,scaffold_4
37,3334001,3761000,426999,False,75,scaffold_4
38,4055001,4073000,17999,False,75,scaffold_4
39,4942001,5061000,118999,False,75,scaffold_4
40,5170001,5224000,53999,False,75,scaffold_4
41,5475001,5506000,30999,False,75,scaffold_4
42,5514001,5620000,105999,False,75,scaffold_4
43,5657001,5784000,126999,False,75,scaffold_4
44,5786001,5820000,33999,False,75,scaffold_4
45,6148001,6194000,45999,False,75,scaffold_4
46,6770001,6817000,46999,False,75,scaffold_4
47,6894001,6924000,29999,False,75,scaffold_4
48,7036001,7079000,42999,False,75,scaffold_4
49,7225001,7276000,50999,False,75,scaffold_4
50,7640001,7664000,23999,False,75,scaffold_4
51,8844001,9699000,854999,False,75,scaffold_4
52,9700001,9845951,145950,True,75,scaffold_4
0,318001,387000,68999,False,75,scaffold_5
1,462001,524000,61999,False,75,scaffold_5
2,671001,695000,23999,False,75,scaffold_5
3,933001,947000,13999,False,75,scaffold_5
4,2516001,2522000,5999,False,75,scaffold_5
5,2552001,2738000,185999,False,75,scaffold_5
6,2813001,2874000,60999,False,75,scaffold_5
7,3133001,3245000,111999,False,75,scaffold_5
8,3322001,3511000,188999,False,75,scaffold_5
9,3622001,3643000,20999,False,75,scaffold_5
10,3962001,4101000,138999,False,75,scaffold_5
11,4120001,4222000,101999,False,75,scaffold_5
12,4240001,4275000,34999,False,75,scaffold_5
13,4444001,4507000,62999,False,75,scaffold_5
14,4600001,4680000,79999,False,75,scaffold_5
15,4691001,4861000,169999,False,75,scaffold_5
16,4892001,4919000,26999,False,75,scaffold_5
17,5259001,5274000,14999,False,75,scaffold_5
18,5288001,5344000,55999,False,75,scaffold_5
19,6410001,6420000,9999,False,75,scaffold_5
20,6453001,6686000,232999,False,75,scaffold_5
21,6886001,6906000,19999,False,75,scaffold_5
22,7317001,7328000,10999,False,75,scaffold_5
23,7406001,7441000,34999,False,75,scaffold_5
24,7454001,7483000,28999,False,75,scaffold_5
25,7580001,7656000,75999,False,75,scaffold_5
26,8436001,8460000,23999,False,75,scaffold_5
27,8553001,8616000,62999,False,75,scaffold_5
28,8659001,8686000,26999,False,75,scaffold_5
29,8712001,9364176,652175,True,75,scaffold_5
0,65001,75000,9999,False,75,scaffold_6
1,77001,84000,6999,False,75,scaffold_6
2,86001,114000,27999,False,75,scaffold_6
3,163001,208000,44999,False,75,scaffold_6
4,240001,253000,12999,False,75,scaffold_6
5,256001,334000,77999,False,75,scaffold_6
6,553001,561000,7999,False,75,scaffold_6
7,786001,799000,12999,False,75,scaffold_6
8,1236001,1263000,26999,False,75,scaffold_6
9,1478001,1549000,70999,False,75,scaffold_6
10,1866001,1906000,39999,False,75,scaffold_6
11,2026001,2087000,60999,False,75,scaffold_6
12,2131001,2199000,67999,False,75,scaffold_6
13,2239001,2282000,42999,False,75,scaffold_6
14,2336001,2595000,258999,False,75,scaffold_6
15,2596001,2872000,275999,False,75,scaffold_6
16,2937001,3014000,76999,False,75,scaffold_6
17,3114001,3178000,63999,False,75,scaffold_6
18,3223001,3343000,119999,False,75,scaffold_6
19,3392001,3788000,395999,False,75,scaffold_6
20,3897001,3913000,15999,False,75,scaffold_6
21,4011001,4072000,60999,False,75,scaffold_6
22,4073001,4194000,120999,False,75,scaffold_6
23,6010001,6087000,76999,False,75,scaffold_6
24,7184001,7338000,153999,False,75,scaffold_6
25,7389001,7478000,88999,False,75,scaffold_6
26,7550001,7796000,245999,False,75,scaffold_6
27,7811001,8268281,457280,True,75,scaffold_6
0,1,8000,7999,True,75,scaffold_7
1,13001,34000,20999,False,75,scaffold_7
2,322001,340000,17999,False,75,scaffold_7
3,342001,508000,165999,False,75,scaffold_7
4,571001,579000,7999,False,75,scaffold_7
5,650001,675000,24999,False,75,scaffold_7
6,706001,753000,46999,False,75,scaffold_7
7,764001,829000,64999,False,75,scaffold_7
8,859001,864000,4999,False,75,scaffold_7
9,865001,938000,72999,False,75,scaffold_7
10,964001,966000,1999,False,75,scaffold_7
11,968001,981000,12999,False,75,scaffold_7
12,982001,1044000,61999,False,75,scaffold_7
13,1048001,1104000,55999,False,75,scaffold_7
14,1106001,1140000,33999,False,75,scaffold_7
15,1191001,1460000,268999,False,75,scaffold_7
16,1461001,1512000,50999,False,75,scaffold_7
17,1588001,1693000,104999,False,75,scaffold_7
18,1737001,1759000,21999,False,75,scaffold_7
19,1851001,1892000,40999,False,75,scaffold_7
20,2851001,2879000,27999,False,75,scaffold_7
21,3298001,3370000,71999,False,75,scaffold_7
22,3523001,3551000,27999,False,75,scaffold_7
23,3593001,3777000,183999,False,75,scaffold_7
24,4027001,4042000,14999,False,75,scaffold_7
25,4414001,4517000,102999,False,75,scaffold_7
26,4658001,4734000,75999,False,75,scaffold_7
27,4978001,5149000,170999,False,75,scaffold_7
28,5470001,5516000,45999,False,75,scaffold_7
29,5520001,5536000,15999,False,75,scaffold_7
30,6953001,7502216,549215,True,75,scaffold_7
0,1,6000,5999,True,75,scaffold_8
1,42001,89000,46999,False,75,scaffold_8
2,364001,367000,2999,False,75,scaffold_8
3,2362001,2372000,9999,False,75,scaffold_8
4,2443001,2552000,108999,False,75,scaffold_8
5,2652001,2682000,29999,False,75,scaffold_8
6,2745001,2756000,10999,False,75,scaffold_8
7,2798001,2844000,45999,False,75,scaffold_8
8,2846001,2888000,41999,False,75,scaffold_8
9,3036001,3525000,488999,False,75,scaffold_8
10,3584001,3612000,27999,False,75,scaffold_8
11,3615001,3947000,331999,False,75,scaffold_8
12,4039001,4107000,67999,False,75,scaffold_8
13,4173001,4220000,46999,False,75,scaffold_8
14,4400001,4432000,31999,False,75,scaffold_8
15,4814001,4838000,23999,False,75,scaffold_8
16,5125001,5134000,8999,False,75,scaffold_8
17,5170001,5241000,70999,False,75,scaffold_8
18,5580001,5594000,13999,False,75,scaffold_8
19,5651001,5694000,42999,False,75,scaffold_8
20,5761001,5772000,10999,False,75,scaffold_8
21,6327001,6334544,7543,True,75,scaffold_8
0,1,22000,21999,True,75,scaffold_9
1,109001,118000,8999,False,75,scaffold_9
2,121001,138000,16999,False,75,scaffold_9
3,299001,316000,16999,False,75,scaffold_9
4,319001,411000,91999,False,75,scaffold_9
5,413001,434000,20999,False,75,scaffold_9
6,484001,531000,46999,False,75,scaffold_9
7,651001,659000,7999,False,75,scaffold_9
8,660001,665000,4999,False,75,scaffold_9
9,670001,696000,25999,False,75,scaffold_9
10,731001,741000,9999,False,75,scaffold_9
11,816001,844000,27999,False,75,scaffold_9
12,874001,986000,111999,False,75,scaffold_9
13,987001,996000,8999,False,75,scaffold_9
14,997001,1007000,9999,False,75,scaffold_9
15,1010001,1150000,139999,False,75,scaffold_9
16,1151001,1166000,14999,False,75,scaffold_9
17,1312001,1379000,66999,False,75,scaffold_9
18,1487001,1500000,12999,False,75,scaffold_9
19,1599001,1616000,16999,False,75,scaffold_9
20,1749001,1809000,59999,False,75,scaffold_9
21,1892001,1902000,9999,False,75,scaffold_9
22,1970001,2056000,85999,False,75,scaffold_9
23,2598001,2616000,17999,False,75,scaffold_9
24,2736001,3381000,644999,False,75,scaffold_9
25,3383001,5107000,1723999,False,75,scaffold_9
26,5112001,5238000,125999,False,75,scaffold_9
27,5239001,5490000,250999,False,75,scaffold_9
28,5493001,6331288,838287,True,75,scaffold_9
0,1,199000,198999,True,75,scaffold_10
1,257001,414000,156999,False,75,scaffold_10
2,415001,482000,66999,False,75,scaffold_10
3,483001,582000,98999,False,75,scaffold_10
4,596001,795000,198999,False,75,scaffold_10
5,888001,962000,73999,False,75,scaffold_10
6,1084001,1112000,27999,False,75,scaffold_10
7,2087001,2103000,15999,False,75,scaffold_10
8,2140001,2169000,28999,False,75,scaffold_10
9,2268001,2301000,32999,False,75,scaffold_10
10,2346001,2390000,43999,False,75,scaffold_10
11,2600001,2637000,36999,False,75,scaffold_10
12,4002001,4012000,9999,False,75,scaffold_10
13,4052001,4091000,38999,False,75,scaffold_10
14,4154001,4174000,19999,False,75,scaffold_10
15,4335001,4364000,28999,False,75,scaffold_10
16,4443001,4461000,17999,False,75,scaffold_10
17,4470001,4502000,31999,False,75,scaffold_10
18,4503001,4513000,9999,False,75,scaffold_10
19,4515001,4523000,7999,False,75,scaffold_10
20,4526001,4548000,21999,False,75,scaffold_10
21,4565001,4596000,30999,False,75,scaffold_10
22,4679001,4688000,8999,False,75,scaffold_10
23,4734001,4766000,31999,False,75,scaffold_10
24,4769001,4776000,6999,False,75,scaffold_10
25,4798001,4824000,25999,False,75,scaffold_10
26,4828001,4846000,17999,False,75,scaffold_10
27,4848001,4861000,12999,False,75,scaffold_10
28,4865001,4866973,1972,True,75,scaffold_10
0,10001,91000,80999,False,75,scaffold_11
1,148001,167000,18999,False,75,scaffold_11
2,169001,191000,21999,False,75,scaffold_11
3,213001,236000,22999,False,75,scaffold_11
4,240001,253000,12999,False,75,scaffold_11
5,289001,320000,30999,False,75,scaffold_11
6,419001,431000,11999,False,75,scaffold_11
7,648001,656000,7999,False,75,scaffold_11
8,1403001,1409000,5999,False,75,scaffold_11
9,1423001,1426000,2999,False,75,scaffold_11
10,1975001,1998000,22999,False,75,scaffold_11
11,2701001,2877000,175999,False,75,scaffold_11
12,3090001,3123000,32999,False,75,scaffold_11
13,3185001,3383000,197999,False,75,scaffold_11
14,3423001,3478000,54999,False,75,scaffold_11
15,3535001,3655000,119999,False,75,scaffold_11
16,3702001,3926000,223999,False,75,scaffold_11
17,4009001,4160000,150999,False,75,scaffold_11
18,4189001,4710000,520999,False,75,scaffold_11
19,4713001,4766820,53819,True,75,scaffold_11
0,1,389000,388999,True,75,scaffold_12
1,402001,1486000,1083999,False,75,scaffold_12
2,1720001,1733000,12999,False,75,scaffold_12
3,2044001,2102000,57999,False,75,scaffold_12
4,2135001,2165000,29999,False,75,scaffold_12
5,2459001,2486000,26999,False,75,scaffold_12
6,2571001,2617000,45999,False,75,scaffold_12
7,2660001,2682000,21999,False,75,scaffold_12
8,2685001,2699000,13999,False,75,scaffold_12
9,2700001,2708000,7999,False,75,scaffold_12
0,1,342000,341999,True,76,scaffold_1
1,482001,498000,15999,False,76,scaffold_1
2,574001,643000,68999,False,76,scaffold_1
3,686001,716000,29999,False,76,scaffold_1
4,717001,743000,25999,False,76,scaffold_1
5,1827001,1898000,70999,False,76,scaffold_1
6,1954001,1964000,9999,False,76,scaffold_1
7,1965001,1984000,18999,False,76,scaffold_1
8,2449001,2517000,67999,False,76,scaffold_1
9,2729001,2746000,16999,False,76,scaffold_1
10,3181001,3208000,26999,False,76,scaffold_1
11,3715001,3734000,18999,False,76,scaffold_1
12,3910001,3941000,30999,False,76,scaffold_1
13,4062001,4111000,48999,False,76,scaffold_1
14,4322001,4354000,31999,False,76,scaffold_1
15,4921001,5010000,88999,False,76,scaffold_1
16,5481001,5511000,29999,False,76,scaffold_1
17,6108001,6153000,44999,False,76,scaffold_1
18,6228001,6378000,149999,False,76,scaffold_1
19,6384001,6507000,122999,False,76,scaffold_1
20,6543001,6555000,11999,False,76,scaffold_1
21,7038001,7247000,208999,False,76,scaffold_1
22,7248001,7583000,334999,False,76,scaffold_1
23,7590001,8656000,1065999,False,76,scaffold_1
24,8658001,9584000,925999,False,76,scaffold_1
25,9586001,10355000,768999,False,76,scaffold_1
26,10461001,10630000,168999,False,76,scaffold_1
27,10808001,10811000,2999,False,76,scaffold_1
28,10839001,10857000,17999,False,76,scaffold_1
29,11346001,11504000,157999,False,76,scaffold_1
30,11614001,11952000,337999,False,76,scaffold_1
31,12184001,12204000,19999,False,76,scaffold_1
32,12662001,12722000,59999,False,76,scaffold_1
33,12777001,12888000,110999,False,76,scaffold_1
34,13113001,13211000,97999,False,76,scaffold_1
35,13347001,13419000,71999,False,76,scaffold_1
36,14471001,14479000,7999,False,76,scaffold_1
0,22001,48000,25999,False,76,scaffold_2
1,93001,159000,65999,False,76,scaffold_2
2,168001,177000,8999,False,76,scaffold_2
3,303001,318000,14999,False,76,scaffold_2
4,332001,374000,41999,False,76,scaffold_2
5,2086001,2099000,12999,False,76,scaffold_2
6,2336001,2358000,21999,False,76,scaffold_2
7,2441001,2553000,111999,False,76,scaffold_2
8,2660001,2689000,28999,False,76,scaffold_2
9,2694001,2742000,47999,False,76,scaffold_2
10,2868001,2899000,30999,False,76,scaffold_2
11,3333001,3344000,10999,False,76,scaffold_2
12,3452001,3465000,12999,False,76,scaffold_2
13,3754001,3783000,28999,False,76,scaffold_2
14,4385001,4409000,23999,False,76,scaffold_2
15,4426001,4457000,30999,False,76,scaffold_2
16,4519001,4654000,134999,False,76,scaffold_2
17,5022001,5031000,8999,False,76,scaffold_2
18,5033001,5061000,27999,False,76,scaffold_2
19,5360001,5393000,32999,False,76,scaffold_2
20,5491001,5512000,20999,False,76,scaffold_2
21,5672001,5757000,84999,False,76,scaffold_2
22,6261001,6330000,68999,False,76,scaffold_2
23,6331001,6341000,9999,False,76,scaffold_2
24,6591001,6628000,36999,False,76,scaffold_2
25,7439001,7472000,32999,False,76,scaffold_2
26,7563001,7697000,133999,False,76,scaffold_2
27,7786001,7893000,106999,False,76,scaffold_2
28,7933001,8161000,227999,False,76,scaffold_2
29,8261001,8294000,32999,False,76,scaffold_2
30,8331001,8333000,1999,False,76,scaffold_2
31,8346001,8453000,106999,False,76,scaffold_2
32,8509001,8562000,52999,False,76,scaffold_2
33,11367001,11373000,5999,False,76,scaffold_2
34,11520001,11785000,264999,False,76,scaffold_2
0,1,2000,1999,True,76,scaffold_3
1,51001,55000,3999,False,76,scaffold_3
2,618001,646000,27999,False,76,scaffold_3
3,798001,900000,101999,False,76,scaffold_3
4,2084001,2108000,23999,False,76,scaffold_3
5,2291001,2321000,29999,False,76,scaffold_3
6,2487001,2533000,45999,False,76,scaffold_3
7,3772001,3803000,30999,False,76,scaffold_3
8,3826001,3845000,18999,False,76,scaffold_3
9,4127001,4398000,270999,False,76,scaffold_3
10,4418001,4518000,99999,False,76,scaffold_3
11,4547001,4558000,10999,False,76,scaffold_3
12,4662001,4671000,8999,False,76,scaffold_3
13,5494001,5509000,14999,False,76,scaffold_3
14,6908001,6969000,60999,False,76,scaffold_3
15,6979001,7078000,98999,False,76,scaffold_3
16,7288001,7298000,9999,False,76,scaffold_3
17,7370001,7397000,26999,False,76,scaffold_3
18,7522001,7556000,33999,False,76,scaffold_3
19,7692001,7799000,106999,False,76,scaffold_3
20,7819001,7839000,19999,False,76,scaffold_3
21,8175001,8253000,77999,False,76,scaffold_3
22,8462001,8528000,65999,False,76,scaffold_3
23,8575001,8594000,18999,False,76,scaffold_3
24,9968001,9996000,27999,False,76,scaffold_3
25,10461001,10483000,21999,False,76,scaffold_3
26,10587001,11163000,575999,False,76,scaffold_3
0,17001,32000,14999,False,76,scaffold_4
1,48001,88000,39999,False,76,scaffold_4
2,135001,146000,10999,False,76,scaffold_4
3,147001,151000,3999,False,76,scaffold_4
4,155001,160000,4999,False,76,scaffold_4
5,161001,215000,53999,False,76,scaffold_4
6,217001,226000,8999,False,76,scaffold_4
7,227001,266000,38999,False,76,scaffold_4
8,289001,310000,20999,False,76,scaffold_4
9,313001,344000,30999,False,76,scaffold_4
10,355001,374000,18999,False,76,scaffold_4
11,375001,380000,4999,False,76,scaffold_4
12,404001,425000,20999,False,76,scaffold_4
13,429001,498000,68999,False,76,scaffold_4
14,608001,691000,82999,False,76,scaffold_4
15,701001,714000,12999,False,76,scaffold_4
16,1121001,1136000,14999,False,76,scaffold_4
17,1137001,1208000,70999,False,76,scaffold_4
18,1210001,1226000,15999,False,76,scaffold_4
19,1235001,1253000,17999,False,76,scaffold_4
20,1254001,1262000,7999,False,76,scaffold_4
21,1265001,1279000,13999,False,76,scaffold_4
22,1283001,1337000,53999,False,76,scaffold_4
23,1372001,1597000,224999,False,76,scaffold_4
24,1613001,1849000,235999,False,76,scaffold_4
25,1850001,2006000,155999,False,76,scaffold_4
26,2007001,2069000,61999,False,76,scaffold_4
27,2071001,2118000,46999,False,76,scaffold_4
28,2162001,2185000,22999,False,76,scaffold_4
29,2188001,2206000,17999,False,76,scaffold_4
30,2210001,2218000,7999,False,76,scaffold_4
31,2219001,2246000,26999,False,76,scaffold_4
32,2247001,2268000,20999,False,76,scaffold_4
33,2269001,2280000,10999,False,76,scaffold_4
34,2282001,2310000,27999,False,76,scaffold_4
35,2312001,2340000,27999,False,76,scaffold_4
36,2342001,2352000,9999,False,76,scaffold_4
37,2428001,2445000,16999,False,76,scaffold_4
38,2477001,2582000,104999,False,76,scaffold_4
39,2619001,2634000,14999,False,76,scaffold_4
40,3336001,3634000,297999,False,76,scaffold_4
41,3650001,3760000,109999,False,76,scaffold_4
42,4944001,4985000,40999,False,76,scaffold_4
43,4989001,4994000,4999,False,76,scaffold_4
44,5179001,5186000,6999,False,76,scaffold_4
45,5477001,5506000,28999,False,76,scaffold_4
46,5516001,5620000,103999,False,76,scaffold_4
47,5668001,5784000,115999,False,76,scaffold_4
48,6150001,6190000,39999,False,76,scaffold_4
49,6768001,6817000,48999,False,76,scaffold_4
50,6902001,6924000,21999,False,76,scaffold_4
51,7037001,7062000,24999,False,76,scaffold_4
52,7228001,7273000,44999,False,76,scaffold_4
53,8849001,9699000,849999,False,76,scaffold_4
54,9700001,9845951,145950,True,76,scaffold_4
0,319001,385000,65999,False,76,scaffold_5
1,463001,524000,60999,False,76,scaffold_5
2,836001,839000,2999,False,76,scaffold_5
3,933001,947000,13999,False,76,scaffold_5
4,2509001,2515000,5999,False,76,scaffold_5
5,2565001,2581000,15999,False,76,scaffold_5
6,2619001,2739000,119999,False,76,scaffold_5
7,2813001,2871000,57999,False,76,scaffold_5
8,3133001,3185000,51999,False,76,scaffold_5
9,3218001,3247000,28999,False,76,scaffold_5
10,3322001,3509000,186999,False,76,scaffold_5
11,3962001,4101000,138999,False,76,scaffold_5
12,4121001,4220000,98999,False,76,scaffold_5
13,4233001,4263000,29999,False,76,scaffold_5
14,4446001,4498000,51999,False,76,scaffold_5
15,4601001,4681000,79999,False,76,scaffold_5
16,4691001,4736000,44999,False,76,scaffold_5
17,4788001,4861000,72999,False,76,scaffold_5
18,4897001,4918000,20999,False,76,scaffold_5
19,5318001,5345000,26999,False,76,scaffold_5
20,6506001,6597000,90999,False,76,scaffold_5
21,7454001,7483000,28999,False,76,scaffold_5
22,7580001,7609000,28999,False,76,scaffold_5
23,7622001,7654000,31999,False,76,scaffold_5
24,8666001,8689000,22999,False,76,scaffold_5
25,8730001,9363000,632999,False,76,scaffold_5
26,9364001,9364176,175,True,76,scaffold_5
0,79001,84000,4999,False,76,scaffold_6
1,86001,113000,26999,False,76,scaffold_6
2,241001,254000,12999,False,76,scaffold_6
3,368001,376000,7999,False,76,scaffold_6
4,1229001,1258000,28999,False,76,scaffold_6
5,1478001,1546000,67999,False,76,scaffold_6
6,1864001,1906000,41999,False,76,scaffold_6
7,2039001,2088000,48999,False,76,scaffold_6
8,2129001,2191000,61999,False,76,scaffold_6
9,2336001,2595000,258999,False,76,scaffold_6
10,2596001,2693000,96999,False,76,scaffold_6
11,2712001,2851000,138999,False,76,scaffold_6
12,2927001,3015000,87999,False,76,scaffold_6
13,3112001,3175000,62999,False,76,scaffold_6
14,3224001,3301000,76999,False,76,scaffold_6
15,3408001,3428000,19999,False,76,scaffold_6
16,3461001,3766000,304999,False,76,scaffold_6
17,3901001,3912000,10999,False,76,scaffold_6
18,4016001,4066000,49999,False,76,scaffold_6
19,4080001,4192000,111999,False,76,scaffold_6
20,6010001,6064000,53999,False,76,scaffold_6
21,7268001,7337000,68999,False,76,scaffold_6
22,7555001,7796000,240999,False,76,scaffold_6
23,7811001,8268281,457280,True,76,scaffold_6
0,1,8000,7999,True,76,scaffold_7
1,13001,31000,17999,False,76,scaffold_7
2,323001,340000,16999,False,76,scaffold_7
3,342001,508000,165999,False,76,scaffold_7
4,554001,563000,8999,False,76,scaffold_7
5,571001,577000,5999,False,76,scaffold_7
6,706001,736000,29999,False,76,scaffold_7
7,764001,809000,44999,False,76,scaffold_7
8,859001,864000,4999,False,76,scaffold_7
9,865001,872000,6999,False,76,scaffold_7
10,874001,949000,74999,False,76,scaffold_7
11,950001,963000,12999,False,76,scaffold_7
12,964001,966000,1999,False,76,scaffold_7
13,968001,980000,11999,False,76,scaffold_7
14,982001,1044000,61999,False,76,scaffold_7
15,1048001,1088000,39999,False,76,scaffold_7
16,1191001,1512000,320999,False,76,scaffold_7
17,1588001,1695000,106999,False,76,scaffold_7
18,3326001,3370000,43999,False,76,scaffold_7
19,3593001,3656000,62999,False,76,scaffold_7
20,4416001,4517000,100999,False,76,scaffold_7
21,4658001,4733000,74999,False,76,scaffold_7
22,4979001,5115000,135999,False,76,scaffold_7
23,5482001,5516000,33999,False,76,scaffold_7
24,6955001,7502216,547215,True,76,scaffold_7
0,67001,85000,17999,False,76,scaffold_8
1,2444001,2525000,80999,False,76,scaffold_8
2,2650001,2683000,32999,False,76,scaffold_8
3,2742001,2757000,14999,False,76,scaffold_8
4,2798001,2844000,45999,False,76,scaffold_8
5,3059001,3525000,465999,False,76,scaffold_8
6,3584001,3612000,27999,False,76,scaffold_8
7,3615001,3913000,297999,False,76,scaffold_8
8,4061001,4095000,33999,False,76,scaffold_8
9,4403001,4426000,22999,False,76,scaffold_8
10,5126001,5134000,7999,False,76,scaffold_8
11,5173001,5241000,67999,False,76,scaffold_8
12,6321001,6334544,13543,True,76,scaffold_8
0,1,22000,21999,True,76,scaffold_9
1,109001,117000,7999,False,76,scaffold_9
2,121001,137000,15999,False,76,scaffold_9
3,189001,194000,4999,False,76,scaffold_9
4,303001,315000,11999,False,76,scaffold_9
5,319001,332000,12999,False,76,scaffold_9
6,366001,411000,44999,False,76,scaffold_9
7,413001,434000,20999,False,76,scaffold_9
8,509001,531000,21999,False,76,scaffold_9
9,547001,561000,13999,False,76,scaffold_9
10,671001,696000,24999,False,76,scaffold_9
11,730001,742000,11999,False,76,scaffold_9
12,815001,843000,27999,False,76,scaffold_9
13,850001,860000,9999,False,76,scaffold_9
14,873001,986000,112999,False,76,scaffold_9
15,988001,995000,6999,False,76,scaffold_9
16,1001001,1007000,5999,False,76,scaffold_9
17,1009001,1085000,75999,False,76,scaffold_9
18,1087001,1150000,62999,False,76,scaffold_9
19,1151001,1165000,13999,False,76,scaffold_9
20,1312001,1377000,64999,False,76,scaffold_9
21,1749001,1791000,41999,False,76,scaffold_9
22,2176001,2187000,10999,False,76,scaffold_9
23,2601001,2616000,14999,False,76,scaffold_9
24,2741001,2752000,10999,False,76,scaffold_9
25,2870001,3381000,510999,False,76,scaffold_9
26,3383001,5107000,1723999,False,76,scaffold_9
27,5112001,5115000,2999,False,76,scaffold_9
28,5116001,5238000,121999,False,76,scaffold_9
29,5239001,5298000,58999,False,76,scaffold_9
30,5299001,6331288,1032287,True,76,scaffold_9
0,1,198000,197999,True,76,scaffold_10
1,326001,405000,78999,False,76,scaffold_10
2,471001,482000,10999,False,76,scaffold_10
3,483001,576000,92999,False,76,scaffold_10
4,603001,755000,151999,False,76,scaffold_10
5,888001,917000,28999,False,76,scaffold_10
6,923001,962000,38999,False,76,scaffold_10
7,1087001,1112000,24999,False,76,scaffold_10
8,2141001,2174000,32999,False,76,scaffold_10
9,2346001,2368000,21999,False,76,scaffold_10
10,3272001,3274000,1999,False,76,scaffold_10
11,4054001,4091000,36999,False,76,scaffold_10
12,4154001,4174000,19999,False,76,scaffold_10
13,4445001,4456000,10999,False,76,scaffold_10
14,4503001,4513000,9999,False,76,scaffold_10
15,4515001,4523000,7999,False,76,scaffold_10
16,4526001,4548000,21999,False,76,scaffold_10
17,4574001,4596000,21999,False,76,scaffold_10
18,4679001,4688000,8999,False,76,scaffold_10
19,4734001,4776000,41999,False,76,scaffold_10
20,4798001,4824000,25999,False,76,scaffold_10
21,4827001,4843000,15999,False,76,scaffold_10
22,4848001,4853000,4999,False,76,scaffold_10
0,10001,33000,22999,False,76,scaffold_11
1,42001,92000,49999,False,76,scaffold_11
2,149001,167000,17999,False,76,scaffold_11
3,169001,191000,21999,False,76,scaffold_11
4,214001,236000,21999,False,76,scaffold_11
5,240001,248000,7999,False,76,scaffold_11
6,419001,431000,11999,False,76,scaffold_11
7,648001,656000,7999,False,76,scaffold_11
8,949001,951000,1999,False,76,scaffold_11
9,1025001,1034000,8999,False,76,scaffold_11
10,1423001,1426000,2999,False,76,scaffold_11
11,2701001,2875000,173999,False,76,scaffold_11
12,3188001,3259000,70999,False,76,scaffold_11
13,3328001,3383000,54999,False,76,scaffold_11
14,3702001,3929000,226999,False,76,scaffold_11
15,4134001,4159000,24999,False,76,scaffold_11
16,4262001,4710000,447999,False,76,scaffold_11
17,4713001,4766820,53819,True,76,scaffold_11
0,1,370000,369999,True,76,scaffold_12
1,404001,537000,132999,False,76,scaffold_12
2,582001,856000,273999,False,76,scaffold_12
3,865001,1449000,583999,False,76,scaffold_12
4,1720001,1733000,12999,False,76,scaffold_12
5,2571001,2618000,46999,False,76,scaffold_12
0,1,340000,339999,True,77,scaffold_1
1,482001,498000,15999,False,77,scaffold_1
2,572001,643000,70999,False,77,scaffold_1
3,686001,713000,26999,False,77,scaffold_1
4,736001,741000,4999,False,77,scaffold_1
5,1281001,1292000,10999,False,77,scaffold_1
6,1954001,1964000,9999,False,77,scaffold_1
7,1965001,1984000,18999,False,77,scaffold_1
8,2449001,2517000,67999,False,77,scaffold_1
9,2729001,2746000,16999,False,77,scaffold_1
10,3181001,3208000,26999,False,77,scaffold_1
11,3715001,3733000,17999,False,77,scaffold_1
12,3916001,3941000,24999,False,77,scaffold_1
13,4065001,4111000,45999,False,77,scaffold_1
14,4322001,4354000,31999,False,77,scaffold_1
15,4929001,4963000,33999,False,77,scaffold_1
16,4969001,4983000,13999,False,77,scaffold_1
17,5484001,5511000,26999,False,77,scaffold_1
18,6108001,6153000,44999,False,77,scaffold_1
19,6228001,6381000,152999,False,77,scaffold_1
20,6384001,6507000,122999,False,77,scaffold_1
21,6545001,6554000,8999,False,77,scaffold_1
22,7038001,7247000,208999,False,77,scaffold_1
23,7248001,7584000,335999,False,77,scaffold_1
24,7590001,8477000,886999,False,77,scaffold_1
25,8478001,8656000,177999,False,77,scaffold_1
26,8658001,9584000,925999,False,77,scaffold_1
27,9586001,10354000,767999,False,77,scaffold_1
28,10461001,10637000,175999,False,77,scaffold_1
29,10808001,10811000,2999,False,77,scaffold_1
30,10836001,10858000,21999,False,77,scaffold_1
31,11351001,11504000,152999,False,77,scaffold_1
32,11614001,11951000,336999,False,77,scaffold_1
33,12184001,12204000,19999,False,77,scaffold_1
34,12678001,12722000,43999,False,77,scaffold_1
35,12777001,12888000,110999,False,77,scaffold_1
36,13181001,13211000,29999,False,77,scaffold_1
37,13347001,13377000,29999,False,77,scaffold_1
38,13901001,13903000,1999,False,77,scaffold_1
39,14007001,14009000,1999,False,77,scaffold_1
0,22001,48000,25999,False,77,scaffold_2
1,93001,159000,65999,False,77,scaffold_2
2,168001,177000,8999,False,77,scaffold_2
3,303001,318000,14999,False,77,scaffold_2
4,332001,374000,41999,False,77,scaffold_2
5,2336001,2358000,21999,False,77,scaffold_2
6,2406001,2423000,16999,False,77,scaffold_2
7,2441001,2553000,111999,False,77,scaffold_2
8,2660001,2689000,28999,False,77,scaffold_2
9,2694001,2742000,47999,False,77,scaffold_2
10,2994001,3012000,17999,False,77,scaffold_2
11,3454001,3463000,8999,False,77,scaffold_2
12,3767001,3781000,13999,False,77,scaffold_2
13,4385001,4409000,23999,False,77,scaffold_2
14,4429001,4456000,26999,False,77,scaffold_2
15,4525001,4553000,27999,False,77,scaffold_2
16,4608001,4653000,44999,False,77,scaffold_2
17,5022001,5031000,8999,False,77,scaffold_2
18,5033001,5061000,27999,False,77,scaffold_2
19,5491001,5511000,19999,False,77,scaffold_2
20,5672001,5704000,31999,False,77,scaffold_2
21,6261001,6330000,68999,False,77,scaffold_2
22,6331001,6342000,10999,False,77,scaffold_2
23,7439001,7472000,32999,False,77,scaffold_2
24,7563001,7697000,133999,False,77,scaffold_2
25,7786001,7890000,103999,False,77,scaffold_2
26,7934001,7969000,34999,False,77,scaffold_2
27,7982001,8088000,105999,False,77,scaffold_2
28,8331001,8333000,1999,False,77,scaffold_2
29,8346001,8389000,42999,False,77,scaffold_2
30,8509001,8535000,25999,False,77,scaffold_2
31,11367001,11374000,6999,False,77,scaffold_2
32,11520001,11785000,264999,False,77,scaffold_2
0,1,2000,1999,True,77,scaffold_3
1,51001,55000,3999,False,77,scaffold_3
2,102001,104000,1999,False,77,scaffold_3
3,799001,900000,100999,False,77,scaffold_3
4,2085001,2108000,22999,False,77,scaffold_3
5,2291001,2321000,29999,False,77,scaffold_3
6,2498001,2533000,34999,False,77,scaffold_3
7,4150001,4383000,232999,False,77,scaffold_3
8,4418001,4518000,99999,False,77,scaffold_3
9,4547001,4558000,10999,False,77,scaffold_3
10,4654001,4678000,23999,False,77,scaffold_3
11,6911001,6962000,50999,False,77,scaffold_3
12,6979001,7042000,62999,False,77,scaffold_3
13,7540001,7556000,15999,False,77,scaffold_3
14,7692001,7724000,31999,False,77,scaffold_3
15,7823001,7838000,14999,False,77,scaffold_3
16,8208001,8255000,46999,False,77,scaffold_3
17,8462001,8527000,64999,False,77,scaffold_3
18,8575001,8594000,18999,False,77,scaffold_3
19,9968001,9996000,27999,False,77,scaffold_3
20,10461001,10480000,18999,False,77,scaffold_3
21,10587001,11165000,577999,False,77,scaffold_3
0,17001,32000,14999,False,77,scaffold_4
1,48001,81000,32999,False,77,scaffold_4
2,131001,146000,14999,False,77,scaffold_4
3,147001,151000,3999,False,77,scaffold_4
4,155001,160000,4999,False,77,scaffold_4
5,161001,215000,53999,False,77,scaffold_4
6,217001,226000,8999,False,77,scaffold_4
7,227001,266000,38999,False,77,scaffold_4
8,294001,310000,15999,False,77,scaffold_4
9,355001,374000,18999,False,77,scaffold_4
10,375001,380000,4999,False,77,scaffold_4
11,412001,425000,12999,False,77,scaffold_4
12,429001,498000,68999,False,77,scaffold_4
13,545001,606000,60999,False,77,scaffold_4
14,608001,661000,52999,False,77,scaffold_4
15,670001,691000,20999,False,77,scaffold_4
16,701001,714000,12999,False,77,scaffold_4
17,1121001,1136000,14999,False,77,scaffold_4
18,1137001,1179000,41999,False,77,scaffold_4
19,1199001,1208000,8999,False,77,scaffold_4
20,1210001,1226000,15999,False,77,scaffold_4
21,1229001,1231000,1999,False,77,scaffold_4
22,1235001,1246000,10999,False,77,scaffold_4
23,1248001,1253000,4999,False,77,scaffold_4
24,1254001,1262000,7999,False,77,scaffold_4
25,1265001,1279000,13999,False,77,scaffold_4
26,1283001,1314000,30999,False,77,scaffold_4
27,1373001,1591000,217999,False,77,scaffold_4
28,1749001,1817000,67999,False,77,scaffold_4
29,1826001,1849000,22999,False,77,scaffold_4
30,1851001,1860000,8999,False,77,scaffold_4
31,1940001,1957000,16999,False,77,scaffold_4
32,1958001,1988000,29999,False,77,scaffold_4
33,2036001,2065000,28999,False,77,scaffold_4
34,2247001,2279000,31999,False,77,scaffold_4
35,2284001,2340000,55999,False,77,scaffold_4
36,2480001,2550000,69999,False,77,scaffold_4
37,3335001,3632000,296999,False,77,scaffold_4
38,3676001,3759000,82999,False,77,scaffold_4
39,4944001,4984000,39999,False,77,scaffold_4
40,5477001,5506000,28999,False,77,scaffold_4
41,5514001,5620000,105999,False,77,scaffold_4
42,5669001,5784000,114999,False,77,scaffold_4
43,7037001,7062000,24999,False,77,scaffold_4
44,8849001,9699000,849999,False,77,scaffold_4
45,9700001,9845951,145950,True,77,scaffold_4
0,191001,204000,12999,False,77,scaffold_5
1,296001,299000,2999,False,77,scaffold_5
2,318001,326000,7999,False,77,scaffold_5
3,327001,368000,40999,False,77,scaffold_5
4,499001,523000,23999,False,77,scaffold_5
5,933001,947000,13999,False,77,scaffold_5
6,1062001,1068000,5999,False,77,scaffold_5
7,2565001,2581000,15999,False,77,scaffold_5
8,2625001,2732000,106999,False,77,scaffold_5
9,2816001,2871000,54999,False,77,scaffold_5
10,3167001,3184000,16999,False,77,scaffold_5
11,3322001,3438000,115999,False,77,scaffold_5
12,3451001,3494000,42999,False,77,scaffold_5
13,3962001,4101000,138999,False,77,scaffold_5
14,4121001,4219000,97999,False,77,scaffold_5
15,4246001,4263000,16999,False,77,scaffold_5
16,4446001,4483000,36999,False,77,scaffold_5
17,4603001,4649000,45999,False,77,scaffold_5
18,4691001,4717000,25999,False,77,scaffold_5
19,4819001,4861000,41999,False,77,scaffold_5
20,4904001,4917000,12999,False,77,scaffold_5
21,5318001,5346000,27999,False,77,scaffold_5
22,8730001,9363000,632999,False,77,scaffold_5
23,9364001,9364176,175,True,77,scaffold_5
0,79001,84000,4999,False,77,scaffold_6
1,86001,112000,25999,False,77,scaffold_6
2,239001,254000,14999,False,77,scaffold_6
3,267001,278000,10999,False,77,scaffold_6
4,1237001,1256000,18999,False,77,scaffold_6
5,1479001,1546000,66999,False,77,scaffold_6
6,2023001,2086000,62999,False,77,scaffold_6
7,2130001,2169000,38999,False,77,scaffold_6
8,2371001,2595000,223999,False,77,scaffold_6
9,2596001,2653000,56999,False,77,scaffold_6
10,2657001,2691000,33999,False,77,scaffold_6
11,2731001,2851000,119999,False,77,scaffold_6
12,2933001,3014000,80999,False,77,scaffold_6
13,3115001,3149000,33999,False,77,scaffold_6
14,3224001,3301000,76999,False,77,scaffold_6
15,3407001,3428000,20999,False,77,scaffold_6
16,3462001,3521000,58999,False,77,scaffold_6
17,3528001,3766000,237999,False,77,scaffold_6
18,3901001,3912000,10999,False,77,scaffold_6
19,4019001,4040000,20999,False,77,scaffold_6
20,4086001,4193000,106999,False,77,scaffold_6
21,6011001,6060000,48999,False,77,scaffold_6
22,7278001,7336000,57999,False,77,scaffold_6
23,7560001,7795000,234999,False,77,scaffold_6
24,7811001,8268281,457280,True,77,scaffold_6
0,1,7000,6999,True,77,scaffold_7
1,11001,31000,19999,False,77,scaffold_7
2,323001,340000,16999,False,77,scaffold_7
3,342001,507000,164999,False,77,scaffold_7
4,554001,563000,8999,False,77,scaffold_7
5,571001,577000,5999,False,77,scaffold_7
6,706001,736000,29999,False,77,scaffold_7
7,764001,809000,44999,False,77,scaffold_7
8,859001,864000,4999,False,77,scaffold_7
9,982001,1044000,61999,False,77,scaffold_7
10,1048001,1104000,55999,False,77,scaffold_7
11,1204001,1512000,307999,False,77,scaffold_7
12,1588001,1688000,99999,False,77,scaffold_7
13,3326001,3369000,42999,False,77,scaffold_7
14,3596001,3649000,52999,False,77,scaffold_7
15,4418001,4517000,98999,False,77,scaffold_7
16,4658001,4681000,22999,False,77,scaffold_7
17,4979001,5030000,50999,False,77,scaffold_7
18,5077001,5113000,35999,False,77,scaffold_7
19,6955001,7502216,547215,True,77,scaffold_7
0,66001,85000,18999,False,77,scaffold_8
1,722001,724000,1999,False,77,scaffold_8
2,2662001,2683000,20999,False,77,scaffold_8
3,2745001,2756000,10999,False,77,scaffold_8
4,3060001,3525000,464999,False,77,scaffold_8
5,3587001,3610000,22999,False,77,scaffold_8
6,3621001,3913000,291999,False,77,scaffold_8
7,5200001,5241000,40999,False,77,scaffold_8
0,109001,117000,7999,False,77,scaffold_9
1,300001,315000,14999,False,77,scaffold_9
2,319001,332000,12999,False,77,scaffold_9
3,367001,411000,43999,False,77,scaffold_9
4,413001,434000,20999,False,77,scaffold_9
5,502001,531000,28999,False,77,scaffold_9
6,671001,696000,24999,False,77,scaffold_9
7,732001,742000,9999,False,77,scaffold_9
8,794001,803000,8999,False,77,scaffold_9
9,816001,841000,24999,False,77,scaffold_9
10,873001,986000,112999,False,77,scaffold_9
11,988001,995000,6999,False,77,scaffold_9
12,1001001,1007000,5999,False,77,scaffold_9
13,1009001,1031000,21999,False,77,scaffold_9
14,1036001,1085000,48999,False,77,scaffold_9
15,1087001,1150000,62999,False,77,scaffold_9
16,1151001,1164000,12999,False,77,scaffold_9
17,1312001,1377000,64999,False,77,scaffold_9
18,1766001,1790000,23999,False,77,scaffold_9
19,2601001,2616000,14999,False,77,scaffold_9
20,2874001,3381000,506999,False,77,scaffold_9
21,3383001,5100000,1716999,False,77,scaffold_9
22,5101001,5107000,5999,False,77,scaffold_9
23,5112001,5115000,2999,False,77,scaffold_9
24,5116001,5237000,120999,False,77,scaffold_9
25,5239001,5298000,58999,False,77,scaffold_9
26,5300001,5490000,189999,False,77,scaffold_9
27,5491001,6331288,840287,True,77,scaffold_9
0,1,197000,196999,True,77,scaffold_10
1,375001,405000,29999,False,77,scaffold_10
2,472001,482000,9999,False,77,scaffold_10
3,483001,496000,12999,False,77,scaffold_10
4,506001,576000,69999,False,77,scaffold_10
5,603001,748000,144999,False,77,scaffold_10
6,888001,917000,28999,False,77,scaffold_10
7,924001,962000,37999,False,77,scaffold_10
8,1087001,1105000,17999,False,77,scaffold_10
9,2346001,2366000,19999,False,77,scaffold_10
10,3264001,3268000,3999,False,77,scaffold_10
11,4054001,4091000,36999,False,77,scaffold_10
12,4154001,4174000,19999,False,77,scaffold_10
13,4467001,4476000,8999,False,77,scaffold_10
14,4506001,4513000,6999,False,77,scaffold_10
15,4515001,4523000,7999,False,77,scaffold_10
16,4526001,4548000,21999,False,77,scaffold_10
17,4576001,4596000,19999,False,77,scaffold_10
18,4679001,4688000,8999,False,77,scaffold_10
19,4734001,4766000,31999,False,77,scaffold_10
20,4791001,4797000,5999,False,77,scaffold_10
21,4798001,4824000,25999,False,77,scaffold_10
22,4827001,4843000,15999,False,77,scaffold_10
23,4848001,4861000,12999,False,77,scaffold_10
24,4865001,4866973,1972,True,77,scaffold_10
0,11001,34000,22999,False,77,scaffold_11
1,40001,93000,52999,False,77,scaffold_11
2,149001,167000,17999,False,77,scaffold_11
3,169001,191000,21999,False,77,scaffold_11
4,213001,235000,21999,False,77,scaffold_11
5,240001,247000,6999,False,77,scaffold_11
6,419001,431000,11999,False,77,scaffold_11
7,648001,656000,7999,False,77,scaffold_11
8,1025001,1034000,8999,False,77,scaffold_11
9,1305001,1307000,1999,False,77,scaffold_11
10,1423001,1426000,2999,False,77,scaffold_11
11,2701001,2873000,171999,False,77,scaffold_11
12,3189001,3254000,64999,False,77,scaffold_11
13,3331001,3371000,39999,False,77,scaffold_11
14,3702001,3933000,230999,False,77,scaffold_11
15,3944001,3971000,26999,False,77,scaffold_11
16,4321001,4710000,388999,False,77,scaffold_11
17,4713001,4766820,53819,True,77,scaffold_11
0,1,240000,239999,True,77,scaffold_12
1,290001,369000,78999,False,77,scaffold_12
2,476001,490000,13999,False,77,scaffold_12
3,582001,730000,147999,False,77,scaffold_12
4,739001,856000,116999,False,77,scaffold_12
5,865001,1354000,488999,False,77,scaffold_12
6,1720001,1733000,12999,False,77,scaffold_12
7,2571001,2618000,46999,False,77,scaffold_12
0,1,342000,341999,True,78,scaffold_1
1,409001,440000,30999,False,78,scaffold_1
2,482001,498000,15999,False,78,scaffold_1
3,571001,643000,71999,False,78,scaffold_1
4,686001,756000,69999,False,78,scaffold_1
5,1175001,1193000,17999,False,78,scaffold_1
6,1280001,1292000,11999,False,78,scaffold_1
7,1612001,1660000,47999,False,78,scaffold_1
8,1813001,1899000,85999,False,78,scaffold_1
9,1916001,1982000,65999,False,78,scaffold_1
10,2353001,2415000,61999,False,78,scaffold_1
11,2449001,2532000,82999,False,78,scaffold_1
12,2566001,2577000,10999,False,78,scaffold_1
13,2729001,2746000,16999,False,78,scaffold_1
14,2990001,3023000,32999,False,78,scaffold_1
15,3179001,3209000,29999,False,78,scaffold_1
16,3445001,3493000,47999,False,78,scaffold_1
17,3685001,3743000,57999,False,78,scaffold_1
18,3902001,3941000,38999,False,78,scaffold_1
19,4001001,4033000,31999,False,78,scaffold_1
20,4062001,4116000,53999,False,78,scaffold_1
21,4321001,4356000,34999,False,78,scaffold_1
22,4796001,4814000,17999,False,78,scaffold_1
23,4922001,5022000,99999,False,78,scaffold_1
24,5087001,5113000,25999,False,78,scaffold_1
25,5482001,5521000,38999,False,78,scaffold_1
26,5535001,5570000,34999,False,78,scaffold_1
27,5853001,5915000,61999,False,78,scaffold_1
28,6108001,6153000,44999,False,78,scaffold_1
29,6154001,6177000,22999,False,78,scaffold_1
30,6201001,6511000,309999,False,78,scaffold_1
31,6542001,6574000,31999,False,78,scaffold_1
32,6838001,6856000,17999,False,78,scaffold_1
33,7038001,7247000,208999,False,78,scaffold_1
34,7248001,7584000,335999,False,78,scaffold_1
35,7590001,8656000,1065999,False,78,scaffold_1
36,8658001,9584000,925999,False,78,scaffold_1
37,9586001,10369000,782999,False,78,scaffold_1
38,10460001,10640000,179999,False,78,scaffold_1
39,10664001,10758000,93999,False,78,scaffold_1
40,10837001,10857000,19999,False,78,scaffold_1
41,10920001,10965000,44999,False,78,scaffold_1
42,11275001,11512000,236999,False,78,scaffold_1
43,11555001,11964000,408999,False,78,scaffold_1
44,12184001,12236000,51999,False,78,scaffold_1
45,12652001,12723000,70999,False,78,scaffold_1
46,12746001,12755000,8999,False,78,scaffold_1
47,12775001,12951000,175999,False,78,scaffold_1
48,12965001,13006000,40999,False,78,scaffold_1
49,13024001,13043000,18999,False,78,scaffold_1
50,13094001,13216000,121999,False,78,scaffold_1
51,13347001,13431000,83999,False,78,scaffold_1
52,13816001,13845000,28999,False,78,scaffold_1
53,14288001,14308000,19999,False,78,scaffold_1
54,14647001,14663000,15999,False,78,scaffold_1
0,1,48000,47999,True,78,scaffold_2
1,67001,91000,23999,False,78,scaffold_2
2,93001,160000,66999,False,78,scaffold_2
3,165001,177000,11999,False,78,scaffold_2
4,240001,288000,47999,False,78,scaffold_2
5,296001,318000,21999,False,78,scaffold_2
6,332001,374000,41999,False,78,scaffold_2
7,729001,739000,9999,False,78,scaffold_2
8,2086001,2101000,14999,False,78,scaffold_2
9,2315001,2334000,18999,False,78,scaffold_2
10,2336001,2609000,272999,False,78,scaffold_2
11,2627001,2639000,11999,False,78,scaffold_2
12,2645001,2689000,43999,False,78,scaffold_2
13,2693001,2744000,50999,False,78,scaffold_2
14,2766001,2788000,21999,False,78,scaffold_2
15,2974001,3021000,46999,False,78,scaffold_2
16,3367001,3390000,22999,False,78,scaffold_2
17,3449001,3486000,36999,False,78,scaffold_2
18,3754001,3792000,37999,False,78,scaffold_2
19,4244001,4274000,29999,False,78,scaffold_2
20,4381001,4409000,27999,False,78,scaffold_2
21,4426001,4458000,31999,False,78,scaffold_2
22,4519001,4658000,138999,False,78,scaffold_2
23,4730001,4761000,30999,False,78,scaffold_2
24,4786001,4790000,3999,False,78,scaffold_2
25,4793001,4810000,16999,False,78,scaffold_2
26,4918001,4955000,36999,False,78,scaffold_2
27,5021001,5031000,9999,False,78,scaffold_2
28,5033001,5104000,70999,False,78,scaffold_2
29,5287001,5300000,12999,False,78,scaffold_2
30,5350001,5402000,51999,False,78,scaffold_2
31,5407001,5515000,107999,False,78,scaffold_2
32,5620001,5709000,88999,False,78,scaffold_2
33,5715001,5779000,63999,False,78,scaffold_2
34,5840001,5888000,47999,False,78,scaffold_2
35,5909001,5949000,39999,False,78,scaffold_2
36,6261001,6330000,68999,False,78,scaffold_2
37,6331001,6351000,19999,False,78,scaffold_2
38,6371001,6449000,77999,False,78,scaffold_2
39,6575001,6634000,58999,False,78,scaffold_2
40,7005001,7038000,32999,False,78,scaffold_2
41,7063001,7102000,38999,False,78,scaffold_2
42,7373001,7473000,99999,False,78,scaffold_2
43,7491001,7518000,26999,False,78,scaffold_2
44,7550001,7561000,10999,False,78,scaffold_2
45,7563001,7697000,133999,False,78,scaffold_2
46,7786001,7917000,130999,False,78,scaffold_2
47,7933001,8313000,379999,False,78,scaffold_2
48,8331001,8333000,1999,False,78,scaffold_2
49,8335001,8345000,9999,False,78,scaffold_2
50,8346001,8455000,108999,False,78,scaffold_2
51,8507001,8562000,54999,False,78,scaffold_2
52,9030001,9047000,16999,False,78,scaffold_2
53,9138001,9175000,36999,False,78,scaffold_2
54,9601001,9635000,33999,False,78,scaffold_2
55,9673001,9708000,34999,False,78,scaffold_2
56,9867001,9904000,36999,False,78,scaffold_2
57,10444001,10495000,50999,False,78,scaffold_2
58,11367001,11384000,16999,False,78,scaffold_2
59,11395001,11425000,29999,False,78,scaffold_2
60,11520001,11789000,268999,False,78,scaffold_2
0,1,2000,1999,True,78,scaffold_3
1,618001,646000,27999,False,78,scaffold_3
2,796001,901000,104999,False,78,scaffold_3
3,1936001,1980000,43999,False,78,scaffold_3
4,2008001,2108000,99999,False,78,scaffold_3
5,2110001,2120000,9999,False,78,scaffold_3
6,2291001,2338000,46999,False,78,scaffold_3
7,2432001,2462000,29999,False,78,scaffold_3
8,2486001,2532000,45999,False,78,scaffold_3
9,3768001,3892000,123999,False,78,scaffold_3
10,3909001,3921000,11999,False,78,scaffold_3
11,4068001,4090000,21999,False,78,scaffold_3
12,4091001,4519000,427999,False,78,scaffold_3
13,4540001,4558000,17999,False,78,scaffold_3
14,4614001,4686000,71999,False,78,scaffold_3
15,5157001,5205000,47999,False,78,scaffold_3
16,5493001,5506000,12999,False,78,scaffold_3
17,5878001,5918000,39999,False,78,scaffold_3
18,5919001,5945000,25999,False,78,scaffold_3
19,5990001,6022000,31999,False,78,scaffold_3
20,6744001,6790000,45999,False,78,scaffold_3
21,6910001,6962000,51999,False,78,scaffold_3
22,6963001,7093000,129999,False,78,scaffold_3
23,7287001,7301000,13999,False,78,scaffold_3
24,7334001,7398000,63999,False,78,scaffold_3
25,7449001,7458000,8999,False,78,scaffold_3
26,7483001,7556000,72999,False,78,scaffold_3
27,7678001,7857000,178999,False,78,scaffold_3
28,8033001,8112000,78999,False,78,scaffold_3
29,8185001,8255000,69999,False,78,scaffold_3
30,8427001,8527000,99999,False,78,scaffold_3
31,8575001,8593000,17999,False,78,scaffold_3
32,9005001,9079000,73999,False,78,scaffold_3
33,9968001,9995000,26999,False,78,scaffold_3
34,10064001,10087000,22999,False,78,scaffold_3
35,10551001,10571000,19999,False,78,scaffold_3
36,10574001,11182071,608070,True,78,scaffold_3
0,11001,13000,1999,False,78,scaffold_4
1,14001,16000,1999,False,78,scaffold_4
2,17001,33000,15999,False,78,scaffold_4
3,48001,88000,39999,False,78,scaffold_4
4,132001,146000,13999,False,78,scaffold_4
5,147001,151000,3999,False,78,scaffold_4
6,155001,215000,59999,False,78,scaffold_4
7,217001,226000,8999,False,78,scaffold_4
8,227001,278000,50999,False,78,scaffold_4
9,283001,311000,27999,False,78,scaffold_4
10,312001,344000,31999,False,78,scaffold_4
11,345001,353000,7999,False,78,scaffold_4
12,355001,374000,18999,False,78,scaffold_4
13,390001,410000,19999,False,78,scaffold_4
14,412001,425000,12999,False,78,scaffold_4
15,429001,498000,68999,False,78,scaffold_4
16,539001,606000,66999,False,78,scaffold_4
17,608001,691000,82999,False,78,scaffold_4
18,701001,713000,11999,False,78,scaffold_4
19,1043001,1047000,3999,False,78,scaffold_4
20,1053001,1064000,10999,False,78,scaffold_4
21,1073001,1081000,7999,False,78,scaffold_4
22,1120001,1136000,15999,False,78,scaffold_4
23,1137001,1226000,88999,False,78,scaffold_4
24,1235001,1253000,17999,False,78,scaffold_4
25,1254001,1262000,7999,False,78,scaffold_4
26,1265001,1279000,13999,False,78,scaffold_4
27,1283001,1599000,315999,False,78,scaffold_4
28,1613001,2218000,604999,False,78,scaffold_4
29,2219001,2246000,26999,False,78,scaffold_4
30,2247001,2268000,20999,False,78,scaffold_4
31,2269001,2461000,191999,False,78,scaffold_4
32,2477001,2635000,157999,False,78,scaffold_4
33,2676001,2795000,118999,False,78,scaffold_4
34,2924001,2965000,40999,False,78,scaffold_4
35,3031001,3127000,95999,False,78,scaffold_4
36,3231001,3271000,39999,False,78,scaffold_4
37,3335001,3762000,426999,False,78,scaffold_4
38,4055001,4086000,30999,False,78,scaffold_4
39,4900001,5060000,159999,False,78,scaffold_4
40,5169001,5243000,73999,False,78,scaffold_4
41,5339001,5400000,60999,False,78,scaffold_4
42,5477001,5506000,28999,False,78,scaffold_4
43,5514001,5784000,269999,False,78,scaffold_4
44,5786001,5818000,31999,False,78,scaffold_4
45,6068001,6115000,46999,False,78,scaffold_4
46,6145001,6195000,49999,False,78,scaffold_4
47,6281001,6296000,14999,False,78,scaffold_4
48,6796001,6816000,19999,False,78,scaffold_4
49,6893001,6924000,30999,False,78,scaffold_4
50,6926001,7001000,74999,False,78,scaffold_4
51,7036001,7124000,87999,False,78,scaffold_4
52,7207001,7274000,66999,False,78,scaffold_4
53,7629001,7664000,34999,False,78,scaffold_4
54,8845001,9699000,853999,False,78,scaffold_4
55,9700001,9845951,145950,True,78,scaffold_4
0,1,5000,4999,True,78,scaffold_5
1,139001,173000,33999,False,78,scaffold_5
2,189001,203000,13999,False,78,scaffold_5
3,319001,385000,65999,False,78,scaffold_5
4,454001,526000,71999,False,78,scaffold_5
5,836001,843000,6999,False,78,scaffold_5
6,933001,947000,13999,False,78,scaffold_5
7,1065001,1068000,2999,False,78,scaffold_5
8,2552001,2895000,342999,False,78,scaffold_5
9,3133001,3258000,124999,False,78,scaffold_5
10,3322001,3514000,191999,False,78,scaffold_5
11,3619001,3658000,38999,False,78,scaffold_5
12,3956001,4101000,144999,False,78,scaffold_5
13,4110001,4274000,163999,False,78,scaffold_5
14,4445001,4521000,75999,False,78,scaffold_5
15,4573001,4923000,349999,False,78,scaffold_5
16,4969001,4992000,22999,False,78,scaffold_5
17,5061001,5081000,19999,False,78,scaffold_5
18,5217001,5275000,57999,False,78,scaffold_5
19,5286001,5344000,57999,False,78,scaffold_5
20,6409001,6421000,11999,False,78,scaffold_5
21,6454001,6666000,211999,False,78,scaffold_5
22,6888001,6905000,16999,False,78,scaffold_5
23,7406001,7441000,34999,False,78,scaffold_5
24,7454001,7513000,58999,False,78,scaffold_5
25,7560001,7655000,94999,False,78,scaffold_5
26,7676001,7748000,71999,False,78,scaffold_5
27,8258001,8279000,20999,False,78,scaffold_5
28,8411001,8468000,56999,False,78,scaffold_5
29,8552001,8616000,63999,False,78,scaffold_5
30,8659001,8687000,27999,False,78,scaffold_5
31,8707001,9364176,657175,True,78,scaffold_5
0,65001,75000,9999,False,78,scaffold_6
1,76001,85000,8999,False,78,scaffold_6
2,86001,113000,26999,False,78,scaffold_6
3,163001,208000,44999,False,78,scaffold_6
4,239001,262000,22999,False,78,scaffold_6
5,267001,328000,60999,False,78,scaffold_6
6,1148001,1226000,77999,False,78,scaffold_6
7,1229001,1266000,36999,False,78,scaffold_6
8,1284001,1309000,24999,False,78,scaffold_6
9,1431001,1550000,118999,False,78,scaffold_6
10,1854001,1906000,51999,False,78,scaffold_6
11,2026001,2105000,78999,False,78,scaffold_6
12,2127001,2195000,67999,False,78,scaffold_6
13,2236001,2283000,46999,False,78,scaffold_6
14,2335001,2872000,536999,False,78,scaffold_6
15,2933001,3034000,100999,False,78,scaffold_6
16,3081001,3201000,119999,False,78,scaffold_6
17,3223001,3350000,126999,False,78,scaffold_6
18,3351001,3366000,14999,False,78,scaffold_6
19,3399001,3794000,394999,False,78,scaffold_6
20,3900001,3913000,12999,False,78,scaffold_6
21,3966001,4072000,105999,False,78,scaffold_6
22,4073001,4192000,118999,False,78,scaffold_6
23,4835001,4872000,36999,False,78,scaffold_6
24,4965001,4997000,31999,False,78,scaffold_6
25,6002001,6087000,84999,False,78,scaffold_6
26,6123001,6186000,62999,False,78,scaffold_6
27,6784001,6803000,18999,False,78,scaffold_6
28,6815001,6851000,35999,False,78,scaffold_6
29,7184001,7248000,63999,False,78,scaffold_6
30,7263001,7339000,75999,False,78,scaffold_6
31,7390001,7475000,84999,False,78,scaffold_6
32,7541001,8268281,727280,True,78,scaffold_6
0,1,9000,8999,True,78,scaffold_7
1,11001,31000,19999,False,78,scaffold_7
2,311001,340000,28999,False,78,scaffold_7
3,342001,509000,166999,False,78,scaffold_7
4,571001,575000,3999,False,78,scaffold_7
5,623001,677000,53999,False,78,scaffold_7
6,689001,736000,46999,False,78,scaffold_7
7,740001,753000,12999,False,78,scaffold_7
8,764001,829000,64999,False,78,scaffold_7
9,859001,864000,4999,False,78,scaffold_7
10,865001,938000,72999,False,78,scaffold_7
11,968001,980000,11999,False,78,scaffold_7
12,982001,1044000,61999,False,78,scaffold_7
13,1048001,1104000,55999,False,78,scaffold_7
14,1105001,1148000,42999,False,78,scaffold_7
15,1168001,1460000,291999,False,78,scaffold_7
16,1461001,1512000,50999,False,78,scaffold_7
17,1582001,1697000,114999,False,78,scaffold_7
18,1743001,1757000,13999,False,78,scaffold_7
19,1758001,1782000,23999,False,78,scaffold_7
20,1862001,1891000,28999,False,78,scaffold_7
21,3295001,3377000,81999,False,78,scaffold_7
22,3523001,3766000,242999,False,78,scaffold_7
23,4415001,4518000,102999,False,78,scaffold_7
24,4550001,4580000,29999,False,78,scaffold_7
25,4640001,4736000,95999,False,78,scaffold_7
26,4755001,4834000,78999,False,78,scaffold_7
27,4978001,5167000,188999,False,78,scaffold_7
28,5468001,5536000,67999,False,78,scaffold_7
29,6332001,6369000,36999,False,78,scaffold_7
30,6567001,6590000,22999,False,78,scaffold_7
31,6751001,6797000,45999,False,78,scaffold_7
32,6954001,7502216,548215,True,78,scaffold_7
0,32001,85000,52999,False,78,scaffold_8
1,96001,101000,4999,False,78,scaffold_8
2,1859001,1929000,69999,False,78,scaffold_8
3,2361001,2377000,15999,False,78,scaffold_8
4,2413001,2553000,139999,False,78,scaffold_8
5,2648001,2714000,65999,False,78,scaffold_8
6,2741001,2758000,16999,False,78,scaffold_8
7,2798001,2844000,45999,False,78,scaffold_8
8,2847001,2896000,48999,False,78,scaffold_8
9,3032001,3525000,492999,False,78,scaffold_8
10,3580001,3934000,353999,False,78,scaffold_8
11,4039001,4108000,68999,False,78,scaffold_8
12,4173001,4254000,80999,False,78,scaffold_8
13,4330001,4353000,22999,False,78,scaffold_8
14,4400001,4432000,31999,False,78,scaffold_8
15,4629001,4650000,20999,False,78,scaffold_8
16,4814001,4849000,34999,False,78,scaffold_8
17,5083001,5241000,157999,False,78,scaffold_8
18,5578001,5596000,17999,False,78,scaffold_8
19,5657001,5705000,47999,False,78,scaffold_8
20,6324001,6334544,10543,True,78,scaffold_8
0,1,22000,21999,True,78,scaffold_9
1,109001,118000,8999,False,78,scaffold_9
2,121001,138000,16999,False,78,scaffold_9
3,298001,315000,16999,False,78,scaffold_9
4,319001,411000,91999,False,78,scaffold_9
5,413001,435000,21999,False,78,scaffold_9
6,484001,531000,46999,False,78,scaffold_9
7,547001,561000,13999,False,78,scaffold_9
8,647001,665000,17999,False,78,scaffold_9
9,670001,697000,26999,False,78,scaffold_9
10,729001,741000,11999,False,78,scaffold_9
11,807001,842000,34999,False,78,scaffold_9
12,878001,986000,107999,False,78,scaffold_9
13,987001,995000,7999,False,78,scaffold_9
14,997001,1007000,9999,False,78,scaffold_9
15,1008001,1033000,24999,False,78,scaffold_9
16,1035001,1085000,49999,False,78,scaffold_9
17,1087001,1165000,77999,False,78,scaffold_9
18,1311001,1383000,71999,False,78,scaffold_9
19,1426001,1436000,9999,False,78,scaffold_9
20,1457001,1465000,7999,False,78,scaffold_9
21,1487001,1500000,12999,False,78,scaffold_9
22,1502001,1592000,89999,False,78,scaffold_9
23,1763001,1803000,39999,False,78,scaffold_9
24,1922001,1951000,28999,False,78,scaffold_9
25,1984001,2063000,78999,False,78,scaffold_9
26,2075001,2111000,35999,False,78,scaffold_9
27,2148001,2171000,22999,False,78,scaffold_9
28,2586001,2661000,74999,False,78,scaffold_9
29,2731001,3381000,649999,False,78,scaffold_9
30,3383001,5099000,1715999,False,78,scaffold_9
31,5101001,5107000,5999,False,78,scaffold_9
32,5112001,5115000,2999,False,78,scaffold_9
33,5116001,5238000,121999,False,78,scaffold_9
34,5239001,5298000,58999,False,78,scaffold_9
35,5299001,6331288,1032287,True,78,scaffold_9
0,1,235000,234999,True,78,scaffold_10
1,257001,414000,156999,False,78,scaffold_10
2,415001,482000,66999,False,78,scaffold_10
3,483001,582000,98999,False,78,scaffold_10
4,596001,877000,280999,False,78,scaffold_10
5,888001,1022000,133999,False,78,scaffold_10
6,1036001,1069000,32999,False,78,scaffold_10
7,1073001,1146000,72999,False,78,scaffold_10
8,1444001,1468000,23999,False,78,scaffold_10
9,1516001,1529000,12999,False,78,scaffold_10
10,1606001,1621000,14999,False,78,scaffold_10
11,2079001,2107000,27999,False,78,scaffold_10
12,2129001,2167000,37999,False,78,scaffold_10
13,2268001,2300000,31999,False,78,scaffold_10
14,2346001,2466000,119999,False,78,scaffold_10
15,2556001,2585000,28999,False,78,scaffold_10
16,2601001,2635000,33999,False,78,scaffold_10
17,2715001,2745000,29999,False,78,scaffold_10
18,2799001,2811000,11999,False,78,scaffold_10
19,3571001,3582000,10999,False,78,scaffold_10
20,3777001,3795000,17999,False,78,scaffold_10
21,4001001,4012000,10999,False,78,scaffold_10
22,4048001,4098000,49999,False,78,scaffold_10
23,4154001,4174000,19999,False,78,scaffold_10
24,4335001,4365000,29999,False,78,scaffold_10
25,4443001,4477000,33999,False,78,scaffold_10
26,4478001,4502000,23999,False,78,scaffold_10
27,4503001,4513000,9999,False,78,scaffold_10
28,4515001,4523000,7999,False,78,scaffold_10
29,4525001,4548000,22999,False,78,scaffold_10
30,4565001,4596000,30999,False,78,scaffold_10
31,4681001,4688000,6999,False,78,scaffold_10
32,4734001,4766000,31999,False,78,scaffold_10
33,4769001,4776000,6999,False,78,scaffold_10
34,4798001,4826000,27999,False,78,scaffold_10
35,4828001,4846000,17999,False,78,scaffold_10
36,4848001,4861000,12999,False,78,scaffold_10
37,4862001,4866973,4972,True,78,scaffold_10
0,10001,95000,84999,False,78,scaffold_11
1,145001,167000,21999,False,78,scaffold_11
2,169001,236000,66999,False,78,scaffold_11
3,240001,249000,8999,False,78,scaffold_11
4,288001,320000,31999,False,78,scaffold_11
5,419001,431000,11999,False,78,scaffold_11
6,637001,656000,18999,False,78,scaffold_11
7,1403001,1412000,8999,False,78,scaffold_11
8,1474001,1477000,2999,False,78,scaffold_11
9,1959001,1989000,29999,False,78,scaffold_11
10,2008001,2049000,40999,False,78,scaffold_11
11,2701001,2878000,176999,False,78,scaffold_11
12,2980001,3012000,31999,False,78,scaffold_11
13,3081001,3183000,101999,False,78,scaffold_11
14,3184001,3292000,107999,False,78,scaffold_11
15,3331001,3383000,51999,False,78,scaffold_11
16,3433001,3483000,49999,False,78,scaffold_11
17,3487001,3933000,445999,False,78,scaffold_11
18,3986001,4160000,173999,False,78,scaffold_11
19,4189001,4710000,520999,False,78,scaffold_11
20,4713001,4766820,53819,True,78,scaffold_11
0,1,1501000,1500999,True,78,scaffold_12
1,1719001,1734000,14999,False,78,scaffold_12
2,2054001,2103000,48999,False,78,scaffold_12
3,2129001,2165000,35999,False,78,scaffold_12
4,2559001,2570000,10999,False,78,scaffold_12
5,2571001,2618000,46999,False,78,scaffold_12
0,1,439000,438999,True,79,scaffold_1
1,473001,498000,24999,False,79,scaffold_1
2,574001,660000,85999,False,79,scaffold_1
3,686001,943000,256999,False,79,scaffold_1
4,1168001,1292000,123999,False,79,scaffold_1
5,1309001,1368000,58999,False,79,scaffold_1
6,1628001,1660000,31999,False,79,scaffold_1
7,1661001,1696000,34999,False,79,scaffold_1
8,1765001,1984000,218999,False,79,scaffold_1
9,1988001,2056000,67999,False,79,scaffold_1
10,2267001,2414000,146999,False,79,scaffold_1
11,2449001,2583000,133999,False,79,scaffold_1
12,2724001,2746000,21999,False,79,scaffold_1
13,2887001,2927000,39999,False,79,scaffold_1
14,2960001,3240000,279999,False,79,scaffold_1
15,3244001,3258000,13999,False,79,scaffold_1
16,3276001,3336000,59999,False,79,scaffold_1
17,3442001,3665000,222999,False,79,scaffold_1
18,3683001,4179000,495999,False,79,scaffold_1
19,4213001,4393000,179999,False,79,scaffold_1
20,4413001,4545000,131999,False,79,scaffold_1
21,4614001,4791000,176999,False,79,scaffold_1
22,4796001,5066000,269999,False,79,scaffold_1
23,5087001,5202000,114999,False,79,scaffold_1
24,5345001,5376000,30999,False,79,scaffold_1
25,5436001,5521000,84999,False,79,scaffold_1
26,5535001,5620000,84999,False,79,scaffold_1
27,5848001,5952000,103999,False,79,scaffold_1
28,6040001,6069000,28999,False,79,scaffold_1
29,6108001,6153000,44999,False,79,scaffold_1
30,6154001,6194000,39999,False,79,scaffold_1
31,6201001,6381000,179999,False,79,scaffold_1
32,6384001,6575000,190999,False,79,scaffold_1
33,6804001,6954000,149999,False,79,scaffold_1
34,6969001,6991000,21999,False,79,scaffold_1
35,6993001,7247000,253999,False,79,scaffold_1
36,7248001,7583000,334999,False,79,scaffold_1
37,7590001,8656000,1065999,False,79,scaffold_1
38,8658001,9584000,925999,False,79,scaffold_1
39,9586001,9785000,198999,False,79,scaffold_1
40,9786001,10757000,970999,False,79,scaffold_1
41,10836001,10858000,21999,False,79,scaffold_1
42,10884001,10966000,81999,False,79,scaffold_1
43,11013001,11964000,950999,False,79,scaffold_1
44,12146001,12243000,96999,False,79,scaffold_1
45,12329001,12376000,46999,False,79,scaffold_1
46,12387001,12396000,8999,False,79,scaffold_1
47,12398001,13217000,818999,False,79,scaffold_1
48,13319001,13493000,173999,False,79,scaffold_1
49,13517001,13537000,19999,False,79,scaffold_1
50,13557001,13590000,32999,False,79,scaffold_1
51,13591001,13638000,46999,False,79,scaffold_1
52,13665001,13709000,43999,False,79,scaffold_1
53,13748001,13845000,96999,False,79,scaffold_1
54,13846001,13927000,80999,False,79,scaffold_1
55,13928001,13955000,26999,False,79,scaffold_1
56,13958001,14005000,46999,False,79,scaffold_1
57,14007001,14079000,71999,False,79,scaffold_1
58,14266001,14310000,43999,False,79,scaffold_1
59,14500001,14529000,28999,False,79,scaffold_1
60,14530001,14613000,82999,False,79,scaffold_1
61,14649001,14664000,14999,False,79,scaffold_1
62,14782001,14794116,12115,True,79,scaffold_1
0,21001,48000,26999,False,79,scaffold_2
1,69001,91000,21999,False,79,scaffold_2
2,92001,159000,66999,False,79,scaffold_2
3,168001,177000,8999,False,79,scaffold_2
4,249001,288000,38999,False,79,scaffold_2
5,296001,318000,21999,False,79,scaffold_2
6,333001,374000,40999,False,79,scaffold_2
7,418001,449000,30999,False,79,scaffold_2
8,599001,625000,25999,False,79,scaffold_2
9,1001001,1013000,11999,False,79,scaffold_2
10,1019001,1068000,48999,False,79,scaffold_2
11,1115001,1191000,75999,False,79,scaffold_2
12,1234001,1259000,24999,False,79,scaffold_2
13,1310001,1340000,29999,False,79,scaffold_2
14,1360001,1556000,195999,False,79,scaffold_2
15,1570001,1900000,329999,False,79,scaffold_2
16,1929001,1977000,47999,False,79,scaffold_2
17,2043001,2246000,202999,False,79,scaffold_2
18,2247001,2286000,38999,False,79,scaffold_2
19,2303001,2334000,30999,False,79,scaffold_2
20,2336001,2609000,272999,False,79,scaffold_2
21,2647001,2688000,40999,False,79,scaffold_2
22,2694001,2747000,52999,False,79,scaffold_2
23,2766001,2788000,21999,False,79,scaffold_2
24,2790001,2856000,65999,False,79,scaffold_2
25,2868001,3021000,152999,False,79,scaffold_2
26,3022001,3045000,22999,False,79,scaffold_2
27,3174001,3187000,12999,False,79,scaffold_2
28,3224001,3284000,59999,False,79,scaffold_2
29,3317001,3390000,72999,False,79,scaffold_2
30,3449001,3714000,264999,False,79,scaffold_2
31,3749001,3955000,205999,False,79,scaffold_2
32,4007001,4124000,116999,False,79,scaffold_2
33,4202001,4790000,587999,False,79,scaffold_2
34,4793001,4810000,16999,False,79,scaffold_2
35,4852001,4986000,133999,False,79,scaffold_2
36,5018001,5105000,86999,False,79,scaffold_2
37,5124001,5242000,117999,False,79,scaffold_2
38,5247001,5590000,342999,False,79,scaffold_2
39,5604001,5782000,177999,False,79,scaffold_2
40,5829001,6146000,316999,False,79,scaffold_2
41,6228001,6350000,121999,False,79,scaffold_2
42,6365001,6466000,100999,False,79,scaffold_2
43,6499001,6676000,176999,False,79,scaffold_2
44,6695001,6758000,62999,False,79,scaffold_2
45,6802001,6913000,110999,False,79,scaffold_2
46,6945001,7038000,92999,False,79,scaffold_2
47,7050001,7098000,47999,False,79,scaffold_2
48,7162001,7233000,70999,False,79,scaffold_2
49,7341001,7477000,135999,False,79,scaffold_2
50,7486001,7518000,31999,False,79,scaffold_2
51,7546001,7561000,14999,False,79,scaffold_2
52,7563001,8323000,759999,False,79,scaffold_2
53,8346001,8456000,109999,False,79,scaffold_2
54,8464001,8494000,29999,False,79,scaffold_2
55,8495001,8564000,68999,False,79,scaffold_2
56,8933001,9094000,160999,False,79,scaffold_2
57,9117001,9202000,84999,False,79,scaffold_2
58,9229001,9492000,262999,False,79,scaffold_2
59,9568001,9636000,67999,False,79,scaffold_2
60,9669001,9731000,61999,False,79,scaffold_2
61,9790001,9860000,69999,False,79,scaffold_2
62,10457001,10495000,37999,False,79,scaffold_2
63,10517001,10731000,213999,False,79,scaffold_2
64,10847001,10887000,39999,False,79,scaffold_2
65,10929001,10964000,34999,False,79,scaffold_2
66,11025001,11126000,100999,False,79,scaffold_2
67,11295001,11502000,206999,False,79,scaffold_2
68,11519001,11786000,266999,False,79,scaffold_2
69,11798001,11802476,4475,True,79,scaffold_2
0,218001,234000,15999,False,79,scaffold_3
1,235001,267000,31999,False,79,scaffold_3
2,618001,646000,27999,False,79,scaffold_3
3,771001,958000,186999,False,79,scaffold_3
4,960001,976000,15999,False,79,scaffold_3
5,1067001,1084000,16999,False,79,scaffold_3
6,1163001,1225000,61999,False,79,scaffold_3
7,1524001,1582000,57999,False,79,scaffold_3
8,1584001,1739000,154999,False,79,scaffold_3
9,1741001,1785000,43999,False,79,scaffold_3
10,1851001,1990000,138999,False,79,scaffold_3
11,1995001,2108000,112999,False,79,scaffold_3
12,2109001,2341000,231999,False,79,scaffold_3
13,2372001,2428000,55999,False,79,scaffold_3
14,2431001,2533000,101999,False,79,scaffold_3
15,2534001,2543000,8999,False,79,scaffold_3
16,2561001,2568000,6999,False,79,scaffold_3
17,2593001,2609000,15999,False,79,scaffold_3
18,2633001,2874000,240999,False,79,scaffold_3
19,2886001,2940000,53999,False,79,scaffold_3
20,2961001,3062000,100999,False,79,scaffold_3
21,3066001,3279000,212999,False,79,scaffold_3
22,3297001,3351000,53999,False,79,scaffold_3
23,3471001,3541000,69999,False,79,scaffold_3
24,3561001,3894000,332999,False,79,scaffold_3
25,3907001,3921000,13999,False,79,scaffold_3
26,3926001,3946000,19999,False,79,scaffold_3
27,3974001,4519000,544999,False,79,scaffold_3
28,4614001,4687000,72999,False,79,scaffold_3
29,4778001,4809000,30999,False,79,scaffold_3
30,4854001,4926000,71999,False,79,scaffold_3
31,4969001,5306000,336999,False,79,scaffold_3
32,5340001,5537000,196999,False,79,scaffold_3
33,5538001,6123000,584999,False,79,scaffold_3
34,6257001,6305000,47999,False,79,scaffold_3
35,6511001,6584000,72999,False,79,scaffold_3
36,6710001,7157000,446999,False,79,scaffold_3
37,7222001,7402000,179999,False,79,scaffold_3
38,7483001,7557000,73999,False,79,scaffold_3
39,7577001,7648000,70999,False,79,scaffold_3
40,7673001,8117000,443999,False,79,scaffold_3
41,8121001,8160000,38999,False,79,scaffold_3
42,8176001,8255000,78999,False,79,scaffold_3
43,8314001,8627000,312999,False,79,scaffold_3
44,8653001,8717000,63999,False,79,scaffold_3
45,8757001,8806000,48999,False,79,scaffold_3
46,8815001,8916000,100999,False,79,scaffold_3
47,8956001,9102000,145999,False,79,scaffold_3
48,9104001,9252000,147999,False,79,scaffold_3
49,9273001,9352000,78999,False,79,scaffold_3
50,9387001,9409000,21999,False,79,scaffold_3
51,9437001,9722000,284999,False,79,scaffold_3
52,9724001,9907000,182999,False,79,scaffold_3
53,9935001,9996000,60999,False,79,scaffold_3
54,10042001,10147000,104999,False,79,scaffold_3
55,10233001,10301000,67999,False,79,scaffold_3
56,10461001,10486000,24999,False,79,scaffold_3
57,10551001,10572000,20999,False,79,scaffold_3
58,10574001,11182071,608070,True,79,scaffold_3
0,1,7000,6999,True,79,scaffold_4
1,11001,13000,1999,False,79,scaffold_4
2,17001,32000,14999,False,79,scaffold_4
3,48001,88000,39999,False,79,scaffold_4
4,120001,146000,25999,False,79,scaffold_4
5,147001,151000,3999,False,79,scaffold_4
6,155001,215000,59999,False,79,scaffold_4
7,217001,278000,60999,False,79,scaffold_4
8,283001,353000,69999,False,79,scaffold_4
9,355001,374000,18999,False,79,scaffold_4
10,375001,380000,4999,False,79,scaffold_4
11,391001,410000,18999,False,79,scaffold_4
12,411001,425000,13999,False,79,scaffold_4
13,429001,505000,75999,False,79,scaffold_4
14,510001,532000,21999,False,79,scaffold_4
15,539001,592000,52999,False,79,scaffold_4
16,593001,607000,13999,False,79,scaffold_4
17,608001,691000,82999,False,79,scaffold_4
18,1082001,1086000,3999,False,79,scaffold_4
19,1087001,1109000,21999,False,79,scaffold_4
20,1113001,1136000,22999,False,79,scaffold_4
21,1137001,1226000,88999,False,79,scaffold_4
22,1229001,1279000,49999,False,79,scaffold_4
23,1283001,1605000,321999,False,79,scaffold_4
24,1609001,1611000,1999,False,79,scaffold_4
25,1613001,2218000,604999,False,79,scaffold_4
26,2219001,2268000,48999,False,79,scaffold_4
27,2269001,2461000,191999,False,79,scaffold_4
28,2475001,2871000,395999,False,79,scaffold_4
29,2890001,3128000,237999,False,79,scaffold_4
30,3157001,3841000,683999,False,79,scaffold_4
31,3850001,3889000,38999,False,79,scaffold_4
32,3997001,4197000,199999,False,79,scaffold_4
33,4198001,4308000,109999,False,79,scaffold_4
34,4702001,4740000,37999,False,79,scaffold_4
35,4844001,5106000,261999,False,79,scaffold_4
36,5169001,5506000,336999,False,79,scaffold_4
37,5514001,5784000,269999,False,79,scaffold_4
38,5786001,6612000,825999,False,79,scaffold_4
39,6619001,6668000,48999,False,79,scaffold_4
40,6707001,6924000,216999,False,79,scaffold_4
41,6926001,7023000,96999,False,79,scaffold_4
42,7036001,7124000,87999,False,79,scaffold_4
43,7129001,7429000,299999,False,79,scaffold_4
44,7457001,7525000,67999,False,79,scaffold_4
45,7526001,7571000,44999,False,79,scaffold_4
46,7603001,7667000,63999,False,79,scaffold_4
47,7685001,7765000,79999,False,79,scaffold_4
48,7774001,7781000,6999,False,79,scaffold_4
49,7836001,7922000,85999,False,79,scaffold_4
50,7975001,8002000,26999,False,79,scaffold_4
51,8032001,8139000,106999,False,79,scaffold_4
52,8387001,8414000,26999,False,79,scaffold_4
53,8653001,8678000,24999,False,79,scaffold_4
54,8703001,8825000,121999,False,79,scaffold_4
55,8844001,9699000,854999,False,79,scaffold_4
56,9700001,9845951,145950,True,79,scaffold_4
0,28001,32000,3999,False,79,scaffold_5
1,43001,47000,3999,False,79,scaffold_5
2,48001,89000,40999,False,79,scaffold_5
3,141001,174000,32999,False,79,scaffold_5
4,188001,202000,13999,False,79,scaffold_5
5,318001,420000,101999,False,79,scaffold_5
6,442001,526000,83999,False,79,scaffold_5
7,563001,579000,15999,False,79,scaffold_5
8,610001,656000,45999,False,79,scaffold_5
9,669001,719000,49999,False,79,scaffold_5
10,804001,832000,27999,False,79,scaffold_5
11,844001,862000,17999,False,79,scaffold_5
12,922001,976000,53999,False,79,scaffold_5
13,1062001,1068000,5999,False,79,scaffold_5
14,1069001,1105000,35999,False,79,scaffold_5
15,1264001,1305000,40999,False,79,scaffold_5
16,1317001,1404000,86999,False,79,scaffold_5
17,1626001,1655000,28999,False,79,scaffold_5
18,1670001,1683000,12999,False,79,scaffold_5
19,1878001,1895000,16999,False,79,scaffold_5
20,1912001,1935000,22999,False,79,scaffold_5
21,1937001,1968000,30999,False,79,scaffold_5
22,2080001,2104000,23999,False,79,scaffold_5
23,2264001,2303000,38999,False,79,scaffold_5
24,2381001,2406000,24999,False,79,scaffold_5
25,2475001,2515000,39999,False,79,scaffold_5
26,2516001,3078000,561999,False,79,scaffold_5
27,3090001,3511000,420999,False,79,scaffold_5
28,3532001,3598000,65999,False,79,scaffold_5
29,3599001,3688000,88999,False,79,scaffold_5
30,3765001,3946000,180999,False,79,scaffold_5
31,3961001,5115000,1153999,False,79,scaffold_5
32,5212001,5346000,133999,False,79,scaffold_5
33,5348001,5447000,98999,False,79,scaffold_5
34,5498001,5533000,34999,False,79,scaffold_5
35,5689001,5739000,49999,False,79,scaffold_5
36,6389001,6854000,464999,False,79,scaffold_5
37,6882001,6969000,86999,False,79,scaffold_5
38,7035001,7085000,49999,False,79,scaffold_5
39,7166001,7244000,77999,False,79,scaffold_5
40,7258001,7364000,105999,False,79,scaffold_5
41,7406001,7443000,36999,False,79,scaffold_5
42,7454001,7514000,59999,False,79,scaffold_5
43,7523001,7749000,225999,False,79,scaffold_5
44,7780001,7808000,27999,False,79,scaffold_5
45,7815001,7877000,61999,False,79,scaffold_5
46,8258001,8280000,21999,False,79,scaffold_5
47,8322001,8345000,22999,False,79,scaffold_5
48,8408001,8471000,62999,False,79,scaffold_5
49,8547001,9364176,817175,True,79,scaffold_5
0,41001,75000,33999,False,79,scaffold_6
1,78001,84000,5999,False,79,scaffold_6
2,86001,121000,34999,False,79,scaffold_6
3,139001,211000,71999,False,79,scaffold_6
4,223001,371000,147999,False,79,scaffold_6
5,467001,489000,21999,False,79,scaffold_6
6,554001,581000,26999,False,79,scaffold_6
7,630001,762000,131999,False,79,scaffold_6
8,764001,803000,38999,False,79,scaffold_6
9,833001,854000,20999,False,79,scaffold_6
10,900001,1050000,149999,False,79,scaffold_6
11,1120001,1310000,189999,False,79,scaffold_6
12,1376001,1600000,223999,False,79,scaffold_6
13,1653001,2107000,453999,False,79,scaffold_6
14,2116001,2300000,183999,False,79,scaffold_6
15,2305001,2872000,566999,False,79,scaffold_6
16,2903001,3350000,446999,False,79,scaffold_6
17,3351001,3808000,456999,False,79,scaffold_6
18,3810001,4072000,261999,False,79,scaffold_6
19,4073001,4207000,133999,False,79,scaffold_6
20,4248001,4487000,238999,False,79,scaffold_6
21,4601001,4757000,155999,False,79,scaffold_6
22,4814001,4918000,103999,False,79,scaffold_6
23,4925001,4994000,68999,False,79,scaffold_6
24,5135001,5190000,54999,False,79,scaffold_6
25,5288001,5319000,30999,False,79,scaffold_6
26,5442001,5468000,25999,False,79,scaffold_6
27,5551001,5812000,260999,False,79,scaffold_6
28,5861001,6333000,471999,False,79,scaffold_6
29,6446001,6506000,59999,False,79,scaffold_6
30,6647001,6714000,66999,False,79,scaffold_6
31,6763001,6804000,40999,False,79,scaffold_6
32,6833001,6866000,32999,False,79,scaffold_6
33,6911001,7142000,230999,False,79,scaffold_6
34,7185001,7343000,157999,False,79,scaffold_6
35,7376001,7530000,153999,False,79,scaffold_6
36,7531001,8268281,737280,True,79,scaffold_6
0,1,9000,8999,True,79,scaffold_7
1,10001,34000,23999,False,79,scaffold_7
2,50001,59000,8999,False,79,scaffold_7
3,285001,510000,224999,False,79,scaffold_7
4,614001,736000,121999,False,79,scaffold_7
5,740001,753000,12999,False,79,scaffold_7
6,764001,827000,62999,False,79,scaffold_7
7,875001,945000,69999,False,79,scaffold_7
8,953001,963000,9999,False,79,scaffold_7
9,964001,980000,15999,False,79,scaffold_7
10,982001,1044000,61999,False,79,scaffold_7
11,1048001,1148000,99999,False,79,scaffold_7
12,1160001,1782000,621999,False,79,scaffold_7
13,1816001,1947000,130999,False,79,scaffold_7
14,1972001,2056000,83999,False,79,scaffold_7
15,2223001,2273000,49999,False,79,scaffold_7
16,2362001,2410000,47999,False,79,scaffold_7
17,2427001,2743000,315999,False,79,scaffold_7
18,2828001,2959000,130999,False,79,scaffold_7
19,3039001,3083000,43999,False,79,scaffold_7
20,3096001,3136000,39999,False,79,scaffold_7
21,3164001,3188000,23999,False,79,scaffold_7
22,3196001,3270000,73999,False,79,scaffold_7
23,3296001,3408000,111999,False,79,scaffold_7
24,3480001,3809000,328999,False,79,scaffold_7
25,3861001,3983000,121999,False,79,scaffold_7
26,4021001,4066000,44999,False,79,scaffold_7
27,4317001,4597000,279999,False,79,scaffold_7
28,4631001,5207000,575999,False,79,scaffold_7
29,5262001,5293000,30999,False,79,scaffold_7
30,5369001,5661000,291999,False,79,scaffold_7
31,5780001,5965000,184999,False,79,scaffold_7
32,6004001,6094000,89999,False,79,scaffold_7
33,6096001,6391000,294999,False,79,scaffold_7
34,6546001,6840000,293999,False,79,scaffold_7
35,6944001,7270000,325999,False,79,scaffold_7
36,7271001,7502216,231215,True,79,scaffold_7
0,30001,63000,32999,False,79,scaffold_8
1,67001,85000,17999,False,79,scaffold_8
2,1002001,1054000,51999,False,79,scaffold_8
3,1109001,1131000,21999,False,79,scaffold_8
4,1362001,1435000,72999,False,79,scaffold_8
5,1563001,1585000,21999,False,79,scaffold_8
6,1857001,1929000,71999,False,79,scaffold_8
7,2057001,2620000,562999,False,79,scaffold_8
8,2648001,2845000,196999,False,79,scaffold_8
9,2846001,3614000,767999,False,79,scaffold_8
10,3615001,4273000,657999,False,79,scaffold_8
11,4329001,4438000,108999,False,79,scaffold_8
12,4466001,4483000,16999,False,79,scaffold_8
13,4567001,4684000,116999,False,79,scaffold_8
14,4724001,4772000,47999,False,79,scaffold_8
15,4799001,4875000,75999,False,79,scaffold_8
16,4892001,4964000,71999,False,79,scaffold_8
17,4984001,5245000,260999,False,79,scaffold_8
18,5357001,5491000,133999,False,79,scaffold_8
19,5503001,5597000,93999,False,79,scaffold_8
20,5651001,5718000,66999,False,79,scaffold_8
21,5727001,6334544,607543,True,79,scaffold_8
0,1,22000,21999,True,79,scaffold_9
1,79001,106000,26999,False,79,scaffold_9
2,109001,140000,30999,False,79,scaffold_9
3,302001,411000,108999,False,79,scaffold_9
4,413001,434000,20999,False,79,scaffold_9
5,436001,439000,2999,False,79,scaffold_9
6,442001,531000,88999,False,79,scaffold_9
7,646001,665000,18999,False,79,scaffold_9
8,671001,696000,24999,False,79,scaffold_9
9,719001,742000,22999,False,79,scaffold_9
10,808001,841000,32999,False,79,scaffold_9
11,886001,986000,99999,False,79,scaffold_9
12,987001,995000,7999,False,79,scaffold_9
13,1001001,1007000,5999,False,79,scaffold_9
14,1009001,1085000,75999,False,79,scaffold_9
15,1087001,1150000,62999,False,79,scaffold_9
16,1151001,1184000,32999,False,79,scaffold_9
17,1202001,1274000,71999,False,79,scaffold_9
18,1311001,1391000,79999,False,79,scaffold_9
19,1457001,1471000,13999,False,79,scaffold_9
20,1483001,1586000,102999,False,79,scaffold_9
21,1587001,1806000,218999,False,79,scaffold_9
22,1816001,1856000,39999,False,79,scaffold_9
23,1885001,1960000,74999,False,79,scaffold_9
24,1970001,2171000,200999,False,79,scaffold_9
25,2174001,2721000,546999,False,79,scaffold_9
26,2737001,3381000,643999,False,79,scaffold_9
27,3383001,5110000,1726999,False,79,scaffold_9
28,5112001,5115000,2999,False,79,scaffold_9
29,5116001,5238000,121999,False,79,scaffold_9
30,5239001,5298000,58999,False,79,scaffold_9
31,5299001,6331288,1032287,True,79,scaffold_9
0,1,879000,878999,True,79,scaffold_10
1,888001,1068000,179999,False,79,scaffold_10
2,1073001,1156000,82999,False,79,scaffold_10
3,1272001,1844000,571999,False,79,scaffold_10
4,1864001,1947000,82999,False,79,scaffold_10
5,1981001,2113000,131999,False,79,scaffold_10
6,2140001,2816000,675999,False,79,scaffold_10
7,2817001,2904000,86999,False,79,scaffold_10
8,2918001,2957000,38999,False,79,scaffold_10
9,2967001,3015000,47999,False,79,scaffold_10
10,3061001,3204000,142999,False,79,scaffold_10
11,3339001,3433000,93999,False,79,scaffold_10
12,3434001,3444000,9999,False,79,scaffold_10
13,3468001,3476000,7999,False,79,scaffold_10
14,3481001,3534000,52999,False,79,scaffold_10
15,3570001,3582000,11999,False,79,scaffold_10
16,3633001,3676000,42999,False,79,scaffold_10
17,4004001,4088000,83999,False,79,scaffold_10
18,4154001,4195000,40999,False,79,scaffold_10
19,4234001,4246000,11999,False,79,scaffold_10
20,4316001,4324000,7999,False,79,scaffold_10
21,4334001,4466000,131999,False,79,scaffold_10
22,4467001,4502000,34999,False,79,scaffold_10
23,4503001,4513000,9999,False,79,scaffold_10
24,4515001,4523000,7999,False,79,scaffold_10
25,4526001,4548000,21999,False,79,scaffold_10
26,4554001,4562000,7999,False,79,scaffold_10
27,4565001,4626000,60999,False,79,scaffold_10
28,4642001,4678000,35999,False,79,scaffold_10
29,4679001,4688000,8999,False,79,scaffold_10
30,4716001,4776000,59999,False,79,scaffold_10
31,4798001,4824000,25999,False,79,scaffold_10
32,4827001,4843000,15999,False,79,scaffold_10
33,4844001,4846000,1999,False,79,scaffold_10
34,4848001,4861000,12999,False,79,scaffold_10
35,4865001,4866973,1972,True,79,scaffold_10
0,10001,98000,87999,False,79,scaffold_11
1,132001,167000,34999,False,79,scaffold_11
2,169001,212000,42999,False,79,scaffold_11
3,213001,236000,22999,False,79,scaffold_11
4,240001,252000,11999,False,79,scaffold_11
5,295001,323000,27999,False,79,scaffold_11
6,419001,431000,11999,False,79,scaffold_11
7,648001,656000,7999,False,79,scaffold_11
8,1028001,1034000,5999,False,79,scaffold_11
9,1179001,1215000,35999,False,79,scaffold_11
10,1220001,1249000,28999,False,79,scaffold_11
11,1310001,1398000,87999,False,79,scaffold_11
12,1403001,1409000,5999,False,79,scaffold_11
13,1432001,1469000,36999,False,79,scaffold_11
14,1474001,1478000,3999,False,79,scaffold_11
15,1520001,1599000,78999,False,79,scaffold_11
16,1718001,1741000,22999,False,79,scaffold_11
17,1815001,2007000,191999,False,79,scaffold_11
18,2008001,2059000,50999,False,79,scaffold_11
19,2084001,2172000,87999,False,79,scaffold_11
20,2177001,2233000,55999,False,79,scaffold_11
21,2674001,2920000,245999,False,79,scaffold_11
22,2947001,3034000,86999,False,79,scaffold_11
23,3083001,3384000,300999,False,79,scaffold_11
24,3418001,4710000,1291999,False,79,scaffold_11
25,4712001,4766820,54819,True,79,scaffold_11
0,1,1499000,1498999,True,79,scaffold_12
1,1542001,1601000,58999,False,79,scaffold_12
2,1638001,1694000,55999,False,79,scaffold_12
3,1718001,1750000,31999,False,79,scaffold_12
4,1773001,2015000,241999,False,79,scaffold_12
5,2016001,2125000,108999,False,79,scaffold_12
6,2129001,2185000,55999,False,79,scaffold_12
7,2283001,2437000,153999,False,79,scaffold_12
8,2571001,2610000,38999,False,79,scaffold_12
9,2673001,2682000,8999,False,79,scaffold_12
10,2685001,2707000,21999,False,79,scaffold_12
0,1,340000,339999,True,80,scaffold_1
1,482001,498000,15999,False,80,scaffold_1
2,574001,643000,68999,False,80,scaffold_1
3,686001,743000,56999,False,80,scaffold_1
4,1281001,1292000,10999,False,80,scaffold_1
5,1828001,1898000,69999,False,80,scaffold_1
6,1954001,1964000,9999,False,80,scaffold_1
7,1965001,1984000,18999,False,80,scaffold_1
8,2449001,2517000,67999,False,80,scaffold_1
9,2729001,2746000,16999,False,80,scaffold_1
10,3180001,3208000,27999,False,80,scaffold_1
11,3715001,3733000,17999,False,80,scaffold_1
12,3916001,3941000,24999,False,80,scaffold_1
13,4063001,4111000,47999,False,80,scaffold_1
14,4322001,4354000,31999,False,80,scaffold_1
15,4927001,4997000,69999,False,80,scaffold_1
16,5481001,5512000,30999,False,80,scaffold_1
17,5545001,5567000,21999,False,80,scaffold_1
18,6108001,6153000,44999,False,80,scaffold_1
19,6228001,6507000,278999,False,80,scaffold_1
20,6544001,6554000,9999,False,80,scaffold_1
21,7037001,7247000,209999,False,80,scaffold_1
22,7248001,7583000,334999,False,80,scaffold_1
23,7590001,8477000,886999,False,80,scaffold_1
24,8478001,8656000,177999,False,80,scaffold_1
25,8658001,9584000,925999,False,80,scaffold_1
26,9586001,10355000,768999,False,80,scaffold_1
27,10461001,10630000,168999,False,80,scaffold_1
28,10808001,10811000,2999,False,80,scaffold_1
29,10837001,10856000,18999,False,80,scaffold_1
30,11344001,11504000,159999,False,80,scaffold_1
31,11613001,11951000,337999,False,80,scaffold_1
32,12184001,12204000,19999,False,80,scaffold_1
33,12652001,12722000,69999,False,80,scaffold_1
34,12777001,12888000,110999,False,80,scaffold_1
35,13113001,13211000,97999,False,80,scaffold_1
36,13347001,13404000,56999,False,80,scaffold_1
37,14007001,14013000,5999,False,80,scaffold_1
38,14285001,14308000,22999,False,80,scaffold_1
0,22001,48000,25999,False,80,scaffold_2
1,117001,159000,41999,False,80,scaffold_2
2,165001,177000,11999,False,80,scaffold_2
3,303001,318000,14999,False,80,scaffold_2
4,331001,374000,42999,False,80,scaffold_2
5,2336001,2358000,21999,False,80,scaffold_2
6,2405001,2424000,18999,False,80,scaffold_2
7,2441001,2553000,111999,False,80,scaffold_2
8,2660001,2689000,28999,False,80,scaffold_2
9,2694001,2742000,47999,False,80,scaffold_2
10,3454001,3463000,8999,False,80,scaffold_2
11,4385001,4409000,23999,False,80,scaffold_2
12,4429001,4456000,26999,False,80,scaffold_2
13,4521001,4654000,132999,False,80,scaffold_2
14,5022001,5031000,8999,False,80,scaffold_2
15,5033001,5061000,27999,False,80,scaffold_2
16,5491001,5511000,19999,False,80,scaffold_2
17,5668001,5704000,35999,False,80,scaffold_2
18,6261001,6330000,68999,False,80,scaffold_2
19,6331001,6342000,10999,False,80,scaffold_2
20,6430001,6448000,17999,False,80,scaffold_2
21,7439001,7472000,32999,False,80,scaffold_2
22,7563001,7697000,133999,False,80,scaffold_2
23,7786001,7891000,104999,False,80,scaffold_2
24,7934001,8092000,157999,False,80,scaffold_2
25,8261001,8294000,32999,False,80,scaffold_2
26,8331001,8333000,1999,False,80,scaffold_2
27,8334001,8344000,9999,False,80,scaffold_2
28,8346001,8453000,106999,False,80,scaffold_2
29,8509001,8557000,47999,False,80,scaffold_2
30,11367001,11373000,5999,False,80,scaffold_2
31,11520001,11785000,264999,False,80,scaffold_2
0,1,2000,1999,True,80,scaffold_3
1,51001,55000,3999,False,80,scaffold_3
2,799001,900000,100999,False,80,scaffold_3
3,2084001,2108000,23999,False,80,scaffold_3
4,2291001,2321000,29999,False,80,scaffold_3
5,2487001,2533000,45999,False,80,scaffold_3
6,3826001,3845000,18999,False,80,scaffold_3
7,4111001,4383000,271999,False,80,scaffold_3
8,4418001,4518000,99999,False,80,scaffold_3
9,4547001,4558000,10999,False,80,scaffold_3
10,4654001,4678000,23999,False,80,scaffold_3
11,6910001,6962000,51999,False,80,scaffold_3
12,6963001,7047000,83999,False,80,scaffold_3
13,7055001,7071000,15999,False,80,scaffold_3
14,7540001,7556000,15999,False,80,scaffold_3
15,7692001,7756000,63999,False,80,scaffold_3
16,7776001,7786000,9999,False,80,scaffold_3
17,7820001,7840000,19999,False,80,scaffold_3
18,8207001,8253000,45999,False,80,scaffold_3
19,8462001,8527000,64999,False,80,scaffold_3
20,8575001,8594000,18999,False,80,scaffold_3
21,9968001,9995000,26999,False,80,scaffold_3
22,10461001,10483000,21999,False,80,scaffold_3
23,10587001,11165000,577999,False,80,scaffold_3
0,17001,32000,14999,False,80,scaffold_4
1,49001,88000,38999,False,80,scaffold_4
2,121001,151000,29999,False,80,scaffold_4
3,155001,160000,4999,False,80,scaffold_4
4,161001,215000,53999,False,80,scaffold_4
5,217001,226000,8999,False,80,scaffold_4
6,227001,241000,13999,False,80,scaffold_4
7,242001,266000,23999,False,80,scaffold_4
8,355001,374000,18999,False,80,scaffold_4
9,375001,380000,4999,False,80,scaffold_4
10,395001,410000,14999,False,80,scaffold_4
11,411001,425000,13999,False,80,scaffold_4
12,429001,439000,9999,False,80,scaffold_4
13,450001,500000,49999,False,80,scaffold_4
14,547001,606000,58999,False,80,scaffold_4
15,608001,661000,52999,False,80,scaffold_4
16,670001,691000,20999,False,80,scaffold_4
17,695001,697000,1999,False,80,scaffold_4
18,701001,714000,12999,False,80,scaffold_4
19,1121001,1198000,76999,False,80,scaffold_4
20,1199001,1208000,8999,False,80,scaffold_4
21,1210001,1226000,15999,False,80,scaffold_4
22,1235001,1253000,17999,False,80,scaffold_4
23,1254001,1262000,7999,False,80,scaffold_4
24,1265001,1279000,13999,False,80,scaffold_4
25,1283001,1316000,32999,False,80,scaffold_4
26,1372001,1591000,218999,False,80,scaffold_4
27,1613001,1635000,21999,False,80,scaffold_4
28,1653001,1957000,303999,False,80,scaffold_4
29,1958001,2002000,43999,False,80,scaffold_4
30,2018001,2099000,80999,False,80,scaffold_4
31,2284001,2340000,55999,False,80,scaffold_4
32,2399001,2462000,62999,False,80,scaffold_4
33,2480001,2581000,100999,False,80,scaffold_4
34,2600001,2635000,34999,False,80,scaffold_4
35,3336001,3632000,295999,False,80,scaffold_4
36,3676001,3760000,83999,False,80,scaffold_4
37,4941001,4984000,42999,False,80,scaffold_4
38,5477001,5506000,28999,False,80,scaffold_4
39,5514001,5620000,105999,False,80,scaffold_4
40,5661001,5784000,122999,False,80,scaffold_4
41,6903001,6924000,20999,False,80,scaffold_4
42,7037001,7062000,24999,False,80,scaffold_4
43,7228001,7265000,36999,False,80,scaffold_4
44,8849001,9699000,849999,False,80,scaffold_4
45,9700001,9845951,145950,True,80,scaffold_4
0,318001,326000,7999,False,80,scaffold_5
1,327001,368000,40999,False,80,scaffold_5
2,464001,491000,26999,False,80,scaffold_5
3,493001,523000,29999,False,80,scaffold_5
4,933001,947000,13999,False,80,scaffold_5
5,2564001,2581000,16999,False,80,scaffold_5
6,2625001,2734000,108999,False,80,scaffold_5
7,2816001,2871000,54999,False,80,scaffold_5
8,3133001,3185000,51999,False,80,scaffold_5
9,3322001,3498000,175999,False,80,scaffold_5
10,3962001,4101000,138999,False,80,scaffold_5
11,4121001,4142000,20999,False,80,scaffold_5
12,4155001,4219000,63999,False,80,scaffold_5
13,4246001,4262000,15999,False,80,scaffold_5
14,4446001,4503000,56999,False,80,scaffold_5
15,4601001,4660000,58999,False,80,scaffold_5
16,4691001,4718000,26999,False,80,scaffold_5
17,4772001,4861000,88999,False,80,scaffold_5
18,4904001,4917000,12999,False,80,scaffold_5
19,5318001,5346000,27999,False,80,scaffold_5
20,6509001,6566000,56999,False,80,scaffold_5
21,7581001,7611000,29999,False,80,scaffold_5
22,7621001,7653000,31999,False,80,scaffold_5
23,8670001,8689000,18999,False,80,scaffold_5
24,8713001,9364176,651175,True,80,scaffold_5
0,79001,84000,4999,False,80,scaffold_6
1,86001,113000,26999,False,80,scaffold_6
2,241001,254000,12999,False,80,scaffold_6
3,256001,262000,5999,False,80,scaffold_6
4,267001,283000,15999,False,80,scaffold_6
5,1229001,1258000,28999,False,80,scaffold_6
6,1479001,1546000,66999,False,80,scaffold_6
7,2023001,2087000,63999,False,80,scaffold_6
8,2130001,2169000,38999,False,80,scaffold_6
9,2354001,2595000,240999,False,80,scaffold_6
10,2596001,2653000,56999,False,80,scaffold_6
11,2655001,2691000,35999,False,80,scaffold_6
12,2731001,2872000,140999,False,80,scaffold_6
13,2927001,2931000,3999,False,80,scaffold_6
14,2933001,3014000,80999,False,80,scaffold_6
15,3112001,3174000,61999,False,80,scaffold_6
16,3224001,3301000,76999,False,80,scaffold_6
17,3407001,3428000,20999,False,80,scaffold_6
18,3461001,3766000,304999,False,80,scaffold_6
19,3901001,3912000,10999,False,80,scaffold_6
20,4018001,4047000,28999,False,80,scaffold_6
21,4084001,4192000,107999,False,80,scaffold_6
22,6011001,6060000,48999,False,80,scaffold_6
23,7282001,7337000,54999,False,80,scaffold_6
24,7393001,7434000,40999,False,80,scaffold_6
25,7550001,7796000,245999,False,80,scaffold_6
26,7811001,8268281,457280,True,80,scaffold_6
0,1,8000,7999,True,80,scaffold_7
1,13001,31000,17999,False,80,scaffold_7
2,323001,340000,16999,False,80,scaffold_7
3,342001,508000,165999,False,80,scaffold_7
4,554001,563000,8999,False,80,scaffold_7
5,571001,577000,5999,False,80,scaffold_7
6,706001,736000,29999,False,80,scaffold_7
7,764001,809000,44999,False,80,scaffold_7
8,859001,864000,4999,False,80,scaffold_7
9,982001,1044000,61999,False,80,scaffold_7
10,1048001,1104000,55999,False,80,scaffold_7
11,1191001,1460000,268999,False,80,scaffold_7
12,1461001,1512000,50999,False,80,scaffold_7
13,1588001,1695000,106999,False,80,scaffold_7
14,3326001,3369000,42999,False,80,scaffold_7
15,3593001,3649000,55999,False,80,scaffold_7
16,4416001,4517000,100999,False,80,scaffold_7
17,4658001,4681000,22999,False,80,scaffold_7
18,4978001,5030000,51999,False,80,scaffold_7
19,5074001,5149000,74999,False,80,scaffold_7
20,5483001,5516000,32999,False,80,scaffold_7
21,5520001,5533000,12999,False,80,scaffold_7
22,6955001,7502216,547215,True,80,scaffold_7
0,67001,85000,17999,False,80,scaffold_8
1,722001,724000,1999,False,80,scaffold_8
2,2449001,2468000,18999,False,80,scaffold_8
3,2536001,2551000,14999,False,80,scaffold_8
4,2661001,2683000,21999,False,80,scaffold_8
5,2742001,2757000,14999,False,80,scaffold_8
6,2808001,2844000,35999,False,80,scaffold_8
7,3059001,3525000,465999,False,80,scaffold_8
8,3584001,3612000,27999,False,80,scaffold_8
9,3620001,3934000,313999,False,80,scaffold_8
10,5125001,5134000,8999,False,80,scaffold_8
11,5200001,5241000,40999,False,80,scaffold_8
12,6325001,6334544,9543,True,80,scaffold_8
0,109001,117000,7999,False,80,scaffold_9
1,299001,315000,15999,False,80,scaffold_9
2,366001,411000,44999,False,80,scaffold_9
3,413001,434000,20999,False,80,scaffold_9
4,503001,531000,27999,False,80,scaffold_9
5,670001,696000,25999,False,80,scaffold_9
6,732001,742000,9999,False,80,scaffold_9
7,794001,803000,8999,False,80,scaffold_9
8,814001,842000,27999,False,80,scaffold_9
9,886001,986000,99999,False,80,scaffold_9
10,988001,995000,6999,False,80,scaffold_9
11,1001001,1007000,5999,False,80,scaffold_9
12,1009001,1031000,21999,False,80,scaffold_9
13,1036001,1085000,48999,False,80,scaffold_9
14,1087001,1150000,62999,False,80,scaffold_9
15,1151001,1164000,12999,False,80,scaffold_9
16,1312001,1377000,64999,False,80,scaffold_9
17,1487001,1499000,11999,False,80,scaffold_9
18,1764001,1791000,26999,False,80,scaffold_9
19,2599001,2616000,16999,False,80,scaffold_9
20,2782001,2803000,20999,False,80,scaffold_9
21,2871001,3381000,509999,False,80,scaffold_9
22,3383001,5107000,1723999,False,80,scaffold_9
23,5112001,5115000,2999,False,80,scaffold_9
24,5116001,5238000,121999,False,80,scaffold_9
25,5239001,5298000,58999,False,80,scaffold_9
26,5300001,6331288,1031287,True,80,scaffold_9
0,1,136000,135999,True,80,scaffold_10
1,137001,197000,59999,False,80,scaffold_10
2,373001,414000,40999,False,80,scaffold_10
3,471001,482000,10999,False,80,scaffold_10
4,483001,580000,96999,False,80,scaffold_10
5,603001,754000,150999,False,80,scaffold_10
6,888001,916000,27999,False,80,scaffold_10
7,924001,962000,37999,False,80,scaffold_10
8,1087001,1105000,17999,False,80,scaffold_10
9,2145001,2166000,20999,False,80,scaffold_10
10,2273001,2295000,21999,False,80,scaffold_10
11,2346001,2367000,20999,False,80,scaffold_10
12,4053001,4091000,37999,False,80,scaffold_10
13,4154001,4174000,19999,False,80,scaffold_10
14,4443001,4462000,18999,False,80,scaffold_10
15,4467001,4477000,9999,False,80,scaffold_10
16,4515001,4523000,7999,False,80,scaffold_10
17,4526001,4548000,21999,False,80,scaffold_10
18,4576001,4595000,18999,False,80,scaffold_10
19,4679001,4688000,8999,False,80,scaffold_10
20,4734001,4766000,31999,False,80,scaffold_10
21,4769001,4776000,6999,False,80,scaffold_10
22,4798001,4824000,25999,False,80,scaffold_10
23,4827001,4843000,15999,False,80,scaffold_10
24,4848001,4861000,12999,False,80,scaffold_10
25,4865001,4866973,1972,True,80,scaffold_10
0,10001,37000,26999,False,80,scaffold_11
1,38001,93000,54999,False,80,scaffold_11
2,149001,167000,17999,False,80,scaffold_11
3,169001,191000,21999,False,80,scaffold_11
4,213001,235000,21999,False,80,scaffold_11
5,240001,248000,7999,False,80,scaffold_11
6,419001,431000,11999,False,80,scaffold_11
7,648001,656000,7999,False,80,scaffold_11
8,940001,942000,1999,False,80,scaffold_11
9,1025001,1034000,8999,False,80,scaffold_11
10,2701001,2872000,170999,False,80,scaffold_11
11,3217001,3259000,41999,False,80,scaffold_11
12,3331001,3382000,50999,False,80,scaffold_11
13,3702001,3933000,230999,False,80,scaffold_11
14,4315001,4710000,394999,False,80,scaffold_11
15,4713001,4766820,53819,True,80,scaffold_11
0,1,369000,368999,True,80,scaffold_12
1,474001,538000,63999,False,80,scaffold_12
2,582001,737000,154999,False,80,scaffold_12
3,739001,856000,116999,False,80,scaffold_12
4,865001,1427000,561999,False,80,scaffold_12
5,1720001,1733000,12999,False,80,scaffold_12
6,2559001,2566000,6999,False,80,scaffold_12
7,2571001,2610000,38999,False,80,scaffold_12
8,2675001,2682000,6999,False,80,scaffold_12
0,1,342000,341999,True,81,scaffold_1
1,482001,498000,15999,False,81,scaffold_1
2,571001,643000,71999,False,81,scaffold_1
3,686001,749000,62999,False,81,scaffold_1
4,1280001,1292000,11999,False,81,scaffold_1
5,1812001,1898000,85999,False,81,scaffold_1
6,1922001,1984000,61999,False,81,scaffold_1
7,1986001,1999000,12999,False,81,scaffold_1
8,2449001,2517000,67999,False,81,scaffold_1
9,2727001,2746000,18999,False,81,scaffold_1
10,3174001,3212000,37999,False,81,scaffold_1
11,3713001,3757000,43999,False,81,scaffold_1
12,3803001,3879000,75999,False,81,scaffold_1
13,3902001,3941000,38999,False,81,scaffold_1
14,3992001,4032000,39999,False,81,scaffold_1
15,4062001,4115000,52999,False,81,scaffold_1
16,4315001,4354000,38999,False,81,scaffold_1
17,4796001,4811000,14999,False,81,scaffold_1
18,4923001,5000000,76999,False,81,scaffold_1
19,5087001,5114000,26999,False,81,scaffold_1
20,5440001,5455000,14999,False,81,scaffold_1
21,5481001,5511000,29999,False,81,scaffold_1
22,5535001,5579000,43999,False,81,scaffold_1
23,5854001,5913000,58999,False,81,scaffold_1
24,6108001,6153000,44999,False,81,scaffold_1
25,6154001,6177000,22999,False,81,scaffold_1
26,6204001,6509000,304999,False,81,scaffold_1
27,6543001,6557000,13999,False,81,scaffold_1
28,7038001,7247000,208999,False,81,scaffold_1
29,7248001,7583000,334999,False,81,scaffold_1
30,7590001,8656000,1065999,False,81,scaffold_1
31,8658001,9584000,925999,False,81,scaffold_1
32,9586001,10354000,767999,False,81,scaffold_1
33,10461001,10640000,178999,False,81,scaffold_1
34,10734001,10761000,26999,False,81,scaffold_1
35,10841001,10854000,12999,False,81,scaffold_1
36,10920001,10955000,34999,False,81,scaffold_1
37,11276001,11307000,30999,False,81,scaffold_1
38,11308001,11535000,226999,False,81,scaffold_1
39,11551001,11963000,411999,False,81,scaffold_1
40,12182001,12206000,23999,False,81,scaffold_1
41,12662001,12758000,95999,False,81,scaffold_1
42,12774001,12888000,113999,False,81,scaffold_1
43,12899001,12939000,39999,False,81,scaffold_1
44,13099001,13211000,111999,False,81,scaffold_1
45,13347001,13431000,83999,False,81,scaffold_1
46,13559001,13590000,30999,False,81,scaffold_1
47,13818001,13839000,20999,False,81,scaffold_1
48,14290001,14308000,17999,False,81,scaffold_1
49,14647001,14663000,15999,False,81,scaffold_1
0,1,48000,47999,True,81,scaffold_2
1,95001,159000,63999,False,81,scaffold_2
2,165001,177000,11999,False,81,scaffold_2
3,296001,318000,21999,False,81,scaffold_2
4,333001,374000,40999,False,81,scaffold_2
5,1321001,1332000,10999,False,81,scaffold_2
6,2315001,2334000,18999,False,81,scaffold_2
7,2336001,2379000,42999,False,81,scaffold_2
8,2398001,2415000,16999,False,81,scaffold_2
9,2416001,2553000,136999,False,81,scaffold_2
10,2567001,2609000,41999,False,81,scaffold_2
11,2645001,2689000,43999,False,81,scaffold_2
12,2694001,2745000,50999,False,81,scaffold_2
13,2884001,2885000,999,False,81,scaffold_2
14,2886001,2897000,10999,False,81,scaffold_2
15,2993001,3021000,27999,False,81,scaffold_2
16,3364001,3390000,25999,False,81,scaffold_2
17,3450001,3486000,35999,False,81,scaffold_2
18,3754001,3791000,36999,False,81,scaffold_2
19,4243001,4272000,28999,False,81,scaffold_2
20,4383001,4409000,25999,False,81,scaffold_2
21,4426001,4458000,31999,False,81,scaffold_2
22,4521001,4661000,139999,False,81,scaffold_2
23,4784001,4790000,5999,False,81,scaffold_2
24,4918001,4938000,19999,False,81,scaffold_2
25,5021001,5104000,82999,False,81,scaffold_2
26,5357001,5394000,36999,False,81,scaffold_2
27,5442001,5514000,71999,False,81,scaffold_2
28,5615001,5706000,90999,False,81,scaffold_2
29,5717001,5758000,40999,False,81,scaffold_2
30,5840001,5887000,46999,False,81,scaffold_2
31,6261001,6352000,90999,False,81,scaffold_2
32,6394001,6449000,54999,False,81,scaffold_2
33,6591001,6628000,36999,False,81,scaffold_2
34,7018001,7038000,19999,False,81,scaffold_2
35,7065001,7096000,30999,False,81,scaffold_2
36,7439001,7476000,36999,False,81,scaffold_2
37,7492001,7503000,10999,False,81,scaffold_2
38,7550001,7561000,10999,False,81,scaffold_2
39,7563001,7697000,133999,False,81,scaffold_2
40,7785001,7916000,130999,False,81,scaffold_2
41,7934001,8161000,226999,False,81,scaffold_2
42,8192001,8313000,120999,False,81,scaffold_2
43,8331001,8333000,1999,False,81,scaffold_2
44,8335001,8345000,9999,False,81,scaffold_2
45,8346001,8455000,108999,False,81,scaffold_2
46,8495001,8562000,66999,False,81,scaffold_2
47,9012001,9047000,34999,False,81,scaffold_2
48,9140001,9168000,27999,False,81,scaffold_2
49,9601001,9635000,33999,False,81,scaffold_2
50,11520001,11786000,265999,False,81,scaffold_2
0,618001,646000,27999,False,81,scaffold_3
1,798001,900000,101999,False,81,scaffold_3
2,2010001,2108000,97999,False,81,scaffold_3
3,2291001,2321000,29999,False,81,scaffold_3
4,2433001,2533000,99999,False,81,scaffold_3
5,2718001,2735000,16999,False,81,scaffold_3
6,3261001,3268000,6999,False,81,scaffold_3
7,3768001,3893000,124999,False,81,scaffold_3
8,4108001,4403000,294999,False,81,scaffold_3
9,4417001,4518000,100999,False,81,scaffold_3
10,4547001,4558000,10999,False,81,scaffold_3
11,4568001,4578000,9999,False,81,scaffold_3
12,4639001,4686000,46999,False,81,scaffold_3
13,5156001,5191000,34999,False,81,scaffold_3
14,5238001,5271000,32999,False,81,scaffold_3
15,5863001,5938000,74999,False,81,scaffold_3
16,5985001,6020000,34999,False,81,scaffold_3
17,6744001,6784000,39999,False,81,scaffold_3
18,6910001,6962000,51999,False,81,scaffold_3
19,6963001,7097000,133999,False,81,scaffold_3
20,7336001,7401000,64999,False,81,scaffold_3
21,7451001,7458000,6999,False,81,scaffold_3
22,7506001,7556000,49999,False,81,scaffold_3
23,7676001,7857000,180999,False,81,scaffold_3
24,8183001,8253000,69999,False,81,scaffold_3
25,8462001,8527000,64999,False,81,scaffold_3
26,8575001,8594000,18999,False,81,scaffold_3
27,9968001,9996000,27999,False,81,scaffold_3
28,10461001,10485000,23999,False,81,scaffold_3
29,10585001,11182071,597070,True,81,scaffold_3
0,17001,32000,14999,False,81,scaffold_4
1,49001,88000,38999,False,81,scaffold_4
2,120001,146000,25999,False,81,scaffold_4
3,147001,151000,3999,False,81,scaffold_4
4,155001,215000,59999,False,81,scaffold_4
5,217001,273000,55999,False,81,scaffold_4
6,283001,344000,60999,False,81,scaffold_4
7,345001,353000,7999,False,81,scaffold_4
8,355001,374000,18999,False,81,scaffold_4
9,375001,410000,34999,False,81,scaffold_4
10,412001,425000,12999,False,81,scaffold_4
11,429001,504000,74999,False,81,scaffold_4
12,542001,592000,49999,False,81,scaffold_4
13,608001,691000,82999,False,81,scaffold_4
14,695001,697000,1999,False,81,scaffold_4
15,700001,714000,13999,False,81,scaffold_4
16,1043001,1047000,3999,False,81,scaffold_4
17,1087001,1110000,22999,False,81,scaffold_4
18,1113001,1208000,94999,False,81,scaffold_4
19,1210001,1226000,15999,False,81,scaffold_4
20,1268001,1279000,10999,False,81,scaffold_4
21,1283001,1605000,321999,False,81,scaffold_4
22,1613001,2181000,567999,False,81,scaffold_4
23,2210001,2246000,35999,False,81,scaffold_4
24,2247001,2281000,33999,False,81,scaffold_4
25,2284001,2461000,176999,False,81,scaffold_4
26,2476001,2635000,158999,False,81,scaffold_4
27,2702001,2783000,80999,False,81,scaffold_4
28,3077001,3128000,50999,False,81,scaffold_4
29,3334001,3761000,426999,False,81,scaffold_4
30,4055001,4078000,22999,False,81,scaffold_4
31,4900001,5061000,160999,False,81,scaffold_4
32,5172001,5246000,73999,False,81,scaffold_4
33,5300001,5326000,25999,False,81,scaffold_4
34,5477001,5506000,28999,False,81,scaffold_4
35,5516001,5620000,103999,False,81,scaffold_4
36,5660001,5784000,123999,False,81,scaffold_4
37,5786001,5815000,28999,False,81,scaffold_4
38,6145001,6193000,47999,False,81,scaffold_4
39,6797001,6817000,19999,False,81,scaffold_4
40,6878001,6924000,45999,False,81,scaffold_4
41,7036001,7079000,42999,False,81,scaffold_4
42,7201001,7303000,101999,False,81,scaffold_4
43,7630001,7665000,34999,False,81,scaffold_4
44,8846001,9699000,852999,False,81,scaffold_4
45,9700001,9845951,145950,True,81,scaffold_4
0,1,5000,4999,True,81,scaffold_5
1,143001,175000,31999,False,81,scaffold_5
2,189001,204000,14999,False,81,scaffold_5
3,319001,326000,6999,False,81,scaffold_5
4,327001,428000,100999,False,81,scaffold_5
5,460001,526000,65999,False,81,scaffold_5
6,669001,696000,26999,False,81,scaffold_5
7,836001,842000,5999,False,81,scaffold_5
8,933001,955000,21999,False,81,scaffold_5
9,2477001,2493000,15999,False,81,scaffold_5
10,2552001,2737000,184999,False,81,scaffold_5
11,2814001,2875000,60999,False,81,scaffold_5
12,3133001,3248000,114999,False,81,scaffold_5
13,3322001,3514000,191999,False,81,scaffold_5
14,3616001,3659000,42999,False,81,scaffold_5
15,3844001,3878000,33999,False,81,scaffold_5
16,3961001,4101000,139999,False,81,scaffold_5
17,4118001,4222000,103999,False,81,scaffold_5
18,4227001,4273000,45999,False,81,scaffold_5
19,4446001,4525000,78999,False,81,scaffold_5
20,4600001,4680000,79999,False,81,scaffold_5
21,4690001,4926000,235999,False,81,scaffold_5
22,4973001,4990000,16999,False,81,scaffold_5
23,5283001,5312000,28999,False,81,scaffold_5
24,5314001,5345000,30999,False,81,scaffold_5
25,6393001,6420000,26999,False,81,scaffold_5
26,6454001,6666000,211999,False,81,scaffold_5
27,7559001,7658000,98999,False,81,scaffold_5
28,8258001,8263000,4999,False,81,scaffold_5
29,8552001,8617000,64999,False,81,scaffold_5
30,8654001,8686000,31999,False,81,scaffold_5
31,8713001,9364176,651175,True,81,scaffold_5
0,61001,75000,13999,False,81,scaffold_6
1,76001,85000,8999,False,81,scaffold_6
2,86001,116000,29999,False,81,scaffold_6
3,163001,207000,43999,False,81,scaffold_6
4,239001,254000,14999,False,81,scaffold_6
5,265001,288000,22999,False,81,scaffold_6
6,553001,560000,6999,False,81,scaffold_6
7,1157001,1180000,22999,False,81,scaffold_6
8,1229001,1258000,28999,False,81,scaffold_6
9,1288001,1305000,16999,False,81,scaffold_6
10,1479001,1546000,66999,False,81,scaffold_6
11,1868001,1906000,37999,False,81,scaffold_6
12,2026001,2104000,77999,False,81,scaffold_6
13,2128001,2193000,64999,False,81,scaffold_6
14,2237001,2283000,45999,False,81,scaffold_6
15,2335001,2595000,259999,False,81,scaffold_6
16,2596001,2691000,94999,False,81,scaffold_6
17,2711001,2872000,160999,False,81,scaffold_6
18,2937001,3032000,94999,False,81,scaffold_6
19,3112001,3174000,61999,False,81,scaffold_6
20,3223001,3308000,84999,False,81,scaffold_6
21,3400001,3798000,397999,False,81,scaffold_6
22,3898001,3913000,14999,False,81,scaffold_6
23,3966001,4072000,105999,False,81,scaffold_6
24,4073001,4207000,133999,False,81,scaffold_6
25,5602001,5646000,43999,False,81,scaffold_6
26,6010001,6087000,76999,False,81,scaffold_6
27,6784001,6803000,18999,False,81,scaffold_6
28,7184001,7337000,152999,False,81,scaffold_6
29,7389001,7436000,46999,False,81,scaffold_6
30,7549001,8268281,719280,True,81,scaffold_6
0,13001,31000,17999,False,81,scaffold_7
1,312001,509000,196999,False,81,scaffold_7
2,646001,753000,106999,False,81,scaffold_7
3,764001,826000,61999,False,81,scaffold_7
4,859001,864000,4999,False,81,scaffold_7
5,865001,963000,97999,False,81,scaffold_7
6,964001,966000,1999,False,81,scaffold_7
7,968001,980000,11999,False,81,scaffold_7
8,982001,1044000,61999,False,81,scaffold_7
9,1048001,1101000,52999,False,81,scaffold_7
10,1204001,1512000,307999,False,81,scaffold_7
11,1588001,1689000,100999,False,81,scaffold_7
12,1851001,1875000,23999,False,81,scaffold_7
13,2930001,2952000,21999,False,81,scaffold_7
14,3297001,3387000,89999,False,81,scaffold_7
15,3522001,3564000,41999,False,81,scaffold_7
16,3577001,3766000,188999,False,81,scaffold_7
17,4324001,4361000,36999,False,81,scaffold_7
18,4416001,4517000,100999,False,81,scaffold_7
19,4658001,4734000,75999,False,81,scaffold_7
20,4777001,4833000,55999,False,81,scaffold_7
21,4978001,5149000,170999,False,81,scaffold_7
22,5483001,5536000,52999,False,81,scaffold_7
23,6096001,6108000,11999,False,81,scaffold_7
24,6955001,7270000,314999,False,81,scaffold_7
25,7271001,7502216,231215,True,81,scaffold_7
0,1,7000,6999,True,81,scaffold_8
1,66001,85000,18999,False,81,scaffold_8
2,93001,102000,8999,False,81,scaffold_8
3,2415001,2552000,136999,False,81,scaffold_8
4,2650001,2686000,35999,False,81,scaffold_8
5,2742001,2757000,14999,False,81,scaffold_8
6,2798001,2844000,45999,False,81,scaffold_8
7,3056001,3529000,472999,False,81,scaffold_8
8,3581001,3612000,30999,False,81,scaffold_8
9,3615001,3936000,320999,False,81,scaffold_8
10,4038001,4108000,69999,False,81,scaffold_8
11,4173001,4221000,47999,False,81,scaffold_8
12,4396001,4433000,36999,False,81,scaffold_8
13,5124001,5135000,10999,False,81,scaffold_8
14,5168001,5244000,75999,False,81,scaffold_8
15,5579001,5597000,17999,False,81,scaffold_8
16,5650001,5710000,59999,False,81,scaffold_8
17,5761001,5774000,12999,False,81,scaffold_8
18,6322001,6334544,12543,True,81,scaffold_8
0,1,22000,21999,True,81,scaffold_9
1,109001,118000,8999,False,81,scaffold_9
2,121001,136000,14999,False,81,scaffold_9
3,298001,411000,112999,False,81,scaffold_9
4,413001,434000,20999,False,81,scaffold_9
5,483001,531000,47999,False,81,scaffold_9
6,548001,561000,12999,False,81,scaffold_9
7,652001,665000,12999,False,81,scaffold_9
8,671001,697000,25999,False,81,scaffold_9
9,730001,741000,10999,False,81,scaffold_9
10,814001,842000,27999,False,81,scaffold_9
11,851001,862000,10999,False,81,scaffold_9
12,872001,986000,113999,False,81,scaffold_9
13,987001,995000,7999,False,81,scaffold_9
14,997001,1007000,9999,False,81,scaffold_9
15,1009001,1031000,21999,False,81,scaffold_9
16,1036001,1085000,48999,False,81,scaffold_9
17,1087001,1150000,62999,False,81,scaffold_9
18,1151001,1179000,27999,False,81,scaffold_9
19,1311001,1383000,71999,False,81,scaffold_9
20,1599001,1623000,23999,False,81,scaffold_9
21,1656001,1700000,43999,False,81,scaffold_9
22,1749001,1806000,56999,False,81,scaffold_9
23,1987001,2058000,70999,False,81,scaffold_9
24,2597001,2616000,18999,False,81,scaffold_9
25,2735001,3381000,645999,False,81,scaffold_9
26,3383001,5107000,1723999,False,81,scaffold_9
27,5109001,5111000,1999,False,81,scaffold_9
28,5112001,5115000,2999,False,81,scaffold_9
29,5116001,5238000,121999,False,81,scaffold_9
30,5239001,5298000,58999,False,81,scaffold_9
31,5300001,5490000,189999,False,81,scaffold_9
32,5493001,6331288,838287,True,81,scaffold_9
0,1,236000,235999,True,81,scaffold_10
1,257001,414000,156999,False,81,scaffold_10
2,415001,482000,66999,False,81,scaffold_10
3,483001,581000,97999,False,81,scaffold_10
4,601001,841000,239999,False,81,scaffold_10
5,888001,921000,32999,False,81,scaffold_10
6,923001,987000,63999,False,81,scaffold_10
7,1073001,1146000,72999,False,81,scaffold_10
8,1425001,1463000,37999,False,81,scaffold_10
9,1636001,1670000,33999,False,81,scaffold_10
10,2141001,2167000,25999,False,81,scaffold_10
11,2346001,2368000,21999,False,81,scaffold_10
12,2560001,2579000,18999,False,81,scaffold_10
13,4002001,4014000,11999,False,81,scaffold_10
14,4052001,4093000,40999,False,81,scaffold_10
15,4142001,4149000,6999,False,81,scaffold_10
16,4154001,4174000,19999,False,81,scaffold_10
17,4234001,4247000,12999,False,81,scaffold_10
18,4335001,4365000,29999,False,81,scaffold_10
19,4443001,4462000,18999,False,81,scaffold_10
20,4467001,4502000,34999,False,81,scaffold_10
21,4503001,4513000,9999,False,81,scaffold_10
22,4515001,4523000,7999,False,81,scaffold_10
23,4526001,4548000,21999,False,81,scaffold_10
24,4554001,4562000,7999,False,81,scaffold_10
25,4565001,4596000,30999,False,81,scaffold_10
26,4713001,4732000,18999,False,81,scaffold_10
27,4733001,4766000,32999,False,81,scaffold_10
28,4767001,4776000,8999,False,81,scaffold_10
29,4798001,4824000,25999,False,81,scaffold_10
30,4828001,4843000,14999,False,81,scaffold_10
31,4848001,4861000,12999,False,81,scaffold_10
32,4865001,4866973,1972,True,81,scaffold_10
0,11001,93000,81999,False,81,scaffold_11
1,132001,168000,35999,False,81,scaffold_11
2,169001,212000,42999,False,81,scaffold_11
3,213001,236000,22999,False,81,scaffold_11
4,240001,252000,11999,False,81,scaffold_11
5,295001,319000,23999,False,81,scaffold_11
6,419001,431000,11999,False,81,scaffold_11
7,637001,656000,18999,False,81,scaffold_11
8,781001,785000,3999,False,81,scaffold_11
9,1025001,1034000,8999,False,81,scaffold_11
10,1474001,1477000,2999,False,81,scaffold_11
11,2701001,2877000,175999,False,81,scaffold_11
12,2980001,3011000,30999,False,81,scaffold_11
13,3088001,3161000,72999,False,81,scaffold_11
14,3185001,3291000,105999,False,81,scaffold_11
15,3328001,3383000,54999,False,81,scaffold_11
16,3553001,3933000,379999,False,81,scaffold_11
17,4009001,4159000,149999,False,81,scaffold_11
18,4189001,4710000,520999,False,81,scaffold_11
19,4713001,4766820,53819,True,81,scaffold_11
0,1,393000,392999,True,81,scaffold_12
1,402001,1494000,1091999,False,81,scaffold_12
2,1713001,1746000,32999,False,81,scaffold_12
3,2068001,2103000,34999,False,81,scaffold_12
4,2128001,2161000,32999,False,81,scaffold_12
5,2571001,2612000,40999,False,81,scaffold_12
6,2661001,2682000,20999,False,81,scaffold_12
7,2747001,2747968,967,True,81,scaffold_12
0,1,342000,341999,True,82,scaffold_1
1,482001,498000,15999,False,82,scaffold_1
2,574001,643000,68999,False,82,scaffold_1
3,686001,750000,63999,False,82,scaffold_1
4,1827001,1898000,70999,False,82,scaffold_1
5,1954001,1964000,9999,False,82,scaffold_1
6,1965001,1984000,18999,False,82,scaffold_1
7,2449001,2517000,67999,False,82,scaffold_1
8,2564001,2582000,17999,False,82,scaffold_1
9,2729001,2746000,16999,False,82,scaffold_1
10,3178001,3209000,30999,False,82,scaffold_1
11,3713001,3742000,28999,False,82,scaffold_1
12,3909001,3941000,31999,False,82,scaffold_1
13,3994001,4030000,35999,False,82,scaffold_1
14,4060001,4112000,51999,False,82,scaffold_1
15,4315001,4354000,38999,False,82,scaffold_1
16,4927001,5019000,91999,False,82,scaffold_1
17,5484001,5511000,26999,False,82,scaffold_1
18,5535001,5570000,34999,False,82,scaffold_1
19,6108001,6153000,44999,False,82,scaffold_1
20,6154001,6176000,21999,False,82,scaffold_1
21,6228001,6381000,152999,False,82,scaffold_1
22,6384001,6507000,122999,False,82,scaffold_1
23,6544001,6554000,9999,False,82,scaffold_1
24,7038001,7247000,208999,False,82,scaffold_1
25,7248001,7584000,335999,False,82,scaffold_1
26,7590001,8477000,886999,False,82,scaffold_1
27,8478001,8656000,177999,False,82,scaffold_1
28,8658001,8829000,170999,False,82,scaffold_1
29,8830001,9584000,753999,False,82,scaffold_1
30,9586001,10356000,769999,False,82,scaffold_1
31,10460001,10636000,175999,False,82,scaffold_1
32,10808001,10811000,2999,False,82,scaffold_1
33,10832001,10858000,25999,False,82,scaffold_1
34,11344001,11503000,158999,False,82,scaffold_1
35,11601001,11951000,349999,False,82,scaffold_1
36,12184001,12204000,19999,False,82,scaffold_1
37,12652001,12722000,69999,False,82,scaffold_1
38,12776001,12888000,111999,False,82,scaffold_1
39,13113001,13211000,97999,False,82,scaffold_1
40,13347001,13404000,56999,False,82,scaffold_1
41,14285001,14308000,22999,False,82,scaffold_1
42,14471001,14479000,7999,False,82,scaffold_1
43,14690001,14692000,1999,False,82,scaffold_1
44,14789001,14794116,5115,True,82,scaffold_1
0,22001,48000,25999,False,82,scaffold_2
1,93001,159000,65999,False,82,scaffold_2
2,168001,176000,7999,False,82,scaffold_2
3,302001,318000,15999,False,82,scaffold_2
4,330001,374000,43999,False,82,scaffold_2
5,2336001,2358000,21999,False,82,scaffold_2
6,2404001,2424000,19999,False,82,scaffold_2
7,2441001,2600000,158999,False,82,scaffold_2
8,2658001,2689000,30999,False,82,scaffold_2
9,2694001,2746000,51999,False,82,scaffold_2
10,2768001,2788000,19999,False,82,scaffold_2
11,2994001,3012000,17999,False,82,scaffold_2
12,3174001,3187000,12999,False,82,scaffold_2
13,3450001,3465000,14999,False,82,scaffold_2
14,3754001,3783000,28999,False,82,scaffold_2
15,4385001,4409000,23999,False,82,scaffold_2
16,4427001,4458000,30999,False,82,scaffold_2
17,4521001,4657000,135999,False,82,scaffold_2
18,4783001,4790000,6999,False,82,scaffold_2
19,4917001,4948000,30999,False,82,scaffold_2
20,5022001,5031000,8999,False,82,scaffold_2
21,5033001,5061000,27999,False,82,scaffold_2
22,5080001,5104000,23999,False,82,scaffold_2
23,5370001,5393000,22999,False,82,scaffold_2
24,5447001,5481000,33999,False,82,scaffold_2
25,5490001,5512000,21999,False,82,scaffold_2
26,5668001,5704000,35999,False,82,scaffold_2
27,5719001,5756000,36999,False,82,scaffold_2
28,6261001,6330000,68999,False,82,scaffold_2
29,6331001,6350000,18999,False,82,scaffold_2
30,6590001,6628000,37999,False,82,scaffold_2
31,7019001,7034000,14999,False,82,scaffold_2
32,7439001,7472000,32999,False,82,scaffold_2
33,7563001,7697000,133999,False,82,scaffold_2
34,7786001,7917000,130999,False,82,scaffold_2
35,7934001,8138000,203999,False,82,scaffold_2
36,8261001,8296000,34999,False,82,scaffold_2
37,8331001,8333000,1999,False,82,scaffold_2
38,8346001,8454000,107999,False,82,scaffold_2
39,8509001,8563000,53999,False,82,scaffold_2
40,11367001,11377000,9999,False,82,scaffold_2
41,11520001,11786000,265999,False,82,scaffold_2
0,1,2000,1999,True,82,scaffold_3
1,43001,46000,2999,False,82,scaffold_3
2,102001,104000,1999,False,82,scaffold_3
3,203001,207000,3999,False,82,scaffold_3
4,799001,847000,47999,False,82,scaffold_3
5,849001,901000,51999,False,82,scaffold_3
6,2040001,2108000,67999,False,82,scaffold_3
7,2110001,2115000,4999,False,82,scaffold_3
8,2291001,2322000,30999,False,82,scaffold_3
9,2484001,2533000,48999,False,82,scaffold_3
10,3826001,3891000,64999,False,82,scaffold_3
11,4108001,4398000,289999,False,82,scaffold_3
12,4418001,4518000,99999,False,82,scaffold_3
13,4547001,4558000,10999,False,82,scaffold_3
14,4652001,4685000,32999,False,82,scaffold_3
15,5881001,5903000,21999,False,82,scaffold_3
16,5990001,6022000,31999,False,82,scaffold_3
17,6907001,6962000,54999,False,82,scaffold_3
18,6963001,7089000,125999,False,82,scaffold_3
19,7533001,7563000,29999,False,82,scaffold_3
20,7692001,7798000,105999,False,82,scaffold_3
21,7819001,7842000,22999,False,82,scaffold_3
22,8183001,8253000,69999,False,82,scaffold_3
23,8462001,8527000,64999,False,82,scaffold_3
24,8575001,8593000,17999,False,82,scaffold_3
25,9968001,9996000,27999,False,82,scaffold_3
26,10461001,10484000,22999,False,82,scaffold_3
27,10586001,11167000,580999,False,82,scaffold_3
0,17001,29000,11999,False,82,scaffold_4
1,30001,32000,1999,False,82,scaffold_4
2,48001,81000,32999,False,82,scaffold_4
3,132001,146000,13999,False,82,scaffold_4
4,147001,151000,3999,False,82,scaffold_4
5,155001,215000,59999,False,82,scaffold_4
6,217001,226000,8999,False,82,scaffold_4
7,227001,266000,38999,False,82,scaffold_4
8,290001,311000,20999,False,82,scaffold_4
9,313001,353000,39999,False,82,scaffold_4
10,355001,374000,18999,False,82,scaffold_4
11,375001,380000,4999,False,82,scaffold_4
12,411001,425000,13999,False,82,scaffold_4
13,429001,499000,69999,False,82,scaffold_4
14,545001,606000,60999,False,82,scaffold_4
15,608001,661000,52999,False,82,scaffold_4
16,670001,691000,20999,False,82,scaffold_4
17,701001,714000,12999,False,82,scaffold_4
18,1121001,1136000,14999,False,82,scaffold_4
19,1137001,1198000,60999,False,82,scaffold_4
20,1199001,1226000,26999,False,82,scaffold_4
21,1265001,1279000,13999,False,82,scaffold_4
22,1283001,1320000,36999,False,82,scaffold_4
23,1371001,1599000,227999,False,82,scaffold_4
24,1613001,1957000,343999,False,82,scaffold_4
25,1958001,2004000,45999,False,82,scaffold_4
26,2029001,2101000,71999,False,82,scaffold_4
27,2219001,2280000,60999,False,82,scaffold_4
28,2284001,2310000,25999,False,82,scaffold_4
29,2312001,2339000,26999,False,82,scaffold_4
30,2429001,2461000,31999,False,82,scaffold_4
31,2476001,2588000,111999,False,82,scaffold_4
32,2597001,2635000,37999,False,82,scaffold_4
33,3095001,3125000,29999,False,82,scaffold_4
34,3335001,3633000,297999,False,82,scaffold_4
35,3645001,3760000,114999,False,82,scaffold_4
36,4901001,5045000,143999,False,82,scaffold_4
37,5174001,5222000,47999,False,82,scaffold_4
38,5475001,5506000,30999,False,82,scaffold_4
39,5515001,5620000,104999,False,82,scaffold_4
40,5661001,5784000,122999,False,82,scaffold_4
41,6145001,6193000,47999,False,82,scaffold_4
42,6791001,6817000,25999,False,82,scaffold_4
43,6902001,6924000,21999,False,82,scaffold_4
44,7036001,7062000,25999,False,82,scaffold_4
45,8846001,9699000,852999,False,82,scaffold_4
46,9700001,9845951,145950,True,82,scaffold_4
0,1,4000,3999,True,82,scaffold_5
1,190001,204000,13999,False,82,scaffold_5
2,296001,300000,3999,False,82,scaffold_5
3,320001,326000,5999,False,82,scaffold_5
4,327001,368000,40999,False,82,scaffold_5
5,463001,523000,59999,False,82,scaffold_5
6,836001,842000,5999,False,82,scaffold_5
7,933001,947000,13999,False,82,scaffold_5
8,2511001,2515000,3999,False,82,scaffold_5
9,2564001,2581000,16999,False,82,scaffold_5
10,2625001,2734000,108999,False,82,scaffold_5
11,2813001,2871000,57999,False,82,scaffold_5
12,3133001,3185000,51999,False,82,scaffold_5
13,3217001,3256000,38999,False,82,scaffold_5
14,3323001,3498000,174999,False,82,scaffold_5
15,3962001,4101000,138999,False,82,scaffold_5
16,4121001,4219000,97999,False,82,scaffold_5
17,4246001,4265000,18999,False,82,scaffold_5
18,4445001,4506000,60999,False,82,scaffold_5
19,4602001,4667000,64999,False,82,scaffold_5
20,4691001,4861000,169999,False,82,scaffold_5
21,5260001,5273000,12999,False,82,scaffold_5
22,5290001,5312000,21999,False,82,scaffold_5
23,5314001,5346000,31999,False,82,scaffold_5
24,6409001,6419000,9999,False,82,scaffold_5
25,6482001,6653000,170999,False,82,scaffold_5
26,7097001,7100000,2999,False,82,scaffold_5
27,7454001,7483000,28999,False,82,scaffold_5
28,7580001,7611000,30999,False,82,scaffold_5
29,7621001,7643000,21999,False,82,scaffold_5
30,8670001,8689000,18999,False,82,scaffold_5
31,8713001,9364176,651175,True,82,scaffold_5
0,79001,85000,5999,False,82,scaffold_6
1,86001,112000,25999,False,82,scaffold_6
2,240001,254000,13999,False,82,scaffold_6
3,257001,262000,4999,False,82,scaffold_6
4,267001,283000,15999,False,82,scaffold_6
5,553001,568000,14999,False,82,scaffold_6
6,1237001,1258000,20999,False,82,scaffold_6
7,1479001,1546000,66999,False,82,scaffold_6
8,2023001,2087000,63999,False,82,scaffold_6
9,2130001,2193000,62999,False,82,scaffold_6
10,2348001,2595000,246999,False,82,scaffold_6
11,2596001,2690000,93999,False,82,scaffold_6
12,2731001,2872000,140999,False,82,scaffold_6
13,2934001,3014000,79999,False,82,scaffold_6
14,3115001,3149000,33999,False,82,scaffold_6
15,3223001,3301000,77999,False,82,scaffold_6
16,3407001,3428000,20999,False,82,scaffold_6
17,3460001,3767000,306999,False,82,scaffold_6
18,3901001,3912000,10999,False,82,scaffold_6
19,4018001,4072000,53999,False,82,scaffold_6
20,4073001,4193000,119999,False,82,scaffold_6
21,6010001,6063000,52999,False,82,scaffold_6
22,7263001,7337000,73999,False,82,scaffold_6
23,7549001,8268281,719280,True,82,scaffold_6
0,1,6000,5999,True,82,scaffold_7
1,13001,34000,20999,False,82,scaffold_7
2,321001,340000,18999,False,82,scaffold_7
3,342001,508000,165999,False,82,scaffold_7
4,554001,563000,8999,False,82,scaffold_7
5,571001,577000,5999,False,82,scaffold_7
6,706001,736000,29999,False,82,scaffold_7
7,743001,753000,9999,False,82,scaffold_7
8,764001,809000,44999,False,82,scaffold_7
9,859001,864000,4999,False,82,scaffold_7
10,964001,966000,1999,False,82,scaffold_7
11,968001,981000,12999,False,82,scaffold_7
12,982001,1044000,61999,False,82,scaffold_7
13,1191001,1512000,320999,False,82,scaffold_7
14,1588001,1688000,99999,False,82,scaffold_7
15,3326001,3369000,42999,False,82,scaffold_7
16,3523001,3551000,27999,False,82,scaffold_7
17,3593001,3661000,67999,False,82,scaffold_7
18,3683001,3766000,82999,False,82,scaffold_7
19,4416001,4517000,100999,False,82,scaffold_7
20,4658001,4730000,71999,False,82,scaffold_7
21,4979001,5149000,169999,False,82,scaffold_7
22,5484001,5535000,50999,False,82,scaffold_7
23,6954001,7270000,315999,False,82,scaffold_7
24,7271001,7502216,231215,True,82,scaffold_7
0,67001,85000,17999,False,82,scaffold_8
1,93001,101000,7999,False,82,scaffold_8
2,299001,304000,4999,False,82,scaffold_8
3,2444001,2525000,80999,False,82,scaffold_8
4,2654001,2683000,28999,False,82,scaffold_8
5,2742001,2757000,14999,False,82,scaffold_8
6,2799001,2844000,44999,False,82,scaffold_8
7,3060001,3525000,464999,False,82,scaffold_8
8,3580001,3612000,31999,False,82,scaffold_8
9,3615001,3913000,297999,False,82,scaffold_8
10,4038001,4099000,60999,False,82,scaffold_8
11,4204001,4221000,16999,False,82,scaffold_8
12,5088001,5136000,47999,False,82,scaffold_8
13,5196001,5241000,44999,False,82,scaffold_8
14,6324001,6334544,10543,True,82,scaffold_8
0,109001,117000,7999,False,82,scaffold_9
1,121001,138000,16999,False,82,scaffold_9
2,303001,315000,11999,False,82,scaffold_9
3,319001,333000,13999,False,82,scaffold_9
4,366001,411000,44999,False,82,scaffold_9
5,413001,434000,20999,False,82,scaffold_9
6,502001,531000,28999,False,82,scaffold_9
7,671001,696000,24999,False,82,scaffold_9
8,731001,742000,10999,False,82,scaffold_9
9,815001,843000,27999,False,82,scaffold_9
10,850001,862000,11999,False,82,scaffold_9
11,873001,986000,112999,False,82,scaffold_9
12,988001,995000,6999,False,82,scaffold_9
13,1001001,1007000,5999,False,82,scaffold_9
14,1010001,1085000,74999,False,82,scaffold_9
15,1087001,1150000,62999,False,82,scaffold_9
16,1151001,1160000,8999,False,82,scaffold_9
17,1311001,1377000,65999,False,82,scaffold_9
18,1599001,1610000,10999,False,82,scaffold_9
19,1749001,1791000,41999,False,82,scaffold_9
20,2148001,2171000,22999,False,82,scaffold_9
21,2599001,2616000,16999,False,82,scaffold_9
22,2845001,3381000,535999,False,82,scaffold_9
23,3383001,5100000,1716999,False,82,scaffold_9
24,5101001,5106000,4999,False,82,scaffold_9
25,5112001,5115000,2999,False,82,scaffold_9
26,5116001,5237000,120999,False,82,scaffold_9
27,5239001,5298000,58999,False,82,scaffold_9
28,5299001,5491000,191999,False,82,scaffold_9
29,5493001,6331288,838287,True,82,scaffold_9
0,1,136000,135999,True,82,scaffold_10
1,137001,210000,72999,False,82,scaffold_10
2,287001,414000,126999,False,82,scaffold_10
3,415001,482000,66999,False,82,scaffold_10
4,483001,576000,92999,False,82,scaffold_10
5,602001,794000,191999,False,82,scaffold_10
6,888001,916000,27999,False,82,scaffold_10
7,923001,962000,38999,False,82,scaffold_10
8,1073001,1112000,38999,False,82,scaffold_10
9,2143001,2173000,29999,False,82,scaffold_10
10,2269001,2299000,29999,False,82,scaffold_10
11,2346001,2364000,17999,False,82,scaffold_10
12,4054001,4091000,36999,False,82,scaffold_10
13,4154001,4174000,19999,False,82,scaffold_10
14,4445001,4462000,16999,False,82,scaffold_10
15,4467001,4476000,8999,False,82,scaffold_10
16,4503001,4513000,9999,False,82,scaffold_10
17,4515001,4523000,7999,False,82,scaffold_10
18,4526001,4548000,21999,False,82,scaffold_10
19,4565001,4596000,30999,False,82,scaffold_10
20,4681001,4688000,6999,False,82,scaffold_10
21,4734001,4766000,31999,False,82,scaffold_10
22,4769001,4776000,6999,False,82,scaffold_10
23,4798001,4824000,25999,False,82,scaffold_10
24,4828001,4843000,14999,False,82,scaffold_10
25,4848001,4861000,12999,False,82,scaffold_10
26,4865001,4866973,1972,True,82,scaffold_10
0,9001,34000,24999,False,82,scaffold_11
1,38001,93000,54999,False,82,scaffold_11
2,149001,167000,17999,False,82,scaffold_11
3,169001,191000,21999,False,82,scaffold_11
4,213001,236000,22999,False,82,scaffold_11
5,240001,247000,6999,False,82,scaffold_11
6,419001,431000,11999,False,82,scaffold_11
7,648001,656000,7999,False,82,scaffold_11
8,781001,785000,3999,False,82,scaffold_11
9,1025001,1034000,8999,False,82,scaffold_11
10,1423001,1426000,2999,False,82,scaffold_11
11,1474001,1477000,2999,False,82,scaffold_11
12,2701001,2876000,174999,False,82,scaffold_11
13,2983001,3011000,27999,False,82,scaffold_11
14,3187001,3292000,104999,False,82,scaffold_11
15,3328001,3383000,54999,False,82,scaffold_11
16,3560001,3572000,11999,False,82,scaffold_11
17,3702001,3926000,223999,False,82,scaffold_11
18,4134001,4159000,24999,False,82,scaffold_11
19,4184001,4710000,525999,False,82,scaffold_11
20,4712001,4766820,54819,True,82,scaffold_11
0,1,551000,550999,True,82,scaffold_12
1,569001,856000,286999,False,82,scaffold_12
2,864001,1469000,604999,False,82,scaffold_12
3,1719001,1733000,13999,False,82,scaffold_12
4,2088001,2103000,14999,False,82,scaffold_12
5,2559001,2566000,6999,False,82,scaffold_12
6,2571001,2610000,38999,False,82,scaffold_12
0,1,342000,341999,True,83,scaffold_1
1,482001,498000,15999,False,83,scaffold_1
2,572001,643000,70999,False,83,scaffold_1
3,686001,750000,63999,False,83,scaffold_1
4,1279001,1292000,12999,False,83,scaffold_1
5,1311001,1331000,19999,False,83,scaffold_1
6,1628001,1660000,31999,False,83,scaffold_1
7,1812001,1898000,85999,False,83,scaffold_1
8,1916001,1984000,67999,False,83,scaffold_1
9,1988001,2000000,11999,False,83,scaffold_1
10,2363001,2386000,22999,False,83,scaffold_1
11,2449001,2517000,67999,False,83,scaffold_1
12,2560001,2582000,21999,False,83,scaffold_1
13,2727001,2746000,18999,False,83,scaffold_1
14,2896001,2925000,28999,False,83,scaffold_1
15,2997001,3021000,23999,False,83,scaffold_1
16,3180001,3209000,28999,False,83,scaffold_1
17,3712001,3816000,103999,False,83,scaffold_1
18,3848001,3878000,29999,False,83,scaffold_1
19,3902001,3940000,37999,False,83,scaffold_1
20,3956001,4030000,73999,False,83,scaffold_1
21,4063001,4113000,49999,False,83,scaffold_1
22,4306001,4372000,65999,False,83,scaffold_1
23,4796001,4813000,16999,False,83,scaffold_1
24,4927001,5025000,97999,False,83,scaffold_1
25,5087001,5114000,26999,False,83,scaffold_1
26,5481001,5521000,39999,False,83,scaffold_1
27,5535001,5579000,43999,False,83,scaffold_1
28,5852001,5876000,23999,False,83,scaffold_1
29,6108001,6153000,44999,False,83,scaffold_1
30,6154001,6379000,224999,False,83,scaffold_1
31,6384001,6565000,180999,False,83,scaffold_1
32,6834001,6851000,16999,False,83,scaffold_1
33,7037001,7247000,209999,False,83,scaffold_1
34,7248001,7588000,339999,False,83,scaffold_1
35,7590001,8477000,886999,False,83,scaffold_1
36,8478001,8656000,177999,False,83,scaffold_1
37,8658001,9584000,925999,False,83,scaffold_1
38,9586001,10370000,783999,False,83,scaffold_1
39,10449001,10639000,189999,False,83,scaffold_1
40,10736001,10755000,18999,False,83,scaffold_1
41,10837001,10857000,19999,False,83,scaffold_1
42,10918001,10940000,21999,False,83,scaffold_1
43,11275001,11962000,686999,False,83,scaffold_1
44,12184001,12243000,58999,False,83,scaffold_1
45,12427001,12447000,19999,False,83,scaffold_1
46,12625001,12722000,96999,False,83,scaffold_1
47,12734001,12755000,20999,False,83,scaffold_1
48,12774001,12891000,116999,False,83,scaffold_1
49,12899001,12945000,45999,False,83,scaffold_1
50,12966001,13002000,35999,False,83,scaffold_1
51,13098001,13213000,114999,False,83,scaffold_1
52,13340001,13431000,90999,False,83,scaffold_1
53,13517001,13538000,20999,False,83,scaffold_1
54,13564001,13584000,19999,False,83,scaffold_1
55,13812001,13845000,32999,False,83,scaffold_1
56,13847001,13852000,4999,False,83,scaffold_1
57,13897001,13927000,29999,False,83,scaffold_1
58,14287001,14313000,25999,False,83,scaffold_1
59,14649001,14663000,13999,False,83,scaffold_1
0,22001,48000,25999,False,83,scaffold_2
1,93001,160000,66999,False,83,scaffold_2
2,168001,177000,8999,False,83,scaffold_2
3,254001,288000,33999,False,83,scaffold_2
4,296001,318000,21999,False,83,scaffold_2
5,332001,374000,41999,False,83,scaffold_2
6,390001,406000,15999,False,83,scaffold_2
7,2085001,2101000,15999,False,83,scaffold_2
8,2336001,2602000,265999,False,83,scaffold_2
9,2627001,2639000,11999,False,83,scaffold_2
10,2645001,2689000,43999,False,83,scaffold_2
11,2694001,2746000,51999,False,83,scaffold_2
12,2876001,3012000,135999,False,83,scaffold_2
13,3331001,3344000,12999,False,83,scaffold_2
14,3367001,3413000,45999,False,83,scaffold_2
15,3450001,3487000,36999,False,83,scaffold_2
16,3669001,3700000,30999,False,83,scaffold_2
17,3754001,3792000,37999,False,83,scaffold_2
18,4243001,4263000,19999,False,83,scaffold_2
19,4334001,4409000,74999,False,83,scaffold_2
20,4426001,4502000,75999,False,83,scaffold_2
21,4519001,4671000,151999,False,83,scaffold_2
22,4781001,4790000,8999,False,83,scaffold_2
23,4793001,4807000,13999,False,83,scaffold_2
24,4917001,4962000,44999,False,83,scaffold_2
25,5021001,5104000,82999,False,83,scaffold_2
26,5287001,5323000,35999,False,83,scaffold_2
27,5370001,5395000,24999,False,83,scaffold_2
28,5413001,5535000,121999,False,83,scaffold_2
29,5658001,5759000,100999,False,83,scaffold_2
30,5840001,5891000,50999,False,83,scaffold_2
31,5969001,6023000,53999,False,83,scaffold_2
32,6261001,6330000,68999,False,83,scaffold_2
33,6331001,6351000,19999,False,83,scaffold_2
34,6386001,6449000,62999,False,83,scaffold_2
35,6576001,6634000,57999,False,83,scaffold_2
36,6801001,6865000,63999,False,83,scaffold_2
37,7004001,7039000,34999,False,83,scaffold_2
38,7050001,7097000,46999,False,83,scaffold_2
39,7162001,7204000,41999,False,83,scaffold_2
40,7428001,7472000,43999,False,83,scaffold_2
41,7563001,7708000,144999,False,83,scaffold_2
42,7764001,7917000,152999,False,83,scaffold_2
43,7933001,8174000,240999,False,83,scaffold_2
44,8260001,8313000,52999,False,83,scaffold_2
45,8331001,8333000,1999,False,83,scaffold_2
46,8340001,8345000,4999,False,83,scaffold_2
47,8346001,8454000,107999,False,83,scaffold_2
48,8509001,8562000,52999,False,83,scaffold_2
49,9028001,9047000,18999,False,83,scaffold_2
50,9138001,9174000,35999,False,83,scaffold_2
51,9327001,9382000,54999,False,83,scaffold_2
52,9601001,9635000,33999,False,83,scaffold_2
53,9661001,9696000,34999,False,83,scaffold_2
54,10676001,10708000,31999,False,83,scaffold_2
55,10710001,10729000,18999,False,83,scaffold_2
56,11520001,11786000,265999,False,83,scaffold_2
0,618001,646000,27999,False,83,scaffold_3
1,791001,901000,109999,False,83,scaffold_3
2,1489001,1510000,20999,False,83,scaffold_3
3,2038001,2108000,69999,False,83,scaffold_3
4,2109001,2118000,8999,False,83,scaffold_3
5,2291001,2336000,44999,False,83,scaffold_3
6,2487001,2532000,44999,False,83,scaffold_3
7,2642001,2682000,39999,False,83,scaffold_3
8,2717001,2756000,38999,False,83,scaffold_3
9,3064001,3084000,19999,False,83,scaffold_3
10,3620001,3644000,23999,False,83,scaffold_3
11,3768001,3904000,135999,False,83,scaffold_3
12,3906001,3921000,14999,False,83,scaffold_3
13,4108001,4385000,276999,False,83,scaffold_3
14,4415001,4519000,103999,False,83,scaffold_3
15,4547001,4558000,10999,False,83,scaffold_3
16,4638001,4688000,49999,False,83,scaffold_3
17,5154001,5195000,40999,False,83,scaffold_3
18,5493001,5508000,14999,False,83,scaffold_3
19,5974001,6020000,45999,False,83,scaffold_3
20,6543001,6576000,32999,False,83,scaffold_3
21,6741001,6807000,65999,False,83,scaffold_3
22,6888001,6962000,73999,False,83,scaffold_3
23,6963001,7089000,125999,False,83,scaffold_3
24,7115001,7157000,41999,False,83,scaffold_3
25,7371001,7397000,25999,False,83,scaffold_3
26,7426001,7445000,18999,False,83,scaffold_3
27,7522001,7556000,33999,False,83,scaffold_3
28,7679001,7870000,190999,False,83,scaffold_3
29,8034001,8106000,71999,False,83,scaffold_3
30,8121001,8156000,34999,False,83,scaffold_3
31,8183001,8253000,69999,False,83,scaffold_3
32,8398001,8449000,50999,False,83,scaffold_3
33,8462001,8527000,64999,False,83,scaffold_3
34,8575001,8593000,17999,False,83,scaffold_3
35,8757001,8771000,13999,False,83,scaffold_3
36,9005001,9075000,69999,False,83,scaffold_3
37,9228001,9253000,24999,False,83,scaffold_3
38,9968001,9996000,27999,False,83,scaffold_3
39,10576001,11182071,606070,True,83,scaffold_3
0,1,7000,6999,True,83,scaffold_4
1,14001,16000,1999,False,83,scaffold_4
2,17001,29000,11999,False,83,scaffold_4
3,48001,88000,39999,False,83,scaffold_4
4,120001,151000,30999,False,83,scaffold_4
5,155001,215000,59999,False,83,scaffold_4
6,217001,280000,62999,False,83,scaffold_4
7,283001,307000,23999,False,83,scaffold_4
8,318001,344000,25999,False,83,scaffold_4
9,346001,353000,6999,False,83,scaffold_4
10,355001,374000,18999,False,83,scaffold_4
11,375001,380000,4999,False,83,scaffold_4
12,383001,410000,26999,False,83,scaffold_4
13,412001,425000,12999,False,83,scaffold_4
14,429001,498000,68999,False,83,scaffold_4
15,540001,592000,51999,False,83,scaffold_4
16,608001,691000,82999,False,83,scaffold_4
17,701001,727000,25999,False,83,scaffold_4
18,1053001,1064000,10999,False,83,scaffold_4
19,1087001,1097000,9999,False,83,scaffold_4
20,1098001,1109000,10999,False,83,scaffold_4
21,1113001,1136000,22999,False,83,scaffold_4
22,1138001,1208000,69999,False,83,scaffold_4
23,1210001,1226000,15999,False,83,scaffold_4
24,1229001,1234000,4999,False,83,scaffold_4
25,1235001,1253000,17999,False,83,scaffold_4
26,1254001,1279000,24999,False,83,scaffold_4
27,1283001,1600000,316999,False,83,scaffold_4
28,1613001,2130000,516999,False,83,scaffold_4
29,2142001,2218000,75999,False,83,scaffold_4
30,2219001,2246000,26999,False,83,scaffold_4
31,2247001,2281000,33999,False,83,scaffold_4
32,2282001,2462000,179999,False,83,scaffold_4
33,2475001,2637000,161999,False,83,scaffold_4
34,2683001,2809000,125999,False,83,scaffold_4
35,2918001,2956000,37999,False,83,scaffold_4
36,3030001,3067000,36999,False,83,scaffold_4
37,3088001,3130000,41999,False,83,scaffold_4
38,3281001,3320000,38999,False,83,scaffold_4
39,3334001,3761000,426999,False,83,scaffold_4
40,4055001,4105000,49999,False,83,scaffold_4
41,4900001,5057000,156999,False,83,scaffold_4
42,5169001,5243000,73999,False,83,scaffold_4
43,5300001,5438000,137999,False,83,scaffold_4
44,5473001,5506000,32999,False,83,scaffold_4
45,5514001,5632000,117999,False,83,scaffold_4
46,5655001,5784000,128999,False,83,scaffold_4
47,5786001,5818000,31999,False,83,scaffold_4
48,6145001,6193000,47999,False,83,scaffold_4
49,6615001,6617000,1999,False,83,scaffold_4
50,6762001,6817000,54999,False,83,scaffold_4
51,6893001,6924000,30999,False,83,scaffold_4
52,6926001,7021000,94999,False,83,scaffold_4
53,7036001,7124000,87999,False,83,scaffold_4
54,7201001,7273000,71999,False,83,scaffold_4
55,7352001,7379000,26999,False,83,scaffold_4
56,7629001,7665000,35999,False,83,scaffold_4
57,8727001,8770000,42999,False,83,scaffold_4
58,8845001,9699000,853999,False,83,scaffold_4
59,9700001,9845951,145950,True,83,scaffold_4
0,28001,32000,3999,False,83,scaffold_5
1,141001,173000,31999,False,83,scaffold_5
2,318001,421000,102999,False,83,scaffold_5
3,463001,523000,59999,False,83,scaffold_5
4,669001,720000,50999,False,83,scaffold_5
5,933001,947000,13999,False,83,scaffold_5
6,1062001,1073000,10999,False,83,scaffold_5
7,1256001,1283000,26999,False,83,scaffold_5
8,2474001,2496000,21999,False,83,scaffold_5
9,2510001,2515000,4999,False,83,scaffold_5
10,2557001,2878000,320999,False,83,scaffold_5
11,3133001,3269000,135999,False,83,scaffold_5
12,3309001,3513000,203999,False,83,scaffold_5
13,3619001,3657000,37999,False,83,scaffold_5
14,3961001,4101000,139999,False,83,scaffold_5
15,4120001,4222000,101999,False,83,scaffold_5
16,4232001,4321000,88999,False,83,scaffold_5
17,4444001,4554000,109999,False,83,scaffold_5
18,4572001,4926000,353999,False,83,scaffold_5
19,4968001,5026000,57999,False,83,scaffold_5
20,5056001,5097000,40999,False,83,scaffold_5
21,5200001,5275000,74999,False,83,scaffold_5
22,5287001,5310000,22999,False,83,scaffold_5
23,5317001,5346000,28999,False,83,scaffold_5
24,6393001,6666000,272999,False,83,scaffold_5
25,6877001,6908000,30999,False,83,scaffold_5
26,7292001,7326000,33999,False,83,scaffold_5
27,7406001,7441000,34999,False,83,scaffold_5
28,7454001,7488000,33999,False,83,scaffold_5
29,7548001,7610000,61999,False,83,scaffold_5
30,7622001,7656000,33999,False,83,scaffold_5
31,8412001,8469000,56999,False,83,scaffold_5
32,8551001,8617000,65999,False,83,scaffold_5
33,8658001,8688000,29999,False,83,scaffold_5
34,8707001,9364176,657175,True,83,scaffold_5
0,42001,75000,32999,False,83,scaffold_6
1,77001,85000,7999,False,83,scaffold_6
2,86001,116000,29999,False,83,scaffold_6
3,153001,209000,55999,False,83,scaffold_6
4,239001,253000,13999,False,83,scaffold_6
5,267001,318000,50999,False,83,scaffold_6
6,378001,398000,19999,False,83,scaffold_6
7,1157001,1226000,68999,False,83,scaffold_6
8,1229001,1262000,32999,False,83,scaffold_6
9,1284001,1310000,25999,False,83,scaffold_6
10,1431001,1470000,38999,False,83,scaffold_6
11,1478001,1556000,77999,False,83,scaffold_6
12,1557001,1595000,37999,False,83,scaffold_6
13,1867001,1902000,34999,False,83,scaffold_6
14,2026001,2104000,77999,False,83,scaffold_6
15,2128001,2211000,82999,False,83,scaffold_6
16,2236001,2283000,46999,False,83,scaffold_6
17,2307001,2595000,287999,False,83,scaffold_6
18,2596001,2691000,94999,False,83,scaffold_6
19,2711001,2872000,160999,False,83,scaffold_6
20,2934001,3016000,81999,False,83,scaffold_6
21,3097001,3207000,109999,False,83,scaffold_6
22,3222001,3792000,569999,False,83,scaffold_6
23,3882001,3932000,49999,False,83,scaffold_6
24,3966001,4072000,105999,False,83,scaffold_6
25,4073001,4206000,132999,False,83,scaffold_6
26,4843001,4869000,25999,False,83,scaffold_6
27,4894001,4918000,23999,False,83,scaffold_6
28,5598001,5646000,47999,False,83,scaffold_6
29,5930001,5972000,41999,False,83,scaffold_6
30,5988001,6083000,94999,False,83,scaffold_6
31,6124001,6188000,63999,False,83,scaffold_6
32,7186001,7249000,62999,False,83,scaffold_6
33,7257001,7339000,81999,False,83,scaffold_6
34,7390001,7485000,94999,False,83,scaffold_6
35,7557001,8268281,711280,True,83,scaffold_6
0,1,9000,8999,True,83,scaffold_7
1,13001,31000,17999,False,83,scaffold_7
2,240001,250000,9999,False,83,scaffold_7
3,296001,340000,43999,False,83,scaffold_7
4,342001,508000,165999,False,83,scaffold_7
5,622001,736000,113999,False,83,scaffold_7
6,737001,755000,17999,False,83,scaffold_7
7,764001,809000,44999,False,83,scaffold_7
8,810001,843000,32999,False,83,scaffold_7
9,858001,929000,70999,False,83,scaffold_7
10,930001,946000,15999,False,83,scaffold_7
11,968001,981000,12999,False,83,scaffold_7
12,982001,1044000,61999,False,83,scaffold_7
13,1048001,1122000,73999,False,83,scaffold_7
14,1160001,1187000,26999,False,83,scaffold_7
15,1191001,1513000,321999,False,83,scaffold_7
16,1588001,1702000,113999,False,83,scaffold_7
17,1738001,1757000,18999,False,83,scaffold_7
18,1851001,1891000,39999,False,83,scaffold_7
19,2851001,2875000,23999,False,83,scaffold_7
20,2910001,2950000,39999,False,83,scaffold_7
21,3297001,3375000,77999,False,83,scaffold_7
22,3521001,3767000,245999,False,83,scaffold_7
23,4415001,4517000,101999,False,83,scaffold_7
24,4522001,4580000,57999,False,83,scaffold_7
25,4635001,4736000,100999,False,83,scaffold_7
26,4754001,4855000,100999,False,83,scaffold_7
27,4934001,5149000,214999,False,83,scaffold_7
28,5422001,5431000,8999,False,83,scaffold_7
29,5473001,5541000,67999,False,83,scaffold_7
30,6189001,6246000,56999,False,83,scaffold_7
31,6559001,6588000,28999,False,83,scaffold_7
32,6954001,7270000,315999,False,83,scaffold_7
33,7271001,7502216,231215,True,83,scaffold_7
0,1,6000,5999,True,83,scaffold_8
1,31001,85000,53999,False,83,scaffold_8
2,1020001,1042000,21999,False,83,scaffold_8
3,1362001,1422000,59999,False,83,scaffold_8
4,1858001,1930000,71999,False,83,scaffold_8
5,2360001,2379000,18999,False,83,scaffold_8
6,2443001,2587000,143999,False,83,scaffold_8
7,2646001,2844000,197999,False,83,scaffold_8
8,2846001,2890000,43999,False,83,scaffold_8
9,3032001,3526000,493999,False,83,scaffold_8
10,3578001,3612000,33999,False,83,scaffold_8
11,3615001,3947000,331999,False,83,scaffold_8
12,4038001,4108000,69999,False,83,scaffold_8
13,4168001,4260000,91999,False,83,scaffold_8
14,4330001,4372000,41999,False,83,scaffold_8
15,4397001,4433000,35999,False,83,scaffold_8
16,5073001,5137000,63999,False,83,scaffold_8
17,5163001,5241000,77999,False,83,scaffold_8
18,5525001,5596000,70999,False,83,scaffold_8
19,5651001,5703000,51999,False,83,scaffold_8
20,5760001,5774000,13999,False,83,scaffold_8
21,5820001,5845000,24999,False,83,scaffold_8
22,5889001,5909000,19999,False,83,scaffold_8
23,6322001,6334544,12543,True,83,scaffold_8
0,1,22000,21999,True,83,scaffold_9
1,109001,119000,9999,False,83,scaffold_9
2,121001,148000,26999,False,83,scaffold_9
3,236001,243000,6999,False,83,scaffold_9
4,271001,276000,4999,False,83,scaffold_9
5,298001,315000,16999,False,83,scaffold_9
6,319001,411000,91999,False,83,scaffold_9
7,413001,434000,20999,False,83,scaffold_9
8,484001,531000,46999,False,83,scaffold_9
9,532001,534000,1999,False,83,scaffold_9
10,547001,561000,13999,False,83,scaffold_9
11,652001,665000,12999,False,83,scaffold_9
12,671001,696000,24999,False,83,scaffold_9
13,731001,742000,10999,False,83,scaffold_9
14,814001,843000,28999,False,83,scaffold_9
15,872001,986000,113999,False,83,scaffold_9
16,987001,995000,7999,False,83,scaffold_9
17,997001,1085000,87999,False,83,scaffold_9
18,1087001,1177000,89999,False,83,scaffold_9
19,1202001,1217000,14999,False,83,scaffold_9
20,1311001,1383000,71999,False,83,scaffold_9
21,1406001,1421000,14999,False,83,scaffold_9
22,1456001,1466000,9999,False,83,scaffold_9
23,1487001,1500000,12999,False,83,scaffold_9
24,1580001,1592000,11999,False,83,scaffold_9
25,1599001,1625000,25999,False,83,scaffold_9
26,1637001,1692000,54999,False,83,scaffold_9
27,1715001,1807000,91999,False,83,scaffold_9
28,1970001,2056000,85999,False,83,scaffold_9
29,2096001,2132000,35999,False,83,scaffold_9
30,2193001,2243000,49999,False,83,scaffold_9
31,2594001,2664000,69999,False,83,scaffold_9
32,2731001,3381000,649999,False,83,scaffold_9
33,3383001,5110000,1726999,False,83,scaffold_9
34,5112001,5114000,1999,False,83,scaffold_9
35,5116001,5238000,121999,False,83,scaffold_9
36,5239001,5298000,58999,False,83,scaffold_9
37,5300001,6331288,1031287,True,83,scaffold_9
0,1,414000,413999,True,83,scaffold_10
1,415001,482000,66999,False,83,scaffold_10
2,483001,796000,312999,False,83,scaffold_10
3,806001,877000,70999,False,83,scaffold_10
4,888001,1069000,180999,False,83,scaffold_10
5,1087001,1146000,58999,False,83,scaffold_10
6,1370001,1437000,66999,False,83,scaffold_10
7,1439001,1463000,23999,False,83,scaffold_10
8,1637001,1671000,33999,False,83,scaffold_10
9,1800001,1826000,25999,False,83,scaffold_10
10,2086001,2103000,16999,False,83,scaffold_10
11,2136001,2173000,36999,False,83,scaffold_10
12,2268001,2326000,57999,False,83,scaffold_10
13,2346001,2425000,78999,False,83,scaffold_10
14,2599001,2653000,53999,False,83,scaffold_10
15,3153001,3184000,30999,False,83,scaffold_10
16,3465001,3476000,10999,False,83,scaffold_10
17,4049001,4094000,44999,False,83,scaffold_10
18,4154001,4174000,19999,False,83,scaffold_10
19,4335001,4359000,23999,False,83,scaffold_10
20,4443001,4477000,33999,False,83,scaffold_10
21,4478001,4502000,23999,False,83,scaffold_10
22,4503001,4513000,9999,False,83,scaffold_10
23,4515001,4523000,7999,False,83,scaffold_10
24,4526001,4548000,21999,False,83,scaffold_10
25,4565001,4596000,30999,False,83,scaffold_10
26,4681001,4687000,5999,False,83,scaffold_10
27,4733001,4751000,17999,False,83,scaffold_10
28,4752001,4776000,23999,False,83,scaffold_10
29,4798001,4824000,25999,False,83,scaffold_10
30,4827001,4846000,18999,False,83,scaffold_10
31,4848001,4861000,12999,False,83,scaffold_10
32,4865001,4866973,1972,True,83,scaffold_10
0,10001,93000,82999,False,83,scaffold_11
1,132001,167000,34999,False,83,scaffold_11
2,169001,193000,23999,False,83,scaffold_11
3,213001,235000,21999,False,83,scaffold_11
4,239001,252000,12999,False,83,scaffold_11
5,292001,319000,26999,False,83,scaffold_11
6,419001,431000,11999,False,83,scaffold_11
7,648001,656000,7999,False,83,scaffold_11
8,1028001,1034000,5999,False,83,scaffold_11
9,1219001,1243000,23999,False,83,scaffold_11
10,1403001,1409000,5999,False,83,scaffold_11
11,1474001,1477000,2999,False,83,scaffold_11
12,1775001,1802000,26999,False,83,scaffold_11
13,1966001,2006000,39999,False,83,scaffold_11
14,2008001,2024000,15999,False,83,scaffold_11
15,2701001,2891000,189999,False,83,scaffold_11
16,2946001,3019000,72999,False,83,scaffold_11
17,3083001,3176000,92999,False,83,scaffold_11
18,3184001,3384000,199999,False,83,scaffold_11
19,3444001,3478000,33999,False,83,scaffold_11
20,3505001,3972000,466999,False,83,scaffold_11
21,3991001,4161000,169999,False,83,scaffold_11
22,4180001,4710000,529999,False,83,scaffold_11
23,4712001,4766820,54819,True,83,scaffold_11
0,1,857000,856999,True,83,scaffold_12
1,864001,1509000,644999,False,83,scaffold_12
2,1560001,1583000,22999,False,83,scaffold_12
3,1720001,1746000,25999,False,83,scaffold_12
4,1970001,2005000,34999,False,83,scaffold_12
5,2006001,2041000,34999,False,83,scaffold_12
6,2044001,2094000,49999,False,83,scaffold_12
7,2136001,2178000,41999,False,83,scaffold_12
8,2571001,2618000,46999,False,83,scaffold_12
9,2660001,2682000,21999,False,83,scaffold_12
10,2685001,2699000,13999,False,83,scaffold_12
11,2700001,2708000,7999,False,83,scaffold_12
12,2710001,2723000,12999,False,83,scaffold_12
0,1,342000,341999,True,84,scaffold_1
1,482001,498000,15999,False,84,scaffold_1
2,571001,643000,71999,False,84,scaffold_1
3,686001,759000,72999,False,84,scaffold_1
4,1281001,1292000,10999,False,84,scaffold_1
5,1813001,1898000,84999,False,84,scaffold_1
6,1950001,1984000,33999,False,84,scaffold_1
7,2372001,2413000,40999,False,84,scaffold_1
8,2449001,2532000,82999,False,84,scaffold_1
9,2727001,2746000,18999,False,84,scaffold_1
10,3172001,3208000,35999,False,84,scaffold_1
11,3688001,3692000,3999,False,84,scaffold_1
12,3699001,3742000,42999,False,84,scaffold_1
13,3848001,3879000,30999,False,84,scaffold_1
14,3901001,3941000,39999,False,84,scaffold_1
15,3951001,4033000,81999,False,84,scaffold_1
16,4061001,4114000,52999,False,84,scaffold_1
17,4308001,4355000,46999,False,84,scaffold_1
18,4796001,4814000,17999,False,84,scaffold_1
19,4927001,5022000,94999,False,84,scaffold_1
20,5087001,5110000,22999,False,84,scaffold_1
21,5481001,5512000,30999,False,84,scaffold_1
22,5535001,5593000,57999,False,84,scaffold_1
23,5852001,5878000,25999,False,84,scaffold_1
24,5886001,5909000,22999,False,84,scaffold_1
25,6108001,6177000,68999,False,84,scaffold_1
26,6228001,6535000,306999,False,84,scaffold_1
27,6542001,6561000,18999,False,84,scaffold_1
28,6833001,6855000,21999,False,84,scaffold_1
29,7037001,7247000,209999,False,84,scaffold_1
30,7248001,7584000,335999,False,84,scaffold_1
31,7590001,8656000,1065999,False,84,scaffold_1
32,8658001,9584000,925999,False,84,scaffold_1
33,9586001,10366000,779999,False,84,scaffold_1
34,10460001,10640000,179999,False,84,scaffold_1
35,10733001,10763000,29999,False,84,scaffold_1
36,10837001,10858000,20999,False,84,scaffold_1
37,10918001,10941000,22999,False,84,scaffold_1
38,11283001,11964000,680999,False,84,scaffold_1
39,12184001,12205000,20999,False,84,scaffold_1
40,12652001,12723000,70999,False,84,scaffold_1
41,12775001,12888000,112999,False,84,scaffold_1
42,12899001,12947000,47999,False,84,scaffold_1
43,12964001,13002000,37999,False,84,scaffold_1
44,13113001,13212000,98999,False,84,scaffold_1
45,13347001,13431000,83999,False,84,scaffold_1
46,13796001,13845000,48999,False,84,scaffold_1
47,13930001,13932000,1999,False,84,scaffold_1
48,13958001,13994000,35999,False,84,scaffold_1
49,14287001,14308000,20999,False,84,scaffold_1
0,21001,48000,26999,False,84,scaffold_2
1,93001,159000,65999,False,84,scaffold_2
2,165001,177000,11999,False,84,scaffold_2
3,192001,213000,20999,False,84,scaffold_2
4,296001,318000,21999,False,84,scaffold_2
5,332001,374000,41999,False,84,scaffold_2
6,2085001,2101000,15999,False,84,scaffold_2
7,2336001,2389000,52999,False,84,scaffold_2
8,2404001,2424000,19999,False,84,scaffold_2
9,2440001,2553000,112999,False,84,scaffold_2
10,2660001,2689000,28999,False,84,scaffold_2
11,2694001,2746000,51999,False,84,scaffold_2
12,2803001,2855000,51999,False,84,scaffold_2
13,2868001,2904000,35999,False,84,scaffold_2
14,2974001,3021000,46999,False,84,scaffold_2
15,3022001,3062000,39999,False,84,scaffold_2
16,3363001,3389000,25999,False,84,scaffold_2
17,3450001,3466000,15999,False,84,scaffold_2
18,3659001,3691000,31999,False,84,scaffold_2
19,3754001,3784000,29999,False,84,scaffold_2
20,4373001,4409000,35999,False,84,scaffold_2
21,4427001,4457000,29999,False,84,scaffold_2
22,4515001,4656000,140999,False,84,scaffold_2
23,4780001,4790000,9999,False,84,scaffold_2
24,4793001,4810000,16999,False,84,scaffold_2
25,4918001,4955000,36999,False,84,scaffold_2
26,5020001,5104000,83999,False,84,scaffold_2
27,5370001,5393000,22999,False,84,scaffold_2
28,5414001,5530000,115999,False,84,scaffold_2
29,5619001,5759000,139999,False,84,scaffold_2
30,5840001,5887000,46999,False,84,scaffold_2
31,5909001,6023000,113999,False,84,scaffold_2
32,6261001,6330000,68999,False,84,scaffold_2
33,6331001,6350000,18999,False,84,scaffold_2
34,6394001,6449000,54999,False,84,scaffold_2
35,6576001,6629000,52999,False,84,scaffold_2
36,7005001,7039000,33999,False,84,scaffold_2
37,7063001,7097000,33999,False,84,scaffold_2
38,7428001,7473000,44999,False,84,scaffold_2
39,7491001,7518000,26999,False,84,scaffold_2
40,7547001,7561000,13999,False,84,scaffold_2
41,7563001,7700000,136999,False,84,scaffold_2
42,7786001,8230000,443999,False,84,scaffold_2
43,8259001,8313000,53999,False,84,scaffold_2
44,8335001,8345000,9999,False,84,scaffold_2
45,8346001,8454000,107999,False,84,scaffold_2
46,8495001,8564000,68999,False,84,scaffold_2
47,9140001,9174000,33999,False,84,scaffold_2
48,9316001,9364000,47999,False,84,scaffold_2
49,11366001,11386000,19999,False,84,scaffold_2
50,11395001,11410000,14999,False,84,scaffold_2
51,11520001,11786000,265999,False,84,scaffold_2
0,528001,539000,10999,False,84,scaffold_3
1,618001,647000,28999,False,84,scaffold_3
2,795001,903000,107999,False,84,scaffold_3
3,1496001,1510000,13999,False,84,scaffold_3
4,1940001,1979000,38999,False,84,scaffold_3
5,2008001,2108000,99999,False,84,scaffold_3
6,2280001,2341000,60999,False,84,scaffold_3
7,2485001,2532000,46999,False,84,scaffold_3
8,2624001,2683000,58999,False,84,scaffold_3
9,3261001,3277000,15999,False,84,scaffold_3
10,3609001,3643000,33999,False,84,scaffold_3
11,3768001,3821000,52999,False,84,scaffold_3
12,3822001,3892000,69999,False,84,scaffold_3
13,4096001,4403000,306999,False,84,scaffold_3
14,4416001,4521000,104999,False,84,scaffold_3
15,4547001,4558000,10999,False,84,scaffold_3
16,4641001,4689000,47999,False,84,scaffold_3
17,5159001,5209000,49999,False,84,scaffold_3
18,5239001,5270000,30999,False,84,scaffold_3
19,5431001,5449000,17999,False,84,scaffold_3
20,5807001,6020000,212999,False,84,scaffold_3
21,6543001,6578000,34999,False,84,scaffold_3
22,6739001,6808000,68999,False,84,scaffold_3
23,6849001,6962000,112999,False,84,scaffold_3
24,6963001,7096000,132999,False,84,scaffold_3
25,7341001,7362000,20999,False,84,scaffold_3
26,7370001,7395000,24999,False,84,scaffold_3
27,7449001,7458000,8999,False,84,scaffold_3
28,7483001,7556000,72999,False,84,scaffold_3
29,7678001,7886000,207999,False,84,scaffold_3
30,8034001,8107000,72999,False,84,scaffold_3
31,8183001,8253000,69999,False,84,scaffold_3
32,8427001,8447000,19999,False,84,scaffold_3
33,8462001,8527000,64999,False,84,scaffold_3
34,8575001,8594000,18999,False,84,scaffold_3
35,9020001,9079000,58999,False,84,scaffold_3
36,9968001,9995000,26999,False,84,scaffold_3
37,10550001,10571000,20999,False,84,scaffold_3
38,10587001,11182071,595070,True,84,scaffold_3
0,1,7000,6999,True,84,scaffold_4
1,11001,13000,1999,False,84,scaffold_4
2,17001,32000,14999,False,84,scaffold_4
3,48001,88000,39999,False,84,scaffold_4
4,110001,115000,4999,False,84,scaffold_4
5,120001,131000,10999,False,84,scaffold_4
6,132001,146000,13999,False,84,scaffold_4
7,147001,151000,3999,False,84,scaffold_4
8,155001,215000,59999,False,84,scaffold_4
9,217001,241000,23999,False,84,scaffold_4
10,242001,267000,24999,False,84,scaffold_4
11,283001,353000,69999,False,84,scaffold_4
12,355001,374000,18999,False,84,scaffold_4
13,375001,380000,4999,False,84,scaffold_4
14,389001,410000,20999,False,84,scaffold_4
15,412001,425000,12999,False,84,scaffold_4
16,426001,513000,86999,False,84,scaffold_4
17,539001,592000,52999,False,84,scaffold_4
18,593001,606000,12999,False,84,scaffold_4
19,608001,691000,82999,False,84,scaffold_4
20,1043001,1047000,3999,False,84,scaffold_4
21,1118001,1136000,17999,False,84,scaffold_4
22,1138001,1208000,69999,False,84,scaffold_4
23,1209001,1226000,16999,False,84,scaffold_4
24,1229001,1253000,23999,False,84,scaffold_4
25,1269001,1279000,9999,False,84,scaffold_4
26,1283001,1333000,49999,False,84,scaffold_4
27,1334001,1599000,264999,False,84,scaffold_4
28,1613001,2134000,520999,False,84,scaffold_4
29,2138001,2199000,60999,False,84,scaffold_4
30,2200001,2206000,5999,False,84,scaffold_4
31,2207001,2218000,10999,False,84,scaffold_4
32,2219001,2461000,241999,False,84,scaffold_4
33,2476001,2635000,158999,False,84,scaffold_4
34,2662001,2675000,12999,False,84,scaffold_4
35,2676001,2720000,43999,False,84,scaffold_4
36,2730001,2795000,64999,False,84,scaffold_4
37,2926001,2956000,29999,False,84,scaffold_4
38,3087001,3127000,39999,False,84,scaffold_4
39,3205001,3268000,62999,False,84,scaffold_4
40,3298001,3315000,16999,False,84,scaffold_4
41,3334001,3633000,298999,False,84,scaffold_4
42,3645001,3766000,120999,False,84,scaffold_4
43,4055001,4105000,49999,False,84,scaffold_4
44,4901001,5055000,153999,False,84,scaffold_4
45,5170001,5224000,53999,False,84,scaffold_4
46,5301001,5402000,100999,False,84,scaffold_4
47,5476001,5506000,29999,False,84,scaffold_4
48,5514001,5784000,269999,False,84,scaffold_4
49,5785001,5815000,29999,False,84,scaffold_4
50,6068001,6108000,39999,False,84,scaffold_4
51,6145001,6193000,47999,False,84,scaffold_4
52,6769001,6817000,47999,False,84,scaffold_4
53,6873001,6924000,50999,False,84,scaffold_4
54,6926001,6941000,14999,False,84,scaffold_4
55,6969001,7003000,33999,False,84,scaffold_4
56,7036001,7124000,87999,False,84,scaffold_4
57,7193001,7283000,89999,False,84,scaffold_4
58,7642001,7662000,19999,False,84,scaffold_4
59,7860001,7875000,14999,False,84,scaffold_4
60,8064001,8084000,19999,False,84,scaffold_4
61,8844001,9699000,854999,False,84,scaffold_4
62,9700001,9845951,145950,True,84,scaffold_4
0,28001,32000,3999,False,84,scaffold_5
1,318001,428000,109999,False,84,scaffold_5
2,444001,524000,79999,False,84,scaffold_5
3,669001,699000,29999,False,84,scaffold_5
4,933001,947000,13999,False,84,scaffold_5
5,1658001,1661000,2999,False,84,scaffold_5
6,2476001,2492000,15999,False,84,scaffold_5
7,2560001,2874000,313999,False,84,scaffold_5
8,3121001,3249000,127999,False,84,scaffold_5
9,3277001,3522000,244999,False,84,scaffold_5
10,3536001,3545000,8999,False,84,scaffold_5
11,3617001,3658000,40999,False,84,scaffold_5
12,3961001,4101000,139999,False,84,scaffold_5
13,4119001,4321000,201999,False,84,scaffold_5
14,4445001,4523000,77999,False,84,scaffold_5
15,4596001,4683000,86999,False,84,scaffold_5
16,4687001,4751000,63999,False,84,scaffold_5
17,4752001,4925000,172999,False,84,scaffold_5
18,5055001,5083000,27999,False,84,scaffold_5
19,5255001,5312000,56999,False,84,scaffold_5
20,5314001,5346000,31999,False,84,scaffold_5
21,5713001,5738000,24999,False,84,scaffold_5
22,6408001,6420000,11999,False,84,scaffold_5
23,6455001,6691000,235999,False,84,scaffold_5
24,6886001,6907000,20999,False,84,scaffold_5
25,7295001,7328000,32999,False,84,scaffold_5
26,7372001,7387000,14999,False,84,scaffold_5
27,7407001,7445000,37999,False,84,scaffold_5
28,7454001,7512000,57999,False,84,scaffold_5
29,7556001,7619000,62999,False,84,scaffold_5
30,7620001,7658000,37999,False,84,scaffold_5
31,7711001,7746000,34999,False,84,scaffold_5
32,8435001,8468000,32999,False,84,scaffold_5
33,8551001,8616000,64999,False,84,scaffold_5
34,8659001,8687000,27999,False,84,scaffold_5
35,8713001,9364176,651175,True,84,scaffold_5
0,62001,74000,11999,False,84,scaffold_6
1,76001,85000,8999,False,84,scaffold_6
2,86001,114000,27999,False,84,scaffold_6
3,164001,209000,44999,False,84,scaffold_6
4,239001,329000,89999,False,84,scaffold_6
5,782001,801000,18999,False,84,scaffold_6
6,1154001,1226000,71999,False,84,scaffold_6
7,1229001,1267000,37999,False,84,scaffold_6
8,1281001,1311000,29999,False,84,scaffold_6
9,1435001,1465000,29999,False,84,scaffold_6
10,1478001,1550000,71999,False,84,scaffold_6
11,1559001,1596000,36999,False,84,scaffold_6
12,1867001,1906000,38999,False,84,scaffold_6
13,2030001,2103000,72999,False,84,scaffold_6
14,2128001,2195000,66999,False,84,scaffold_6
15,2236001,2269000,32999,False,84,scaffold_6
16,2334001,2595000,260999,False,84,scaffold_6
17,2596001,2872000,275999,False,84,scaffold_6
18,2928001,3024000,95999,False,84,scaffold_6
19,3112001,3346000,233999,False,84,scaffold_6
20,3404001,3806000,401999,False,84,scaffold_6
21,3898001,3917000,18999,False,84,scaffold_6
22,3967001,4072000,104999,False,84,scaffold_6
23,4073001,4196000,122999,False,84,scaffold_6
24,5705001,5740000,34999,False,84,scaffold_6
25,5901001,5972000,70999,False,84,scaffold_6
26,6004001,6083000,78999,False,84,scaffold_6
27,6124001,6197000,72999,False,84,scaffold_6
28,6776001,6805000,28999,False,84,scaffold_6
29,7183001,7248000,64999,False,84,scaffold_6
30,7256001,7339000,82999,False,84,scaffold_6
31,7388001,7484000,95999,False,84,scaffold_6
32,7560001,8268281,708280,True,84,scaffold_6
0,1,6000,5999,True,84,scaffold_7
1,13001,31000,17999,False,84,scaffold_7
2,290001,340000,49999,False,84,scaffold_7
3,342001,508000,165999,False,84,scaffold_7
4,555001,563000,7999,False,84,scaffold_7
5,571001,591000,19999,False,84,scaffold_7
6,623001,641000,17999,False,84,scaffold_7
7,647001,736000,88999,False,84,scaffold_7
8,741001,753000,11999,False,84,scaffold_7
9,764001,839000,74999,False,84,scaffold_7
10,859001,864000,4999,False,84,scaffold_7
11,865001,938000,72999,False,84,scaffold_7
12,968001,980000,11999,False,84,scaffold_7
13,982001,1044000,61999,False,84,scaffold_7
14,1048001,1136000,87999,False,84,scaffold_7
15,1190001,1512000,321999,False,84,scaffold_7
16,1588001,1690000,101999,False,84,scaffold_7
17,1739001,1782000,42999,False,84,scaffold_7
18,1850001,1891000,40999,False,84,scaffold_7
19,2851001,2875000,23999,False,84,scaffold_7
20,2932001,2953000,20999,False,84,scaffold_7
21,3297001,3370000,72999,False,84,scaffold_7
22,3521001,3550000,28999,False,84,scaffold_7
23,3585001,3766000,180999,False,84,scaffold_7
24,4028001,4053000,24999,False,84,scaffold_7
25,4415001,4580000,164999,False,84,scaffold_7
26,4632001,4821000,188999,False,84,scaffold_7
27,4979001,5167000,187999,False,84,scaffold_7
28,5482001,5536000,53999,False,84,scaffold_7
29,5609001,5626000,16999,False,84,scaffold_7
30,6577001,6589000,11999,False,84,scaffold_7
31,6954001,7270000,315999,False,84,scaffold_7
32,7271001,7502216,231215,True,84,scaffold_7
0,66001,87000,20999,False,84,scaffold_8
1,1024001,1034000,9999,False,84,scaffold_8
2,2362001,2378000,15999,False,84,scaffold_8
3,2384001,2552000,167999,False,84,scaffold_8
4,2646001,2683000,36999,False,84,scaffold_8
5,2740001,2844000,103999,False,84,scaffold_8
6,3060001,3125000,64999,False,84,scaffold_8
7,3126001,3525000,398999,False,84,scaffold_8
8,3578001,3612000,33999,False,84,scaffold_8
9,3615001,3939000,323999,False,84,scaffold_8
10,4038001,4108000,69999,False,84,scaffold_8
11,4398001,4434000,35999,False,84,scaffold_8
12,5086001,5137000,50999,False,84,scaffold_8
13,5168001,5241000,72999,False,84,scaffold_8
14,5527001,5596000,68999,False,84,scaffold_8
15,5651001,5695000,43999,False,84,scaffold_8
16,5761001,5774000,12999,False,84,scaffold_8
17,5775001,5803000,27999,False,84,scaffold_8
18,6320001,6334544,14543,True,84,scaffold_8
0,109001,118000,8999,False,84,scaffold_9
1,121001,141000,19999,False,84,scaffold_9
2,271001,276000,4999,False,84,scaffold_9
3,319001,411000,91999,False,84,scaffold_9
4,413001,440000,26999,False,84,scaffold_9
5,477001,531000,53999,False,84,scaffold_9
6,547001,563000,15999,False,84,scaffold_9
7,652001,665000,12999,False,84,scaffold_9
8,671001,696000,24999,False,84,scaffold_9
9,731001,741000,9999,False,84,scaffold_9
10,813001,843000,29999,False,84,scaffold_9
11,872001,995000,122999,False,84,scaffold_9
12,997001,1000000,2999,False,84,scaffold_9
13,1001001,1007000,5999,False,84,scaffold_9
14,1009001,1161000,151999,False,84,scaffold_9
15,1245001,1257000,11999,False,84,scaffold_9
16,1311001,1382000,70999,False,84,scaffold_9
17,1428001,1440000,11999,False,84,scaffold_9
18,1487001,1498000,10999,False,84,scaffold_9
19,1656001,1690000,33999,False,84,scaffold_9
20,1749001,1811000,61999,False,84,scaffold_9
21,1922001,1940000,17999,False,84,scaffold_9
22,1987001,2037000,49999,False,84,scaffold_9
23,2038001,2054000,15999,False,84,scaffold_9
24,2105001,2133000,27999,False,84,scaffold_9
25,2147001,2168000,20999,False,84,scaffold_9
26,2597001,2617000,19999,False,84,scaffold_9
27,2731001,3381000,649999,False,84,scaffold_9
28,3383001,5107000,1723999,False,84,scaffold_9
29,5112001,5115000,2999,False,84,scaffold_9
30,5116001,5238000,121999,False,84,scaffold_9
31,5239001,5298000,58999,False,84,scaffold_9
32,5299001,5490000,190999,False,84,scaffold_9
33,5493001,6331288,838287,True,84,scaffold_9
0,1,233000,232999,True,84,scaffold_10
1,258001,414000,155999,False,84,scaffold_10
2,415001,482000,66999,False,84,scaffold_10
3,483001,582000,98999,False,84,scaffold_10
4,597001,877000,279999,False,84,scaffold_10
5,888001,979000,90999,False,84,scaffold_10
6,1073001,1151000,77999,False,84,scaffold_10
7,1373001,1435000,61999,False,84,scaffold_10
8,1603001,1658000,54999,False,84,scaffold_10
9,1803001,1817000,13999,False,84,scaffold_10
10,2090001,2111000,20999,False,84,scaffold_10
11,2130001,2169000,38999,False,84,scaffold_10
12,2268001,2326000,57999,False,84,scaffold_10
13,2346001,2471000,124999,False,84,scaffold_10
14,2600001,2660000,59999,False,84,scaffold_10
15,3116001,3131000,14999,False,84,scaffold_10
16,3162001,3177000,14999,False,84,scaffold_10
17,3575001,3582000,6999,False,84,scaffold_10
18,4052001,4091000,38999,False,84,scaffold_10
19,4154001,4174000,19999,False,84,scaffold_10
20,4336001,4358000,21999,False,84,scaffold_10
21,4443001,4462000,18999,False,84,scaffold_10
22,4467001,4476000,8999,False,84,scaffold_10
23,4515001,4523000,7999,False,84,scaffold_10
24,4526001,4548000,21999,False,84,scaffold_10
25,4554001,4562000,7999,False,84,scaffold_10
26,4565001,4596000,30999,False,84,scaffold_10
27,4734001,4766000,31999,False,84,scaffold_10
28,4798001,4826000,27999,False,84,scaffold_10
29,4828001,4843000,14999,False,84,scaffold_10
30,4848001,4861000,12999,False,84,scaffold_10
31,4865001,4866973,1972,True,84,scaffold_10
0,10001,98000,87999,False,84,scaffold_11
1,149001,167000,17999,False,84,scaffold_11
2,169001,212000,42999,False,84,scaffold_11
3,213001,236000,22999,False,84,scaffold_11
4,240001,248000,7999,False,84,scaffold_11
5,291001,320000,28999,False,84,scaffold_11
6,419001,431000,11999,False,84,scaffold_11
7,647001,656000,8999,False,84,scaffold_11
8,789001,795000,5999,False,84,scaffold_11
9,1025001,1034000,8999,False,84,scaffold_11
10,1474001,1477000,2999,False,84,scaffold_11
11,1858001,1870000,11999,False,84,scaffold_11
12,1872001,1894000,21999,False,84,scaffold_11
13,1995001,2007000,11999,False,84,scaffold_11
14,2008001,2050000,41999,False,84,scaffold_11
15,2699001,2877000,177999,False,84,scaffold_11
16,2957001,3011000,53999,False,84,scaffold_11
17,3090001,3383000,292999,False,84,scaffold_11
18,3429001,3479000,49999,False,84,scaffold_11
19,3521001,3934000,412999,False,84,scaffold_11
20,3940001,3971000,30999,False,84,scaffold_11
21,3990001,4159000,168999,False,84,scaffold_11
22,4189001,4710000,520999,False,84,scaffold_11
23,4713001,4766820,53819,True,84,scaffold_11
0,1,856000,855999,True,84,scaffold_12
1,865001,1484000,618999,False,84,scaffold_12
2,1717001,1747000,29999,False,84,scaffold_12
3,1937001,1952000,14999,False,84,scaffold_12
4,1977001,2005000,27999,False,84,scaffold_12
5,2043001,2102000,58999,False,84,scaffold_12
6,2129001,2190000,60999,False,84,scaffold_12
7,2571001,2618000,46999,False,84,scaffold_12
0,1,342000,341999,True,85,scaffold_1
1,408001,440000,31999,False,85,scaffold_1
2,480001,498000,17999,False,85,scaffold_1
3,571001,643000,71999,False,85,scaffold_1
4,686001,757000,70999,False,85,scaffold_1
5,1619001,1660000,40999,False,85,scaffold_1
6,1814001,1899000,84999,False,85,scaffold_1
7,1917001,1964000,46999,False,85,scaffold_1
8,1965001,1984000,18999,False,85,scaffold_1
9,1988001,2001000,12999,False,85,scaffold_1
10,2355001,2422000,66999,False,85,scaffold_1
11,2449001,2527000,77999,False,85,scaffold_1
12,2729001,2746000,16999,False,85,scaffold_1
13,2897001,2925000,27999,False,85,scaffold_1
14,3011001,3014000,2999,False,85,scaffold_1
15,3174001,3212000,37999,False,85,scaffold_1
16,3456001,3499000,42999,False,85,scaffold_1
17,3578001,3618000,39999,False,85,scaffold_1
18,3712001,3750000,37999,False,85,scaffold_1
19,3768001,3879000,110999,False,85,scaffold_1
20,3901001,3941000,39999,False,85,scaffold_1
21,3960001,4032000,71999,False,85,scaffold_1
22,4062001,4118000,55999,False,85,scaffold_1
23,4304001,4356000,51999,False,85,scaffold_1
24,4709001,4744000,34999,False,85,scaffold_1
25,4796001,4813000,16999,False,85,scaffold_1
26,4927001,5025000,97999,False,85,scaffold_1
27,5041001,5060000,18999,False,85,scaffold_1
28,5087001,5115000,27999,False,85,scaffold_1
29,5166001,5181000,14999,False,85,scaffold_1
30,5441001,5451000,9999,False,85,scaffold_1
31,5481001,5521000,39999,False,85,scaffold_1
32,5535001,5587000,51999,False,85,scaffold_1
33,5851001,5911000,59999,False,85,scaffold_1
34,6108001,6381000,272999,False,85,scaffold_1
35,6383001,6531000,147999,False,85,scaffold_1
36,6542001,6563000,20999,False,85,scaffold_1
37,6835001,6852000,16999,False,85,scaffold_1
38,7038001,7247000,208999,False,85,scaffold_1
39,7248001,7588000,339999,False,85,scaffold_1
40,7590001,8656000,1065999,False,85,scaffold_1
41,8658001,9584000,925999,False,85,scaffold_1
42,9586001,10363000,776999,False,85,scaffold_1
43,10457001,10638000,180999,False,85,scaffold_1
44,10715001,10762000,46999,False,85,scaffold_1
45,10808001,10811000,2999,False,85,scaffold_1
46,10835001,10857000,21999,False,85,scaffold_1
47,10920001,10961000,40999,False,85,scaffold_1
48,11014001,11031000,16999,False,85,scaffold_1
49,11274001,11951000,676999,False,85,scaffold_1
50,12184001,12211000,26999,False,85,scaffold_1
51,12638001,12888000,249999,False,85,scaffold_1
52,12901001,13002000,100999,False,85,scaffold_1
53,13100001,13212000,111999,False,85,scaffold_1
54,13347001,13433000,85999,False,85,scaffold_1
55,13517001,13537000,19999,False,85,scaffold_1
56,13555001,13581000,25999,False,85,scaffold_1
57,13781001,13845000,63999,False,85,scaffold_1
58,13914001,13944000,29999,False,85,scaffold_1
59,13968001,14005000,36999,False,85,scaffold_1
60,14285001,14307000,21999,False,85,scaffold_1
61,14647001,14663000,15999,False,85,scaffold_1
0,1,48000,47999,True,85,scaffold_2
1,93001,159000,65999,False,85,scaffold_2
2,168001,177000,8999,False,85,scaffold_2
3,255001,270000,14999,False,85,scaffold_2
4,297001,318000,20999,False,85,scaffold_2
5,332001,374000,41999,False,85,scaffold_2
6,1316001,1334000,17999,False,85,scaffold_2
7,1524001,1547000,22999,False,85,scaffold_2
8,2085001,2101000,15999,False,85,scaffold_2
9,2315001,2335000,19999,False,85,scaffold_2
10,2336001,2553000,216999,False,85,scaffold_2
11,2627001,2639000,11999,False,85,scaffold_2
12,2645001,2689000,43999,False,85,scaffold_2
13,2693001,2746000,52999,False,85,scaffold_2
14,2766001,2788000,21999,False,85,scaffold_2
15,2878001,2902000,23999,False,85,scaffold_2
16,2974001,3021000,46999,False,85,scaffold_2
17,3331001,3343000,11999,False,85,scaffold_2
18,3363001,3389000,25999,False,85,scaffold_2
19,3449001,3487000,37999,False,85,scaffold_2
20,3743001,3790000,46999,False,85,scaffold_2
21,4243001,4277000,33999,False,85,scaffold_2
22,4380001,4409000,28999,False,85,scaffold_2
23,4427001,4459000,31999,False,85,scaffold_2
24,4470001,4670000,199999,False,85,scaffold_2
25,4793001,4809000,15999,False,85,scaffold_2
26,4909001,4962000,52999,False,85,scaffold_2
27,5021001,5104000,82999,False,85,scaffold_2
28,5286001,5305000,18999,False,85,scaffold_2
29,5358001,5481000,122999,False,85,scaffold_2
30,5490001,5515000,24999,False,85,scaffold_2
31,5622001,5761000,138999,False,85,scaffold_2
32,5839001,5888000,48999,False,85,scaffold_2
33,5912001,6058000,145999,False,85,scaffold_2
34,6110001,6138000,27999,False,85,scaffold_2
35,6244001,6351000,106999,False,85,scaffold_2
36,6396001,6449000,52999,False,85,scaffold_2
37,6575001,6628000,52999,False,85,scaffold_2
38,6810001,6883000,72999,False,85,scaffold_2
39,7018001,7039000,20999,False,85,scaffold_2
40,7049001,7097000,47999,False,85,scaffold_2
41,7137001,7232000,94999,False,85,scaffold_2
42,7349001,7473000,123999,False,85,scaffold_2
43,7491001,7518000,26999,False,85,scaffold_2
44,7549001,7562000,12999,False,85,scaffold_2
45,7563001,7708000,144999,False,85,scaffold_2
46,7779001,8236000,456999,False,85,scaffold_2
47,8260001,8315000,54999,False,85,scaffold_2
48,8335001,8345000,9999,False,85,scaffold_2
49,8346001,8455000,108999,False,85,scaffold_2
50,8495001,8563000,67999,False,85,scaffold_2
51,9010001,9068000,57999,False,85,scaffold_2
52,9140001,9174000,33999,False,85,scaffold_2
53,9327001,9382000,54999,False,85,scaffold_2
54,9601001,9631000,29999,False,85,scaffold_2
55,11395001,11426000,30999,False,85,scaffold_2
56,11520001,11786000,265999,False,85,scaffold_2
57,11801001,11802476,1475,True,85,scaffold_2
0,352001,362000,9999,False,85,scaffold_3
1,521001,526000,4999,False,85,scaffold_3
2,528001,539000,10999,False,85,scaffold_3
3,618001,646000,27999,False,85,scaffold_3
4,795001,900000,104999,False,85,scaffold_3
5,1066001,1084000,17999,False,85,scaffold_3
6,1156001,1162000,5999,False,85,scaffold_3
7,1936001,1980000,43999,False,85,scaffold_3
8,1995001,2108000,112999,False,85,scaffold_3
9,2109001,2116000,6999,False,85,scaffold_3
10,2263001,2341000,77999,False,85,scaffold_3
11,2434001,2471000,36999,False,85,scaffold_3
12,2487001,2533000,45999,False,85,scaffold_3
13,2650001,2667000,16999,False,85,scaffold_3
14,2712001,2737000,24999,False,85,scaffold_3
15,3066001,3078000,11999,False,85,scaffold_3
16,3768001,3892000,123999,False,85,scaffold_3
17,3908001,3921000,12999,False,85,scaffold_3
18,4007001,4031000,23999,False,85,scaffold_3
19,4108001,4403000,294999,False,85,scaffold_3
20,4415001,4521000,105999,False,85,scaffold_3
21,4539001,4558000,18999,False,85,scaffold_3
22,4637001,4690000,52999,False,85,scaffold_3
23,5065001,5088000,22999,False,85,scaffold_3
24,5807001,5946000,138999,False,85,scaffold_3
25,5974001,6019000,44999,False,85,scaffold_3
26,6672001,6698000,25999,False,85,scaffold_3
27,6743001,6780000,36999,False,85,scaffold_3
28,6910001,6962000,51999,False,85,scaffold_3
29,6963001,7098000,134999,False,85,scaffold_3
30,7255001,7301000,45999,False,85,scaffold_3
31,7335001,7398000,62999,False,85,scaffold_3
32,7449001,7460000,10999,False,85,scaffold_3
33,7483001,7556000,72999,False,85,scaffold_3
34,7602001,7621000,18999,False,85,scaffold_3
35,7679001,7883000,203999,False,85,scaffold_3
36,8028001,8116000,87999,False,85,scaffold_3
37,8120001,8156000,35999,False,85,scaffold_3
38,8175001,8253000,77999,False,85,scaffold_3
39,8398001,8535000,136999,False,85,scaffold_3
40,8575001,8593000,17999,False,85,scaffold_3
41,9006001,9084000,77999,False,85,scaffold_3
42,9968001,9995000,26999,False,85,scaffold_3
43,10462001,10484000,21999,False,85,scaffold_3
44,10587001,11170000,582999,False,85,scaffold_3
45,11178001,11182071,4070,True,85,scaffold_3
0,1,7000,6999,True,85,scaffold_4
1,10001,13000,2999,False,85,scaffold_4
2,14001,16000,1999,False,85,scaffold_4
3,17001,33000,15999,False,85,scaffold_4
4,48001,87000,38999,False,85,scaffold_4
5,120001,151000,30999,False,85,scaffold_4
6,155001,215000,59999,False,85,scaffold_4
7,217001,266000,48999,False,85,scaffold_4
8,283001,344000,60999,False,85,scaffold_4
9,345001,353000,7999,False,85,scaffold_4
10,355001,374000,18999,False,85,scaffold_4
11,375001,380000,4999,False,85,scaffold_4
12,382001,410000,27999,False,85,scaffold_4
13,411001,425000,13999,False,85,scaffold_4
14,429001,505000,75999,False,85,scaffold_4
15,507001,606000,98999,False,85,scaffold_4
16,608001,691000,82999,False,85,scaffold_4
17,701001,727000,25999,False,85,scaffold_4
18,1053001,1081000,27999,False,85,scaffold_4
19,1087001,1110000,22999,False,85,scaffold_4
20,1113001,1136000,22999,False,85,scaffold_4
21,1137001,1226000,88999,False,85,scaffold_4
22,1229001,1253000,23999,False,85,scaffold_4
23,1254001,1279000,24999,False,85,scaffold_4
24,1280001,1598000,317999,False,85,scaffold_4
25,1613001,1957000,343999,False,85,scaffold_4
26,1958001,2206000,247999,False,85,scaffold_4
27,2207001,2268000,60999,False,85,scaffold_4
28,2269001,2461000,191999,False,85,scaffold_4
29,2480001,2635000,154999,False,85,scaffold_4
30,2735001,2795000,59999,False,85,scaffold_4
31,3028001,3128000,99999,False,85,scaffold_4
32,3335001,3777000,441999,False,85,scaffold_4
33,4057001,4101000,43999,False,85,scaffold_4
34,4900001,5063000,162999,False,85,scaffold_4
35,5170001,5244000,73999,False,85,scaffold_4
36,5343001,5356000,12999,False,85,scaffold_4
37,5476001,5506000,29999,False,85,scaffold_4
38,5515001,5635000,119999,False,85,scaffold_4
39,5655001,5784000,128999,False,85,scaffold_4
40,5786001,5827000,40999,False,85,scaffold_4
41,6131001,6236000,104999,False,85,scaffold_4
42,6285001,6295000,9999,False,85,scaffold_4
43,6615001,6617000,1999,False,85,scaffold_4
44,6705001,6817000,111999,False,85,scaffold_4
45,6894001,6924000,29999,False,85,scaffold_4
46,6950001,6995000,44999,False,85,scaffold_4
47,7036001,7124000,87999,False,85,scaffold_4
48,7153001,7173000,19999,False,85,scaffold_4
49,7208001,7323000,114999,False,85,scaffold_4
50,7629001,7665000,35999,False,85,scaffold_4
51,7985001,8015000,29999,False,85,scaffold_4
52,8059001,8077000,17999,False,85,scaffold_4
53,8844001,9699000,854999,False,85,scaffold_4
54,9700001,9845951,145950,True,85,scaffold_4
0,141001,173000,31999,False,85,scaffold_5
1,318001,326000,7999,False,85,scaffold_5
2,327001,430000,102999,False,85,scaffold_5
3,445001,524000,78999,False,85,scaffold_5
4,669001,721000,51999,False,85,scaffold_5
5,933001,947000,13999,False,85,scaffold_5
6,1364001,1378000,13999,False,85,scaffold_5
7,1544001,1557000,12999,False,85,scaffold_5
8,2257001,2303000,45999,False,85,scaffold_5
9,2550001,2877000,326999,False,85,scaffold_5
10,3130001,3554000,423999,False,85,scaffold_5
11,3616001,3659000,42999,False,85,scaffold_5
12,3961001,4101000,139999,False,85,scaffold_5
13,4118001,4376000,257999,False,85,scaffold_5
14,4445001,4527000,81999,False,85,scaffold_5
15,4595001,4921000,325999,False,85,scaffold_5
16,4973001,4990000,16999,False,85,scaffold_5
17,5221001,5275000,53999,False,85,scaffold_5
18,5278001,5312000,33999,False,85,scaffold_5
19,5314001,5344000,29999,False,85,scaffold_5
20,5510001,5527000,16999,False,85,scaffold_5
21,5719001,5738000,18999,False,85,scaffold_5
22,6392001,6438000,45999,False,85,scaffold_5
23,6451001,6721000,269999,False,85,scaffold_5
24,6763001,6793000,29999,False,85,scaffold_5
25,6881001,6907000,25999,False,85,scaffold_5
26,6915001,6966000,50999,False,85,scaffold_5
27,7295001,7327000,31999,False,85,scaffold_5
28,7372001,7386000,13999,False,85,scaffold_5
29,7412001,7442000,29999,False,85,scaffold_5
30,7454001,7484000,29999,False,85,scaffold_5
31,7560001,7619000,58999,False,85,scaffold_5
32,7620001,7662000,41999,False,85,scaffold_5
33,7711001,7744000,32999,False,85,scaffold_5
34,8258001,8280000,21999,False,85,scaffold_5
35,8413001,8469000,55999,False,85,scaffold_5
36,8553001,8617000,63999,False,85,scaffold_5
37,8648001,8685000,36999,False,85,scaffold_5
38,8705001,9363000,657999,False,85,scaffold_5
39,9364001,9364176,175,True,85,scaffold_5
0,61001,74000,12999,False,85,scaffold_6
1,86001,114000,27999,False,85,scaffold_6
2,148001,210000,61999,False,85,scaffold_6
3,239001,356000,116999,False,85,scaffold_6
4,785001,800000,14999,False,85,scaffold_6
5,1146001,1226000,79999,False,85,scaffold_6
6,1228001,1266000,37999,False,85,scaffold_6
7,1285001,1314000,28999,False,85,scaffold_6
8,1429001,1547000,117999,False,85,scaffold_6
9,1558001,1595000,36999,False,85,scaffold_6
10,1824001,1906000,81999,False,85,scaffold_6
11,2008001,2019000,10999,False,85,scaffold_6
12,2023001,2106000,82999,False,85,scaffold_6
13,2126001,2211000,84999,False,85,scaffold_6
14,2247001,2263000,15999,False,85,scaffold_6
15,2334001,2872000,537999,False,85,scaffold_6
16,2933001,3017000,83999,False,85,scaffold_6
17,3113001,3209000,95999,False,85,scaffold_6
18,3223001,3789000,565999,False,85,scaffold_6
19,3899001,3913000,13999,False,85,scaffold_6
20,3973001,4196000,222999,False,85,scaffold_6
21,4833001,4869000,35999,False,85,scaffold_6
22,5559001,5647000,87999,False,85,scaffold_6
23,5938001,5972000,33999,False,85,scaffold_6
24,6004001,6092000,87999,False,85,scaffold_6
25,6124001,6196000,71999,False,85,scaffold_6
26,6783001,6804000,20999,False,85,scaffold_6
27,7184001,7337000,152999,False,85,scaffold_6
28,7390001,7476000,85999,False,85,scaffold_6
29,7545001,8268281,723280,True,85,scaffold_6
0,1,8000,7999,True,85,scaffold_7
1,286001,340000,53999,False,85,scaffold_7
2,342001,508000,165999,False,85,scaffold_7
3,552001,561000,8999,False,85,scaffold_7
4,621001,676000,54999,False,85,scaffold_7
5,706001,753000,46999,False,85,scaffold_7
6,764001,828000,63999,False,85,scaffold_7
7,859001,864000,4999,False,85,scaffold_7
8,865001,948000,82999,False,85,scaffold_7
9,949001,966000,16999,False,85,scaffold_7
10,968001,1044000,75999,False,85,scaffold_7
11,1048001,1148000,99999,False,85,scaffold_7
12,1191001,1459000,267999,False,85,scaffold_7
13,1461001,1512000,50999,False,85,scaffold_7
14,1588001,1692000,103999,False,85,scaffold_7
15,1727001,1778000,50999,False,85,scaffold_7
16,1850001,1902000,51999,False,85,scaffold_7
17,2834001,2871000,36999,False,85,scaffold_7
18,3292001,3370000,77999,False,85,scaffold_7
19,3521001,3766000,244999,False,85,scaffold_7
20,4026001,4046000,19999,False,85,scaffold_7
21,4324001,4362000,37999,False,85,scaffold_7
22,4415001,4536000,120999,False,85,scaffold_7
23,4550001,4596000,45999,False,85,scaffold_7
24,4658001,4820000,161999,False,85,scaffold_7
25,4953001,5149000,195999,False,85,scaffold_7
26,5420001,5434000,13999,False,85,scaffold_7
27,5470001,5536000,65999,False,85,scaffold_7
28,6328001,6358000,29999,False,85,scaffold_7
29,6644001,6675000,30999,False,85,scaffold_7
30,6946001,7270000,323999,False,85,scaffold_7
31,7271001,7502216,231215,True,85,scaffold_7
0,1,7000,6999,True,85,scaffold_8
1,31001,85000,53999,False,85,scaffold_8
2,817001,819000,1999,False,85,scaffold_8
3,1022001,1047000,24999,False,85,scaffold_8
4,1863001,1935000,71999,False,85,scaffold_8
5,2096001,2152000,55999,False,85,scaffold_8
6,2360001,2585000,224999,False,85,scaffold_8
7,2650001,2683000,32999,False,85,scaffold_8
8,2684001,2758000,73999,False,85,scaffold_8
9,2798001,2844000,45999,False,85,scaffold_8
10,3033001,3125000,91999,False,85,scaffold_8
11,3126001,3550000,423999,False,85,scaffold_8
12,3578001,3614000,35999,False,85,scaffold_8
13,3615001,3939000,323999,False,85,scaffold_8
14,4034001,4105000,70999,False,85,scaffold_8
15,4171001,4266000,94999,False,85,scaffold_8
16,4391001,4433000,41999,False,85,scaffold_8
17,4469001,4489000,19999,False,85,scaffold_8
18,4729001,4767000,37999,False,85,scaffold_8
19,4815001,4836000,20999,False,85,scaffold_8
20,4901001,4915000,13999,False,85,scaffold_8
21,5094001,5241000,146999,False,85,scaffold_8
22,5579001,5597000,17999,False,85,scaffold_8
23,5650001,5695000,44999,False,85,scaffold_8
24,5760001,5806000,45999,False,85,scaffold_8
25,5889001,5903000,13999,False,85,scaffold_8
26,6320001,6334544,14543,True,85,scaffold_8
0,1,23000,22999,True,85,scaffold_9
1,109001,119000,9999,False,85,scaffold_9
2,121001,140000,18999,False,85,scaffold_9
3,189001,194000,4999,False,85,scaffold_9
4,235001,243000,7999,False,85,scaffold_9
5,298001,411000,112999,False,85,scaffold_9
6,413001,434000,20999,False,85,scaffold_9
7,481001,531000,49999,False,85,scaffold_9
8,549001,563000,13999,False,85,scaffold_9
9,652001,665000,12999,False,85,scaffold_9
10,669001,697000,27999,False,85,scaffold_9
11,732001,741000,8999,False,85,scaffold_9
12,814001,843000,28999,False,85,scaffold_9
13,871001,986000,114999,False,85,scaffold_9
14,987001,995000,7999,False,85,scaffold_9
15,997001,1085000,87999,False,85,scaffold_9
16,1087001,1150000,62999,False,85,scaffold_9
17,1151001,1176000,24999,False,85,scaffold_9
18,1312001,1403000,90999,False,85,scaffold_9
19,1404001,1421000,16999,False,85,scaffold_9
20,1428001,1442000,13999,False,85,scaffold_9
21,1456001,1464000,7999,False,85,scaffold_9
22,1477001,1481000,3999,False,85,scaffold_9
23,1487001,1500000,12999,False,85,scaffold_9
24,1560001,1585000,24999,False,85,scaffold_9
25,1600001,1622000,21999,False,85,scaffold_9
26,1655001,1693000,37999,False,85,scaffold_9
27,1749001,1792000,42999,False,85,scaffold_9
28,1836001,1853000,16999,False,85,scaffold_9
29,1894001,1953000,58999,False,85,scaffold_9
30,1987001,2058000,70999,False,85,scaffold_9
31,2076001,2132000,55999,False,85,scaffold_9
32,2147001,2172000,24999,False,85,scaffold_9
33,2597001,2636000,38999,False,85,scaffold_9
34,2737001,3381000,643999,False,85,scaffold_9
35,3383001,5107000,1723999,False,85,scaffold_9
36,5112001,5238000,125999,False,85,scaffold_9
37,5239001,5298000,58999,False,85,scaffold_9
38,5300001,5490000,189999,False,85,scaffold_9
39,5493001,6331288,838287,True,85,scaffold_9
0,1,414000,413999,True,85,scaffold_10
1,415001,482000,66999,False,85,scaffold_10
2,483001,582000,98999,False,85,scaffold_10
3,597001,921000,323999,False,85,scaffold_10
4,923001,1069000,145999,False,85,scaffold_10
5,1087001,1146000,58999,False,85,scaffold_10
6,1426001,1472000,45999,False,85,scaffold_10
7,1799001,1821000,21999,False,85,scaffold_10
8,2079001,2103000,23999,False,85,scaffold_10
9,2131001,2171000,39999,False,85,scaffold_10
10,2197001,2225000,27999,False,85,scaffold_10
11,2271001,2333000,61999,False,85,scaffold_10
12,2334001,2476000,141999,False,85,scaffold_10
13,2560001,2582000,21999,False,85,scaffold_10
14,2599001,2645000,45999,False,85,scaffold_10
15,3481001,3491000,9999,False,85,scaffold_10
16,3775001,3795000,19999,False,85,scaffold_10
17,4001001,4012000,10999,False,85,scaffold_10
18,4046001,4111000,64999,False,85,scaffold_10
19,4154001,4174000,19999,False,85,scaffold_10
20,4197001,4211000,13999,False,85,scaffold_10
21,4335001,4366000,30999,False,85,scaffold_10
22,4443001,4466000,22999,False,85,scaffold_10
23,4467001,4513000,45999,False,85,scaffold_10
24,4515001,4548000,32999,False,85,scaffold_10
25,4553001,4562000,8999,False,85,scaffold_10
26,4565001,4597000,31999,False,85,scaffold_10
27,4681001,4688000,6999,False,85,scaffold_10
28,4734001,4776000,41999,False,85,scaffold_10
29,4798001,4824000,25999,False,85,scaffold_10
30,4828001,4843000,14999,False,85,scaffold_10
31,4848001,4861000,12999,False,85,scaffold_10
32,4865001,4866973,1972,True,85,scaffold_10
0,10001,34000,23999,False,85,scaffold_11
1,40001,95000,54999,False,85,scaffold_11
2,132001,167000,34999,False,85,scaffold_11
3,169001,212000,42999,False,85,scaffold_11
4,213001,236000,22999,False,85,scaffold_11
5,240001,253000,12999,False,85,scaffold_11
6,294001,321000,26999,False,85,scaffold_11
7,382001,394000,11999,False,85,scaffold_11
8,419001,431000,11999,False,85,scaffold_11
9,647001,656000,8999,False,85,scaffold_11
10,1474001,1478000,3999,False,85,scaffold_11
11,1526001,1541000,14999,False,85,scaffold_11
12,1985001,2050000,64999,False,85,scaffold_11
13,2687001,2877000,189999,False,85,scaffold_11
14,2978001,3019000,40999,False,85,scaffold_11
15,3083001,3176000,92999,False,85,scaffold_11
16,3185001,3383000,197999,False,85,scaffold_11
17,3429001,3477000,47999,False,85,scaffold_11
18,3519001,3971000,451999,False,85,scaffold_11
19,4003001,4159000,155999,False,85,scaffold_11
20,4180001,4710000,529999,False,85,scaffold_11
21,4712001,4766820,54819,True,85,scaffold_11
0,1,1483000,1482999,True,85,scaffold_12
1,1716001,1733000,16999,False,85,scaffold_12
2,1972001,2001000,28999,False,85,scaffold_12
3,2050001,2102000,51999,False,85,scaffold_12
4,2136001,2163000,26999,False,85,scaffold_12
5,2340001,2378000,37999,False,85,scaffold_12
6,2571001,2618000,46999,False,85,scaffold_12
7,2659001,2682000,22999,False,85,scaffold_12
0,1,355000,354999,True,86,scaffold_1
1,376001,392000,15999,False,86,scaffold_1
2,482001,498000,15999,False,86,scaffold_1
3,571001,643000,71999,False,86,scaffold_1
4,686001,757000,70999,False,86,scaffold_1
5,794001,848000,53999,False,86,scaffold_1
6,858001,948000,89999,False,86,scaffold_1
7,1179001,1196000,16999,False,86,scaffold_1
8,1608001,1660000,51999,False,86,scaffold_1
9,1661001,1674000,12999,False,86,scaffold_1
10,1676001,1691000,14999,False,86,scaffold_1
11,1725001,1964000,238999,False,86,scaffold_1
12,1965001,2022000,56999,False,86,scaffold_1
13,2323001,2387000,63999,False,86,scaffold_1
14,2449001,2517000,67999,False,86,scaffold_1
15,2563001,2582000,18999,False,86,scaffold_1
16,2727001,2746000,18999,False,86,scaffold_1
17,2902001,2921000,18999,False,86,scaffold_1
18,3171001,3213000,41999,False,86,scaffold_1
19,3444001,3500000,55999,False,86,scaffold_1
20,3711001,3941000,229999,False,86,scaffold_1
21,3942001,4113000,170999,False,86,scaffold_1
22,4312001,4550000,237999,False,86,scaffold_1
23,4641001,4795000,153999,False,86,scaffold_1
24,4796001,5025000,228999,False,86,scaffold_1
25,5040001,5065000,24999,False,86,scaffold_1
26,5085001,5124000,38999,False,86,scaffold_1
27,5137001,5202000,64999,False,86,scaffold_1
28,5436001,5460000,23999,False,86,scaffold_1
29,5481001,5521000,39999,False,86,scaffold_1
30,5522001,5579000,56999,False,86,scaffold_1
31,5854001,5915000,60999,False,86,scaffold_1
32,6108001,6177000,68999,False,86,scaffold_1
33,6205001,6565000,359999,False,86,scaffold_1
34,6810001,6862000,51999,False,86,scaffold_1
35,6864001,6883000,18999,False,86,scaffold_1
36,6925001,6953000,27999,False,86,scaffold_1
37,7038001,7247000,208999,False,86,scaffold_1
38,7248001,8656000,1407999,False,86,scaffold_1
39,8658001,9484000,825999,False,86,scaffold_1
40,9485001,9584000,98999,False,86,scaffold_1
41,9586001,10369000,782999,False,86,scaffold_1
42,10447001,10638000,190999,False,86,scaffold_1
43,10835001,10857000,21999,False,86,scaffold_1
44,10916001,10985000,68999,False,86,scaffold_1
45,11013001,11054000,40999,False,86,scaffold_1
46,11122001,11230000,107999,False,86,scaffold_1
47,11270001,11962000,691999,False,86,scaffold_1
48,12184001,12240000,55999,False,86,scaffold_1
49,12329001,12373000,43999,False,86,scaffold_1
50,12425001,12449000,23999,False,86,scaffold_1
51,12496001,12588000,91999,False,86,scaffold_1
52,12596001,12939000,342999,False,86,scaffold_1
53,12965001,13048000,82999,False,86,scaffold_1
54,13113001,13216000,102999,False,86,scaffold_1
55,13339001,13496000,156999,False,86,scaffold_1
56,13517001,13590000,72999,False,86,scaffold_1
57,13591001,13624000,32999,False,86,scaffold_1
58,13667001,13710000,42999,False,86,scaffold_1
59,13784001,13845000,60999,False,86,scaffold_1
60,13847001,13885000,37999,False,86,scaffold_1
61,13912001,13927000,14999,False,86,scaffold_1
62,13928001,13941000,12999,False,86,scaffold_1
63,13949001,13954000,4999,False,86,scaffold_1
64,13959001,13977000,17999,False,86,scaffold_1
65,14053001,14079000,25999,False,86,scaffold_1
66,14285001,14310000,24999,False,86,scaffold_1
67,14523001,14577000,53999,False,86,scaffold_1
68,14578001,14591000,12999,False,86,scaffold_1
69,14647001,14664000,16999,False,86,scaffold_1
0,21001,48000,26999,False,86,scaffold_2
1,93001,159000,65999,False,86,scaffold_2
2,165001,177000,11999,False,86,scaffold_2
3,314001,318000,3999,False,86,scaffold_2
4,333001,374000,40999,False,86,scaffold_2
5,429001,441000,11999,False,86,scaffold_2
6,1233001,1258000,24999,False,86,scaffold_2
7,1310001,1340000,29999,False,86,scaffold_2
8,1349001,1415000,65999,False,86,scaffold_2
9,1444001,1557000,112999,False,86,scaffold_2
10,1593001,1613000,19999,False,86,scaffold_2
11,1625001,1657000,31999,False,86,scaffold_2
12,1693001,1718000,24999,False,86,scaffold_2
13,1805001,1861000,55999,False,86,scaffold_2
14,1872001,1897000,24999,False,86,scaffold_2
15,2053001,2133000,79999,False,86,scaffold_2
16,2336001,2609000,272999,False,86,scaffold_2
17,2626001,2639000,12999,False,86,scaffold_2
18,2645001,2689000,43999,False,86,scaffold_2
19,2694001,2747000,52999,False,86,scaffold_2
20,2766001,2856000,89999,False,86,scaffold_2
21,2878001,3021000,142999,False,86,scaffold_2
22,3022001,3059000,36999,False,86,scaffold_2
23,3174001,3187000,12999,False,86,scaffold_2
24,3294001,3389000,94999,False,86,scaffold_2
25,3448001,3712000,263999,False,86,scaffold_2
26,3744001,3792000,47999,False,86,scaffold_2
27,3859001,3932000,72999,False,86,scaffold_2
28,4242001,4409000,166999,False,86,scaffold_2
29,4427001,4458000,30999,False,86,scaffold_2
30,4490001,4791000,300999,False,86,scaffold_2
31,4793001,4805000,11999,False,86,scaffold_2
32,4917001,4982000,64999,False,86,scaffold_2
33,5014001,5104000,89999,False,86,scaffold_2
34,5285001,5564000,278999,False,86,scaffold_2
35,5616001,5776000,159999,False,86,scaffold_2
36,5829001,5996000,166999,False,86,scaffold_2
37,6005001,6059000,53999,False,86,scaffold_2
38,6089001,6140000,50999,False,86,scaffold_2
39,6159001,6183000,23999,False,86,scaffold_2
40,6240001,6350000,109999,False,86,scaffold_2
41,6365001,6469000,103999,False,86,scaffold_2
42,6574001,6631000,56999,False,86,scaffold_2
43,6698001,6724000,25999,False,86,scaffold_2
44,6940001,6979000,38999,False,86,scaffold_2
45,7001001,7047000,45999,False,86,scaffold_2
46,7049001,7097000,47999,False,86,scaffold_2
47,7428001,7475000,46999,False,86,scaffold_2
48,7491001,7518000,26999,False,86,scaffold_2
49,7548001,7561000,12999,False,86,scaffold_2
50,7563001,7918000,354999,False,86,scaffold_2
51,7933001,8217000,283999,False,86,scaffold_2
52,8259001,8328000,68999,False,86,scaffold_2
53,8334001,8345000,10999,False,86,scaffold_2
54,8346001,8493000,146999,False,86,scaffold_2
55,8495001,8561000,65999,False,86,scaffold_2
56,9006001,9049000,42999,False,86,scaffold_2
57,9139001,9175000,35999,False,86,scaffold_2
58,9281001,9382000,100999,False,86,scaffold_2
59,9597001,9636000,38999,False,86,scaffold_2
60,9788001,9827000,38999,False,86,scaffold_2
61,9868001,9901000,32999,False,86,scaffold_2
62,10442001,10468000,25999,False,86,scaffold_2
63,10711001,10730000,18999,False,86,scaffold_2
64,10859001,10882000,22999,False,86,scaffold_2
65,11024001,11077000,52999,False,86,scaffold_2
66,11313001,11425000,111999,False,86,scaffold_2
67,11520001,11786000,265999,False,86,scaffold_2
68,11797001,11802476,5475,True,86,scaffold_2
0,1,2000,1999,True,86,scaffold_3
1,3001,6000,2999,False,86,scaffold_3
2,218001,227000,8999,False,86,scaffold_3
3,798001,902000,103999,False,86,scaffold_3
4,945001,958000,12999,False,86,scaffold_3
5,1202001,1233000,30999,False,86,scaffold_3
6,1584001,1621000,36999,False,86,scaffold_3
7,1634001,1672000,37999,False,86,scaffold_3
8,1692001,1745000,52999,False,86,scaffold_3
9,1894001,1924000,29999,False,86,scaffold_3
10,1938001,1978000,39999,False,86,scaffold_3
11,2008001,2179000,170999,False,86,scaffold_3
12,2208001,2226000,17999,False,86,scaffold_3
13,2287001,2336000,48999,False,86,scaffold_3
14,2377001,2428000,50999,False,86,scaffold_3
15,2432001,2533000,100999,False,86,scaffold_3
16,2534001,2558000,23999,False,86,scaffold_3
17,2561001,2609000,47999,False,86,scaffold_3
18,2644001,2778000,133999,False,86,scaffold_3
19,2857001,2869000,11999,False,86,scaffold_3
20,2891001,2925000,33999,False,86,scaffold_3
21,2986001,3062000,75999,False,86,scaffold_3
22,3066001,3151000,84999,False,86,scaffold_3
23,3168001,3279000,110999,False,86,scaffold_3
24,3409001,3432000,22999,False,86,scaffold_3
25,3561001,3737000,175999,False,86,scaffold_3
26,3768001,3821000,52999,False,86,scaffold_3
27,3822001,3891000,68999,False,86,scaffold_3
28,3910001,3921000,10999,False,86,scaffold_3
29,3922001,3948000,25999,False,86,scaffold_3
30,4007001,4039000,31999,False,86,scaffold_3
31,4040001,4403000,362999,False,86,scaffold_3
32,4406001,4518000,111999,False,86,scaffold_3
33,4547001,4558000,10999,False,86,scaffold_3
34,4661001,4680000,18999,False,86,scaffold_3
35,4854001,4919000,64999,False,86,scaffold_3
36,4999001,5034000,34999,False,86,scaffold_3
37,5079001,5124000,44999,False,86,scaffold_3
38,5145001,5295000,149999,False,86,scaffold_3
39,5350001,5676000,325999,False,86,scaffold_3
40,5678001,5766000,87999,False,86,scaffold_3
41,5768001,6014000,245999,False,86,scaffold_3
42,6015001,6108000,92999,False,86,scaffold_3
43,6741001,6806000,64999,False,86,scaffold_3
44,6861001,6962000,100999,False,86,scaffold_3
45,6963001,7097000,133999,False,86,scaffold_3
46,7112001,7157000,44999,False,86,scaffold_3
47,7226001,7313000,86999,False,86,scaffold_3
48,7335001,7413000,77999,False,86,scaffold_3
49,7449001,7458000,8999,False,86,scaffold_3
50,7462001,7563000,100999,False,86,scaffold_3
51,7575001,7622000,46999,False,86,scaffold_3
52,7656001,7889000,232999,False,86,scaffold_3
53,8028001,8116000,87999,False,86,scaffold_3
54,8121001,8152000,30999,False,86,scaffold_3
55,8177001,8253000,75999,False,86,scaffold_3
56,8381001,8562000,180999,False,86,scaffold_3
57,8575001,8594000,18999,False,86,scaffold_3
58,8816001,8853000,36999,False,86,scaffold_3
59,8956001,9181000,224999,False,86,scaffold_3
60,9195001,9248000,52999,False,86,scaffold_3
61,9467001,9478000,10999,False,86,scaffold_3
62,9497001,9543000,45999,False,86,scaffold_3
63,9645001,9718000,72999,False,86,scaffold_3
64,9969001,9995000,25999,False,86,scaffold_3
65,10065001,10087000,21999,False,86,scaffold_3
66,10550001,10572000,21999,False,86,scaffold_3
67,10574001,11167000,592999,False,86,scaffold_3
0,1,7000,6999,True,86,scaffold_4
1,17001,32000,14999,False,86,scaffold_4
2,48001,88000,39999,False,86,scaffold_4
3,91001,109000,17999,False,86,scaffold_4
4,110001,115000,4999,False,86,scaffold_4
5,147001,151000,3999,False,86,scaffold_4
6,155001,215000,59999,False,86,scaffold_4
7,217001,226000,8999,False,86,scaffold_4
8,227001,266000,38999,False,86,scaffold_4
9,290001,353000,62999,False,86,scaffold_4
10,355001,374000,18999,False,86,scaffold_4
11,395001,410000,14999,False,86,scaffold_4
12,412001,425000,12999,False,86,scaffold_4
13,429001,502000,72999,False,86,scaffold_4
14,542001,592000,49999,False,86,scaffold_4
15,593001,599000,5999,False,86,scaffold_4
16,600001,606000,5999,False,86,scaffold_4
17,608001,691000,82999,False,86,scaffold_4
18,704001,712000,7999,False,86,scaffold_4
19,1043001,1047000,3999,False,86,scaffold_4
20,1121001,1136000,14999,False,86,scaffold_4
21,1137001,1226000,88999,False,86,scaffold_4
22,1268001,1279000,10999,False,86,scaffold_4
23,1283001,1604000,320999,False,86,scaffold_4
24,1613001,2117000,503999,False,86,scaffold_4
25,2119001,2185000,65999,False,86,scaffold_4
26,2188001,2280000,91999,False,86,scaffold_4
27,2282001,2462000,179999,False,86,scaffold_4
28,2476001,2635000,158999,False,86,scaffold_4
29,2651001,2675000,23999,False,86,scaffold_4
30,2676001,2812000,135999,False,86,scaffold_4
31,2891001,3146000,254999,False,86,scaffold_4
32,3160001,3329000,168999,False,86,scaffold_4
33,3335001,3777000,441999,False,86,scaffold_4
34,3972001,3981000,8999,False,86,scaffold_4
35,4010001,4145000,134999,False,86,scaffold_4
36,4242001,4306000,63999,False,86,scaffold_4
37,4900001,5099000,198999,False,86,scaffold_4
38,5171001,5225000,53999,False,86,scaffold_4
39,5289001,5356000,66999,False,86,scaffold_4
40,5430001,5506000,75999,False,86,scaffold_4
41,5514001,5784000,269999,False,86,scaffold_4
42,5786001,5997000,210999,False,86,scaffold_4
43,6028001,6127000,98999,False,86,scaffold_4
44,6145001,6197000,51999,False,86,scaffold_4
45,6213001,6442000,228999,False,86,scaffold_4
46,6478001,6538000,59999,False,86,scaffold_4
47,6547001,6612000,64999,False,86,scaffold_4
48,6752001,6817000,64999,False,86,scaffold_4
49,6842001,6865000,22999,False,86,scaffold_4
50,6893001,6924000,30999,False,86,scaffold_4
51,6926001,6995000,68999,False,86,scaffold_4
52,7036001,7174000,137999,False,86,scaffold_4
53,7209001,7440000,230999,False,86,scaffold_4
54,7457001,7471000,13999,False,86,scaffold_4
55,7629001,7665000,35999,False,86,scaffold_4
56,7837001,7918000,80999,False,86,scaffold_4
57,7975001,7999000,23999,False,86,scaffold_4
58,8050001,8139000,88999,False,86,scaffold_4
59,8846001,9699000,852999,False,86,scaffold_4
60,9700001,9845951,145950,True,86,scaffold_4
0,319001,398000,78999,False,86,scaffold_5
1,443001,523000,79999,False,86,scaffold_5
2,629001,638000,8999,False,86,scaffold_5
3,639001,661000,21999,False,86,scaffold_5
4,669001,692000,22999,False,86,scaffold_5
5,803001,832000,28999,False,86,scaffold_5
6,836001,843000,6999,False,86,scaffold_5
7,844001,864000,19999,False,86,scaffold_5
8,932001,947000,14999,False,86,scaffold_5
9,1357001,1386000,28999,False,86,scaffold_5
10,1663001,1685000,21999,False,86,scaffold_5
11,1946001,1963000,16999,False,86,scaffold_5
12,2086001,2104000,17999,False,86,scaffold_5
13,2473001,2493000,19999,False,86,scaffold_5
14,2510001,2515000,4999,False,86,scaffold_5
15,2516001,2894000,377999,False,86,scaffold_5
16,3133001,3519000,385999,False,86,scaffold_5
17,3532001,3564000,31999,False,86,scaffold_5
18,3616001,3658000,41999,False,86,scaffold_5
19,3836001,3946000,109999,False,86,scaffold_5
20,3962001,4101000,138999,False,86,scaffold_5
21,4119001,4389000,269999,False,86,scaffold_5
22,4443001,4922000,478999,False,86,scaffold_5
23,5059001,5105000,45999,False,86,scaffold_5
24,5217001,5312000,94999,False,86,scaffold_5
25,5314001,5346000,31999,False,86,scaffold_5
26,5499001,5541000,41999,False,86,scaffold_5
27,5720001,5738000,17999,False,86,scaffold_5
28,6392001,6680000,287999,False,86,scaffold_5
29,6839001,6848000,8999,False,86,scaffold_5
30,6880001,6968000,87999,False,86,scaffold_5
31,7043001,7078000,34999,False,86,scaffold_5
32,7175001,7243000,67999,False,86,scaffold_5
33,7260001,7329000,68999,False,86,scaffold_5
34,7406001,7440000,33999,False,86,scaffold_5
35,7454001,7492000,37999,False,86,scaffold_5
36,7498001,7512000,13999,False,86,scaffold_5
37,7523001,7746000,222999,False,86,scaffold_5
38,7782001,7807000,24999,False,86,scaffold_5
39,8413001,8461000,47999,False,86,scaffold_5
40,8548001,8605000,56999,False,86,scaffold_5
41,8638001,8689000,50999,False,86,scaffold_5
42,8705001,9364176,659175,True,86,scaffold_5
0,79001,85000,5999,False,86,scaffold_6
1,86001,114000,27999,False,86,scaffold_6
2,148001,208000,59999,False,86,scaffold_6
3,239001,263000,23999,False,86,scaffold_6
4,264001,318000,53999,False,86,scaffold_6
5,458001,497000,38999,False,86,scaffold_6
6,590001,596000,5999,False,86,scaffold_6
7,618001,663000,44999,False,86,scaffold_6
8,698001,802000,103999,False,86,scaffold_6
9,833001,852000,18999,False,86,scaffold_6
10,905001,1050000,144999,False,86,scaffold_6
11,1122001,1226000,103999,False,86,scaffold_6
12,1228001,1266000,37999,False,86,scaffold_6
13,1284001,1311000,26999,False,86,scaffold_6
14,1428001,1599000,170999,False,86,scaffold_6
15,1658001,1756000,97999,False,86,scaffold_6
16,1766001,1777000,10999,False,86,scaffold_6
17,1803001,1933000,129999,False,86,scaffold_6
18,1975001,2019000,43999,False,86,scaffold_6
19,2023001,2105000,81999,False,86,scaffold_6
20,2127001,2214000,86999,False,86,scaffold_6
21,2239001,2283000,43999,False,86,scaffold_6
22,2317001,2595000,277999,False,86,scaffold_6
23,2596001,2872000,275999,False,86,scaffold_6
24,2926001,3032000,105999,False,86,scaffold_6
25,3063001,3350000,286999,False,86,scaffold_6
26,3351001,3795000,443999,False,86,scaffold_6
27,3811001,3850000,38999,False,86,scaffold_6
28,3877001,3926000,48999,False,86,scaffold_6
29,3960001,4195000,234999,False,86,scaffold_6
30,4448001,4484000,35999,False,86,scaffold_6
31,4778001,4919000,140999,False,86,scaffold_6
32,4925001,4997000,71999,False,86,scaffold_6
33,5291001,5320000,28999,False,86,scaffold_6
34,5678001,5789000,110999,False,86,scaffold_6
35,5868001,5972000,103999,False,86,scaffold_6
36,6003001,6215000,211999,False,86,scaffold_6
37,6238001,6276000,37999,False,86,scaffold_6
38,6469001,6505000,35999,False,86,scaffold_6
39,6672001,6715000,42999,False,86,scaffold_6
40,6765001,6804000,38999,False,86,scaffold_6
41,6911001,6942000,30999,False,86,scaffold_6
42,7213001,7247000,33999,False,86,scaffold_6
43,7254001,7337000,82999,False,86,scaffold_6
44,7382001,7530000,147999,False,86,scaffold_6
45,7531001,8268281,737280,True,86,scaffold_6
0,13001,31000,17999,False,86,scaffold_7
1,323001,340000,16999,False,86,scaffold_7
2,342001,510000,167999,False,86,scaffold_7
3,571001,577000,5999,False,86,scaffold_7
4,655001,703000,47999,False,86,scaffold_7
5,706001,736000,29999,False,86,scaffold_7
6,741001,753000,11999,False,86,scaffold_7
7,764001,822000,57999,False,86,scaffold_7
8,859001,864000,4999,False,86,scaffold_7
9,868001,938000,69999,False,86,scaffold_7
10,939001,963000,23999,False,86,scaffold_7
11,964001,966000,1999,False,86,scaffold_7
12,968001,980000,11999,False,86,scaffold_7
13,982001,1044000,61999,False,86,scaffold_7
14,1048001,1104000,55999,False,86,scaffold_7
15,1191001,1512000,320999,False,86,scaffold_7
16,1588001,1696000,107999,False,86,scaffold_7
17,1727001,1782000,54999,False,86,scaffold_7
18,1817001,1901000,83999,False,86,scaffold_7
19,1976001,2013000,36999,False,86,scaffold_7
20,2366001,2409000,42999,False,86,scaffold_7
21,2543001,2601000,57999,False,86,scaffold_7
22,2679001,2737000,57999,False,86,scaffold_7
23,2806001,2842000,35999,False,86,scaffold_7
24,2931001,2958000,26999,False,86,scaffold_7
25,3007001,3023000,15999,False,86,scaffold_7
26,3198001,3271000,72999,False,86,scaffold_7
27,3293001,3401000,107999,False,86,scaffold_7
28,3521001,3809000,287999,False,86,scaffold_7
29,3903001,3931000,27999,False,86,scaffold_7
30,4021001,4060000,38999,False,86,scaffold_7
31,4322001,4378000,55999,False,86,scaffold_7
32,4406001,4580000,173999,False,86,scaffold_7
33,4639001,4648000,8999,False,86,scaffold_7
34,4657001,4737000,79999,False,86,scaffold_7
35,4752001,5169000,416999,False,86,scaffold_7
36,5470001,5645000,174999,False,86,scaffold_7
37,5666001,5677000,10999,False,86,scaffold_7
38,5787001,5799000,11999,False,86,scaffold_7
39,6052001,6094000,41999,False,86,scaffold_7
40,6096001,6281000,184999,False,86,scaffold_7
41,6557001,6676000,118999,False,86,scaffold_7
42,6693001,6717000,23999,False,86,scaffold_7
43,6750001,6799000,48999,False,86,scaffold_7
44,6813001,6840000,26999,False,86,scaffold_7
45,6942001,7502216,560215,True,86,scaffold_7
0,1,6000,5999,True,86,scaffold_8
1,66001,87000,20999,False,86,scaffold_8
2,2066001,2154000,87999,False,86,scaffold_8
3,2337001,2531000,193999,False,86,scaffold_8
4,2536001,2599000,62999,False,86,scaffold_8
5,2649001,2846000,196999,False,86,scaffold_8
6,2847001,3125000,277999,False,86,scaffold_8
7,3126001,3614000,487999,False,86,scaffold_8
8,3615001,3944000,328999,False,86,scaffold_8
9,3999001,4267000,267999,False,86,scaffold_8
10,4400001,4431000,30999,False,86,scaffold_8
11,4609001,4644000,34999,False,86,scaffold_8
12,4718001,4776000,57999,False,86,scaffold_8
13,4797001,4924000,126999,False,86,scaffold_8
14,4999001,5035000,35999,False,86,scaffold_8
15,5076001,5246000,169999,False,86,scaffold_8
16,5400001,5475000,74999,False,86,scaffold_8
17,5522001,5596000,73999,False,86,scaffold_8
18,5650001,5723000,72999,False,86,scaffold_8
19,5734001,5804000,69999,False,86,scaffold_8
20,5807001,5944000,136999,False,86,scaffold_8
21,5960001,5996000,35999,False,86,scaffold_8
22,6025001,6149000,123999,False,86,scaffold_8
23,6227001,6306000,78999,False,86,scaffold_8
24,6321001,6334544,13543,True,86,scaffold_8
0,1001,21000,19999,False,86,scaffold_9
1,109001,119000,9999,False,86,scaffold_9
2,121001,141000,19999,False,86,scaffold_9
3,299001,315000,15999,False,86,scaffold_9
4,318001,328000,9999,False,86,scaffold_9
5,366001,411000,44999,False,86,scaffold_9
6,413001,434000,20999,False,86,scaffold_9
7,502001,531000,28999,False,86,scaffold_9
8,547001,563000,15999,False,86,scaffold_9
9,647001,659000,11999,False,86,scaffold_9
10,660001,665000,4999,False,86,scaffold_9
11,671001,696000,24999,False,86,scaffold_9
12,816001,842000,25999,False,86,scaffold_9
13,873001,986000,112999,False,86,scaffold_9
14,988001,1000000,11999,False,86,scaffold_9
15,1001001,1007000,5999,False,86,scaffold_9
16,1009001,1196000,186999,False,86,scaffold_9
17,1201001,1229000,27999,False,86,scaffold_9
18,1312001,1402000,89999,False,86,scaffold_9
19,1404001,1423000,18999,False,86,scaffold_9
20,1427001,1437000,9999,False,86,scaffold_9
21,1457001,1465000,7999,False,86,scaffold_9
22,1483001,1592000,108999,False,86,scaffold_9
23,1593001,1625000,31999,False,86,scaffold_9
24,1637001,1701000,63999,False,86,scaffold_9
25,1732001,1792000,59999,False,86,scaffold_9
26,1814001,1857000,42999,False,86,scaffold_9
27,1866001,1959000,92999,False,86,scaffold_9
28,1971001,2135000,163999,False,86,scaffold_9
29,2136001,2354000,217999,False,86,scaffold_9
30,2389001,2582000,192999,False,86,scaffold_9
31,2584001,2673000,88999,False,86,scaffold_9
32,2674001,2722000,47999,False,86,scaffold_9
33,2731001,3381000,649999,False,86,scaffold_9
34,3383001,5107000,1723999,False,86,scaffold_9
35,5112001,5114000,1999,False,86,scaffold_9
36,5116001,5298000,181999,False,86,scaffold_9
37,5299001,5490000,190999,False,86,scaffold_9
38,5493001,6331288,838287,True,86,scaffold_9
0,1,482000,481999,True,86,scaffold_10
1,483001,582000,98999,False,86,scaffold_10
2,597001,796000,198999,False,86,scaffold_10
3,810001,1069000,258999,False,86,scaffold_10
4,1073001,1154000,80999,False,86,scaffold_10
5,1279001,1290000,10999,False,86,scaffold_10
6,1312001,1363000,50999,False,86,scaffold_10
7,1369001,1472000,102999,False,86,scaffold_10
8,1500001,1570000,69999,False,86,scaffold_10
9,1590001,1663000,72999,False,86,scaffold_10
10,1694001,1760000,65999,False,86,scaffold_10
11,1803001,1817000,13999,False,86,scaffold_10
12,1859001,1922000,62999,False,86,scaffold_10
13,2008001,2071000,62999,False,86,scaffold_10
14,2075001,2113000,37999,False,86,scaffold_10
15,2131001,2333000,201999,False,86,scaffold_10
16,2334001,2475000,140999,False,86,scaffold_10
17,2499001,2520000,20999,False,86,scaffold_10
18,2521001,2657000,135999,False,86,scaffold_10
19,2670001,2811000,140999,False,86,scaffold_10
20,2938001,2954000,15999,False,86,scaffold_10
21,2968001,3002000,33999,False,86,scaffold_10
22,3154001,3188000,33999,False,86,scaffold_10
23,3396001,3424000,27999,False,86,scaffold_10
24,3570001,3582000,11999,False,86,scaffold_10
25,3779001,3795000,15999,False,86,scaffold_10
26,4053001,4091000,37999,False,86,scaffold_10
27,4154001,4181000,26999,False,86,scaffold_10
28,4335001,4361000,25999,False,86,scaffold_10
29,4443001,4462000,18999,False,86,scaffold_10
30,4467001,4502000,34999,False,86,scaffold_10
31,4503001,4513000,9999,False,86,scaffold_10
32,4515001,4523000,7999,False,86,scaffold_10
33,4526001,4548000,21999,False,86,scaffold_10
34,4574001,4596000,21999,False,86,scaffold_10
35,4734001,4766000,31999,False,86,scaffold_10
36,4769001,4776000,6999,False,86,scaffold_10
37,4798001,4824000,25999,False,86,scaffold_10
38,4828001,4843000,14999,False,86,scaffold_10
39,4848001,4861000,12999,False,86,scaffold_10
40,4865001,4866973,1972,True,86,scaffold_10
0,11001,90000,78999,False,86,scaffold_11
1,149001,167000,17999,False,86,scaffold_11
2,169001,191000,21999,False,86,scaffold_11
3,213001,235000,21999,False,86,scaffold_11
4,240001,251000,10999,False,86,scaffold_11
5,295001,316000,20999,False,86,scaffold_11
6,419001,431000,11999,False,86,scaffold_11
7,637001,656000,18999,False,86,scaffold_11
8,1028001,1034000,5999,False,86,scaffold_11
9,1219001,1242000,22999,False,86,scaffold_11
10,1304001,1398000,93999,False,86,scaffold_11
11,1403001,1409000,5999,False,86,scaffold_11
12,1435001,1452000,16999,False,86,scaffold_11
13,1474001,1478000,3999,False,86,scaffold_11
14,1525001,1547000,21999,False,86,scaffold_11
15,1572001,1600000,27999,False,86,scaffold_11
16,1775001,1795000,19999,False,86,scaffold_11
17,1853001,1900000,46999,False,86,scaffold_11
18,1930001,2058000,127999,False,86,scaffold_11
19,2089001,2148000,58999,False,86,scaffold_11
20,2192001,2233000,40999,False,86,scaffold_11
21,2674001,2912000,237999,False,86,scaffold_11
22,2948001,3025000,76999,False,86,scaffold_11
23,3082001,3383000,300999,False,86,scaffold_11
24,3421001,3479000,57999,False,86,scaffold_11
25,3520001,3972000,451999,False,86,scaffold_11
26,3979001,4160000,180999,False,86,scaffold_11
27,4180001,4710000,529999,False,86,scaffold_11
28,4713001,4766820,53819,True,86,scaffold_11
0,1,1500000,1499999,True,86,scaffold_12
1,1565001,1588000,22999,False,86,scaffold_12
2,1640001,1675000,34999,False,86,scaffold_12
3,1713001,1733000,19999,False,86,scaffold_12
4,1786001,1811000,24999,False,86,scaffold_12
5,1882001,2005000,122999,False,86,scaffold_12
6,2006001,2015000,8999,False,86,scaffold_12
7,2016001,2022000,5999,False,86,scaffold_12
8,2023001,2106000,82999,False,86,scaffold_12
9,2130001,2192000,61999,False,86,scaffold_12
10,2291001,2378000,86999,False,86,scaffold_12
11,2571001,2612000,40999,False,86,scaffold_12
12,2660001,2682000,21999,False,86,scaffold_12
0,1,345000,344999,True,87,scaffold_1
1,482001,498000,15999,False,87,scaffold_1
2,565001,643000,77999,False,87,scaffold_1
3,685001,771000,85999,False,87,scaffold_1
4,1281001,1292000,10999,False,87,scaffold_1
5,1614001,1660000,45999,False,87,scaffold_1
6,1742001,1760000,17999,False,87,scaffold_1
7,1811001,1900000,88999,False,87,scaffold_1
8,1918001,1931000,12999,False,87,scaffold_1
9,1950001,1984000,33999,False,87,scaffold_1
10,1988001,1994000,5999,False,87,scaffold_1
11,2372001,2387000,14999,False,87,scaffold_1
12,2449001,2517000,67999,False,87,scaffold_1
13,2729001,2746000,16999,False,87,scaffold_1
14,3175001,3209000,33999,False,87,scaffold_1
15,3714001,3738000,23999,False,87,scaffold_1
16,3812001,3844000,31999,False,87,scaffold_1
17,3901001,3941000,39999,False,87,scaffold_1
18,4001001,4028000,26999,False,87,scaffold_1
19,4062001,4129000,66999,False,87,scaffold_1
20,4306001,4354000,47999,False,87,scaffold_1
21,4796001,4813000,16999,False,87,scaffold_1
22,4927001,5022000,94999,False,87,scaffold_1
23,5095001,5104000,8999,False,87,scaffold_1
24,5481001,5511000,29999,False,87,scaffold_1
25,5534001,5570000,35999,False,87,scaffold_1
26,5859001,5865000,5999,False,87,scaffold_1
27,6108001,6153000,44999,False,87,scaffold_1
28,6154001,6178000,23999,False,87,scaffold_1
29,6201001,6381000,179999,False,87,scaffold_1
30,6382001,6564000,181999,False,87,scaffold_1
31,7038001,7247000,208999,False,87,scaffold_1
32,7248001,7588000,339999,False,87,scaffold_1
33,7590001,8656000,1065999,False,87,scaffold_1
34,8658001,9584000,925999,False,87,scaffold_1
35,9586001,10370000,783999,False,87,scaffold_1
36,10460001,10638000,177999,False,87,scaffold_1
37,10733001,10759000,25999,False,87,scaffold_1
38,10808001,10811000,2999,False,87,scaffold_1
39,10837001,10857000,19999,False,87,scaffold_1
40,10911001,10978000,66999,False,87,scaffold_1
41,11279001,11510000,230999,False,87,scaffold_1
42,11560001,11962000,401999,False,87,scaffold_1
43,12184001,12206000,21999,False,87,scaffold_1
44,12648001,12723000,74999,False,87,scaffold_1
45,12776001,12888000,111999,False,87,scaffold_1
46,12904001,12950000,45999,False,87,scaffold_1
47,12964001,13005000,40999,False,87,scaffold_1
48,13113001,13216000,102999,False,87,scaffold_1
49,13346001,13420000,73999,False,87,scaffold_1
50,13913001,13927000,13999,False,87,scaffold_1
51,14294001,14307000,12999,False,87,scaffold_1
0,1,48000,47999,True,87,scaffold_2
1,95001,159000,63999,False,87,scaffold_2
2,168001,177000,8999,False,87,scaffold_2
3,302001,318000,15999,False,87,scaffold_2
4,330001,374000,43999,False,87,scaffold_2
5,390001,401000,10999,False,87,scaffold_2
6,2085001,2101000,15999,False,87,scaffold_2
7,2342001,2358000,15999,False,87,scaffold_2
8,2398001,2554000,155999,False,87,scaffold_2
9,2566001,2609000,42999,False,87,scaffold_2
10,2660001,2689000,28999,False,87,scaffold_2
11,2694001,2747000,52999,False,87,scaffold_2
12,2766001,2787000,20999,False,87,scaffold_2
13,2805001,2856000,50999,False,87,scaffold_2
14,2878001,3013000,134999,False,87,scaffold_2
15,3030001,3042000,11999,False,87,scaffold_2
16,3333001,3342000,8999,False,87,scaffold_2
17,3450001,3477000,26999,False,87,scaffold_2
18,3754001,3788000,33999,False,87,scaffold_2
19,4244001,4262000,17999,False,87,scaffold_2
20,4340001,4366000,25999,False,87,scaffold_2
21,4382001,4409000,26999,False,87,scaffold_2
22,4425001,4457000,31999,False,87,scaffold_2
23,4516001,4662000,145999,False,87,scaffold_2
24,4780001,4790000,9999,False,87,scaffold_2
25,4793001,4799000,5999,False,87,scaffold_2
26,4918001,4959000,40999,False,87,scaffold_2
27,5018001,5104000,85999,False,87,scaffold_2
28,5409001,5481000,71999,False,87,scaffold_2
29,5491001,5516000,24999,False,87,scaffold_2
30,5618001,5761000,142999,False,87,scaffold_2
31,5840001,5888000,47999,False,87,scaffold_2
32,6007001,6022000,14999,False,87,scaffold_2
33,6226001,6350000,123999,False,87,scaffold_2
34,6385001,6449000,63999,False,87,scaffold_2
35,6580001,6628000,47999,False,87,scaffold_2
36,6947001,6979000,31999,False,87,scaffold_2
37,7006001,7037000,30999,False,87,scaffold_2
38,7049001,7097000,47999,False,87,scaffold_2
39,7438001,7473000,34999,False,87,scaffold_2
40,7491001,7518000,26999,False,87,scaffold_2
41,7563001,7698000,134999,False,87,scaffold_2
42,7786001,7920000,133999,False,87,scaffold_2
43,7933001,8162000,228999,False,87,scaffold_2
44,8260001,8313000,52999,False,87,scaffold_2
45,8331001,8333000,1999,False,87,scaffold_2
46,8335001,8344000,8999,False,87,scaffold_2
47,8346001,8454000,107999,False,87,scaffold_2
48,8509001,8562000,52999,False,87,scaffold_2
49,9140001,9168000,27999,False,87,scaffold_2
50,9601001,9635000,33999,False,87,scaffold_2
51,9850001,9896000,45999,False,87,scaffold_2
52,10713001,10729000,15999,False,87,scaffold_2
53,11366001,11384000,17999,False,87,scaffold_2
54,11520001,11786000,265999,False,87,scaffold_2
0,292001,295000,2999,False,87,scaffold_3
1,528001,539000,10999,False,87,scaffold_3
2,618001,646000,27999,False,87,scaffold_3
3,798001,900000,101999,False,87,scaffold_3
4,2008001,2108000,99999,False,87,scaffold_3
5,2110001,2114000,3999,False,87,scaffold_3
6,2288001,2322000,33999,False,87,scaffold_3
7,2402001,2428000,25999,False,87,scaffold_3
8,2432001,2533000,100999,False,87,scaffold_3
9,2717001,2741000,23999,False,87,scaffold_3
10,3066001,3081000,14999,False,87,scaffold_3
11,3768001,3821000,52999,False,87,scaffold_3
12,3822001,3892000,69999,False,87,scaffold_3
13,3908001,3921000,12999,False,87,scaffold_3
14,3922001,3948000,25999,False,87,scaffold_3
15,4070001,4088000,17999,False,87,scaffold_3
16,4092001,4398000,305999,False,87,scaffold_3
17,4416001,4519000,102999,False,87,scaffold_3
18,4652001,4684000,31999,False,87,scaffold_3
19,5145001,5196000,50999,False,87,scaffold_3
20,5934001,5937000,2999,False,87,scaffold_3
21,5990001,6025000,34999,False,87,scaffold_3
22,6760001,6807000,46999,False,87,scaffold_3
23,6907001,7090000,182999,False,87,scaffold_3
24,7367001,7398000,30999,False,87,scaffold_3
25,7483001,7493000,9999,False,87,scaffold_3
26,7515001,7556000,40999,False,87,scaffold_3
27,7681001,7852000,170999,False,87,scaffold_3
28,8052001,8111000,58999,False,87,scaffold_3
29,8175001,8253000,77999,False,87,scaffold_3
30,8397001,8527000,129999,False,87,scaffold_3
31,8575001,8594000,18999,False,87,scaffold_3
32,9019001,9075000,55999,False,87,scaffold_3
33,9968001,9999000,30999,False,87,scaffold_3
34,10550001,10572000,21999,False,87,scaffold_3
35,10574001,11165000,590999,False,87,scaffold_3
0,14001,16000,1999,False,87,scaffold_4
1,17001,32000,14999,False,87,scaffold_4
2,49001,88000,38999,False,87,scaffold_4
3,147001,151000,3999,False,87,scaffold_4
4,155001,160000,4999,False,87,scaffold_4
5,161001,215000,53999,False,87,scaffold_4
6,218001,226000,7999,False,87,scaffold_4
7,227001,267000,39999,False,87,scaffold_4
8,283001,308000,24999,False,87,scaffold_4
9,313001,344000,30999,False,87,scaffold_4
10,355001,374000,18999,False,87,scaffold_4
11,375001,380000,4999,False,87,scaffold_4
12,389001,410000,20999,False,87,scaffold_4
13,412001,425000,12999,False,87,scaffold_4
14,429001,445000,15999,False,87,scaffold_4
15,449001,498000,48999,False,87,scaffold_4
16,542001,592000,49999,False,87,scaffold_4
17,593001,606000,12999,False,87,scaffold_4
18,608001,691000,82999,False,87,scaffold_4
19,1087001,1097000,9999,False,87,scaffold_4
20,1099001,1107000,7999,False,87,scaffold_4
21,1120001,1136000,15999,False,87,scaffold_4
22,1137001,1208000,70999,False,87,scaffold_4
23,1210001,1226000,15999,False,87,scaffold_4
24,1240001,1253000,12999,False,87,scaffold_4
25,1254001,1262000,7999,False,87,scaffold_4
26,1265001,1279000,13999,False,87,scaffold_4
27,1283001,1597000,313999,False,87,scaffold_4
28,1613001,2118000,504999,False,87,scaffold_4
29,2119001,2128000,8999,False,87,scaffold_4
30,2143001,2185000,41999,False,87,scaffold_4
31,2207001,2246000,38999,False,87,scaffold_4
32,2256001,2268000,11999,False,87,scaffold_4
33,2269001,2281000,11999,False,87,scaffold_4
34,2283001,2340000,56999,False,87,scaffold_4
35,2342001,2461000,118999,False,87,scaffold_4
36,2476001,2635000,158999,False,87,scaffold_4
37,2690001,2793000,102999,False,87,scaffold_4
38,2919001,2966000,46999,False,87,scaffold_4
39,3075001,3127000,51999,False,87,scaffold_4
40,3295001,3764000,468999,False,87,scaffold_4
41,4060001,4071000,10999,False,87,scaffold_4
42,4900001,5050000,149999,False,87,scaffold_4
43,5171001,5225000,53999,False,87,scaffold_4
44,5300001,5329000,28999,False,87,scaffold_4
45,5339001,5377000,37999,False,87,scaffold_4
46,5476001,5506000,29999,False,87,scaffold_4
47,5516001,5632000,115999,False,87,scaffold_4
48,5655001,5784000,128999,False,87,scaffold_4
49,5786001,5828000,41999,False,87,scaffold_4
50,6145001,6192000,46999,False,87,scaffold_4
51,6771001,6788000,16999,False,87,scaffold_4
52,6789001,6817000,27999,False,87,scaffold_4
53,6901001,6924000,22999,False,87,scaffold_4
54,6950001,6995000,44999,False,87,scaffold_4
55,7036001,7079000,42999,False,87,scaffold_4
56,7152001,7285000,132999,False,87,scaffold_4
57,7629001,7665000,35999,False,87,scaffold_4
58,8846001,9699000,852999,False,87,scaffold_4
59,9700001,9845951,145950,True,87,scaffold_4
0,1,5000,4999,True,87,scaffold_5
1,28001,32000,3999,False,87,scaffold_5
2,141001,168000,26999,False,87,scaffold_5
3,318001,387000,68999,False,87,scaffold_5
4,402001,427000,24999,False,87,scaffold_5
5,445001,526000,80999,False,87,scaffold_5
6,669001,697000,27999,False,87,scaffold_5
7,836001,843000,6999,False,87,scaffold_5
8,933001,947000,13999,False,87,scaffold_5
9,2264001,2301000,36999,False,87,scaffold_5
10,2474001,2493000,18999,False,87,scaffold_5
11,2516001,2524000,7999,False,87,scaffold_5
12,2552001,2779000,226999,False,87,scaffold_5
13,2812001,2895000,82999,False,87,scaffold_5
14,3133001,3249000,115999,False,87,scaffold_5
15,3279001,3288000,8999,False,87,scaffold_5
16,3309001,3514000,204999,False,87,scaffold_5
17,3617001,3658000,40999,False,87,scaffold_5
18,3864001,3873000,8999,False,87,scaffold_5
19,3961001,3986000,24999,False,87,scaffold_5
20,3989001,4101000,111999,False,87,scaffold_5
21,4121001,4221000,99999,False,87,scaffold_5
22,4227001,4274000,46999,False,87,scaffold_5
23,4445001,4525000,79999,False,87,scaffold_5
24,4601001,4719000,117999,False,87,scaffold_5
25,4765001,4925000,159999,False,87,scaffold_5
26,4972001,4991000,18999,False,87,scaffold_5
27,5063001,5081000,17999,False,87,scaffold_5
28,5287001,5344000,56999,False,87,scaffold_5
29,6407001,6653000,245999,False,87,scaffold_5
30,6890001,6904000,13999,False,87,scaffold_5
31,7406001,7439000,32999,False,87,scaffold_5
32,7454001,7483000,28999,False,87,scaffold_5
33,7543001,7614000,70999,False,87,scaffold_5
34,7621001,7659000,37999,False,87,scaffold_5
35,7711001,7747000,35999,False,87,scaffold_5
36,8418001,8465000,46999,False,87,scaffold_5
37,8553001,8616000,62999,False,87,scaffold_5
38,8713001,9363000,649999,False,87,scaffold_5
0,79001,84000,4999,False,87,scaffold_6
1,86001,116000,29999,False,87,scaffold_6
2,150001,209000,58999,False,87,scaffold_6
3,239001,254000,14999,False,87,scaffold_6
4,256001,262000,5999,False,87,scaffold_6
5,267001,330000,62999,False,87,scaffold_6
6,1233001,1257000,23999,False,87,scaffold_6
7,1447001,1456000,8999,False,87,scaffold_6
8,1476001,1546000,69999,False,87,scaffold_6
9,1562001,1592000,29999,False,87,scaffold_6
10,1658001,1686000,27999,False,87,scaffold_6
11,1832001,1901000,68999,False,87,scaffold_6
12,2029001,2106000,76999,False,87,scaffold_6
13,2129001,2211000,81999,False,87,scaffold_6
14,2240001,2266000,25999,False,87,scaffold_6
15,2336001,2872000,535999,False,87,scaffold_6
16,2928001,3014000,85999,False,87,scaffold_6
17,3113001,3190000,76999,False,87,scaffold_6
18,3223001,3333000,109999,False,87,scaffold_6
19,3391001,3786000,394999,False,87,scaffold_6
20,3900001,3913000,12999,False,87,scaffold_6
21,3966001,4195000,228999,False,87,scaffold_6
22,6003001,6063000,59999,False,87,scaffold_6
23,6151001,6178000,26999,False,87,scaffold_6
24,6833001,6857000,23999,False,87,scaffold_6
25,7199001,7340000,140999,False,87,scaffold_6
26,7389001,7441000,51999,False,87,scaffold_6
27,7555001,8124000,568999,False,87,scaffold_6
28,8125001,8268281,143280,True,87,scaffold_6
0,13001,34000,20999,False,87,scaffold_7
1,321001,340000,18999,False,87,scaffold_7
2,342001,509000,166999,False,87,scaffold_7
3,554001,563000,8999,False,87,scaffold_7
4,571001,579000,7999,False,87,scaffold_7
5,706001,736000,29999,False,87,scaffold_7
6,739001,753000,13999,False,87,scaffold_7
7,764001,829000,64999,False,87,scaffold_7
8,859001,864000,4999,False,87,scaffold_7
9,868001,901000,32999,False,87,scaffold_7
10,964001,980000,15999,False,87,scaffold_7
11,982001,1044000,61999,False,87,scaffold_7
12,1160001,1187000,26999,False,87,scaffold_7
13,1191001,1459000,267999,False,87,scaffold_7
14,1461001,1512000,50999,False,87,scaffold_7
15,1588001,1695000,106999,False,87,scaffold_7
16,3292001,3375000,82999,False,87,scaffold_7
17,3526001,3766000,239999,False,87,scaffold_7
18,4323001,4361000,37999,False,87,scaffold_7
19,4415001,4431000,15999,False,87,scaffold_7
20,4433001,4512000,78999,False,87,scaffold_7
21,4553001,4575000,21999,False,87,scaffold_7
22,4658001,4738000,79999,False,87,scaffold_7
23,4754001,4854000,99999,False,87,scaffold_7
24,4978001,5150000,171999,False,87,scaffold_7
25,5482001,5536000,53999,False,87,scaffold_7
26,6953001,7270000,316999,False,87,scaffold_7
27,7271001,7502216,231215,True,87,scaffold_7
0,1,6000,5999,True,87,scaffold_8
1,66001,85000,18999,False,87,scaffold_8
2,93001,101000,7999,False,87,scaffold_8
3,1364001,1422000,57999,False,87,scaffold_8
4,2442001,2583000,140999,False,87,scaffold_8
5,2650001,2683000,32999,False,87,scaffold_8
6,2742001,2757000,14999,False,87,scaffold_8
7,2798001,2844000,45999,False,87,scaffold_8
8,3032001,3125000,92999,False,87,scaffold_8
9,3126001,3554000,427999,False,87,scaffold_8
10,3580001,3612000,31999,False,87,scaffold_8
11,3615001,3938000,322999,False,87,scaffold_8
12,4039001,4109000,69999,False,87,scaffold_8
13,4172001,4221000,48999,False,87,scaffold_8
14,4400001,4434000,33999,False,87,scaffold_8
15,5078001,5137000,58999,False,87,scaffold_8
16,5170001,5241000,70999,False,87,scaffold_8
17,5582001,5597000,14999,False,87,scaffold_8
18,5651001,5692000,40999,False,87,scaffold_8
19,6324001,6334544,10543,True,87,scaffold_8
0,1001,17000,15999,False,87,scaffold_9
1,109001,117000,7999,False,87,scaffold_9
2,121001,138000,16999,False,87,scaffold_9
3,366001,411000,44999,False,87,scaffold_9
4,413001,434000,20999,False,87,scaffold_9
5,484001,531000,46999,False,87,scaffold_9
6,647001,659000,11999,False,87,scaffold_9
7,660001,665000,4999,False,87,scaffold_9
8,671001,697000,25999,False,87,scaffold_9
9,732001,742000,9999,False,87,scaffold_9
10,794001,803000,8999,False,87,scaffold_9
11,814001,842000,27999,False,87,scaffold_9
12,883001,986000,102999,False,87,scaffold_9
13,987001,995000,7999,False,87,scaffold_9
14,1001001,1007000,5999,False,87,scaffold_9
15,1009001,1085000,75999,False,87,scaffold_9
16,1087001,1150000,62999,False,87,scaffold_9
17,1151001,1178000,26999,False,87,scaffold_9
18,1311001,1378000,66999,False,87,scaffold_9
19,1764001,1791000,26999,False,87,scaffold_9
20,1987001,2034000,46999,False,87,scaffold_9
21,2074001,2133000,58999,False,87,scaffold_9
22,2596001,2632000,35999,False,87,scaffold_9
23,2735001,3381000,645999,False,87,scaffold_9
24,3383001,5107000,1723999,False,87,scaffold_9
25,5112001,5115000,2999,False,87,scaffold_9
26,5116001,5238000,121999,False,87,scaffold_9
27,5239001,5490000,250999,False,87,scaffold_9
28,5493001,6331288,838287,True,87,scaffold_9
0,1,235000,234999,True,87,scaffold_10
1,257001,414000,156999,False,87,scaffold_10
2,415001,438000,22999,False,87,scaffold_10
3,472001,482000,9999,False,87,scaffold_10
4,483001,577000,93999,False,87,scaffold_10
5,600001,877000,276999,False,87,scaffold_10
6,888001,1069000,180999,False,87,scaffold_10
7,1073001,1141000,67999,False,87,scaffold_10
8,1313001,1338000,24999,False,87,scaffold_10
9,1370001,1465000,94999,False,87,scaffold_10
10,1803001,1822000,18999,False,87,scaffold_10
11,2087001,2103000,15999,False,87,scaffold_10
12,2136001,2167000,30999,False,87,scaffold_10
13,2211001,2227000,15999,False,87,scaffold_10
14,2336001,2372000,35999,False,87,scaffold_10
15,2514001,2520000,5999,False,87,scaffold_10
16,2601001,2652000,50999,False,87,scaffold_10
17,2674001,2694000,19999,False,87,scaffold_10
18,4051001,4091000,39999,False,87,scaffold_10
19,4154001,4175000,20999,False,87,scaffold_10
20,4335001,4365000,29999,False,87,scaffold_10
21,4443001,4462000,18999,False,87,scaffold_10
22,4467001,4476000,8999,False,87,scaffold_10
23,4503001,4513000,9999,False,87,scaffold_10
24,4527001,4548000,20999,False,87,scaffold_10
25,4574001,4597000,22999,False,87,scaffold_10
26,4679001,4688000,8999,False,87,scaffold_10
27,4734001,4766000,31999,False,87,scaffold_10
28,4768001,4776000,7999,False,87,scaffold_10
29,4798001,4824000,25999,False,87,scaffold_10
30,4827001,4843000,15999,False,87,scaffold_10
31,4848001,4861000,12999,False,87,scaffold_10
32,4865001,4866973,1972,True,87,scaffold_10
0,11001,93000,81999,False,87,scaffold_11
1,143001,167000,23999,False,87,scaffold_11
2,169001,191000,21999,False,87,scaffold_11
3,213001,235000,21999,False,87,scaffold_11
4,240001,252000,11999,False,87,scaffold_11
5,293001,317000,23999,False,87,scaffold_11
6,419001,431000,11999,False,87,scaffold_11
7,651001,656000,4999,False,87,scaffold_11
8,1474001,1478000,3999,False,87,scaffold_11
9,2701001,2878000,176999,False,87,scaffold_11
10,2957001,3017000,59999,False,87,scaffold_11
11,3086001,3181000,94999,False,87,scaffold_11
12,3184001,3383000,198999,False,87,scaffold_11
13,3463001,3480000,16999,False,87,scaffold_11
14,3522001,3651000,128999,False,87,scaffold_11
15,3702001,3932000,229999,False,87,scaffold_11
16,4009001,4159000,149999,False,87,scaffold_11
17,4183001,4710000,526999,False,87,scaffold_11
18,4713001,4766820,53819,True,87,scaffold_11
0,1,393000,392999,True,87,scaffold_12
1,404001,439000,34999,False,87,scaffold_12
2,473001,1498000,1024999,False,87,scaffold_12
3,1720001,1733000,12999,False,87,scaffold_12
4,2045001,2103000,57999,False,87,scaffold_12
5,2459001,2477000,17999,False,87,scaffold_12
6,2571001,2618000,46999,False,87,scaffold_12
0,1,342000,341999,True,88,scaffold_1
1,482001,498000,15999,False,88,scaffold_1
2,574001,643000,68999,False,88,scaffold_1
3,686001,743000,56999,False,88,scaffold_1
4,1281001,1292000,10999,False,88,scaffold_1
5,1814001,1899000,84999,False,88,scaffold_1
6,1952001,1964000,11999,False,88,scaffold_1
7,1965001,1984000,18999,False,88,scaffold_1
8,2449001,2517000,67999,False,88,scaffold_1
9,2564001,2579000,14999,False,88,scaffold_1
10,2729001,2746000,16999,False,88,scaffold_1
11,3180001,3209000,28999,False,88,scaffold_1
12,3714001,3737000,22999,False,88,scaffold_1
13,3909001,3941000,31999,False,88,scaffold_1
14,4060001,4111000,50999,False,88,scaffold_1
15,4315001,4355000,39999,False,88,scaffold_1
16,4927001,5021000,93999,False,88,scaffold_1
17,5481001,5511000,29999,False,88,scaffold_1
18,5536001,5570000,33999,False,88,scaffold_1
19,6108001,6153000,44999,False,88,scaffold_1
20,6228001,6381000,152999,False,88,scaffold_1
21,6383001,6507000,123999,False,88,scaffold_1
22,6542001,6575000,32999,False,88,scaffold_1
23,7038001,7247000,208999,False,88,scaffold_1
24,7248001,7584000,335999,False,88,scaffold_1
25,7590001,8656000,1065999,False,88,scaffold_1
26,8658001,9584000,925999,False,88,scaffold_1
27,9586001,10357000,770999,False,88,scaffold_1
28,10461001,10636000,174999,False,88,scaffold_1
29,10808001,10811000,2999,False,88,scaffold_1
30,10832001,10858000,25999,False,88,scaffold_1
31,11351001,11504000,152999,False,88,scaffold_1
32,11614001,11951000,336999,False,88,scaffold_1
33,12184001,12204000,19999,False,88,scaffold_1
34,12652001,12722000,69999,False,88,scaffold_1
35,12777001,12888000,110999,False,88,scaffold_1
36,13114001,13134000,19999,False,88,scaffold_1
37,13178001,13211000,32999,False,88,scaffold_1
38,13347001,13432000,84999,False,88,scaffold_1
39,13819001,13827000,7999,False,88,scaffold_1
40,14285001,14307000,21999,False,88,scaffold_1
41,14471001,14479000,7999,False,88,scaffold_1
0,22001,48000,25999,False,88,scaffold_2
1,93001,159000,65999,False,88,scaffold_2
2,168001,177000,8999,False,88,scaffold_2
3,330001,374000,43999,False,88,scaffold_2
4,2088001,2093000,4999,False,88,scaffold_2
5,2336001,2358000,21999,False,88,scaffold_2
6,2404001,2424000,19999,False,88,scaffold_2
7,2441001,2593000,151999,False,88,scaffold_2
8,2660001,2689000,28999,False,88,scaffold_2
9,2694001,2742000,47999,False,88,scaffold_2
10,2868001,2900000,31999,False,88,scaffold_2
11,2993001,3012000,18999,False,88,scaffold_2
12,3174001,3186000,11999,False,88,scaffold_2
13,3451001,3465000,13999,False,88,scaffold_2
14,3754001,3783000,28999,False,88,scaffold_2
15,4382001,4409000,26999,False,88,scaffold_2
16,4427001,4457000,29999,False,88,scaffold_2
17,4520001,4657000,136999,False,88,scaffold_2
18,4918001,4937000,18999,False,88,scaffold_2
19,5022001,5031000,8999,False,88,scaffold_2
20,5033001,5067000,33999,False,88,scaffold_2
21,5371001,5393000,21999,False,88,scaffold_2
22,5491001,5514000,22999,False,88,scaffold_2
23,5658001,5704000,45999,False,88,scaffold_2
24,5719001,5758000,38999,False,88,scaffold_2
25,6261001,6330000,68999,False,88,scaffold_2
26,6331001,6350000,18999,False,88,scaffold_2
27,6430001,6447000,16999,False,88,scaffold_2
28,6592001,6628000,35999,False,88,scaffold_2
29,7439001,7473000,33999,False,88,scaffold_2
30,7563001,7697000,133999,False,88,scaffold_2
31,7786001,7890000,103999,False,88,scaffold_2
32,7934001,8161000,226999,False,88,scaffold_2
33,8267001,8294000,26999,False,88,scaffold_2
34,8331001,8333000,1999,False,88,scaffold_2
35,8335001,8344000,8999,False,88,scaffold_2
36,8346001,8454000,107999,False,88,scaffold_2
37,8495001,8560000,64999,False,88,scaffold_2
38,11366001,11381000,14999,False,88,scaffold_2
39,11520001,11786000,265999,False,88,scaffold_2
0,618001,646000,27999,False,88,scaffold_3
1,798001,900000,101999,False,88,scaffold_3
2,2015001,2108000,92999,False,88,scaffold_3
3,2109001,2116000,6999,False,88,scaffold_3
4,2291001,2321000,29999,False,88,scaffold_3
5,2485001,2533000,47999,False,88,scaffold_3
6,2650001,2683000,32999,False,88,scaffold_3
7,3769001,3821000,51999,False,88,scaffold_3
8,3822001,3891000,68999,False,88,scaffold_3
9,4108001,4403000,294999,False,88,scaffold_3
10,4410001,4518000,107999,False,88,scaffold_3
11,4547001,4558000,10999,False,88,scaffold_3
12,4652001,4680000,27999,False,88,scaffold_3
13,5985001,6023000,37999,False,88,scaffold_3
14,6908001,6962000,53999,False,88,scaffold_3
15,6963001,7089000,125999,False,88,scaffold_3
16,7518001,7556000,37999,False,88,scaffold_3
17,7692001,7799000,106999,False,88,scaffold_3
18,7818001,7854000,35999,False,88,scaffold_3
19,8177001,8253000,75999,False,88,scaffold_3
20,8462001,8515000,52999,False,88,scaffold_3
21,8517001,8528000,10999,False,88,scaffold_3
22,8575001,8594000,18999,False,88,scaffold_3
23,9968001,9996000,27999,False,88,scaffold_3
24,10461001,10483000,21999,False,88,scaffold_3
25,10587001,11165000,577999,False,88,scaffold_3
0,17001,32000,14999,False,88,scaffold_4
1,48001,88000,39999,False,88,scaffold_4
2,147001,151000,3999,False,88,scaffold_4
3,163001,215000,51999,False,88,scaffold_4
4,217001,226000,8999,False,88,scaffold_4
5,227001,258000,30999,False,88,scaffold_4
6,259001,266000,6999,False,88,scaffold_4
7,318001,344000,25999,False,88,scaffold_4
8,355001,374000,18999,False,88,scaffold_4
9,375001,380000,4999,False,88,scaffold_4
10,396001,410000,13999,False,88,scaffold_4
11,411001,425000,13999,False,88,scaffold_4
12,429001,498000,68999,False,88,scaffold_4
13,545001,599000,53999,False,88,scaffold_4
14,600001,606000,5999,False,88,scaffold_4
15,608001,691000,82999,False,88,scaffold_4
16,695001,697000,1999,False,88,scaffold_4
17,701001,714000,12999,False,88,scaffold_4
18,1121001,1136000,14999,False,88,scaffold_4
19,1137001,1198000,60999,False,88,scaffold_4
20,1199001,1208000,8999,False,88,scaffold_4
21,1210001,1226000,15999,False,88,scaffold_4
22,1236001,1253000,16999,False,88,scaffold_4
23,1265001,1279000,13999,False,88,scaffold_4
24,1283001,1336000,52999,False,88,scaffold_4
25,1372001,1597000,224999,False,88,scaffold_4
26,1613001,1957000,343999,False,88,scaffold_4
27,1958001,2004000,45999,False,88,scaffold_4
28,2029001,2069000,39999,False,88,scaffold_4
29,2071001,2117000,45999,False,88,scaffold_4
30,2142001,2185000,42999,False,88,scaffold_4
31,2219001,2246000,26999,False,88,scaffold_4
32,2247001,2280000,32999,False,88,scaffold_4
33,2283001,2339000,55999,False,88,scaffold_4
34,2393001,2460000,66999,False,88,scaffold_4
35,2477001,2635000,157999,False,88,scaffold_4
36,3104001,3125000,20999,False,88,scaffold_4
37,3336001,3761000,424999,False,88,scaffold_4
38,4941001,4985000,43999,False,88,scaffold_4
39,5172001,5223000,50999,False,88,scaffold_4
40,5477001,5506000,28999,False,88,scaffold_4
41,5513001,5620000,106999,False,88,scaffold_4
42,5661001,5784000,122999,False,88,scaffold_4
43,5786001,5822000,35999,False,88,scaffold_4
44,6156001,6190000,33999,False,88,scaffold_4
45,6802001,6817000,14999,False,88,scaffold_4
46,6902001,6924000,21999,False,88,scaffold_4
47,6973001,6995000,21999,False,88,scaffold_4
48,7037001,7062000,24999,False,88,scaffold_4
49,7227001,7267000,39999,False,88,scaffold_4
50,8846001,9699000,852999,False,88,scaffold_4
51,9703001,9845951,142950,True,88,scaffold_4
0,1,4000,3999,True,88,scaffold_5
1,191001,204000,12999,False,88,scaffold_5
2,296001,300000,3999,False,88,scaffold_5
3,318001,326000,7999,False,88,scaffold_5
4,327001,393000,65999,False,88,scaffold_5
5,463001,485000,21999,False,88,scaffold_5
6,498001,523000,24999,False,88,scaffold_5
7,934001,947000,12999,False,88,scaffold_5
8,2473001,2493000,19999,False,88,scaffold_5
9,2565001,2583000,17999,False,88,scaffold_5
10,2625001,2744000,118999,False,88,scaffold_5
11,2815001,2871000,55999,False,88,scaffold_5
12,3134001,3185000,50999,False,88,scaffold_5
13,3217001,3255000,37999,False,88,scaffold_5
14,3322001,3514000,191999,False,88,scaffold_5
15,3962001,4101000,138999,False,88,scaffold_5
16,4121001,4219000,97999,False,88,scaffold_5
17,4235001,4262000,26999,False,88,scaffold_5
18,4446001,4505000,58999,False,88,scaffold_5
19,4603001,4861000,257999,False,88,scaffold_5
20,4904001,4917000,12999,False,88,scaffold_5
21,5316001,5346000,29999,False,88,scaffold_5
22,6408001,6420000,11999,False,88,scaffold_5
23,6504001,6653000,148999,False,88,scaffold_5
24,6889001,6905000,15999,False,88,scaffold_5
25,7373001,7386000,12999,False,88,scaffold_5
26,7454001,7483000,28999,False,88,scaffold_5
27,7580001,7654000,73999,False,88,scaffold_5
28,8570001,8597000,26999,False,88,scaffold_5
29,8667001,8689000,21999,False,88,scaffold_5
30,8713001,9363000,649999,False,88,scaffold_5
0,79001,84000,4999,False,88,scaffold_6
1,86001,112000,25999,False,88,scaffold_6
2,239001,254000,14999,False,88,scaffold_6
3,257001,262000,4999,False,88,scaffold_6
4,1147001,1197000,49999,False,88,scaffold_6
5,1236001,1258000,21999,False,88,scaffold_6
6,1479001,1546000,66999,False,88,scaffold_6
7,1567001,1594000,26999,False,88,scaffold_6
8,1866001,1906000,39999,False,88,scaffold_6
9,2023001,2087000,63999,False,88,scaffold_6
10,2130001,2195000,64999,False,88,scaffold_6
11,2336001,2595000,258999,False,88,scaffold_6
12,2596001,2653000,56999,False,88,scaffold_6
13,2660001,2691000,30999,False,88,scaffold_6
14,2712001,2851000,138999,False,88,scaffold_6
15,2937001,3016000,78999,False,88,scaffold_6
16,3115001,3191000,75999,False,88,scaffold_6
17,3223001,3301000,77999,False,88,scaffold_6
18,3407001,3428000,20999,False,88,scaffold_6
19,3461001,3521000,59999,False,88,scaffold_6
20,3529001,3787000,257999,False,88,scaffold_6
21,3892001,3913000,20999,False,88,scaffold_6
22,4018001,4069000,50999,False,88,scaffold_6
23,4080001,4192000,111999,False,88,scaffold_6
24,6010001,6063000,52999,False,88,scaffold_6
25,6141001,6189000,47999,False,88,scaffold_6
26,7267001,7337000,69999,False,88,scaffold_6
27,7389001,7436000,46999,False,88,scaffold_6
28,7550001,8268281,718280,True,88,scaffold_6
0,14001,31000,16999,False,88,scaffold_7
1,323001,340000,16999,False,88,scaffold_7
2,342001,508000,165999,False,88,scaffold_7
3,554001,563000,8999,False,88,scaffold_7
4,571001,577000,5999,False,88,scaffold_7
5,706001,724000,17999,False,88,scaffold_7
6,725001,736000,10999,False,88,scaffold_7
7,743001,753000,9999,False,88,scaffold_7
8,764001,829000,64999,False,88,scaffold_7
9,830001,843000,12999,False,88,scaffold_7
10,859001,864000,4999,False,88,scaffold_7
11,964001,966000,1999,False,88,scaffold_7
12,968001,980000,11999,False,88,scaffold_7
13,982001,1044000,61999,False,88,scaffold_7
14,1071001,1101000,29999,False,88,scaffold_7
15,1204001,1512000,307999,False,88,scaffold_7
16,1588001,1695000,106999,False,88,scaffold_7
17,3326001,3369000,42999,False,88,scaffold_7
18,3520001,3551000,30999,False,88,scaffold_7
19,3593001,3767000,173999,False,88,scaffold_7
20,4418001,4536000,117999,False,88,scaffold_7
21,4659001,4681000,21999,False,88,scaffold_7
22,4687001,4736000,48999,False,88,scaffold_7
23,4978001,5149000,170999,False,88,scaffold_7
24,5482001,5536000,53999,False,88,scaffold_7
25,5609001,5647000,37999,False,88,scaffold_7
26,6953001,7270000,316999,False,88,scaffold_7
27,7271001,7502216,231215,True,88,scaffold_7
0,67001,85000,17999,False,88,scaffold_8
1,2444001,2470000,25999,False,88,scaffold_8
2,2492001,2524000,31999,False,88,scaffold_8
3,2651001,2683000,31999,False,88,scaffold_8
4,2741001,2844000,102999,False,88,scaffold_8
5,3058001,3125000,66999,False,88,scaffold_8
6,3126001,3525000,398999,False,88,scaffold_8
7,3579001,3612000,32999,False,88,scaffold_8
8,3615001,3938000,322999,False,88,scaffold_8
9,4037001,4099000,61999,False,88,scaffold_8
10,5083001,5136000,52999,False,88,scaffold_8
11,5196001,5244000,47999,False,88,scaffold_8
12,5678001,5693000,14999,False,88,scaffold_8
13,6322001,6334544,12543,True,88,scaffold_8
0,109001,117000,7999,False,88,scaffold_9
1,300001,315000,14999,False,88,scaffold_9
2,319001,332000,12999,False,88,scaffold_9
3,366001,411000,44999,False,88,scaffold_9
4,413001,434000,20999,False,88,scaffold_9
5,504001,531000,26999,False,88,scaffold_9
6,547001,563000,15999,False,88,scaffold_9
7,671001,696000,24999,False,88,scaffold_9
8,732001,742000,9999,False,88,scaffold_9
9,794001,803000,8999,False,88,scaffold_9
10,815001,842000,26999,False,88,scaffold_9
11,850001,854000,3999,False,88,scaffold_9
12,873001,986000,112999,False,88,scaffold_9
13,988001,995000,6999,False,88,scaffold_9
14,1001001,1007000,5999,False,88,scaffold_9
15,1009001,1031000,21999,False,88,scaffold_9
16,1036001,1085000,48999,False,88,scaffold_9
17,1087001,1150000,62999,False,88,scaffold_9
18,1151001,1160000,8999,False,88,scaffold_9
19,1312001,1378000,65999,False,88,scaffold_9
20,1600001,1622000,21999,False,88,scaffold_9
21,1765001,1790000,24999,False,88,scaffold_9
22,2595001,2616000,20999,False,88,scaffold_9
23,2744001,2757000,12999,False,88,scaffold_9
24,2781001,2803000,21999,False,88,scaffold_9
25,2845001,3381000,535999,False,88,scaffold_9
26,3383001,5107000,1723999,False,88,scaffold_9
27,5112001,5114000,1999,False,88,scaffold_9
28,5116001,5238000,121999,False,88,scaffold_9
29,5239001,5298000,58999,False,88,scaffold_9
30,5300001,5491000,190999,False,88,scaffold_9
31,5493001,6331288,838287,True,88,scaffold_9
0,1,199000,198999,True,88,scaffold_10
1,269001,414000,144999,False,88,scaffold_10
2,415001,482000,66999,False,88,scaffold_10
3,483001,580000,96999,False,88,scaffold_10
4,603001,758000,154999,False,88,scaffold_10
5,782001,794000,11999,False,88,scaffold_10
6,888001,921000,32999,False,88,scaffold_10
7,923001,962000,38999,False,88,scaffold_10
8,1073001,1111000,37999,False,88,scaffold_10
9,2141001,2170000,28999,False,88,scaffold_10
10,2268001,2302000,33999,False,88,scaffold_10
11,2346001,2368000,21999,False,88,scaffold_10
12,2736001,2745000,8999,False,88,scaffold_10
13,4053001,4091000,37999,False,88,scaffold_10
14,4154001,4174000,19999,False,88,scaffold_10
15,4443001,4462000,18999,False,88,scaffold_10
16,4467001,4477000,9999,False,88,scaffold_10
17,4503001,4513000,9999,False,88,scaffold_10
18,4515001,4523000,7999,False,88,scaffold_10
19,4526001,4548000,21999,False,88,scaffold_10
20,4574001,4596000,21999,False,88,scaffold_10
21,4681001,4688000,6999,False,88,scaffold_10
22,4734001,4776000,41999,False,88,scaffold_10
23,4798001,4824000,25999,False,88,scaffold_10
24,4827001,4843000,15999,False,88,scaffold_10
25,4848001,4861000,12999,False,88,scaffold_10
26,4865001,4866973,1972,True,88,scaffold_10
0,10001,34000,23999,False,88,scaffold_11
1,40001,93000,52999,False,88,scaffold_11
2,149001,167000,17999,False,88,scaffold_11
3,169001,191000,21999,False,88,scaffold_11
4,214001,235000,20999,False,88,scaffold_11
5,240001,247000,6999,False,88,scaffold_11
6,419001,431000,11999,False,88,scaffold_11
7,648001,656000,7999,False,88,scaffold_11
8,781001,785000,3999,False,88,scaffold_11
9,1025001,1034000,8999,False,88,scaffold_11
10,1403001,1409000,5999,False,88,scaffold_11
11,1423001,1426000,2999,False,88,scaffold_11
12,1474001,1477000,2999,False,88,scaffold_11
13,2701001,2874000,172999,False,88,scaffold_11
14,2983001,3011000,27999,False,88,scaffold_11
15,3092001,3142000,49999,False,88,scaffold_11
16,3187001,3292000,104999,False,88,scaffold_11
17,3328001,3384000,55999,False,88,scaffold_11
18,3524001,3651000,126999,False,88,scaffold_11
19,3702001,3834000,131999,False,88,scaffold_11
20,3835001,3929000,93999,False,88,scaffold_11
21,4004001,4071000,66999,False,88,scaffold_11
22,4134001,4159000,24999,False,88,scaffold_11
23,4190001,4710000,519999,False,88,scaffold_11
24,4713001,4766820,53819,True,88,scaffold_11
0,1,857000,856999,True,88,scaffold_12
1,865001,1469000,603999,False,88,scaffold_12
2,1720001,1733000,12999,False,88,scaffold_12
3,2560001,2566000,5999,False,88,scaffold_12
4,2571001,2609000,37999,False,88,scaffold_12
5,2685001,2698000,12999,False,88,scaffold_12
0,1,389000,388999,True,89,scaffold_1
1,482001,499000,16999,False,89,scaffold_1
2,571001,643000,71999,False,89,scaffold_1
3,686001,905000,218999,False,89,scaffold_1
4,1062001,1088000,25999,False,89,scaffold_1
5,1168001,1294000,125999,False,89,scaffold_1
6,1615001,1660000,44999,False,89,scaffold_1
7,1719001,1984000,264999,False,89,scaffold_1
8,1986001,2021000,34999,False,89,scaffold_1
9,2291001,2391000,99999,False,89,scaffold_1
10,2395001,2415000,19999,False,89,scaffold_1
11,2447001,2582000,134999,False,89,scaffold_1
12,2652001,2676000,23999,False,89,scaffold_1
13,2724001,2746000,21999,False,89,scaffold_1
14,2902001,2928000,25999,False,89,scaffold_1
15,2976001,3052000,75999,False,89,scaffold_1
16,3172001,3209000,36999,False,89,scaffold_1
17,3277001,3377000,99999,False,89,scaffold_1
18,3445001,3667000,221999,False,89,scaffold_1
19,3685001,3941000,255999,False,89,scaffold_1
20,3942001,4059000,116999,False,89,scaffold_1
21,4060001,4168000,107999,False,89,scaffold_1
22,4312001,4549000,236999,False,89,scaffold_1
23,4640001,4671000,30999,False,89,scaffold_1
24,4705001,4791000,85999,False,89,scaffold_1
25,4796001,5029000,232999,False,89,scaffold_1
26,5037001,5070000,32999,False,89,scaffold_1
27,5083001,5199000,115999,False,89,scaffold_1
28,5345001,5377000,31999,False,89,scaffold_1
29,5436001,5461000,24999,False,89,scaffold_1
30,5481001,5521000,39999,False,89,scaffold_1
31,5529001,5592000,62999,False,89,scaffold_1
32,5822001,5947000,124999,False,89,scaffold_1
33,6030001,6069000,38999,False,89,scaffold_1
34,6108001,6153000,44999,False,89,scaffold_1
35,6154001,6177000,22999,False,89,scaffold_1
36,6201001,6381000,179999,False,89,scaffold_1
37,6382001,6616000,233999,False,89,scaffold_1
38,6712001,6737000,24999,False,89,scaffold_1
39,6831001,6883000,51999,False,89,scaffold_1
40,6931001,6950000,18999,False,89,scaffold_1
41,6974001,6991000,16999,False,89,scaffold_1
42,7038001,7247000,208999,False,89,scaffold_1
43,7248001,7583000,334999,False,89,scaffold_1
44,7586001,7589000,2999,False,89,scaffold_1
45,7590001,8656000,1065999,False,89,scaffold_1
46,8658001,9584000,925999,False,89,scaffold_1
47,9586001,10640000,1053999,False,89,scaffold_1
48,10721001,10756000,34999,False,89,scaffold_1
49,10835001,10857000,21999,False,89,scaffold_1
50,10917001,10991000,73999,False,89,scaffold_1
51,11013001,11070000,56999,False,89,scaffold_1
52,11123001,11251000,127999,False,89,scaffold_1
53,11259001,11964000,704999,False,89,scaffold_1
54,12107001,12244000,136999,False,89,scaffold_1
55,12326001,12380000,53999,False,89,scaffold_1
56,12382001,12396000,13999,False,89,scaffold_1
57,12418001,13068000,649999,False,89,scaffold_1
58,13100001,13216000,115999,False,89,scaffold_1
59,13341001,13455000,113999,False,89,scaffold_1
60,13473001,13496000,22999,False,89,scaffold_1
61,13517001,13610000,92999,False,89,scaffold_1
62,13668001,13710000,41999,False,89,scaffold_1
63,13750001,13768000,17999,False,89,scaffold_1
64,13796001,13845000,48999,False,89,scaffold_1
65,13846001,13875000,28999,False,89,scaffold_1
66,13913001,13927000,13999,False,89,scaffold_1
67,13959001,14005000,45999,False,89,scaffold_1
68,14018001,14041000,22999,False,89,scaffold_1
69,14042001,14082000,39999,False,89,scaffold_1
70,14285001,14307000,21999,False,89,scaffold_1
71,14524001,14591000,66999,False,89,scaffold_1
72,14649001,14664000,14999,False,89,scaffold_1
73,14717001,14726000,8999,False,89,scaffold_1
0,21001,48000,26999,False,89,scaffold_2
1,93001,159000,65999,False,89,scaffold_2
2,165001,177000,11999,False,89,scaffold_2
3,178001,186000,7999,False,89,scaffold_2
4,253001,288000,34999,False,89,scaffold_2
5,296001,318000,21999,False,89,scaffold_2
6,333001,374000,40999,False,89,scaffold_2
7,379001,381000,1999,False,89,scaffold_2
8,388001,402000,13999,False,89,scaffold_2
9,459001,546000,86999,False,89,scaffold_2
10,732001,739000,6999,False,89,scaffold_2
11,1118001,1137000,18999,False,89,scaffold_2
12,1232001,1260000,27999,False,89,scaffold_2
13,1310001,1340000,29999,False,89,scaffold_2
14,1352001,1415000,62999,False,89,scaffold_2
15,1439001,1560000,120999,False,89,scaffold_2
16,1625001,1676000,50999,False,89,scaffold_2
17,1687001,1721000,33999,False,89,scaffold_2
18,1806001,1861000,54999,False,89,scaffold_2
19,1873001,1897000,23999,False,89,scaffold_2
20,2083001,2151000,67999,False,89,scaffold_2
21,2302001,2334000,31999,False,89,scaffold_2
22,2336001,2608000,271999,False,89,scaffold_2
23,2627001,2639000,11999,False,89,scaffold_2
24,2645001,2689000,43999,False,89,scaffold_2
25,2693001,2747000,53999,False,89,scaffold_2
26,2767001,2776000,8999,False,89,scaffold_2
27,2777001,2857000,79999,False,89,scaffold_2
28,2868001,3021000,152999,False,89,scaffold_2
29,3022001,3047000,24999,False,89,scaffold_2
30,3261001,3284000,22999,False,89,scaffold_2
31,3331001,3413000,81999,False,89,scaffold_2
32,3449001,3696000,246999,False,89,scaffold_2
33,3754001,3847000,92999,False,89,scaffold_2
34,3857001,3954000,96999,False,89,scaffold_2
35,4093001,4149000,55999,False,89,scaffold_2
36,4164001,4194000,29999,False,89,scaffold_2
37,4204001,4409000,204999,False,89,scaffold_2
38,4426001,4790000,363999,False,89,scaffold_2
39,4793001,4814000,20999,False,89,scaffold_2
40,4911001,4980000,68999,False,89,scaffold_2
41,5020001,5104000,83999,False,89,scaffold_2
42,5173001,5764000,590999,False,89,scaffold_2
43,5820001,6059000,238999,False,89,scaffold_2
44,6095001,6350000,254999,False,89,scaffold_2
45,6384001,6477000,92999,False,89,scaffold_2
46,6553001,6632000,78999,False,89,scaffold_2
47,6692001,6758000,65999,False,89,scaffold_2
48,6800001,6887000,86999,False,89,scaffold_2
49,6938001,6997000,58999,False,89,scaffold_2
50,6999001,7097000,97999,False,89,scaffold_2
51,7168001,7193000,24999,False,89,scaffold_2
52,7340001,7475000,134999,False,89,scaffold_2
53,7491001,7518000,26999,False,89,scaffold_2
54,7549001,7561000,11999,False,89,scaffold_2
55,7563001,8328000,764999,False,89,scaffold_2
56,8331001,8333000,1999,False,89,scaffold_2
57,8334001,8345000,10999,False,89,scaffold_2
58,8346001,8565000,218999,False,89,scaffold_2
59,8808001,8827000,18999,False,89,scaffold_2
60,8984001,9095000,110999,False,89,scaffold_2
61,9139001,9175000,35999,False,89,scaffold_2
62,9237001,9382000,144999,False,89,scaffold_2
63,9533001,9548000,14999,False,89,scaffold_2
64,9555001,9636000,80999,False,89,scaffold_2
65,9674001,9697000,22999,False,89,scaffold_2
66,9761001,9828000,66999,False,89,scaffold_2
67,10404001,10495000,90999,False,89,scaffold_2
68,10638001,10736000,97999,False,89,scaffold_2
69,10774001,10813000,38999,False,89,scaffold_2
70,10859001,10887000,27999,False,89,scaffold_2
71,10939001,10962000,22999,False,89,scaffold_2
72,11041001,11123000,81999,False,89,scaffold_2
73,11367001,11426000,58999,False,89,scaffold_2
74,11453001,11496000,42999,False,89,scaffold_2
75,11517001,11787000,269999,False,89,scaffold_2
76,11797001,11802476,5475,True,89,scaffold_2
0,540001,548000,7999,False,89,scaffold_3
1,618001,646000,27999,False,89,scaffold_3
2,798001,900000,101999,False,89,scaffold_3
3,1163001,1192000,28999,False,89,scaffold_3
4,1207001,1226000,18999,False,89,scaffold_3
5,1584001,1588000,3999,False,89,scaffold_3
6,1590001,1629000,38999,False,89,scaffold_3
7,1630001,1672000,41999,False,89,scaffold_3
8,1692001,1709000,16999,False,89,scaffold_3
9,1722001,1784000,61999,False,89,scaffold_3
10,1837001,1889000,51999,False,89,scaffold_3
11,1891001,1931000,39999,False,89,scaffold_3
12,1951001,1980000,28999,False,89,scaffold_3
13,2005001,2108000,102999,False,89,scaffold_3
14,2110001,2336000,225999,False,89,scaffold_3
15,2396001,2428000,31999,False,89,scaffold_3
16,2433001,2559000,125999,False,89,scaffold_3
17,2561001,2609000,47999,False,89,scaffold_3
18,2620001,2815000,194999,False,89,scaffold_3
19,2897001,2944000,46999,False,89,scaffold_3
20,3051001,3062000,10999,False,89,scaffold_3
21,3066001,3290000,223999,False,89,scaffold_3
22,3409001,3439000,29999,False,89,scaffold_3
23,3498001,3747000,248999,False,89,scaffold_3
24,3768001,3891000,122999,False,89,scaffold_3
25,3926001,4403000,476999,False,89,scaffold_3
26,4407001,4518000,110999,False,89,scaffold_3
27,4546001,4558000,11999,False,89,scaffold_3
28,4651001,4681000,29999,False,89,scaffold_3
29,4776001,4805000,28999,False,89,scaffold_3
30,4842001,4926000,83999,False,89,scaffold_3
31,4962001,4984000,21999,False,89,scaffold_3
32,4996001,5039000,42999,False,89,scaffold_3
33,5044001,5125000,80999,False,89,scaffold_3
34,5154001,5295000,140999,False,89,scaffold_3
35,5349001,5509000,159999,False,89,scaffold_3
36,5511001,5533000,21999,False,89,scaffold_3
37,5542001,5676000,133999,False,89,scaffold_3
38,5678001,6092000,413999,False,89,scaffold_3
39,6225001,6243000,17999,False,89,scaffold_3
40,6277001,6298000,20999,False,89,scaffold_3
41,6542001,6573000,30999,False,89,scaffold_3
42,6741001,6807000,65999,False,89,scaffold_3
43,6886001,7157000,270999,False,89,scaffold_3
44,7223001,7318000,94999,False,89,scaffold_3
45,7332001,7445000,112999,False,89,scaffold_3
46,7449001,7459000,9999,False,89,scaffold_3
47,7462001,7561000,98999,False,89,scaffold_3
48,7588001,7943000,354999,False,89,scaffold_3
49,8028001,8116000,87999,False,89,scaffold_3
50,8121001,8160000,38999,False,89,scaffold_3
51,8176001,8366000,189999,False,89,scaffold_3
52,8378001,8449000,70999,False,89,scaffold_3
53,8462001,8626000,163999,False,89,scaffold_3
54,8659001,8678000,18999,False,89,scaffold_3
55,8757001,8771000,13999,False,89,scaffold_3
56,8953001,9254000,300999,False,89,scaffold_3
57,9464001,9623000,158999,False,89,scaffold_3
58,9645001,9688000,42999,False,89,scaffold_3
59,9773001,9808000,34999,False,89,scaffold_3
60,9871001,9940000,68999,False,89,scaffold_3
61,9965001,9996000,30999,False,89,scaffold_3
62,10061001,10087000,25999,False,89,scaffold_3
63,10461001,10484000,22999,False,89,scaffold_3
64,10550001,10572000,21999,False,89,scaffold_3
65,10574001,11182071,608070,True,89,scaffold_3
0,1,7000,6999,True,89,scaffold_4
1,11001,13000,1999,False,89,scaffold_4
2,14001,16000,1999,False,89,scaffold_4
3,17001,32000,14999,False,89,scaffold_4
4,48001,89000,40999,False,89,scaffold_4
5,132001,151000,18999,False,89,scaffold_4
6,155001,160000,4999,False,89,scaffold_4
7,161001,215000,53999,False,89,scaffold_4
8,217001,226000,8999,False,89,scaffold_4
9,227001,266000,38999,False,89,scaffold_4
10,290001,311000,20999,False,89,scaffold_4
11,313001,353000,39999,False,89,scaffold_4
12,355001,374000,18999,False,89,scaffold_4
13,375001,380000,4999,False,89,scaffold_4
14,412001,425000,12999,False,89,scaffold_4
15,429001,498000,68999,False,89,scaffold_4
16,542001,592000,49999,False,89,scaffold_4
17,593001,606000,12999,False,89,scaffold_4
18,608001,691000,82999,False,89,scaffold_4
19,695001,697000,1999,False,89,scaffold_4
20,701001,726000,24999,False,89,scaffold_4
21,1087001,1097000,9999,False,89,scaffold_4
22,1098001,1110000,11999,False,89,scaffold_4
23,1113001,1136000,22999,False,89,scaffold_4
24,1137001,1226000,88999,False,89,scaffold_4
25,1229001,1253000,23999,False,89,scaffold_4
26,1254001,1279000,24999,False,89,scaffold_4
27,1283001,1604000,320999,False,89,scaffold_4
28,1613001,2205000,591999,False,89,scaffold_4
29,2219001,2461000,241999,False,89,scaffold_4
30,2476001,2815000,338999,False,89,scaffold_4
31,2847001,2871000,23999,False,89,scaffold_4
32,2890001,3332000,441999,False,89,scaffold_4
33,3334001,3785000,450999,False,89,scaffold_4
34,3828001,4046000,217999,False,89,scaffold_4
35,4048001,4147000,98999,False,89,scaffold_4
36,4172001,4197000,24999,False,89,scaffold_4
37,4242001,4308000,65999,False,89,scaffold_4
38,4817001,5105000,287999,False,89,scaffold_4
39,5170001,5224000,53999,False,89,scaffold_4
40,5269001,5506000,236999,False,89,scaffold_4
41,5514001,5784000,269999,False,89,scaffold_4
42,5786001,5999000,212999,False,89,scaffold_4
43,6048001,6116000,67999,False,89,scaffold_4
44,6146001,6245000,98999,False,89,scaffold_4
45,6285001,6538000,252999,False,89,scaffold_4
46,6705001,6924000,218999,False,89,scaffold_4
47,6926001,7455000,528999,False,89,scaffold_4
48,7457001,7570000,112999,False,89,scaffold_4
49,7628001,7667000,38999,False,89,scaffold_4
50,7843001,7923000,79999,False,89,scaffold_4
51,7972001,8015000,42999,False,89,scaffold_4
52,8049001,8139000,89999,False,89,scaffold_4
53,8653001,8678000,24999,False,89,scaffold_4
54,8738001,8770000,31999,False,89,scaffold_4
55,8775001,8819000,43999,False,89,scaffold_4
56,8845001,9699000,853999,False,89,scaffold_4
57,9700001,9845951,145950,True,89,scaffold_4
0,318001,431000,112999,False,89,scaffold_5
1,462001,523000,60999,False,89,scaffold_5
2,639001,699000,59999,False,89,scaffold_5
3,836001,843000,6999,False,89,scaffold_5
4,906001,947000,40999,False,89,scaffold_5
5,1062001,1113000,50999,False,89,scaffold_5
6,1362001,1394000,31999,False,89,scaffold_5
7,1626001,1632000,5999,False,89,scaffold_5
8,1668001,1684000,15999,False,89,scaffold_5
9,2082001,2104000,21999,False,89,scaffold_5
10,2264001,2303000,38999,False,89,scaffold_5
11,2470001,2496000,25999,False,89,scaffold_5
12,2516001,2900000,383999,False,89,scaffold_5
13,2922001,3035000,112999,False,89,scaffold_5
14,3049001,3066000,16999,False,89,scaffold_5
15,3133001,3520000,386999,False,89,scaffold_5
16,3532001,3563000,30999,False,89,scaffold_5
17,3584001,3658000,73999,False,89,scaffold_5
18,3824001,3948000,123999,False,89,scaffold_5
19,3961001,4101000,139999,False,89,scaffold_5
20,4118001,4437000,318999,False,89,scaffold_5
21,4446001,4993000,546999,False,89,scaffold_5
22,5007001,5177000,169999,False,89,scaffold_5
23,5217001,5346000,128999,False,89,scaffold_5
24,5510001,5528000,17999,False,89,scaffold_5
25,5694001,5738000,43999,False,89,scaffold_5
26,5874001,5886000,11999,False,89,scaffold_5
27,6392001,6726000,333999,False,89,scaffold_5
28,6763001,6854000,90999,False,89,scaffold_5
29,6881001,6968000,86999,False,89,scaffold_5
30,7034001,7086000,51999,False,89,scaffold_5
31,7097001,7100000,2999,False,89,scaffold_5
32,7168001,7275000,106999,False,89,scaffold_5
33,7291001,7330000,38999,False,89,scaffold_5
34,7334001,7364000,29999,False,89,scaffold_5
35,7408001,7442000,33999,False,89,scaffold_5
36,7454001,7513000,58999,False,89,scaffold_5
37,7523001,7619000,95999,False,89,scaffold_5
38,7621001,7897000,275999,False,89,scaffold_5
39,8258001,8266000,7999,False,89,scaffold_5
40,8408001,8469000,60999,False,89,scaffold_5
41,8540001,8616000,75999,False,89,scaffold_5
42,8658001,8687000,28999,False,89,scaffold_5
43,8702001,9364176,662175,True,89,scaffold_5
0,65001,75000,9999,False,89,scaffold_6
1,78001,84000,5999,False,89,scaffold_6
2,86001,114000,27999,False,89,scaffold_6
3,142001,209000,66999,False,89,scaffold_6
4,240001,254000,13999,False,89,scaffold_6
5,256001,321000,64999,False,89,scaffold_6
6,443001,497000,53999,False,89,scaffold_6
7,590001,596000,5999,False,89,scaffold_6
8,618001,665000,46999,False,89,scaffold_6
9,696001,760000,63999,False,89,scaffold_6
10,780001,810000,29999,False,89,scaffold_6
11,833001,848000,14999,False,89,scaffold_6
12,906001,1049000,142999,False,89,scaffold_6
13,1119001,1265000,145999,False,89,scaffold_6
14,1284001,1368000,83999,False,89,scaffold_6
15,1379001,1603000,223999,False,89,scaffold_6
16,1657001,1778000,120999,False,89,scaffold_6
17,1793001,1906000,112999,False,89,scaffold_6
18,1907001,1953000,45999,False,89,scaffold_6
19,1977001,1994000,16999,False,89,scaffold_6
20,2023001,2212000,188999,False,89,scaffold_6
21,2236001,2595000,358999,False,89,scaffold_6
22,2596001,2872000,275999,False,89,scaffold_6
23,2933001,3210000,276999,False,89,scaffold_6
24,3221001,3350000,128999,False,89,scaffold_6
25,3351001,3806000,454999,False,89,scaffold_6
26,3809001,3926000,116999,False,89,scaffold_6
27,3965001,4207000,241999,False,89,scaffold_6
28,4252001,4327000,74999,False,89,scaffold_6
29,4448001,4482000,33999,False,89,scaffold_6
30,4631001,4661000,29999,False,89,scaffold_6
31,4698001,4755000,56999,False,89,scaffold_6
32,4816001,4919000,102999,False,89,scaffold_6
33,4924001,5006000,81999,False,89,scaffold_6
34,5288001,5338000,49999,False,89,scaffold_6
35,5374001,5409000,34999,False,89,scaffold_6
36,5433001,5469000,35999,False,89,scaffold_6
37,5617001,5752000,134999,False,89,scaffold_6
38,5862001,6097000,234999,False,89,scaffold_6
39,6124001,6278000,153999,False,89,scaffold_6
40,6476001,6505000,28999,False,89,scaffold_6
41,6569001,6613000,43999,False,89,scaffold_6
42,6685001,6716000,30999,False,89,scaffold_6
43,6754001,6858000,103999,False,89,scaffold_6
44,6911001,7100000,188999,False,89,scaffold_6
45,7184001,7338000,153999,False,89,scaffold_6
46,7389001,7530000,140999,False,89,scaffold_6
47,7531001,8268281,737280,True,89,scaffold_6
0,1,8000,7999,True,89,scaffold_7
1,13001,34000,20999,False,89,scaffold_7
2,50001,60000,9999,False,89,scaffold_7
3,321001,340000,18999,False,89,scaffold_7
4,342001,509000,166999,False,89,scaffold_7
5,571001,579000,7999,False,89,scaffold_7
6,614001,642000,27999,False,89,scaffold_7
7,650001,675000,24999,False,89,scaffold_7
8,688001,736000,47999,False,89,scaffold_7
9,740001,753000,12999,False,89,scaffold_7
10,763001,829000,65999,False,89,scaffold_7
11,830001,843000,12999,False,89,scaffold_7
12,859001,864000,4999,False,89,scaffold_7
13,867001,948000,80999,False,89,scaffold_7
14,950001,963000,12999,False,89,scaffold_7
15,964001,966000,1999,False,89,scaffold_7
16,968001,980000,11999,False,89,scaffold_7
17,982001,1044000,61999,False,89,scaffold_7
18,1048001,1104000,55999,False,89,scaffold_7
19,1170001,1187000,16999,False,89,scaffold_7
20,1191001,1522000,330999,False,89,scaffold_7
21,1578001,1782000,203999,False,89,scaffold_7
22,1783001,1790000,6999,False,89,scaffold_7
23,1816001,1890000,73999,False,89,scaffold_7
24,1907001,1932000,24999,False,89,scaffold_7
25,1965001,2055000,89999,False,89,scaffold_7
26,2223001,2252000,28999,False,89,scaffold_7
27,2366001,2410000,43999,False,89,scaffold_7
28,2443001,2465000,21999,False,89,scaffold_7
29,2541001,2701000,159999,False,89,scaffold_7
30,2702001,2710000,7999,False,89,scaffold_7
31,2728001,2737000,8999,False,89,scaffold_7
32,2803001,2879000,75999,False,89,scaffold_7
33,2931001,2958000,26999,False,89,scaffold_7
34,3005001,3024000,18999,False,89,scaffold_7
35,3096001,3244000,147999,False,89,scaffold_7
36,3246001,3271000,24999,False,89,scaffold_7
37,3297001,3421000,123999,False,89,scaffold_7
38,3519001,3970000,450999,False,89,scaffold_7
39,4021001,4079000,57999,False,89,scaffold_7
40,4109001,4122000,12999,False,89,scaffold_7
41,4332001,4517000,184999,False,89,scaffold_7
42,4520001,4580000,59999,False,89,scaffold_7
43,4630001,5202000,571999,False,89,scaffold_7
44,5370001,5434000,63999,False,89,scaffold_7
45,5470001,5645000,174999,False,89,scaffold_7
46,5814001,5932000,117999,False,89,scaffold_7
47,5933001,5994000,60999,False,89,scaffold_7
48,6038001,6281000,242999,False,89,scaffold_7
49,6329001,6370000,40999,False,89,scaffold_7
50,6467001,6522000,54999,False,89,scaffold_7
51,6535001,6742000,206999,False,89,scaffold_7
52,6746001,6840000,93999,False,89,scaffold_7
53,6944001,7270000,325999,False,89,scaffold_7
54,7271001,7502216,231215,True,89,scaffold_7
0,1,6000,5999,True,89,scaffold_8
1,67001,85000,17999,False,89,scaffold_8
2,820001,822000,1999,False,89,scaffold_8
3,1362001,1426000,63999,False,89,scaffold_8
4,1858001,1964000,105999,False,89,scaffold_8
5,2014001,2056000,41999,False,89,scaffold_8
6,2058001,2184000,125999,False,89,scaffold_8
7,2300001,2844000,543999,False,89,scaffold_8
8,2847001,2928000,80999,False,89,scaffold_8
9,2948001,3125000,176999,False,89,scaffold_8
10,3126001,3614000,487999,False,89,scaffold_8
11,3615001,4268000,652999,False,89,scaffold_8
12,4329001,4432000,102999,False,89,scaffold_8
13,4566001,4679000,112999,False,89,scaffold_8
14,4724001,4960000,235999,False,89,scaffold_8
15,4983001,5051000,67999,False,89,scaffold_8
16,5069001,5271000,201999,False,89,scaffold_8
17,5400001,5482000,81999,False,89,scaffold_8
18,5524001,5597000,72999,False,89,scaffold_8
19,5649001,5712000,62999,False,89,scaffold_8
20,5728001,5804000,75999,False,89,scaffold_8
21,5817001,6163000,345999,False,89,scaffold_8
22,6214001,6334544,120543,True,89,scaffold_8
0,109001,119000,9999,False,89,scaffold_9
1,121001,138000,16999,False,89,scaffold_9
2,236001,243000,6999,False,89,scaffold_9
3,271001,276000,4999,False,89,scaffold_9
4,366001,411000,44999,False,89,scaffold_9
5,413001,434000,20999,False,89,scaffold_9
6,484001,531000,46999,False,89,scaffold_9
7,547001,563000,15999,False,89,scaffold_9
8,669001,697000,27999,False,89,scaffold_9
9,814001,842000,27999,False,89,scaffold_9
10,872001,881000,8999,False,89,scaffold_9
11,883001,986000,102999,False,89,scaffold_9
12,988001,995000,6999,False,89,scaffold_9
13,1001001,1007000,5999,False,89,scaffold_9
14,1008001,1085000,76999,False,89,scaffold_9
15,1087001,1150000,62999,False,89,scaffold_9
16,1151001,1196000,44999,False,89,scaffold_9
17,1202001,1257000,54999,False,89,scaffold_9
18,1312001,1386000,73999,False,89,scaffold_9
19,1428001,1438000,9999,False,89,scaffold_9
20,1457001,1466000,8999,False,89,scaffold_9
21,1486001,1592000,105999,False,89,scaffold_9
22,1593001,1621000,27999,False,89,scaffold_9
23,1637001,1692000,54999,False,89,scaffold_9
24,1731001,1808000,76999,False,89,scaffold_9
25,1823001,1856000,32999,False,89,scaffold_9
26,1885001,1953000,67999,False,89,scaffold_9
27,1971001,2135000,163999,False,89,scaffold_9
28,2137001,2372000,234999,False,89,scaffold_9
29,2388001,2443000,54999,False,89,scaffold_9
30,2509001,2580000,70999,False,89,scaffold_9
31,2584001,3381000,796999,False,89,scaffold_9
32,3383001,5107000,1723999,False,89,scaffold_9
33,5112001,5114000,1999,False,89,scaffold_9
34,5116001,5238000,121999,False,89,scaffold_9
35,5239001,5298000,58999,False,89,scaffold_9
36,5300001,5490000,189999,False,89,scaffold_9
37,5493001,6331288,838287,True,89,scaffold_9
0,1,414000,413999,True,89,scaffold_10
1,415001,482000,66999,False,89,scaffold_10
2,483001,585000,101999,False,89,scaffold_10
3,596001,881000,284999,False,89,scaffold_10
4,883001,921000,37999,False,89,scaffold_10
5,923001,1068000,144999,False,89,scaffold_10
6,1073001,1212000,138999,False,89,scaffold_10
7,1312001,1760000,447999,False,89,scaffold_10
8,1809001,1816000,6999,False,89,scaffold_10
9,1860001,1919000,58999,False,89,scaffold_10
10,2012001,2110000,97999,False,89,scaffold_10
11,2141001,2181000,39999,False,89,scaffold_10
12,2197001,2476000,278999,False,89,scaffold_10
13,2502001,2653000,150999,False,89,scaffold_10
14,2671001,2708000,36999,False,89,scaffold_10
15,2716001,2811000,94999,False,89,scaffold_10
16,2817001,2868000,50999,False,89,scaffold_10
17,2920001,3015000,94999,False,89,scaffold_10
18,3080001,3179000,98999,False,89,scaffold_10
19,3307001,3350000,42999,False,89,scaffold_10
20,3481001,3525000,43999,False,89,scaffold_10
21,3559001,3583000,23999,False,89,scaffold_10
22,3775001,3795000,19999,False,89,scaffold_10
23,4052001,4091000,38999,False,89,scaffold_10
24,4156001,4182000,25999,False,89,scaffold_10
25,4235001,4242000,6999,False,89,scaffold_10
26,4316001,4324000,7999,False,89,scaffold_10
27,4334001,4366000,31999,False,89,scaffold_10
28,4389001,4411000,21999,False,89,scaffold_10
29,4445001,4462000,16999,False,89,scaffold_10
30,4467001,4502000,34999,False,89,scaffold_10
31,4503001,4513000,9999,False,89,scaffold_10
32,4515001,4523000,7999,False,89,scaffold_10
33,4526001,4548000,21999,False,89,scaffold_10
34,4565001,4598000,32999,False,89,scaffold_10
35,4734001,4766000,31999,False,89,scaffold_10
36,4767001,4776000,8999,False,89,scaffold_10
37,4798001,4824000,25999,False,89,scaffold_10
38,4828001,4843000,14999,False,89,scaffold_10
39,4848001,4861000,12999,False,89,scaffold_10
40,4865001,4866973,1972,True,89,scaffold_10
0,10001,91000,80999,False,89,scaffold_11
1,132001,168000,35999,False,89,scaffold_11
2,169001,212000,42999,False,89,scaffold_11
3,213001,236000,22999,False,89,scaffold_11
4,239001,248000,8999,False,89,scaffold_11
5,296001,313000,16999,False,89,scaffold_11
6,419001,431000,11999,False,89,scaffold_11
7,648001,656000,7999,False,89,scaffold_11
8,1219001,1243000,23999,False,89,scaffold_11
9,1315001,1398000,82999,False,89,scaffold_11
10,1403001,1409000,5999,False,89,scaffold_11
11,1423001,1427000,3999,False,89,scaffold_11
12,1431001,1469000,37999,False,89,scaffold_11
13,1474001,1478000,3999,False,89,scaffold_11
14,1526001,1544000,17999,False,89,scaffold_11
15,1572001,1599000,26999,False,89,scaffold_11
16,1764001,1802000,37999,False,89,scaffold_11
17,1854001,1870000,15999,False,89,scaffold_11
18,1872001,2058000,185999,False,89,scaffold_11
19,2087001,2172000,84999,False,89,scaffold_11
20,2177001,2225000,47999,False,89,scaffold_11
21,2660001,2920000,259999,False,89,scaffold_11
22,2952001,3027000,74999,False,89,scaffold_11
23,3083001,3972000,888999,False,89,scaffold_11
24,3984001,4710000,725999,False,89,scaffold_11
25,4713001,4766820,53819,True,89,scaffold_11
0,1,1509000,1508999,True,89,scaffold_12
1,1559001,1589000,29999,False,89,scaffold_12
2,1640001,1667000,26999,False,89,scaffold_12
3,1720001,1733000,12999,False,89,scaffold_12
4,1784001,2041000,256999,False,89,scaffold_12
5,2043001,2110000,66999,False,89,scaffold_12
6,2131001,2192000,60999,False,89,scaffold_12
7,2340001,2377000,36999,False,89,scaffold_12
8,2571001,2610000,38999,False,89,scaffold_12
9,2710001,2722000,11999,False,89,scaffold_12
0,1,342000,341999,True,90,scaffold_1
1,482001,498000,15999,False,90,scaffold_1
2,571001,643000,71999,False,90,scaffold_1
3,686001,756000,69999,False,90,scaffold_1
4,873001,902000,28999,False,90,scaffold_1
5,1277001,1292000,14999,False,90,scaffold_1
6,1828001,1901000,72999,False,90,scaffold_1
7,1951001,1964000,12999,False,90,scaffold_1
8,1965001,1984000,18999,False,90,scaffold_1
9,1986001,2015000,28999,False,90,scaffold_1
10,2355001,2387000,31999,False,90,scaffold_1
11,2449001,2517000,67999,False,90,scaffold_1
12,2564001,2582000,17999,False,90,scaffold_1
13,2729001,2746000,16999,False,90,scaffold_1
14,2902001,2921000,18999,False,90,scaffold_1
15,3174001,3209000,34999,False,90,scaffold_1
16,3446001,3481000,34999,False,90,scaffold_1
17,3702001,3816000,113999,False,90,scaffold_1
18,3847001,3873000,25999,False,90,scaffold_1
19,3901001,3941000,39999,False,90,scaffold_1
20,3979001,4047000,67999,False,90,scaffold_1
21,4060001,4112000,51999,False,90,scaffold_1
22,4313001,4356000,42999,False,90,scaffold_1
23,4796001,4812000,15999,False,90,scaffold_1
24,4927001,5022000,94999,False,90,scaffold_1
25,5482001,5521000,38999,False,90,scaffold_1
26,5534001,5595000,60999,False,90,scaffold_1
27,6108001,6141000,32999,False,90,scaffold_1
28,6201001,6316000,114999,False,90,scaffold_1
29,6331001,6375000,43999,False,90,scaffold_1
30,6384001,6558000,173999,False,90,scaffold_1
31,6640001,6661000,20999,False,90,scaffold_1
32,6790001,6862000,71999,False,90,scaffold_1
33,6928001,6953000,24999,False,90,scaffold_1
34,7037001,7247000,209999,False,90,scaffold_1
35,7248001,7583000,334999,False,90,scaffold_1
36,7590001,7633000,42999,False,90,scaffold_1
37,7634001,8477000,842999,False,90,scaffold_1
38,8478001,8656000,177999,False,90,scaffold_1
39,8658001,9328000,669999,False,90,scaffold_1
40,9329001,9584000,254999,False,90,scaffold_1
41,9586001,10356000,769999,False,90,scaffold_1
42,10467001,10639000,171999,False,90,scaffold_1
43,10740001,10754000,13999,False,90,scaffold_1
44,10832001,10857000,24999,False,90,scaffold_1
45,11281001,11819000,537999,False,90,scaffold_1
46,11842001,11962000,119999,False,90,scaffold_1
47,12189001,12203000,13999,False,90,scaffold_1
48,12329001,12368000,38999,False,90,scaffold_1
49,12425001,12450000,24999,False,90,scaffold_1
50,12497001,12548000,50999,False,90,scaffold_1
51,12629001,12758000,128999,False,90,scaffold_1
52,12785001,12888000,102999,False,90,scaffold_1
53,12970001,13002000,31999,False,90,scaffold_1
54,13101001,13210000,108999,False,90,scaffold_1
55,13345001,13442000,96999,False,90,scaffold_1
56,13673001,13709000,35999,False,90,scaffold_1
57,13796001,13841000,44999,False,90,scaffold_1
58,13915001,13927000,11999,False,90,scaffold_1
59,13948001,13954000,5999,False,90,scaffold_1
60,13958001,14005000,46999,False,90,scaffold_1
61,14007001,14066000,58999,False,90,scaffold_1
62,14292001,14313000,20999,False,90,scaffold_1
63,14540001,14562000,21999,False,90,scaffold_1
64,14564001,14591000,26999,False,90,scaffold_1
0,1,48000,47999,True,90,scaffold_2
1,95001,159000,63999,False,90,scaffold_2
2,168001,177000,8999,False,90,scaffold_2
3,314001,318000,3999,False,90,scaffold_2
4,333001,374000,40999,False,90,scaffold_2
5,1593001,1613000,19999,False,90,scaffold_2
6,2085001,2107000,21999,False,90,scaffold_2
7,2336001,2389000,52999,False,90,scaffold_2
8,2404001,2593000,188999,False,90,scaffold_2
9,2627001,2639000,11999,False,90,scaffold_2
10,2658001,2689000,30999,False,90,scaffold_2
11,2694001,2746000,51999,False,90,scaffold_2
12,2886001,2906000,19999,False,90,scaffold_2
13,2993001,3021000,27999,False,90,scaffold_2
14,3022001,3050000,27999,False,90,scaffold_2
15,3335001,3342000,6999,False,90,scaffold_2
16,3449001,3465000,15999,False,90,scaffold_2
17,3661001,3695000,33999,False,90,scaffold_2
18,3754001,3789000,34999,False,90,scaffold_2
19,4242001,4409000,166999,False,90,scaffold_2
20,4426001,4458000,31999,False,90,scaffold_2
21,4511001,4670000,158999,False,90,scaffold_2
22,4711001,4760000,48999,False,90,scaffold_2
23,4793001,4808000,14999,False,90,scaffold_2
24,4918001,4963000,44999,False,90,scaffold_2
25,5021001,5062000,40999,False,90,scaffold_2
26,5080001,5104000,23999,False,90,scaffold_2
27,5350001,5396000,45999,False,90,scaffold_2
28,5413001,5488000,74999,False,90,scaffold_2
29,5490001,5519000,28999,False,90,scaffold_2
30,5658001,5758000,99999,False,90,scaffold_2
31,5840001,5892000,51999,False,90,scaffold_2
32,5916001,5986000,69999,False,90,scaffold_2
33,6005001,6053000,47999,False,90,scaffold_2
34,6261001,6330000,68999,False,90,scaffold_2
35,6331001,6351000,19999,False,90,scaffold_2
36,6373001,6449000,75999,False,90,scaffold_2
37,6588001,6631000,42999,False,90,scaffold_2
38,7001001,7037000,35999,False,90,scaffold_2
39,7428001,7473000,44999,False,90,scaffold_2
40,7491001,7516000,24999,False,90,scaffold_2
41,7549001,7561000,11999,False,90,scaffold_2
42,7572001,7697000,124999,False,90,scaffold_2
43,7768001,7919000,150999,False,90,scaffold_2
44,7933001,8313000,379999,False,90,scaffold_2
45,8346001,8449000,102999,False,90,scaffold_2
46,8495001,8563000,67999,False,90,scaffold_2
47,9013001,9047000,33999,False,90,scaffold_2
48,9140001,9174000,33999,False,90,scaffold_2
49,11520001,11786000,265999,False,90,scaffold_2
0,540001,548000,7999,False,90,scaffold_3
1,618001,646000,27999,False,90,scaffold_3
2,794001,900000,105999,False,90,scaffold_3
3,1067001,1084000,16999,False,90,scaffold_3
4,2007001,2108000,100999,False,90,scaffold_3
5,2109001,2116000,6999,False,90,scaffold_3
6,2287001,2336000,48999,False,90,scaffold_3
7,2433001,2532000,98999,False,90,scaffold_3
8,2655001,2688000,32999,False,90,scaffold_3
9,2717001,2732000,14999,False,90,scaffold_3
10,3067001,3140000,72999,False,90,scaffold_3
11,3247001,3277000,29999,False,90,scaffold_3
12,3604001,3643000,38999,False,90,scaffold_3
13,3713001,3735000,21999,False,90,scaffold_3
14,3768001,3891000,122999,False,90,scaffold_3
15,3911001,3921000,9999,False,90,scaffold_3
16,4108001,4398000,289999,False,90,scaffold_3
17,4418001,4518000,99999,False,90,scaffold_3
18,4547001,4558000,10999,False,90,scaffold_3
19,4652001,4679000,26999,False,90,scaffold_3
20,4999001,5038000,38999,False,90,scaffold_3
21,5154001,5207000,52999,False,90,scaffold_3
22,5234001,5274000,39999,False,90,scaffold_3
23,5376001,5450000,73999,False,90,scaffold_3
24,5493001,5505000,11999,False,90,scaffold_3
25,5590001,5672000,81999,False,90,scaffold_3
26,5808001,5946000,137999,False,90,scaffold_3
27,5977001,6024000,46999,False,90,scaffold_3
28,6741001,6782000,40999,False,90,scaffold_3
29,6888001,6962000,73999,False,90,scaffold_3
30,6963001,6972000,8999,False,90,scaffold_3
31,6978001,7087000,108999,False,90,scaffold_3
32,7112001,7157000,44999,False,90,scaffold_3
33,7279001,7301000,21999,False,90,scaffold_3
34,7335001,7399000,63999,False,90,scaffold_3
35,7518001,7556000,37999,False,90,scaffold_3
36,7577001,7622000,44999,False,90,scaffold_3
37,7676001,7872000,195999,False,90,scaffold_3
38,8034001,8114000,79999,False,90,scaffold_3
39,8183001,8253000,69999,False,90,scaffold_3
40,8427001,8528000,100999,False,90,scaffold_3
41,8575001,8594000,18999,False,90,scaffold_3
42,8956001,8980000,23999,False,90,scaffold_3
43,9005001,9080000,74999,False,90,scaffold_3
44,9465001,9535000,69999,False,90,scaffold_3
45,9968001,9996000,27999,False,90,scaffold_3
46,10068001,10087000,18999,False,90,scaffold_3
47,10551001,10570000,18999,False,90,scaffold_3
48,10590001,11166000,575999,False,90,scaffold_3
0,22001,32000,9999,False,90,scaffold_4
1,48001,88000,39999,False,90,scaffold_4
2,120001,146000,25999,False,90,scaffold_4
3,147001,151000,3999,False,90,scaffold_4
4,155001,216000,60999,False,90,scaffold_4
5,217001,226000,8999,False,90,scaffold_4
6,230001,266000,35999,False,90,scaffold_4
7,285001,303000,17999,False,90,scaffold_4
8,355001,374000,18999,False,90,scaffold_4
9,375001,380000,4999,False,90,scaffold_4
10,389001,411000,21999,False,90,scaffold_4
11,412001,425000,12999,False,90,scaffold_4
12,429001,501000,71999,False,90,scaffold_4
13,542001,592000,49999,False,90,scaffold_4
14,593001,606000,12999,False,90,scaffold_4
15,608001,691000,82999,False,90,scaffold_4
16,1087001,1097000,9999,False,90,scaffold_4
17,1120001,1136000,15999,False,90,scaffold_4
18,1137001,1226000,88999,False,90,scaffold_4
19,1229001,1253000,23999,False,90,scaffold_4
20,1254001,1279000,24999,False,90,scaffold_4
21,1283001,1392000,108999,False,90,scaffold_4
22,1393001,1605000,211999,False,90,scaffold_4
23,1613001,2006000,392999,False,90,scaffold_4
24,2007001,2118000,110999,False,90,scaffold_4
25,2119001,2141000,21999,False,90,scaffold_4
26,2142001,2205000,62999,False,90,scaffold_4
27,2210001,2218000,7999,False,90,scaffold_4
28,2219001,2246000,26999,False,90,scaffold_4
29,2247001,2461000,213999,False,90,scaffold_4
30,2477001,2675000,197999,False,90,scaffold_4
31,2676001,2800000,123999,False,90,scaffold_4
32,2891001,2956000,64999,False,90,scaffold_4
33,3030001,3127000,96999,False,90,scaffold_4
34,3334001,3784000,449999,False,90,scaffold_4
35,4055001,4085000,29999,False,90,scaffold_4
36,4901001,5089000,187999,False,90,scaffold_4
37,5169001,5224000,54999,False,90,scaffold_4
38,5338001,5506000,167999,False,90,scaffold_4
39,5514001,5828000,313999,False,90,scaffold_4
40,6145001,6195000,49999,False,90,scaffold_4
41,6287001,6372000,84999,False,90,scaffold_4
42,6764001,6817000,52999,False,90,scaffold_4
43,6842001,6924000,81999,False,90,scaffold_4
44,6950001,6995000,44999,False,90,scaffold_4
45,7036001,7124000,87999,False,90,scaffold_4
46,7133001,7174000,40999,False,90,scaffold_4
47,7192001,7304000,111999,False,90,scaffold_4
48,7352001,7431000,78999,False,90,scaffold_4
49,7629001,7665000,35999,False,90,scaffold_4
50,7977001,8000000,22999,False,90,scaffold_4
51,8049001,8078000,28999,False,90,scaffold_4
52,8848001,9514000,665999,False,90,scaffold_4
53,9515001,9699000,183999,False,90,scaffold_4
54,9702001,9845951,143950,True,90,scaffold_4
0,1,4000,3999,True,90,scaffold_5
1,321001,326000,4999,False,90,scaffold_5
2,327001,398000,70999,False,90,scaffold_5
3,463001,524000,60999,False,90,scaffold_5
4,669001,697000,27999,False,90,scaffold_5
5,836001,838000,1999,False,90,scaffold_5
6,839001,842000,2999,False,90,scaffold_5
7,844001,857000,12999,False,90,scaffold_5
8,933001,947000,13999,False,90,scaffold_5
9,2475001,2498000,22999,False,90,scaffold_5
10,2563001,2826000,262999,False,90,scaffold_5
11,2827001,2871000,43999,False,90,scaffold_5
12,3125001,3250000,124999,False,90,scaffold_5
13,3310001,3512000,201999,False,90,scaffold_5
14,3621001,3659000,37999,False,90,scaffold_5
15,3834001,3875000,40999,False,90,scaffold_5
16,3962001,3999000,36999,False,90,scaffold_5
17,4002001,4101000,98999,False,90,scaffold_5
18,4122001,4379000,256999,False,90,scaffold_5
19,4445001,4554000,108999,False,90,scaffold_5
20,4600001,4862000,261999,False,90,scaffold_5
21,4892001,4915000,22999,False,90,scaffold_5
22,5055001,5083000,27999,False,90,scaffold_5
23,5217001,5275000,57999,False,90,scaffold_5
24,5283001,5346000,62999,False,90,scaffold_5
25,6397001,6439000,41999,False,90,scaffold_5
26,6481001,6514000,32999,False,90,scaffold_5
27,6515001,6671000,155999,False,90,scaffold_5
28,6881001,6906000,24999,False,90,scaffold_5
29,7097001,7100000,2999,False,90,scaffold_5
30,7172001,7241000,68999,False,90,scaffold_5
31,7299001,7327000,27999,False,90,scaffold_5
32,7454001,7512000,57999,False,90,scaffold_5
33,7559001,7619000,59999,False,90,scaffold_5
34,7621001,7654000,32999,False,90,scaffold_5
35,8258001,8260000,1999,False,90,scaffold_5
36,8416001,8468000,51999,False,90,scaffold_5
37,8553001,8616000,62999,False,90,scaffold_5
38,8639001,8689000,49999,False,90,scaffold_5
39,8702001,9275000,572999,False,90,scaffold_5
40,9276001,9307000,30999,False,90,scaffold_5
41,9308001,9364176,56175,True,90,scaffold_5
0,65001,75000,9999,False,90,scaffold_6
1,78001,121000,42999,False,90,scaffold_6
2,153001,208000,54999,False,90,scaffold_6
3,238001,254000,15999,False,90,scaffold_6
4,256001,297000,40999,False,90,scaffold_6
5,368001,376000,7999,False,90,scaffold_6
6,467001,497000,29999,False,90,scaffold_6
7,553001,568000,14999,False,90,scaffold_6
8,598001,601000,2999,False,90,scaffold_6
9,1146001,1226000,79999,False,90,scaffold_6
10,1229001,1256000,26999,False,90,scaffold_6
11,1284001,1311000,26999,False,90,scaffold_6
12,1421001,1455000,33999,False,90,scaffold_6
13,1478001,1546000,67999,False,90,scaffold_6
14,1658001,1716000,57999,False,90,scaffold_6
15,1867001,1905000,37999,False,90,scaffold_6
16,2025001,2104000,78999,False,90,scaffold_6
17,2130001,2211000,80999,False,90,scaffold_6
18,2237001,2283000,45999,False,90,scaffold_6
19,2333001,2595000,261999,False,90,scaffold_6
20,2596001,2872000,275999,False,90,scaffold_6
21,2933001,3031000,97999,False,90,scaffold_6
22,3115001,3209000,93999,False,90,scaffold_6
23,3222001,3788000,565999,False,90,scaffold_6
24,3831001,3845000,13999,False,90,scaffold_6
25,3968001,4195000,226999,False,90,scaffold_6
26,4842001,4868000,25999,False,90,scaffold_6
27,4898001,4916000,17999,False,90,scaffold_6
28,5718001,5743000,24999,False,90,scaffold_6
29,6008001,6090000,81999,False,90,scaffold_6
30,6124001,6195000,70999,False,90,scaffold_6
31,6784001,6804000,19999,False,90,scaffold_6
32,7244001,7335000,90999,False,90,scaffold_6
33,7389001,7436000,46999,False,90,scaffold_6
34,7542001,8268281,726280,True,90,scaffold_6
0,1,9000,8999,True,90,scaffold_7
1,10001,34000,23999,False,90,scaffold_7
2,323001,340000,16999,False,90,scaffold_7
3,342001,508000,165999,False,90,scaffold_7
4,554001,563000,8999,False,90,scaffold_7
5,622001,673000,50999,False,90,scaffold_7
6,689001,703000,13999,False,90,scaffold_7
7,706001,736000,29999,False,90,scaffold_7
8,763001,829000,65999,False,90,scaffold_7
9,830001,843000,12999,False,90,scaffold_7
10,859001,864000,4999,False,90,scaffold_7
11,950001,1044000,93999,False,90,scaffold_7
12,1191001,1460000,268999,False,90,scaffold_7
13,1461001,1510000,48999,False,90,scaffold_7
14,1588001,1616000,27999,False,90,scaffold_7
15,1621001,1696000,74999,False,90,scaffold_7
16,1743001,1780000,36999,False,90,scaffold_7
17,1982001,2010000,27999,False,90,scaffold_7
18,3305001,3370000,64999,False,90,scaffold_7
19,3525001,3808000,282999,False,90,scaffold_7
20,4324001,4363000,38999,False,90,scaffold_7
21,4414001,4512000,97999,False,90,scaffold_7
22,4637001,4745000,107999,False,90,scaffold_7
23,4757001,4759000,1999,False,90,scaffold_7
24,4812001,4855000,42999,False,90,scaffold_7
25,4979001,5149000,169999,False,90,scaffold_7
26,5473001,5584000,110999,False,90,scaffold_7
27,6070001,6094000,23999,False,90,scaffold_7
28,6167001,6246000,78999,False,90,scaffold_7
29,6771001,6786000,14999,False,90,scaffold_7
30,6948001,7270000,321999,False,90,scaffold_7
31,7271001,7502216,231215,True,90,scaffold_7
0,1,6000,5999,True,90,scaffold_8
1,66001,85000,18999,False,90,scaffold_8
2,93001,101000,7999,False,90,scaffold_8
3,728001,732000,3999,False,90,scaffold_8
4,2444001,2552000,107999,False,90,scaffold_8
5,2646001,2683000,36999,False,90,scaffold_8
6,2721001,2844000,122999,False,90,scaffold_8
7,3034001,3612000,577999,False,90,scaffold_8
8,3615001,3871000,255999,False,90,scaffold_8
9,3872001,3947000,74999,False,90,scaffold_8
10,4036001,4119000,82999,False,90,scaffold_8
11,4202001,4221000,18999,False,90,scaffold_8
12,4391001,4433000,41999,False,90,scaffold_8
13,5094001,5241000,146999,False,90,scaffold_8
14,5579001,5595000,15999,False,90,scaffold_8
15,5651001,5710000,58999,False,90,scaffold_8
16,5736001,5738000,1999,False,90,scaffold_8
17,5776001,5804000,27999,False,90,scaffold_8
18,5820001,5877000,56999,False,90,scaffold_8
19,5960001,5997000,36999,False,90,scaffold_8
20,6241001,6302000,60999,False,90,scaffold_8
21,6319001,6334544,15543,True,90,scaffold_8
0,109001,118000,8999,False,90,scaffold_9
1,121001,138000,16999,False,90,scaffold_9
2,358001,411000,52999,False,90,scaffold_9
3,413001,439000,25999,False,90,scaffold_9
4,484001,531000,46999,False,90,scaffold_9
5,547001,563000,15999,False,90,scaffold_9
6,650001,659000,8999,False,90,scaffold_9
7,660001,665000,4999,False,90,scaffold_9
8,670001,697000,26999,False,90,scaffold_9
9,723001,742000,18999,False,90,scaffold_9
10,814001,841000,26999,False,90,scaffold_9
11,886001,986000,99999,False,90,scaffold_9
12,987001,995000,7999,False,90,scaffold_9
13,998001,1085000,86999,False,90,scaffold_9
14,1087001,1094000,6999,False,90,scaffold_9
15,1095001,1177000,81999,False,90,scaffold_9
16,1312001,1391000,78999,False,90,scaffold_9
17,1428001,1437000,8999,False,90,scaffold_9
18,1457001,1464000,6999,False,90,scaffold_9
19,1486001,1500000,13999,False,90,scaffold_9
20,1551001,1585000,33999,False,90,scaffold_9
21,1637001,1679000,41999,False,90,scaffold_9
22,1749001,1791000,41999,False,90,scaffold_9
23,1831001,1855000,23999,False,90,scaffold_9
24,1923001,1941000,17999,False,90,scaffold_9
25,1970001,2133000,162999,False,90,scaffold_9
26,2137001,2170000,32999,False,90,scaffold_9
27,2598001,2684000,85999,False,90,scaffold_9
28,2738001,2837000,98999,False,90,scaffold_9
29,2870001,3381000,510999,False,90,scaffold_9
30,3383001,4770000,1386999,False,90,scaffold_9
31,4771001,5107000,335999,False,90,scaffold_9
32,5112001,5238000,125999,False,90,scaffold_9
33,5239001,5298000,58999,False,90,scaffold_9
34,5300001,5491000,190999,False,90,scaffold_9
35,5493001,6263000,769999,False,90,scaffold_9
36,6264001,6331288,67287,True,90,scaffold_9
0,1,136000,135999,True,90,scaffold_10
1,137001,405000,267999,False,90,scaffold_10
2,419001,582000,162999,False,90,scaffold_10
3,603001,797000,193999,False,90,scaffold_10
4,811001,877000,65999,False,90,scaffold_10
5,888001,963000,74999,False,90,scaffold_10
6,1056001,1069000,12999,False,90,scaffold_10
7,1073001,1147000,73999,False,90,scaffold_10
8,1371001,1474000,102999,False,90,scaffold_10
9,1635001,1674000,38999,False,90,scaffold_10
10,2015001,2111000,95999,False,90,scaffold_10
11,2130001,2172000,41999,False,90,scaffold_10
12,2197001,2300000,102999,False,90,scaffold_10
13,2334001,2475000,140999,False,90,scaffold_10
14,2552001,2634000,81999,False,90,scaffold_10
15,2672001,2712000,39999,False,90,scaffold_10
16,2714001,2733000,18999,False,90,scaffold_10
17,2735001,2813000,77999,False,90,scaffold_10
18,4049001,4087000,37999,False,90,scaffold_10
19,4154001,4174000,19999,False,90,scaffold_10
20,4336001,4359000,22999,False,90,scaffold_10
21,4467001,4502000,34999,False,90,scaffold_10
22,4503001,4513000,9999,False,90,scaffold_10
23,4515001,4548000,32999,False,90,scaffold_10
24,4554001,4562000,7999,False,90,scaffold_10
25,4574001,4597000,22999,False,90,scaffold_10
26,4727001,4732000,4999,False,90,scaffold_10
27,4734001,4776000,41999,False,90,scaffold_10
28,4798001,4824000,25999,False,90,scaffold_10
29,4827001,4843000,15999,False,90,scaffold_10
30,4848001,4861000,12999,False,90,scaffold_10
31,4865001,4866973,1972,True,90,scaffold_10
0,10001,37000,26999,False,90,scaffold_11
1,38001,93000,54999,False,90,scaffold_11
2,143001,167000,23999,False,90,scaffold_11
3,169001,212000,42999,False,90,scaffold_11
4,213001,236000,22999,False,90,scaffold_11
5,240001,252000,11999,False,90,scaffold_11
6,419001,431000,11999,False,90,scaffold_11
7,648001,656000,7999,False,90,scaffold_11
8,767001,773000,5999,False,90,scaffold_11
9,1025001,1034000,8999,False,90,scaffold_11
10,1403001,1409000,5999,False,90,scaffold_11
11,1423001,1426000,2999,False,90,scaffold_11
12,1474001,1478000,3999,False,90,scaffold_11
13,1873001,1884000,10999,False,90,scaffold_11
14,2116001,2172000,55999,False,90,scaffold_11
15,2192001,2223000,30999,False,90,scaffold_11
16,2700001,2878000,177999,False,90,scaffold_11
17,2957001,3019000,61999,False,90,scaffold_11
18,3083001,3176000,92999,False,90,scaffold_11
19,3188001,3383000,194999,False,90,scaffold_11
20,3425001,3480000,54999,False,90,scaffold_11
21,3520001,3693000,172999,False,90,scaffold_11
22,3702001,3927000,224999,False,90,scaffold_11
23,3942001,3972000,29999,False,90,scaffold_11
24,3984001,4159000,174999,False,90,scaffold_11
25,4182001,4286000,103999,False,90,scaffold_11
26,4287001,4766820,479819,True,90,scaffold_11
0,1,496000,495999,True,90,scaffold_12
1,498001,1484000,985999,False,90,scaffold_12
2,1716001,1738000,21999,False,90,scaffold_12
3,1786001,1806000,19999,False,90,scaffold_12
4,2024001,2041000,16999,False,90,scaffold_12
5,2042001,2103000,60999,False,90,scaffold_12
6,2136001,2192000,55999,False,90,scaffold_12
7,2341001,2376000,34999,False,90,scaffold_12
8,2571001,2609000,37999,False,90,scaffold_12
9,2685001,2698000,12999,False,90,scaffold_12
0,1,340000,339999,True,91,scaffold_1
1,482001,498000,15999,False,91,scaffold_1
2,574001,643000,68999,False,91,scaffold_1
3,686001,743000,56999,False,91,scaffold_1
4,1281001,1292000,10999,False,91,scaffold_1
5,1827001,1897000,69999,False,91,scaffold_1
6,1954001,1964000,9999,False,91,scaffold_1
7,1965001,1984000,18999,False,91,scaffold_1
8,1988001,1992000,3999,False,91,scaffold_1
9,2449001,2516000,66999,False,91,scaffold_1
10,2570001,2575000,4999,False,91,scaffold_1
11,2729001,2746000,16999,False,91,scaffold_1
12,3181001,3208000,26999,False,91,scaffold_1
13,3715001,3733000,17999,False,91,scaffold_1
14,3916001,3941000,24999,False,91,scaffold_1
15,4063001,4111000,47999,False,91,scaffold_1
16,4315001,4354000,38999,False,91,scaffold_1
17,4928001,4997000,68999,False,91,scaffold_1
18,5482001,5511000,28999,False,91,scaffold_1
19,6108001,6153000,44999,False,91,scaffold_1
20,6228001,6507000,278999,False,91,scaffold_1
21,6544001,6554000,9999,False,91,scaffold_1
22,7038001,7247000,208999,False,91,scaffold_1
23,7248001,7584000,335999,False,91,scaffold_1
24,7590001,8477000,886999,False,91,scaffold_1
25,8478001,8656000,177999,False,91,scaffold_1
26,8658001,9584000,925999,False,91,scaffold_1
27,9586001,10356000,769999,False,91,scaffold_1
28,10461001,10630000,168999,False,91,scaffold_1
29,10808001,10811000,2999,False,91,scaffold_1
30,10836001,10858000,21999,False,91,scaffold_1
31,11352001,11504000,151999,False,91,scaffold_1
32,11609001,11951000,341999,False,91,scaffold_1
33,12184001,12204000,19999,False,91,scaffold_1
34,12654001,12722000,67999,False,91,scaffold_1
35,12777001,12888000,110999,False,91,scaffold_1
36,13113001,13211000,97999,False,91,scaffold_1
37,13347001,13405000,57999,False,91,scaffold_1
38,14007001,14009000,1999,False,91,scaffold_1
39,14605001,14611000,5999,False,91,scaffold_1
0,22001,48000,25999,False,91,scaffold_2
1,93001,159000,65999,False,91,scaffold_2
2,168001,177000,8999,False,91,scaffold_2
3,302001,318000,15999,False,91,scaffold_2
4,330001,374000,43999,False,91,scaffold_2
5,2336001,2358000,21999,False,91,scaffold_2
6,2405001,2415000,9999,False,91,scaffold_2
7,2416001,2424000,7999,False,91,scaffold_2
8,2441001,2553000,111999,False,91,scaffold_2
9,2660001,2689000,28999,False,91,scaffold_2
10,2694001,2742000,47999,False,91,scaffold_2
11,2997001,3009000,11999,False,91,scaffold_2
12,3454001,3463000,8999,False,91,scaffold_2
13,3768001,3781000,12999,False,91,scaffold_2
14,4385001,4409000,23999,False,91,scaffold_2
15,4427001,4457000,29999,False,91,scaffold_2
16,4524001,4553000,28999,False,91,scaffold_2
17,4607001,4653000,45999,False,91,scaffold_2
18,5022001,5031000,8999,False,91,scaffold_2
19,5033001,5061000,27999,False,91,scaffold_2
20,5491001,5511000,19999,False,91,scaffold_2
21,5672001,5704000,31999,False,91,scaffold_2
22,5719001,5757000,37999,False,91,scaffold_2
23,6261001,6330000,68999,False,91,scaffold_2
24,6331001,6350000,18999,False,91,scaffold_2
25,7439001,7472000,32999,False,91,scaffold_2
26,7563001,7697000,133999,False,91,scaffold_2
27,7786001,7890000,103999,False,91,scaffold_2
28,7934001,7968000,33999,False,91,scaffold_2
29,7981001,8113000,131999,False,91,scaffold_2
30,8331001,8333000,1999,False,91,scaffold_2
31,8346001,8389000,42999,False,91,scaffold_2
32,8509001,8536000,26999,False,91,scaffold_2
33,11366001,11374000,7999,False,91,scaffold_2
34,11520001,11785000,264999,False,91,scaffold_2
0,1,2000,1999,True,91,scaffold_3
1,51001,55000,3999,False,91,scaffold_3
2,102001,104000,1999,False,91,scaffold_3
3,800001,900000,99999,False,91,scaffold_3
4,2085001,2108000,22999,False,91,scaffold_3
5,2110001,2115000,4999,False,91,scaffold_3
6,2291001,2321000,29999,False,91,scaffold_3
7,2487001,2533000,45999,False,91,scaffold_3
8,4109001,4398000,288999,False,91,scaffold_3
9,4418001,4518000,99999,False,91,scaffold_3
10,4546001,4558000,11999,False,91,scaffold_3
11,4654001,4678000,23999,False,91,scaffold_3
12,6907001,6962000,54999,False,91,scaffold_3
13,6980001,7034000,53999,False,91,scaffold_3
14,7449001,7458000,8999,False,91,scaffold_3
15,7538001,7556000,17999,False,91,scaffold_3
16,7692001,7798000,105999,False,91,scaffold_3
17,7822001,7842000,19999,False,91,scaffold_3
18,8177001,8253000,75999,False,91,scaffold_3
19,8462001,8527000,64999,False,91,scaffold_3
20,8575001,8594000,18999,False,91,scaffold_3
21,9968001,9995000,26999,False,91,scaffold_3
22,10461001,10483000,21999,False,91,scaffold_3
23,10587001,11163000,575999,False,91,scaffold_3
0,21001,32000,10999,False,91,scaffold_4
1,49001,88000,38999,False,91,scaffold_4
2,132001,146000,13999,False,91,scaffold_4
3,147001,151000,3999,False,91,scaffold_4
4,155001,160000,4999,False,91,scaffold_4
5,161001,215000,53999,False,91,scaffold_4
6,217001,226000,8999,False,91,scaffold_4
7,227001,266000,38999,False,91,scaffold_4
8,355001,373000,17999,False,91,scaffold_4
9,375001,380000,4999,False,91,scaffold_4
10,412001,425000,12999,False,91,scaffold_4
11,429001,439000,9999,False,91,scaffold_4
12,450001,498000,47999,False,91,scaffold_4
13,545001,592000,46999,False,91,scaffold_4
14,593001,599000,5999,False,91,scaffold_4
15,600001,606000,5999,False,91,scaffold_4
16,608001,661000,52999,False,91,scaffold_4
17,670001,691000,20999,False,91,scaffold_4
18,701001,713000,11999,False,91,scaffold_4
19,1121001,1136000,14999,False,91,scaffold_4
20,1137001,1178000,40999,False,91,scaffold_4
21,1199001,1226000,26999,False,91,scaffold_4
22,1235001,1246000,10999,False,91,scaffold_4
23,1248001,1253000,4999,False,91,scaffold_4
24,1254001,1262000,7999,False,91,scaffold_4
25,1265001,1279000,13999,False,91,scaffold_4
26,1283001,1315000,31999,False,91,scaffold_4
27,1372001,1591000,218999,False,91,scaffold_4
28,1629001,1641000,11999,False,91,scaffold_4
29,1650001,1708000,57999,False,91,scaffold_4
30,1749001,1817000,67999,False,91,scaffold_4
31,1824001,1867000,42999,False,91,scaffold_4
32,1904001,1957000,52999,False,91,scaffold_4
33,1958001,1987000,28999,False,91,scaffold_4
34,2037001,2065000,27999,False,91,scaffold_4
35,2071001,2100000,28999,False,91,scaffold_4
36,2247001,2279000,31999,False,91,scaffold_4
37,2284001,2310000,25999,False,91,scaffold_4
38,2312001,2340000,27999,False,91,scaffold_4
39,2429001,2445000,15999,False,91,scaffold_4
40,2447001,2459000,11999,False,91,scaffold_4
41,2480001,2581000,100999,False,91,scaffold_4
42,3338001,3633000,294999,False,91,scaffold_4
43,3651001,3760000,108999,False,91,scaffold_4
44,4944001,4984000,39999,False,91,scaffold_4
45,5179001,5187000,7999,False,91,scaffold_4
46,5477001,5506000,28999,False,91,scaffold_4
47,5514001,5620000,105999,False,91,scaffold_4
48,5668001,5784000,115999,False,91,scaffold_4
49,6177001,6190000,12999,False,91,scaffold_4
50,6797001,6817000,19999,False,91,scaffold_4
51,6910001,6924000,13999,False,91,scaffold_4
52,7037001,7062000,24999,False,91,scaffold_4
53,8849001,9699000,849999,False,91,scaffold_4
54,9700001,9845951,145950,True,91,scaffold_4
0,1,4000,3999,True,91,scaffold_5
1,318001,326000,7999,False,91,scaffold_5
2,327001,368000,40999,False,91,scaffold_5
3,466001,483000,16999,False,91,scaffold_5
4,495001,523000,27999,False,91,scaffold_5
5,933001,947000,13999,False,91,scaffold_5
6,2565001,2581000,15999,False,91,scaffold_5
7,2619001,2733000,113999,False,91,scaffold_5
8,2816001,2871000,54999,False,91,scaffold_5
9,3136001,3185000,48999,False,91,scaffold_5
10,3322001,3497000,174999,False,91,scaffold_5
11,3962001,4101000,138999,False,91,scaffold_5
12,4121001,4219000,97999,False,91,scaffold_5
13,4246001,4262000,15999,False,91,scaffold_5
14,4446001,4483000,36999,False,91,scaffold_5
15,4601001,4663000,61999,False,91,scaffold_5
16,4691001,4717000,25999,False,91,scaffold_5
17,4789001,4861000,71999,False,91,scaffold_5
18,4904001,4917000,12999,False,91,scaffold_5
19,5318001,5346000,27999,False,91,scaffold_5
20,6516001,6566000,49999,False,91,scaffold_5
21,7097001,7100000,2999,False,91,scaffold_5
22,7373001,7386000,12999,False,91,scaffold_5
23,7622001,7654000,31999,False,91,scaffold_5
24,8676001,8689000,12999,False,91,scaffold_5
25,8730001,9363000,632999,False,91,scaffold_5
0,79001,84000,4999,False,91,scaffold_6
1,86001,113000,26999,False,91,scaffold_6
2,240001,254000,13999,False,91,scaffold_6
3,267001,283000,15999,False,91,scaffold_6
4,1239001,1255000,15999,False,91,scaffold_6
5,1479001,1546000,66999,False,91,scaffold_6
6,2023001,2086000,62999,False,91,scaffold_6
7,2131001,2168000,36999,False,91,scaffold_6
8,2371001,2595000,223999,False,91,scaffold_6
9,2596001,2653000,56999,False,91,scaffold_6
10,2660001,2691000,30999,False,91,scaffold_6
11,2731001,2851000,119999,False,91,scaffold_6
12,2928001,3014000,85999,False,91,scaffold_6
13,3115001,3149000,33999,False,91,scaffold_6
14,3224001,3301000,76999,False,91,scaffold_6
15,3409001,3427000,17999,False,91,scaffold_6
16,3461001,3765000,303999,False,91,scaffold_6
17,3901001,3912000,10999,False,91,scaffold_6
18,4018001,4062000,43999,False,91,scaffold_6
19,4081001,4192000,110999,False,91,scaffold_6
20,6011001,6060000,48999,False,91,scaffold_6
21,7264001,7337000,72999,False,91,scaffold_6
22,7541001,7795000,253999,False,91,scaffold_6
23,7811001,8067000,255999,False,91,scaffold_6
24,8068001,8268281,200280,True,91,scaffold_6
0,1,7000,6999,True,91,scaffold_7
1,13001,31000,17999,False,91,scaffold_7
2,323001,340000,16999,False,91,scaffold_7
3,342001,508000,165999,False,91,scaffold_7
4,554001,563000,8999,False,91,scaffold_7
5,571001,577000,5999,False,91,scaffold_7
6,706001,724000,17999,False,91,scaffold_7
7,725001,736000,10999,False,91,scaffold_7
8,764001,809000,44999,False,91,scaffold_7
9,859001,864000,4999,False,91,scaffold_7
10,964001,966000,1999,False,91,scaffold_7
11,968001,980000,11999,False,91,scaffold_7
12,982001,1044000,61999,False,91,scaffold_7
13,1048001,1098000,49999,False,91,scaffold_7
14,1191001,1512000,320999,False,91,scaffold_7
15,1588001,1688000,99999,False,91,scaffold_7
16,3326001,3369000,42999,False,91,scaffold_7
17,3596001,3659000,62999,False,91,scaffold_7
18,4416001,4535000,118999,False,91,scaffold_7
19,4659001,4680000,20999,False,91,scaffold_7
20,4979001,5030000,50999,False,91,scaffold_7
21,5077001,5111000,33999,False,91,scaffold_7
22,5485001,5535000,49999,False,91,scaffold_7
23,5609001,5627000,17999,False,91,scaffold_7
24,6954001,7270000,315999,False,91,scaffold_7
25,7271001,7502216,231215,True,91,scaffold_7
0,66001,85000,18999,False,91,scaffold_8
1,93001,101000,7999,False,91,scaffold_8
2,2662001,2683000,20999,False,91,scaffold_8
3,2742001,2757000,14999,False,91,scaffold_8
4,3060001,3125000,64999,False,91,scaffold_8
5,3126001,3525000,398999,False,91,scaffold_8
6,3584001,3612000,27999,False,91,scaffold_8
7,3615001,3913000,297999,False,91,scaffold_8
8,5097001,5136000,38999,False,91,scaffold_8
9,5199001,5241000,41999,False,91,scaffold_8
10,6324001,6334544,10543,True,91,scaffold_8
0,109001,117000,7999,False,91,scaffold_9
1,303001,315000,11999,False,91,scaffold_9
2,319001,332000,12999,False,91,scaffold_9
3,367001,411000,43999,False,91,scaffold_9
4,413001,434000,20999,False,91,scaffold_9
5,504001,531000,26999,False,91,scaffold_9
6,548001,563000,14999,False,91,scaffold_9
7,671001,696000,24999,False,91,scaffold_9
8,732001,742000,9999,False,91,scaffold_9
9,814001,842000,27999,False,91,scaffold_9
10,873001,986000,112999,False,91,scaffold_9
11,988001,995000,6999,False,91,scaffold_9
12,1001001,1007000,5999,False,91,scaffold_9
13,1009001,1031000,21999,False,91,scaffold_9
14,1035001,1085000,49999,False,91,scaffold_9
15,1087001,1150000,62999,False,91,scaffold_9
16,1151001,1164000,12999,False,91,scaffold_9
17,1313001,1377000,63999,False,91,scaffold_9
18,1766001,1790000,23999,False,91,scaffold_9
19,2599001,2616000,16999,False,91,scaffold_9
20,2872001,3381000,508999,False,91,scaffold_9
21,3383001,5107000,1723999,False,91,scaffold_9
22,5112001,5115000,2999,False,91,scaffold_9
23,5116001,5238000,121999,False,91,scaffold_9
24,5239001,5298000,58999,False,91,scaffold_9
25,5300001,5490000,189999,False,91,scaffold_9
26,5492001,6331288,839287,True,91,scaffold_9
0,1,136000,135999,True,91,scaffold_10
1,137001,199000,61999,False,91,scaffold_10
2,375001,405000,29999,False,91,scaffold_10
3,472001,482000,9999,False,91,scaffold_10
4,483001,576000,92999,False,91,scaffold_10
5,603001,748000,144999,False,91,scaffold_10
6,888001,916000,27999,False,91,scaffold_10
7,924001,963000,38999,False,91,scaffold_10
8,1087001,1110000,22999,False,91,scaffold_10
9,2346001,2367000,20999,False,91,scaffold_10
10,2735001,2745000,9999,False,91,scaffold_10
11,4054001,4091000,36999,False,91,scaffold_10
12,4154001,4174000,19999,False,91,scaffold_10
13,4443001,4461000,17999,False,91,scaffold_10
14,4506001,4513000,6999,False,91,scaffold_10
15,4515001,4523000,7999,False,91,scaffold_10
16,4526001,4548000,21999,False,91,scaffold_10
17,4576001,4596000,19999,False,91,scaffold_10
18,4680001,4688000,7999,False,91,scaffold_10
19,4734001,4751000,16999,False,91,scaffold_10
20,4752001,4766000,13999,False,91,scaffold_10
21,4767001,4776000,8999,False,91,scaffold_10
22,4798001,4824000,25999,False,91,scaffold_10
23,4828001,4843000,14999,False,91,scaffold_10
24,4848001,4861000,12999,False,91,scaffold_10
25,4865001,4866973,1972,True,91,scaffold_10
0,10001,34000,23999,False,91,scaffold_11
1,40001,93000,52999,False,91,scaffold_11
2,149001,167000,17999,False,91,scaffold_11
3,214001,236000,21999,False,91,scaffold_11
4,419001,431000,11999,False,91,scaffold_11
5,648001,656000,7999,False,91,scaffold_11
6,1025001,1034000,8999,False,91,scaffold_11
7,1423001,1427000,3999,False,91,scaffold_11
8,2701001,2873000,171999,False,91,scaffold_11
9,3212001,3259000,46999,False,91,scaffold_11
10,3331001,3370000,38999,False,91,scaffold_11
11,3702001,3927000,224999,False,91,scaffold_11
12,4309001,4710000,400999,False,91,scaffold_11
13,4713001,4766820,53819,True,91,scaffold_11
0,1,369000,368999,True,91,scaffold_12
1,474001,537000,62999,False,91,scaffold_12
2,582001,856000,273999,False,91,scaffold_12
3,873001,1354000,480999,False,91,scaffold_12
4,1379001,1430000,50999,False,91,scaffold_12
5,1720001,1733000,12999,False,91,scaffold_12
6,2559001,2570000,10999,False,91,scaffold_12
7,2571001,2612000,40999,False,91,scaffold_12
8,2685001,2698000,12999,False,91,scaffold_12
9,2747001,2747968,967,True,91,scaffold_12
0,1,353000,352999,True,92,scaffold_1
1,482001,498000,15999,False,92,scaffold_1
2,570001,643000,72999,False,92,scaffold_1
3,686001,756000,69999,False,92,scaffold_1
4,1281001,1292000,10999,False,92,scaffold_1
5,1608001,1660000,51999,False,92,scaffold_1
6,1661001,1696000,34999,False,92,scaffold_1
7,1812001,1899000,86999,False,92,scaffold_1
8,1951001,1964000,12999,False,92,scaffold_1
9,1965001,1984000,18999,False,92,scaffold_1
10,1988001,2015000,26999,False,92,scaffold_1
11,2363001,2387000,23999,False,92,scaffold_1
12,2449001,2519000,69999,False,92,scaffold_1
13,2565001,2582000,16999,False,92,scaffold_1
14,2726001,2746000,19999,False,92,scaffold_1
15,3173001,3213000,39999,False,92,scaffold_1
16,3443001,3476000,32999,False,92,scaffold_1
17,3713001,3878000,164999,False,92,scaffold_1
18,3901001,3941000,39999,False,92,scaffold_1
19,3956001,4028000,71999,False,92,scaffold_1
20,4063001,4112000,48999,False,92,scaffold_1
21,4313001,4355000,41999,False,92,scaffold_1
22,4796001,4805000,8999,False,92,scaffold_1
23,4922001,5022000,99999,False,92,scaffold_1
24,5088001,5111000,22999,False,92,scaffold_1
25,5165001,5198000,32999,False,92,scaffold_1
26,5436001,5456000,19999,False,92,scaffold_1
27,5481001,5511000,29999,False,92,scaffold_1
28,5535001,5570000,34999,False,92,scaffold_1
29,5856001,5881000,24999,False,92,scaffold_1
30,6108001,6153000,44999,False,92,scaffold_1
31,6154001,6177000,22999,False,92,scaffold_1
32,6201001,6379000,177999,False,92,scaffold_1
33,6384001,6509000,124999,False,92,scaffold_1
34,6542001,6574000,31999,False,92,scaffold_1
35,7038001,7247000,208999,False,92,scaffold_1
36,7248001,7589000,340999,False,92,scaffold_1
37,7590001,8477000,886999,False,92,scaffold_1
38,8478001,8656000,177999,False,92,scaffold_1
39,8658001,9584000,925999,False,92,scaffold_1
40,9586001,10361000,774999,False,92,scaffold_1
41,10461001,10640000,178999,False,92,scaffold_1
42,10808001,10811000,2999,False,92,scaffold_1
43,10920001,10941000,20999,False,92,scaffold_1
44,11015001,11029000,13999,False,92,scaffold_1
45,11278001,11508000,229999,False,92,scaffold_1
46,11556001,11951000,394999,False,92,scaffold_1
47,12184001,12204000,19999,False,92,scaffold_1
48,12553001,12585000,31999,False,92,scaffold_1
49,12652001,12888000,235999,False,92,scaffold_1
50,12974001,12992000,17999,False,92,scaffold_1
51,13017001,13065000,47999,False,92,scaffold_1
52,13113001,13211000,97999,False,92,scaffold_1
53,13347001,13433000,85999,False,92,scaffold_1
54,13817001,13845000,27999,False,92,scaffold_1
55,14134001,14137000,2999,False,92,scaffold_1
56,14285001,14308000,22999,False,92,scaffold_1
57,14648001,14663000,14999,False,92,scaffold_1
58,14690001,14692000,1999,False,92,scaffold_1
0,1,48000,47999,True,92,scaffold_2
1,93001,159000,65999,False,92,scaffold_2
2,168001,177000,8999,False,92,scaffold_2
3,302001,318000,15999,False,92,scaffold_2
4,333001,374000,40999,False,92,scaffold_2
5,732001,739000,6999,False,92,scaffold_2
6,1367001,1401000,33999,False,92,scaffold_2
7,2086001,2110000,23999,False,92,scaffold_2
8,2336001,2607000,270999,False,92,scaffold_2
9,2627001,2639000,11999,False,92,scaffold_2
10,2660001,2689000,28999,False,92,scaffold_2
11,2693001,2746000,52999,False,92,scaffold_2
12,2835001,2855000,19999,False,92,scaffold_2
13,2868001,2906000,37999,False,92,scaffold_2
14,2993001,3021000,27999,False,92,scaffold_2
15,3031001,3043000,11999,False,92,scaffold_2
16,3272001,3282000,9999,False,92,scaffold_2
17,3331001,3344000,12999,False,92,scaffold_2
18,3449001,3466000,16999,False,92,scaffold_2
19,3754001,3790000,35999,False,92,scaffold_2
20,4244001,4275000,30999,False,92,scaffold_2
21,4297001,4409000,111999,False,92,scaffold_2
22,4426001,4458000,31999,False,92,scaffold_2
23,4488001,4659000,170999,False,92,scaffold_2
24,4685001,4790000,104999,False,92,scaffold_2
25,4793001,4805000,11999,False,92,scaffold_2
26,4918001,4959000,40999,False,92,scaffold_2
27,5020001,5068000,47999,False,92,scaffold_2
28,5080001,5104000,23999,False,92,scaffold_2
29,5350001,5393000,42999,False,92,scaffold_2
30,5413001,5481000,67999,False,92,scaffold_2
31,5490001,5514000,23999,False,92,scaffold_2
32,5658001,5759000,100999,False,92,scaffold_2
33,5839001,5887000,47999,False,92,scaffold_2
34,5915001,5992000,76999,False,92,scaffold_2
35,6123001,6155000,31999,False,92,scaffold_2
36,6245001,6330000,84999,False,92,scaffold_2
37,6331001,6350000,18999,False,92,scaffold_2
38,6428001,6454000,25999,False,92,scaffold_2
39,6589001,6628000,38999,False,92,scaffold_2
40,7003001,7039000,35999,False,92,scaffold_2
41,7049001,7097000,47999,False,92,scaffold_2
42,7170001,7197000,26999,False,92,scaffold_2
43,7341001,7473000,131999,False,92,scaffold_2
44,7549001,7561000,11999,False,92,scaffold_2
45,7563001,7698000,134999,False,92,scaffold_2
46,7780001,7916000,135999,False,92,scaffold_2
47,7934001,8199000,264999,False,92,scaffold_2
48,8261001,8314000,52999,False,92,scaffold_2
49,8331001,8333000,1999,False,92,scaffold_2
50,8335001,8344000,8999,False,92,scaffold_2
51,8346001,8451000,104999,False,92,scaffold_2
52,8495001,8564000,68999,False,92,scaffold_2
53,9320001,9382000,61999,False,92,scaffold_2
54,9790001,9828000,37999,False,92,scaffold_2
55,9832001,9889000,56999,False,92,scaffold_2
56,10329001,10353000,23999,False,92,scaffold_2
57,11520001,11786000,265999,False,92,scaffold_2
0,1,2000,1999,True,92,scaffold_3
1,51001,55000,3999,False,92,scaffold_3
2,797001,900000,102999,False,92,scaffold_3
3,2006001,2108000,101999,False,92,scaffold_3
4,2109001,2125000,15999,False,92,scaffold_3
5,2291001,2336000,44999,False,92,scaffold_3
6,2487001,2531000,43999,False,92,scaffold_3
7,2660001,2683000,22999,False,92,scaffold_3
8,2716001,2751000,34999,False,92,scaffold_3
9,3066001,3153000,86999,False,92,scaffold_3
10,3602001,3680000,77999,False,92,scaffold_3
11,3768001,3893000,124999,False,92,scaffold_3
12,3926001,3946000,19999,False,92,scaffold_3
13,4007001,4022000,14999,False,92,scaffold_3
14,4070001,4403000,332999,False,92,scaffold_3
15,4406001,4518000,111999,False,92,scaffold_3
16,4546001,4558000,11999,False,92,scaffold_3
17,4652001,4679000,26999,False,92,scaffold_3
18,4999001,5023000,23999,False,92,scaffold_3
19,5165001,5228000,62999,False,92,scaffold_3
20,5231001,5272000,40999,False,92,scaffold_3
21,5490001,5509000,18999,False,92,scaffold_3
22,5590001,5676000,85999,False,92,scaffold_3
23,5807001,5943000,135999,False,92,scaffold_3
24,5957001,6029000,71999,False,92,scaffold_3
25,6742001,6781000,38999,False,92,scaffold_3
26,6907001,6962000,54999,False,92,scaffold_3
27,6963001,7091000,127999,False,92,scaffold_3
28,7254001,7318000,63999,False,92,scaffold_3
29,7338001,7360000,21999,False,92,scaffold_3
30,7367001,7413000,45999,False,92,scaffold_3
31,7449001,7460000,10999,False,92,scaffold_3
32,7483001,7562000,78999,False,92,scaffold_3
33,7676001,7854000,177999,False,92,scaffold_3
34,8028001,8108000,79999,False,92,scaffold_3
35,8176001,8257000,80999,False,92,scaffold_3
36,8462001,8527000,64999,False,92,scaffold_3
37,8575001,8594000,18999,False,92,scaffold_3
38,9005001,9079000,73999,False,92,scaffold_3
39,9968001,9995000,26999,False,92,scaffold_3
40,10461001,10484000,22999,False,92,scaffold_3
41,10550001,10571000,20999,False,92,scaffold_3
42,10574001,11163000,588999,False,92,scaffold_3
0,17001,29000,11999,False,92,scaffold_4
1,30001,32000,1999,False,92,scaffold_4
2,48001,88000,39999,False,92,scaffold_4
3,133001,146000,12999,False,92,scaffold_4
4,147001,151000,3999,False,92,scaffold_4
5,155001,215000,59999,False,92,scaffold_4
6,217001,226000,8999,False,92,scaffold_4
7,227001,266000,38999,False,92,scaffold_4
8,293001,310000,16999,False,92,scaffold_4
9,319001,344000,24999,False,92,scaffold_4
10,355001,374000,18999,False,92,scaffold_4
11,375001,380000,4999,False,92,scaffold_4
12,412001,425000,12999,False,92,scaffold_4
13,429001,502000,72999,False,92,scaffold_4
14,547001,592000,44999,False,92,scaffold_4
15,593001,599000,5999,False,92,scaffold_4
16,600001,606000,5999,False,92,scaffold_4
17,608001,691000,82999,False,92,scaffold_4
18,701001,712000,10999,False,92,scaffold_4
19,1121001,1136000,14999,False,92,scaffold_4
20,1137001,1198000,60999,False,92,scaffold_4
21,1199001,1208000,8999,False,92,scaffold_4
22,1210001,1226000,15999,False,92,scaffold_4
23,1254001,1262000,7999,False,92,scaffold_4
24,1265001,1279000,13999,False,92,scaffold_4
25,1283001,1336000,52999,False,92,scaffold_4
26,1370001,1600000,229999,False,92,scaffold_4
27,1613001,2065000,451999,False,92,scaffold_4
28,2071001,2117000,45999,False,92,scaffold_4
29,2144001,2185000,40999,False,92,scaffold_4
30,2188001,2206000,17999,False,92,scaffold_4
31,2211001,2218000,6999,False,92,scaffold_4
32,2219001,2246000,26999,False,92,scaffold_4
33,2247001,2279000,31999,False,92,scaffold_4
34,2284001,2310000,25999,False,92,scaffold_4
35,2312001,2340000,27999,False,92,scaffold_4
36,2342001,2445000,102999,False,92,scaffold_4
37,2447001,2460000,12999,False,92,scaffold_4
38,2476001,2635000,158999,False,92,scaffold_4
39,2676001,2795000,118999,False,92,scaffold_4
40,2906001,2958000,51999,False,92,scaffold_4
41,3030001,3128000,97999,False,92,scaffold_4
42,3206001,3333000,126999,False,92,scaffold_4
43,3334001,3768000,433999,False,92,scaffold_4
44,4055001,4078000,22999,False,92,scaffold_4
45,4900001,5085000,184999,False,92,scaffold_4
46,5173001,5224000,50999,False,92,scaffold_4
47,5300001,5506000,205999,False,92,scaffold_4
48,5514001,5784000,269999,False,92,scaffold_4
49,5786001,5825000,38999,False,92,scaffold_4
50,5926001,5959000,32999,False,92,scaffold_4
51,6067001,6100000,32999,False,92,scaffold_4
52,6145001,6196000,50999,False,92,scaffold_4
53,6764001,6817000,52999,False,92,scaffold_4
54,6890001,6921000,30999,False,92,scaffold_4
55,6950001,6995000,44999,False,92,scaffold_4
56,7037001,7062000,24999,False,92,scaffold_4
57,7225001,7324000,98999,False,92,scaffold_4
58,7629001,7665000,35999,False,92,scaffold_4
59,7860001,7875000,14999,False,92,scaffold_4
60,8845001,9699000,853999,False,92,scaffold_4
61,9703001,9845951,142950,True,92,scaffold_4
0,1,4000,3999,True,92,scaffold_5
1,319001,383000,63999,False,92,scaffold_5
2,463001,524000,60999,False,92,scaffold_5
3,836001,843000,6999,False,92,scaffold_5
4,933001,947000,13999,False,92,scaffold_5
5,986001,988000,1999,False,92,scaffold_5
6,1062001,1068000,5999,False,92,scaffold_5
7,2475001,2494000,18999,False,92,scaffold_5
8,2510001,2515000,4999,False,92,scaffold_5
9,2563001,2871000,307999,False,92,scaffold_5
10,3133001,3514000,380999,False,92,scaffold_5
11,3616001,3657000,40999,False,92,scaffold_5
12,3962001,4101000,138999,False,92,scaffold_5
13,4121001,4223000,101999,False,92,scaffold_5
14,4232001,4321000,88999,False,92,scaffold_5
15,4445001,4554000,108999,False,92,scaffold_5
16,4601001,4923000,321999,False,92,scaffold_5
17,5057001,5084000,26999,False,92,scaffold_5
18,5257001,5346000,88999,False,92,scaffold_5
19,5720001,5738000,17999,False,92,scaffold_5
20,6402001,6420000,17999,False,92,scaffold_5
21,6457001,6653000,195999,False,92,scaffold_5
22,7175001,7234000,58999,False,92,scaffold_5
23,7304001,7327000,22999,False,92,scaffold_5
24,7456001,7513000,56999,False,92,scaffold_5
25,7559001,7619000,59999,False,92,scaffold_5
26,7622001,7748000,125999,False,92,scaffold_5
27,8571001,8615000,43999,False,92,scaffold_5
28,8658001,8689000,30999,False,92,scaffold_5
29,8702001,9364176,662175,True,92,scaffold_5
0,66001,75000,8999,False,92,scaffold_6
1,78001,85000,6999,False,92,scaffold_6
2,86001,114000,27999,False,92,scaffold_6
3,161001,210000,48999,False,92,scaffold_6
4,239001,254000,14999,False,92,scaffold_6
5,257001,263000,5999,False,92,scaffold_6
6,264001,297000,32999,False,92,scaffold_6
7,782001,801000,18999,False,92,scaffold_6
8,1147001,1198000,50999,False,92,scaffold_6
9,1229001,1258000,28999,False,92,scaffold_6
10,1286001,1304000,17999,False,92,scaffold_6
11,1435001,1546000,110999,False,92,scaffold_6
12,1561001,1595000,33999,False,92,scaffold_6
13,1657001,1688000,30999,False,92,scaffold_6
14,1842001,1906000,63999,False,92,scaffold_6
15,1907001,1931000,23999,False,92,scaffold_6
16,2023001,2088000,64999,False,92,scaffold_6
17,2129001,2213000,83999,False,92,scaffold_6
18,2236001,2265000,28999,False,92,scaffold_6
19,2335001,2852000,516999,False,92,scaffold_6
20,2933001,3032000,98999,False,92,scaffold_6
21,3104001,3193000,88999,False,92,scaffold_6
22,3223001,3350000,126999,False,92,scaffold_6
23,3351001,3806000,454999,False,92,scaffold_6
24,3809001,3818000,8999,False,92,scaffold_6
25,3897001,3927000,29999,False,92,scaffold_6
26,4018001,4195000,176999,False,92,scaffold_6
27,4838001,4875000,36999,False,92,scaffold_6
28,4955001,4996000,40999,False,92,scaffold_6
29,5777001,5787000,9999,False,92,scaffold_6
30,5861001,5972000,110999,False,92,scaffold_6
31,6010001,6090000,79999,False,92,scaffold_6
32,6125001,6190000,64999,False,92,scaffold_6
33,6244001,6276000,31999,False,92,scaffold_6
34,6765001,6804000,38999,False,92,scaffold_6
35,7221001,7247000,25999,False,92,scaffold_6
36,7263001,7338000,74999,False,92,scaffold_6
37,7382001,7486000,103999,False,92,scaffold_6
38,7541001,8268281,727280,True,92,scaffold_6
0,1,7000,6999,True,92,scaffold_7
1,10001,34000,23999,False,92,scaffold_7
2,323001,340000,16999,False,92,scaffold_7
3,342001,508000,165999,False,92,scaffold_7
4,554001,563000,8999,False,92,scaffold_7
5,571001,577000,5999,False,92,scaffold_7
6,706001,736000,29999,False,92,scaffold_7
7,741001,753000,11999,False,92,scaffold_7
8,764001,827000,62999,False,92,scaffold_7
9,859001,864000,4999,False,92,scaffold_7
10,868001,929000,60999,False,92,scaffold_7
11,930001,945000,14999,False,92,scaffold_7
12,964001,966000,1999,False,92,scaffold_7
13,968001,980000,11999,False,92,scaffold_7
14,982001,1044000,61999,False,92,scaffold_7
15,1048001,1096000,47999,False,92,scaffold_7
16,1191001,1512000,320999,False,92,scaffold_7
17,1588001,1689000,100999,False,92,scaffold_7
18,1861001,1901000,39999,False,92,scaffold_7
19,2546001,2570000,23999,False,92,scaffold_7
20,3325001,3369000,43999,False,92,scaffold_7
21,3521001,3807000,285999,False,92,scaffold_7
22,4021001,4060000,38999,False,92,scaffold_7
23,4415001,4518000,102999,False,92,scaffold_7
24,4642001,4854000,211999,False,92,scaffold_7
25,4978001,5149000,170999,False,92,scaffold_7
26,5482001,5537000,54999,False,92,scaffold_7
27,6167001,6234000,66999,False,92,scaffold_7
28,6644001,6673000,28999,False,92,scaffold_7
29,6749001,6788000,38999,False,92,scaffold_7
30,6953001,7270000,316999,False,92,scaffold_7
31,7271001,7502216,231215,True,92,scaffold_7
0,1,7000,6999,True,92,scaffold_8
1,67001,85000,17999,False,92,scaffold_8
2,93001,102000,8999,False,92,scaffold_8
3,1858001,1928000,69999,False,92,scaffold_8
4,2097001,2134000,36999,False,92,scaffold_8
5,2413001,2529000,115999,False,92,scaffold_8
6,2537001,2552000,14999,False,92,scaffold_8
7,2650001,2683000,32999,False,92,scaffold_8
8,2721001,2844000,122999,False,92,scaffold_8
9,2846001,2890000,43999,False,92,scaffold_8
10,3035001,3525000,489999,False,92,scaffold_8
11,3580001,3614000,33999,False,92,scaffold_8
12,3615001,3944000,328999,False,92,scaffold_8
13,4033001,4111000,77999,False,92,scaffold_8
14,4203001,4221000,17999,False,92,scaffold_8
15,4395001,4431000,35999,False,92,scaffold_8
16,4796001,4831000,34999,False,92,scaffold_8
17,4889001,4916000,26999,False,92,scaffold_8
18,5084001,5137000,52999,False,92,scaffold_8
19,5168001,5244000,75999,False,92,scaffold_8
20,5580001,5595000,14999,False,92,scaffold_8
21,5651001,5695000,43999,False,92,scaffold_8
22,5752001,5775000,22999,False,92,scaffold_8
23,6319001,6334544,15543,True,92,scaffold_8
0,109001,117000,7999,False,92,scaffold_9
1,121001,133000,11999,False,92,scaffold_9
2,299001,315000,15999,False,92,scaffold_9
3,319001,335000,15999,False,92,scaffold_9
4,366001,404000,37999,False,92,scaffold_9
5,413001,442000,28999,False,92,scaffold_9
6,502001,531000,28999,False,92,scaffold_9
7,670001,697000,26999,False,92,scaffold_9
8,732001,741000,8999,False,92,scaffold_9
9,817001,842000,24999,False,92,scaffold_9
10,873001,986000,112999,False,92,scaffold_9
11,988001,995000,6999,False,92,scaffold_9
12,1001001,1007000,5999,False,92,scaffold_9
13,1009001,1085000,75999,False,92,scaffold_9
14,1087001,1150000,62999,False,92,scaffold_9
15,1151001,1171000,19999,False,92,scaffold_9
16,1312001,1383000,70999,False,92,scaffold_9
17,1428001,1441000,12999,False,92,scaffold_9
18,1458001,1463000,4999,False,92,scaffold_9
19,1543001,1584000,40999,False,92,scaffold_9
20,1600001,1620000,19999,False,92,scaffold_9
21,1748001,1791000,42999,False,92,scaffold_9
22,1836001,1857000,20999,False,92,scaffold_9
23,1970001,2037000,66999,False,92,scaffold_9
24,2038001,2133000,94999,False,92,scaffold_9
25,2136001,2171000,34999,False,92,scaffold_9
26,2174001,2239000,64999,False,92,scaffold_9
27,2516001,2580000,63999,False,92,scaffold_9
28,2594001,2640000,45999,False,92,scaffold_9
29,2737001,3381000,643999,False,92,scaffold_9
30,3383001,5099000,1715999,False,92,scaffold_9
31,5101001,5107000,5999,False,92,scaffold_9
32,5112001,5115000,2999,False,92,scaffold_9
33,5116001,5238000,121999,False,92,scaffold_9
34,5239001,5298000,58999,False,92,scaffold_9
35,5300001,5490000,189999,False,92,scaffold_9
36,5491001,6331288,840287,True,92,scaffold_9
0,1,482000,481999,True,92,scaffold_10
1,483001,580000,96999,False,92,scaffold_10
2,603001,795000,191999,False,92,scaffold_10
3,813001,833000,19999,False,92,scaffold_10
4,857001,876000,18999,False,92,scaffold_10
5,888001,1069000,180999,False,92,scaffold_10
6,1073001,1145000,71999,False,92,scaffold_10
7,1313001,1336000,22999,False,92,scaffold_10
8,1389001,1471000,81999,False,92,scaffold_10
9,1632001,1662000,29999,False,92,scaffold_10
10,2089001,2102000,12999,False,92,scaffold_10
11,2140001,2176000,35999,False,92,scaffold_10
12,2270001,2325000,54999,False,92,scaffold_10
13,2346001,2425000,78999,False,92,scaffold_10
14,2426001,2461000,34999,False,92,scaffold_10
15,2521001,2634000,112999,False,92,scaffold_10
16,2671001,2697000,25999,False,92,scaffold_10
17,3573001,3582000,8999,False,92,scaffold_10
18,4051001,4091000,39999,False,92,scaffold_10
19,4154001,4175000,20999,False,92,scaffold_10
20,4443001,4462000,18999,False,92,scaffold_10
21,4467001,4477000,9999,False,92,scaffold_10
22,4478001,4513000,34999,False,92,scaffold_10
23,4515001,4523000,7999,False,92,scaffold_10
24,4526001,4548000,21999,False,92,scaffold_10
25,4575001,4596000,20999,False,92,scaffold_10
26,4680001,4688000,7999,False,92,scaffold_10
27,4734001,4766000,31999,False,92,scaffold_10
28,4769001,4776000,6999,False,92,scaffold_10
29,4798001,4824000,25999,False,92,scaffold_10
30,4827001,4843000,15999,False,92,scaffold_10
31,4848001,4861000,12999,False,92,scaffold_10
32,4865001,4866973,1972,True,92,scaffold_10
0,10001,92000,81999,False,92,scaffold_11
1,149001,167000,17999,False,92,scaffold_11
2,169001,191000,21999,False,92,scaffold_11
3,213001,235000,21999,False,92,scaffold_11
4,240001,248000,7999,False,92,scaffold_11
5,419001,431000,11999,False,92,scaffold_11
6,609001,613000,3999,False,92,scaffold_11
7,637001,656000,18999,False,92,scaffold_11
8,895001,897000,1999,False,92,scaffold_11
9,1025001,1034000,8999,False,92,scaffold_11
10,1359001,1369000,9999,False,92,scaffold_11
11,2701001,2878000,176999,False,92,scaffold_11
12,2951001,3018000,66999,False,92,scaffold_11
13,3082001,3159000,76999,False,92,scaffold_11
14,3186001,3293000,106999,False,92,scaffold_11
15,3331001,3383000,51999,False,92,scaffold_11
16,3422001,3478000,55999,False,92,scaffold_11
17,3521001,3971000,449999,False,92,scaffold_11
18,3996001,4162000,165999,False,92,scaffold_11
19,4182001,4710000,527999,False,92,scaffold_11
20,4713001,4766820,53819,True,92,scaffold_11
0,1,1498000,1497999,True,92,scaffold_12
1,1720001,1747000,26999,False,92,scaffold_12
2,1786001,1806000,19999,False,92,scaffold_12
3,1907001,1961000,53999,False,92,scaffold_12
4,2047001,2104000,56999,False,92,scaffold_12
5,2136001,2179000,42999,False,92,scaffold_12
6,2341001,2380000,38999,False,92,scaffold_12
7,2571001,2612000,40999,False,92,scaffold_12
0,1,340000,339999,True,93,scaffold_1
1,482001,498000,15999,False,93,scaffold_1
2,571001,643000,71999,False,93,scaffold_1
3,686001,743000,56999,False,93,scaffold_1
4,1281001,1292000,10999,False,93,scaffold_1
5,1615001,1660000,44999,False,93,scaffold_1
6,1821001,1900000,78999,False,93,scaffold_1
7,1954001,1964000,9999,False,93,scaffold_1
8,1965001,1984000,18999,False,93,scaffold_1
9,1988001,1998000,9999,False,93,scaffold_1
10,2449001,2517000,67999,False,93,scaffold_1
11,2729001,2746000,16999,False,93,scaffold_1
12,3173001,3209000,35999,False,93,scaffold_1
13,3419001,3425000,5999,False,93,scaffold_1
14,3714001,3738000,23999,False,93,scaffold_1
15,3821001,3869000,47999,False,93,scaffold_1
16,3902001,3941000,38999,False,93,scaffold_1
17,4003001,4029000,25999,False,93,scaffold_1
18,4061001,4112000,50999,False,93,scaffold_1
19,4314001,4354000,39999,False,93,scaffold_1
20,4924001,5024000,99999,False,93,scaffold_1
21,5481001,5512000,30999,False,93,scaffold_1
22,5535001,5570000,34999,False,93,scaffold_1
23,6108001,6151000,42999,False,93,scaffold_1
24,6204001,6381000,176999,False,93,scaffold_1
25,6384001,6491000,106999,False,93,scaffold_1
26,6493001,6503000,9999,False,93,scaffold_1
27,6544001,6555000,10999,False,93,scaffold_1
28,7041001,7247000,205999,False,93,scaffold_1
29,7248001,7583000,334999,False,93,scaffold_1
30,7590001,8477000,886999,False,93,scaffold_1
31,8478001,8656000,177999,False,93,scaffold_1
32,8658001,9584000,925999,False,93,scaffold_1
33,9586001,10353000,766999,False,93,scaffold_1
34,10453001,10623000,169999,False,93,scaffold_1
35,10808001,10811000,2999,False,93,scaffold_1
36,10832001,10858000,25999,False,93,scaffold_1
37,11016001,11029000,12999,False,93,scaffold_1
38,11344001,11504000,159999,False,93,scaffold_1
39,11560001,11951000,390999,False,93,scaffold_1
40,12184001,12204000,19999,False,93,scaffold_1
41,12650001,12723000,72999,False,93,scaffold_1
42,12792001,12888000,95999,False,93,scaffold_1
43,12968001,13001000,32999,False,93,scaffold_1
44,13113001,13211000,97999,False,93,scaffold_1
45,13347001,13430000,82999,False,93,scaffold_1
46,14290001,14310000,19999,False,93,scaffold_1
47,14671001,14674000,2999,False,93,scaffold_1
0,21001,48000,26999,False,93,scaffold_2
1,116001,159000,42999,False,93,scaffold_2
2,168001,177000,8999,False,93,scaffold_2
3,302001,318000,15999,False,93,scaffold_2
4,331001,374000,42999,False,93,scaffold_2
5,2085001,2111000,25999,False,93,scaffold_2
6,2336001,2424000,87999,False,93,scaffold_2
7,2441001,2600000,158999,False,93,scaffold_2
8,2657001,2689000,31999,False,93,scaffold_2
9,2694001,2746000,51999,False,93,scaffold_2
10,2868001,2900000,31999,False,93,scaffold_2
11,2994001,3012000,17999,False,93,scaffold_2
12,3335001,3342000,6999,False,93,scaffold_2
13,3450001,3465000,14999,False,93,scaffold_2
14,3754001,3783000,28999,False,93,scaffold_2
15,4383001,4409000,25999,False,93,scaffold_2
16,4521001,4664000,142999,False,93,scaffold_2
17,4780001,4790000,9999,False,93,scaffold_2
18,4920001,4927000,6999,False,93,scaffold_2
19,5018001,5031000,12999,False,93,scaffold_2
20,5033001,5061000,27999,False,93,scaffold_2
21,5368001,5394000,25999,False,93,scaffold_2
22,5414001,5488000,73999,False,93,scaffold_2
23,5490001,5515000,24999,False,93,scaffold_2
24,5658001,5757000,98999,False,93,scaffold_2
25,5840001,5887000,46999,False,93,scaffold_2
26,5915001,5988000,72999,False,93,scaffold_2
27,6261001,6330000,68999,False,93,scaffold_2
28,6331001,6350000,18999,False,93,scaffold_2
29,6396001,6449000,52999,False,93,scaffold_2
30,6593001,6628000,34999,False,93,scaffold_2
31,7065001,7089000,23999,False,93,scaffold_2
32,7439001,7473000,33999,False,93,scaffold_2
33,7495001,7498000,2999,False,93,scaffold_2
34,7563001,7697000,133999,False,93,scaffold_2
35,7780001,7891000,110999,False,93,scaffold_2
36,7934001,8161000,226999,False,93,scaffold_2
37,8261001,8312000,50999,False,93,scaffold_2
38,8331001,8333000,1999,False,93,scaffold_2
39,8342001,8344000,1999,False,93,scaffold_2
40,8346001,8453000,106999,False,93,scaffold_2
41,8495001,8560000,64999,False,93,scaffold_2
42,9157001,9167000,9999,False,93,scaffold_2
43,11367001,11381000,13999,False,93,scaffold_2
44,11520001,11786000,265999,False,93,scaffold_2
0,1,2000,1999,True,93,scaffold_3
1,51001,55000,3999,False,93,scaffold_3
2,799001,900000,100999,False,93,scaffold_3
3,960001,964000,3999,False,93,scaffold_3
4,2075001,2108000,32999,False,93,scaffold_3
5,2109001,2115000,5999,False,93,scaffold_3
6,2291001,2321000,29999,False,93,scaffold_3
7,2487001,2533000,45999,False,93,scaffold_3
8,3826001,3891000,64999,False,93,scaffold_3
9,4108001,4403000,294999,False,93,scaffold_3
10,4415001,4519000,103999,False,93,scaffold_3
11,4546001,4558000,11999,False,93,scaffold_3
12,4567001,4578000,10999,False,93,scaffold_3
13,4652001,4679000,26999,False,93,scaffold_3
14,5493001,5509000,15999,False,93,scaffold_3
15,5975001,6023000,47999,False,93,scaffold_3
16,6906001,6971000,64999,False,93,scaffold_3
17,6980001,7095000,114999,False,93,scaffold_3
18,7282001,7299000,16999,False,93,scaffold_3
19,7334001,7399000,64999,False,93,scaffold_3
20,7519001,7556000,36999,False,93,scaffold_3
21,7692001,7798000,105999,False,93,scaffold_3
22,7822001,7854000,31999,False,93,scaffold_3
23,8177001,8253000,75999,False,93,scaffold_3
24,8462001,8528000,65999,False,93,scaffold_3
25,8575001,8594000,18999,False,93,scaffold_3
26,9968001,9995000,26999,False,93,scaffold_3
27,10461001,10483000,21999,False,93,scaffold_3
28,10553001,10571000,17999,False,93,scaffold_3
29,10574001,11166000,591999,False,93,scaffold_3
0,17001,32000,14999,False,93,scaffold_4
1,48001,88000,39999,False,93,scaffold_4
2,132001,146000,13999,False,93,scaffold_4
3,147001,151000,3999,False,93,scaffold_4
4,155001,186000,30999,False,93,scaffold_4
5,189001,215000,25999,False,93,scaffold_4
6,217001,226000,8999,False,93,scaffold_4
7,227001,266000,38999,False,93,scaffold_4
8,289001,308000,18999,False,93,scaffold_4
9,313001,344000,30999,False,93,scaffold_4
10,355001,374000,18999,False,93,scaffold_4
11,412001,425000,12999,False,93,scaffold_4
12,429001,498000,68999,False,93,scaffold_4
13,546001,599000,52999,False,93,scaffold_4
14,600001,606000,5999,False,93,scaffold_4
15,608001,661000,52999,False,93,scaffold_4
16,670001,691000,20999,False,93,scaffold_4
17,701001,715000,13999,False,93,scaffold_4
18,1123001,1136000,12999,False,93,scaffold_4
19,1137001,1198000,60999,False,93,scaffold_4
20,1199001,1208000,8999,False,93,scaffold_4
21,1210001,1226000,15999,False,93,scaffold_4
22,1235001,1253000,17999,False,93,scaffold_4
23,1254001,1262000,7999,False,93,scaffold_4
24,1265001,1279000,13999,False,93,scaffold_4
25,1283001,1336000,52999,False,93,scaffold_4
26,1358001,1601000,242999,False,93,scaffold_4
27,1613001,2069000,455999,False,93,scaffold_4
28,2071001,2114000,42999,False,93,scaffold_4
29,2162001,2185000,22999,False,93,scaffold_4
30,2207001,2246000,38999,False,93,scaffold_4
31,2247001,2279000,31999,False,93,scaffold_4
32,2283001,2340000,56999,False,93,scaffold_4
33,2342001,2461000,118999,False,93,scaffold_4
34,2480001,2635000,154999,False,93,scaffold_4
35,2939001,2959000,19999,False,93,scaffold_4
36,3335001,3768000,432999,False,93,scaffold_4
37,4943001,4977000,33999,False,93,scaffold_4
38,4978001,4999000,20999,False,93,scaffold_4
39,5031001,5055000,23999,False,93,scaffold_4
40,5172001,5208000,35999,False,93,scaffold_4
41,5473001,5506000,32999,False,93,scaffold_4
42,5514001,5620000,105999,False,93,scaffold_4
43,5660001,5688000,27999,False,93,scaffold_4
44,5690001,5784000,93999,False,93,scaffold_4
45,5786001,5825000,38999,False,93,scaffold_4
46,6145001,6191000,45999,False,93,scaffold_4
47,6789001,6817000,27999,False,93,scaffold_4
48,6902001,6924000,21999,False,93,scaffold_4
49,6970001,6995000,24999,False,93,scaffold_4
50,7036001,7062000,25999,False,93,scaffold_4
51,7229001,7292000,62999,False,93,scaffold_4
52,7628001,7665000,36999,False,93,scaffold_4
53,8846001,9699000,852999,False,93,scaffold_4
54,9700001,9845951,145950,True,93,scaffold_4
0,1,4000,3999,True,93,scaffold_5
1,190001,204000,13999,False,93,scaffold_5
2,296001,300000,3999,False,93,scaffold_5
3,318001,326000,7999,False,93,scaffold_5
4,327001,385000,57999,False,93,scaffold_5
5,462001,523000,60999,False,93,scaffold_5
6,669001,694000,24999,False,93,scaffold_5
7,753001,756000,2999,False,93,scaffold_5
8,933001,947000,13999,False,93,scaffold_5
9,2475001,2493000,17999,False,93,scaffold_5
10,2565001,2582000,16999,False,93,scaffold_5
11,2619001,2755000,135999,False,93,scaffold_5
12,2762001,2871000,108999,False,93,scaffold_5
13,3133001,3252000,118999,False,93,scaffold_5
14,3300001,3512000,211999,False,93,scaffold_5
15,3962001,4101000,138999,False,93,scaffold_5
16,4119001,4219000,99999,False,93,scaffold_5
17,4246001,4272000,25999,False,93,scaffold_5
18,4446001,4506000,59999,False,93,scaffold_5
19,4600001,4861000,260999,False,93,scaffold_5
20,4882001,4919000,36999,False,93,scaffold_5
21,5259001,5274000,14999,False,93,scaffold_5
22,5283001,5312000,28999,False,93,scaffold_5
23,5314001,5346000,31999,False,93,scaffold_5
24,6408001,6420000,11999,False,93,scaffold_5
25,6504001,6652000,147999,False,93,scaffold_5
26,7454001,7486000,31999,False,93,scaffold_5
27,7571001,7619000,47999,False,93,scaffold_5
28,7621001,7659000,37999,False,93,scaffold_5
29,8552001,8616000,63999,False,93,scaffold_5
30,8667001,8689000,21999,False,93,scaffold_5
31,8711001,9364176,653175,True,93,scaffold_5
0,78001,85000,6999,False,93,scaffold_6
1,86001,113000,26999,False,93,scaffold_6
2,174001,181000,6999,False,93,scaffold_6
3,239001,254000,14999,False,93,scaffold_6
4,257001,262000,4999,False,93,scaffold_6
5,267001,283000,15999,False,93,scaffold_6
6,543001,546000,2999,False,93,scaffold_6
7,1147001,1191000,43999,False,93,scaffold_6
8,1229001,1263000,33999,False,93,scaffold_6
9,1478001,1546000,67999,False,93,scaffold_6
10,1842001,1902000,59999,False,93,scaffold_6
11,2023001,2102000,78999,False,93,scaffold_6
12,2124001,2212000,87999,False,93,scaffold_6
13,2336001,2595000,258999,False,93,scaffold_6
14,2596001,2653000,56999,False,93,scaffold_6
15,2655001,2695000,39999,False,93,scaffold_6
16,2712001,2852000,139999,False,93,scaffold_6
17,2937001,3015000,77999,False,93,scaffold_6
18,3115001,3192000,76999,False,93,scaffold_6
19,3223001,3343000,119999,False,93,scaffold_6
20,3406001,3428000,21999,False,93,scaffold_6
21,3461001,3766000,304999,False,93,scaffold_6
22,3898001,3913000,14999,False,93,scaffold_6
23,4018001,4195000,176999,False,93,scaffold_6
24,6010001,6083000,72999,False,93,scaffold_6
25,7266001,7337000,70999,False,93,scaffold_6
26,7390001,7436000,45999,False,93,scaffold_6
27,7549001,8268281,719280,True,93,scaffold_6
0,1,7000,6999,True,93,scaffold_7
1,13001,31000,17999,False,93,scaffold_7
2,323001,340000,16999,False,93,scaffold_7
3,342001,509000,166999,False,93,scaffold_7
4,554001,563000,8999,False,93,scaffold_7
5,571001,577000,5999,False,93,scaffold_7
6,706001,736000,29999,False,93,scaffold_7
7,743001,753000,9999,False,93,scaffold_7
8,764001,809000,44999,False,93,scaffold_7
9,859001,864000,4999,False,93,scaffold_7
10,964001,966000,1999,False,93,scaffold_7
11,968001,980000,11999,False,93,scaffold_7
12,982001,1044000,61999,False,93,scaffold_7
13,1057001,1089000,31999,False,93,scaffold_7
14,1195001,1460000,264999,False,93,scaffold_7
15,1461001,1512000,50999,False,93,scaffold_7
16,1588001,1648000,59999,False,93,scaffold_7
17,1649001,1690000,40999,False,93,scaffold_7
18,3325001,3367000,41999,False,93,scaffold_7
19,3537001,3547000,9999,False,93,scaffold_7
20,3593001,3766000,172999,False,93,scaffold_7
21,4416001,4517000,100999,False,93,scaffold_7
22,4658001,4682000,23999,False,93,scaffold_7
23,4687001,4730000,42999,False,93,scaffold_7
24,4979001,5149000,169999,False,93,scaffold_7
25,5483001,5536000,52999,False,93,scaffold_7
26,6953001,7270000,316999,False,93,scaffold_7
27,7271001,7502216,231215,True,93,scaffold_7
0,1,6000,5999,True,93,scaffold_8
1,67001,85000,17999,False,93,scaffold_8
2,2430001,2471000,40999,False,93,scaffold_8
3,2492001,2506000,13999,False,93,scaffold_8
4,2658001,2682000,23999,False,93,scaffold_8
5,2721001,2757000,35999,False,93,scaffold_8
6,2798001,2844000,45999,False,93,scaffold_8
7,2846001,2857000,10999,False,93,scaffold_8
8,3060001,3526000,465999,False,93,scaffold_8
9,3580001,3612000,31999,False,93,scaffold_8
10,3615001,3913000,297999,False,93,scaffold_8
11,4038001,4107000,68999,False,93,scaffold_8
12,5088001,5136000,47999,False,93,scaffold_8
13,5172001,5241000,68999,False,93,scaffold_8
14,5581001,5594000,12999,False,93,scaffold_8
15,5651001,5694000,42999,False,93,scaffold_8
16,5750001,5772000,21999,False,93,scaffold_8
17,6320001,6334544,14543,True,93,scaffold_8
0,1001,21000,19999,False,93,scaffold_9
1,109001,117000,7999,False,93,scaffold_9
2,121001,137000,15999,False,93,scaffold_9
3,299001,315000,15999,False,93,scaffold_9
4,319001,334000,14999,False,93,scaffold_9
5,366001,411000,44999,False,93,scaffold_9
6,413001,434000,20999,False,93,scaffold_9
7,501001,531000,29999,False,93,scaffold_9
8,656001,665000,8999,False,93,scaffold_9
9,670001,696000,25999,False,93,scaffold_9
10,732001,742000,9999,False,93,scaffold_9
11,815001,841000,25999,False,93,scaffold_9
12,872001,986000,113999,False,93,scaffold_9
13,988001,995000,6999,False,93,scaffold_9
14,1001001,1007000,5999,False,93,scaffold_9
15,1010001,1085000,74999,False,93,scaffold_9
16,1087001,1150000,62999,False,93,scaffold_9
17,1151001,1175000,23999,False,93,scaffold_9
18,1313001,1379000,65999,False,93,scaffold_9
19,1749001,1791000,41999,False,93,scaffold_9
20,1987001,2036000,48999,False,93,scaffold_9
21,2038001,2055000,16999,False,93,scaffold_9
22,2076001,2106000,29999,False,93,scaffold_9
23,2597001,2616000,18999,False,93,scaffold_9
24,2737001,2803000,65999,False,93,scaffold_9
25,2863001,3381000,517999,False,93,scaffold_9
26,3383001,5107000,1723999,False,93,scaffold_9
27,5112001,5114000,1999,False,93,scaffold_9
28,5116001,5238000,121999,False,93,scaffold_9
29,5239001,5298000,58999,False,93,scaffold_9
30,5300001,5490000,189999,False,93,scaffold_9
31,5493001,6331288,838287,True,93,scaffold_9
0,1,136000,135999,True,93,scaffold_10
1,137001,406000,268999,False,93,scaffold_10
2,453001,482000,28999,False,93,scaffold_10
3,483001,576000,92999,False,93,scaffold_10
4,603001,794000,190999,False,93,scaffold_10
5,888001,921000,32999,False,93,scaffold_10
6,923001,963000,39999,False,93,scaffold_10
7,1073001,1112000,38999,False,93,scaffold_10
8,1389001,1411000,21999,False,93,scaffold_10
9,2140001,2176000,35999,False,93,scaffold_10
10,2272001,2299000,26999,False,93,scaffold_10
11,2346001,2392000,45999,False,93,scaffold_10
12,2558001,2574000,15999,False,93,scaffold_10
13,2673001,2700000,26999,False,93,scaffold_10
14,4054001,4086000,31999,False,93,scaffold_10
15,4154001,4174000,19999,False,93,scaffold_10
16,4446001,4462000,15999,False,93,scaffold_10
17,4527001,4548000,20999,False,93,scaffold_10
18,4574001,4597000,22999,False,93,scaffold_10
19,4681001,4688000,6999,False,93,scaffold_10
20,4734001,4776000,41999,False,93,scaffold_10
21,4798001,4824000,25999,False,93,scaffold_10
22,4827001,4843000,15999,False,93,scaffold_10
23,4848001,4861000,12999,False,93,scaffold_10
24,4865001,4866973,1972,True,93,scaffold_10
0,9001,91000,81999,False,93,scaffold_11
1,124001,128000,3999,False,93,scaffold_11
2,149001,167000,17999,False,93,scaffold_11
3,169001,191000,21999,False,93,scaffold_11
4,214001,236000,21999,False,93,scaffold_11
5,240001,248000,7999,False,93,scaffold_11
6,419001,431000,11999,False,93,scaffold_11
7,648001,656000,7999,False,93,scaffold_11
8,1025001,1034000,8999,False,93,scaffold_11
9,1403001,1409000,5999,False,93,scaffold_11
10,1423001,1426000,2999,False,93,scaffold_11
11,1474001,1478000,3999,False,93,scaffold_11
12,2702001,2877000,174999,False,93,scaffold_11
13,2976001,3018000,41999,False,93,scaffold_11
14,3086001,3145000,58999,False,93,scaffold_11
15,3188001,3292000,103999,False,93,scaffold_11
16,3331001,3383000,51999,False,93,scaffold_11
17,3433001,3478000,44999,False,93,scaffold_11
18,3548001,3650000,101999,False,93,scaffold_11
19,3702001,3972000,269999,False,93,scaffold_11
20,3984001,4159000,174999,False,93,scaffold_11
21,4189001,4710000,520999,False,93,scaffold_11
22,4712001,4766820,54819,True,93,scaffold_11
0,1,385000,384999,True,93,scaffold_12
1,403001,856000,452999,False,93,scaffold_12
2,865001,1469000,603999,False,93,scaffold_12
3,1719001,1733000,13999,False,93,scaffold_12
4,2059001,2103000,43999,False,93,scaffold_12
5,2131001,2155000,23999,False,93,scaffold_12
6,2347001,2377000,29999,False,93,scaffold_12
7,2571001,2614000,42999,False,93,scaffold_12
0,1,342000,341999,True,94,scaffold_1
1,482001,498000,15999,False,94,scaffold_1
2,571001,643000,71999,False,94,scaffold_1
3,686001,743000,56999,False,94,scaffold_1
4,1281001,1292000,10999,False,94,scaffold_1
5,1827001,1898000,70999,False,94,scaffold_1
6,1954001,1964000,9999,False,94,scaffold_1
7,1965001,1984000,18999,False,94,scaffold_1
8,1988001,1994000,5999,False,94,scaffold_1
9,2449001,2517000,67999,False,94,scaffold_1
10,2729001,2746000,16999,False,94,scaffold_1
11,3179001,3208000,28999,False,94,scaffold_1
12,3714001,3734000,19999,False,94,scaffold_1
13,3909001,3941000,31999,False,94,scaffold_1
14,4004001,4027000,22999,False,94,scaffold_1
15,4060001,4111000,50999,False,94,scaffold_1
16,4322001,4354000,31999,False,94,scaffold_1
17,4920001,5009000,88999,False,94,scaffold_1
18,5481001,5511000,29999,False,94,scaffold_1
19,5535001,5569000,33999,False,94,scaffold_1
20,6108001,6153000,44999,False,94,scaffold_1
21,6154001,6177000,22999,False,94,scaffold_1
22,6228001,6509000,280999,False,94,scaffold_1
23,6544001,6554000,9999,False,94,scaffold_1
24,7038001,7247000,208999,False,94,scaffold_1
25,7248001,7589000,340999,False,94,scaffold_1
26,7590001,8656000,1065999,False,94,scaffold_1
27,8658001,9584000,925999,False,94,scaffold_1
28,9586001,10356000,769999,False,94,scaffold_1
29,10461001,10636000,174999,False,94,scaffold_1
30,10808001,10811000,2999,False,94,scaffold_1
31,10839001,10856000,16999,False,94,scaffold_1
32,11351001,11504000,152999,False,94,scaffold_1
33,11614001,11951000,336999,False,94,scaffold_1
34,12184001,12204000,19999,False,94,scaffold_1
35,12652001,12722000,69999,False,94,scaffold_1
36,12777001,12888000,110999,False,94,scaffold_1
37,12966001,13002000,35999,False,94,scaffold_1
38,13113001,13211000,97999,False,94,scaffold_1
39,13347001,13430000,82999,False,94,scaffold_1
40,14290001,14308000,17999,False,94,scaffold_1
41,14455001,14457000,1999,False,94,scaffold_1
42,14471001,14479000,7999,False,94,scaffold_1
43,14689001,14692000,2999,False,94,scaffold_1
0,22001,48000,25999,False,94,scaffold_2
1,93001,159000,65999,False,94,scaffold_2
2,168001,176000,7999,False,94,scaffold_2
3,302001,318000,15999,False,94,scaffold_2
4,333001,374000,40999,False,94,scaffold_2
5,2085001,2103000,17999,False,94,scaffold_2
6,2336001,2358000,21999,False,94,scaffold_2
7,2404001,2424000,19999,False,94,scaffold_2
8,2441001,2553000,111999,False,94,scaffold_2
9,2660001,2689000,28999,False,94,scaffold_2
10,2694001,2742000,47999,False,94,scaffold_2
11,2868001,2899000,30999,False,94,scaffold_2
12,2993001,3012000,18999,False,94,scaffold_2
13,3336001,3341000,4999,False,94,scaffold_2
14,3454001,3464000,9999,False,94,scaffold_2
15,3759001,3783000,23999,False,94,scaffold_2
16,4339001,4409000,69999,False,94,scaffold_2
17,4426001,4457000,30999,False,94,scaffold_2
18,4521001,4656000,134999,False,94,scaffold_2
19,4918001,4946000,27999,False,94,scaffold_2
20,5022001,5031000,8999,False,94,scaffold_2
21,5033001,5061000,27999,False,94,scaffold_2
22,5370001,5393000,22999,False,94,scaffold_2
23,5491001,5515000,23999,False,94,scaffold_2
24,5668001,5704000,35999,False,94,scaffold_2
25,5719001,5757000,37999,False,94,scaffold_2
26,6261001,6330000,68999,False,94,scaffold_2
27,6331001,6351000,19999,False,94,scaffold_2
28,6398001,6449000,50999,False,94,scaffold_2
29,6589001,6628000,38999,False,94,scaffold_2
30,7018001,7037000,18999,False,94,scaffold_2
31,7064001,7087000,22999,False,94,scaffold_2
32,7439001,7473000,33999,False,94,scaffold_2
33,7563001,7697000,133999,False,94,scaffold_2
34,7785001,7890000,104999,False,94,scaffold_2
35,7934001,8136000,201999,False,94,scaffold_2
36,8261001,8294000,32999,False,94,scaffold_2
37,8331001,8333000,1999,False,94,scaffold_2
38,8346001,8453000,106999,False,94,scaffold_2
39,8495001,8561000,65999,False,94,scaffold_2
40,11520001,11785000,264999,False,94,scaffold_2
0,51001,55000,3999,False,94,scaffold_3
1,618001,646000,27999,False,94,scaffold_3
2,799001,900000,100999,False,94,scaffold_3
3,2015001,2108000,92999,False,94,scaffold_3
4,2291001,2321000,29999,False,94,scaffold_3
5,2487001,2533000,45999,False,94,scaffold_3
6,2716001,2736000,19999,False,94,scaffold_3
7,3770001,3820000,49999,False,94,scaffold_3
8,3822001,3874000,51999,False,94,scaffold_3
9,4106001,4403000,296999,False,94,scaffold_3
10,4410001,4518000,107999,False,94,scaffold_3
11,4547001,4558000,10999,False,94,scaffold_3
12,4648001,4679000,30999,False,94,scaffold_3
13,5494001,5509000,14999,False,94,scaffold_3
14,5990001,6020000,29999,False,94,scaffold_3
15,6908001,6962000,53999,False,94,scaffold_3
16,6963001,7089000,125999,False,94,scaffold_3
17,7154001,7157000,2999,False,94,scaffold_3
18,7336001,7362000,25999,False,94,scaffold_3
19,7522001,7556000,33999,False,94,scaffold_3
20,7692001,7799000,106999,False,94,scaffold_3
21,7818001,7839000,20999,False,94,scaffold_3
22,8183001,8247000,63999,False,94,scaffold_3
23,8462001,8527000,64999,False,94,scaffold_3
24,8575001,8594000,18999,False,94,scaffold_3
25,9968001,9996000,27999,False,94,scaffold_3
26,10461001,10483000,21999,False,94,scaffold_3
27,10587001,11167000,579999,False,94,scaffold_3
0,17001,32000,14999,False,94,scaffold_4
1,48001,88000,39999,False,94,scaffold_4
2,121001,146000,24999,False,94,scaffold_4
3,147001,151000,3999,False,94,scaffold_4
4,155001,160000,4999,False,94,scaffold_4
5,161001,215000,53999,False,94,scaffold_4
6,217001,226000,8999,False,94,scaffold_4
7,227001,266000,38999,False,94,scaffold_4
8,318001,344000,25999,False,94,scaffold_4
9,355001,374000,18999,False,94,scaffold_4
10,375001,380000,4999,False,94,scaffold_4
11,412001,425000,12999,False,94,scaffold_4
12,429001,498000,68999,False,94,scaffold_4
13,545001,592000,46999,False,94,scaffold_4
14,593001,599000,5999,False,94,scaffold_4
15,600001,606000,5999,False,94,scaffold_4
16,608001,661000,52999,False,94,scaffold_4
17,670001,691000,20999,False,94,scaffold_4
18,695001,697000,1999,False,94,scaffold_4
19,701001,715000,13999,False,94,scaffold_4
20,1121001,1136000,14999,False,94,scaffold_4
21,1137001,1198000,60999,False,94,scaffold_4
22,1199001,1226000,26999,False,94,scaffold_4
23,1265001,1279000,13999,False,94,scaffold_4
24,1283001,1336000,52999,False,94,scaffold_4
25,1362001,1594000,231999,False,94,scaffold_4
26,1613001,1957000,343999,False,94,scaffold_4
27,1958001,2006000,47999,False,94,scaffold_4
28,2007001,2097000,89999,False,94,scaffold_4
29,2162001,2185000,22999,False,94,scaffold_4
30,2211001,2218000,6999,False,94,scaffold_4
31,2219001,2280000,60999,False,94,scaffold_4
32,2284001,2310000,25999,False,94,scaffold_4
33,2312001,2340000,27999,False,94,scaffold_4
34,2398001,2461000,62999,False,94,scaffold_4
35,2476001,2583000,106999,False,94,scaffold_4
36,2597001,2635000,37999,False,94,scaffold_4
37,3336001,3761000,424999,False,94,scaffold_4
38,4941001,5001000,59999,False,94,scaffold_4
39,5172001,5224000,51999,False,94,scaffold_4
40,5474001,5506000,31999,False,94,scaffold_4
41,5516001,5620000,103999,False,94,scaffold_4
42,5659001,5784000,124999,False,94,scaffold_4
43,6145001,6193000,47999,False,94,scaffold_4
44,6765001,6817000,51999,False,94,scaffold_4
45,6903001,6924000,20999,False,94,scaffold_4
46,6970001,6995000,24999,False,94,scaffold_4
47,7036001,7062000,25999,False,94,scaffold_4
48,7227001,7290000,62999,False,94,scaffold_4
49,8846001,9699000,852999,False,94,scaffold_4
50,9700001,9845951,145950,True,94,scaffold_4
0,318001,368000,49999,False,94,scaffold_5
1,463001,523000,59999,False,94,scaffold_5
2,933001,947000,13999,False,94,scaffold_5
3,2476001,2493000,16999,False,94,scaffold_5
4,2563001,2738000,174999,False,94,scaffold_5
5,2813001,2894000,80999,False,94,scaffold_5
6,3134001,3186000,51999,False,94,scaffold_5
7,3300001,3512000,211999,False,94,scaffold_5
8,3622001,3652000,29999,False,94,scaffold_5
9,3962001,4101000,138999,False,94,scaffold_5
10,4121001,4219000,97999,False,94,scaffold_5
11,4246001,4272000,25999,False,94,scaffold_5
12,4446001,4526000,79999,False,94,scaffold_5
13,4603001,4650000,46999,False,94,scaffold_5
14,4691001,4861000,169999,False,94,scaffold_5
15,4892001,4919000,26999,False,94,scaffold_5
16,5287001,5312000,24999,False,94,scaffold_5
17,5314001,5346000,31999,False,94,scaffold_5
18,5515001,5527000,11999,False,94,scaffold_5
19,6411001,6417000,5999,False,94,scaffold_5
20,6504001,6653000,148999,False,94,scaffold_5
21,7097001,7100000,2999,False,94,scaffold_5
22,7373001,7387000,13999,False,94,scaffold_5
23,7454001,7483000,28999,False,94,scaffold_5
24,7559001,7610000,50999,False,94,scaffold_5
25,7622001,7655000,32999,False,94,scaffold_5
26,8659001,8689000,29999,False,94,scaffold_5
27,8730001,9364176,634175,True,94,scaffold_5
0,79001,114000,34999,False,94,scaffold_6
1,239001,254000,14999,False,94,scaffold_6
2,1147001,1197000,49999,False,94,scaffold_6
3,1237001,1256000,18999,False,94,scaffold_6
4,1479001,1547000,67999,False,94,scaffold_6
5,1563001,1597000,33999,False,94,scaffold_6
6,1866001,1906000,39999,False,94,scaffold_6
7,2023001,2087000,63999,False,94,scaffold_6
8,2130001,2212000,81999,False,94,scaffold_6
9,2240001,2265000,24999,False,94,scaffold_6
10,2335001,2653000,317999,False,94,scaffold_6
11,2655001,2691000,35999,False,94,scaffold_6
12,2712001,2872000,159999,False,94,scaffold_6
13,2927001,3016000,88999,False,94,scaffold_6
14,3113001,3174000,60999,False,94,scaffold_6
15,3224001,3310000,85999,False,94,scaffold_6
16,3394001,3428000,33999,False,94,scaffold_6
17,3461001,3767000,305999,False,94,scaffold_6
18,3900001,3913000,12999,False,94,scaffold_6
19,4018001,4072000,53999,False,94,scaffold_6
20,4079001,4195000,115999,False,94,scaffold_6
21,6010001,6063000,52999,False,94,scaffold_6
22,6154001,6188000,33999,False,94,scaffold_6
23,7263001,7337000,73999,False,94,scaffold_6
24,7391001,7436000,44999,False,94,scaffold_6
25,7549001,8268281,719280,True,94,scaffold_6
0,13001,34000,20999,False,94,scaffold_7
1,323001,340000,16999,False,94,scaffold_7
2,342001,508000,165999,False,94,scaffold_7
3,554001,564000,9999,False,94,scaffold_7
4,571001,577000,5999,False,94,scaffold_7
5,706001,736000,29999,False,94,scaffold_7
6,764001,809000,44999,False,94,scaffold_7
7,859001,864000,4999,False,94,scaffold_7
8,968001,980000,11999,False,94,scaffold_7
9,982001,1044000,61999,False,94,scaffold_7
10,1048001,1100000,51999,False,94,scaffold_7
11,1191001,1512000,320999,False,94,scaffold_7
12,1588001,1689000,100999,False,94,scaffold_7
13,1770001,1782000,11999,False,94,scaffold_7
14,3326001,3369000,42999,False,94,scaffold_7
15,3529001,3548000,18999,False,94,scaffold_7
16,3593001,3767000,173999,False,94,scaffold_7
17,4415001,4536000,120999,False,94,scaffold_7
18,4643001,4683000,39999,False,94,scaffold_7
19,4687001,4732000,44999,False,94,scaffold_7
20,4978001,5149000,170999,False,94,scaffold_7
21,5482001,5536000,53999,False,94,scaffold_7
22,5609001,5627000,17999,False,94,scaffold_7
23,6075001,6094000,18999,False,94,scaffold_7
24,6953001,7270000,316999,False,94,scaffold_7
25,7271001,7502216,231215,True,94,scaffold_7
0,66001,85000,18999,False,94,scaffold_8
1,2442001,2514000,71999,False,94,scaffold_8
2,2652001,2683000,30999,False,94,scaffold_8
3,2740001,2757000,16999,False,94,scaffold_8
4,2798001,2844000,45999,False,94,scaffold_8
5,3058001,3525000,466999,False,94,scaffold_8
6,3580001,3612000,31999,False,94,scaffold_8
7,3615001,3913000,297999,False,94,scaffold_8
8,4038001,4099000,60999,False,94,scaffold_8
9,4901001,4915000,13999,False,94,scaffold_8
10,5084001,5136000,51999,False,94,scaffold_8
11,5198001,5241000,42999,False,94,scaffold_8
12,5667001,5693000,25999,False,94,scaffold_8
13,6323001,6334544,11543,True,94,scaffold_8
0,109001,117000,7999,False,94,scaffold_9
1,319001,333000,13999,False,94,scaffold_9
2,367001,404000,36999,False,94,scaffold_9
3,413001,434000,20999,False,94,scaffold_9
4,501001,531000,29999,False,94,scaffold_9
5,652001,665000,12999,False,94,scaffold_9
6,671001,696000,24999,False,94,scaffold_9
7,732001,742000,9999,False,94,scaffold_9
8,814001,841000,26999,False,94,scaffold_9
9,886001,986000,99999,False,94,scaffold_9
10,987001,995000,7999,False,94,scaffold_9
11,1001001,1007000,5999,False,94,scaffold_9
12,1009001,1085000,75999,False,94,scaffold_9
13,1087001,1150000,62999,False,94,scaffold_9
14,1151001,1166000,14999,False,94,scaffold_9
15,1312001,1377000,64999,False,94,scaffold_9
16,1564001,1581000,16999,False,94,scaffold_9
17,1749001,1791000,41999,False,94,scaffold_9
18,1989001,2030000,40999,False,94,scaffold_9
19,2088001,2132000,43999,False,94,scaffold_9
20,2601001,2616000,14999,False,94,scaffold_9
21,2782001,2808000,25999,False,94,scaffold_9
22,2845001,3381000,535999,False,94,scaffold_9
23,3383001,5107000,1723999,False,94,scaffold_9
24,5112001,5115000,2999,False,94,scaffold_9
25,5116001,5238000,121999,False,94,scaffold_9
26,5239001,5298000,58999,False,94,scaffold_9
27,5300001,5490000,189999,False,94,scaffold_9
28,5493001,6331288,838287,True,94,scaffold_9
0,1,232000,231999,True,94,scaffold_10
1,259001,414000,154999,False,94,scaffold_10
2,416001,482000,65999,False,94,scaffold_10
3,483001,582000,98999,False,94,scaffold_10
4,602001,757000,154999,False,94,scaffold_10
5,782001,794000,11999,False,94,scaffold_10
6,888001,917000,28999,False,94,scaffold_10
7,923001,963000,39999,False,94,scaffold_10
8,1087001,1112000,24999,False,94,scaffold_10
9,2140001,2173000,32999,False,94,scaffold_10
10,2268001,2299000,30999,False,94,scaffold_10
11,2348001,2363000,14999,False,94,scaffold_10
12,2557001,2573000,15999,False,94,scaffold_10
13,2674001,2700000,25999,False,94,scaffold_10
14,2804001,2811000,6999,False,94,scaffold_10
15,4053001,4091000,37999,False,94,scaffold_10
16,4154001,4174000,19999,False,94,scaffold_10
17,4443001,4462000,18999,False,94,scaffold_10
18,4467001,4477000,9999,False,94,scaffold_10
19,4515001,4523000,7999,False,94,scaffold_10
20,4526001,4548000,21999,False,94,scaffold_10
21,4576001,4596000,19999,False,94,scaffold_10
22,4679001,4688000,8999,False,94,scaffold_10
23,4734001,4766000,31999,False,94,scaffold_10
24,4769001,4776000,6999,False,94,scaffold_10
25,4798001,4824000,25999,False,94,scaffold_10
26,4828001,4843000,14999,False,94,scaffold_10
27,4848001,4861000,12999,False,94,scaffold_10
28,4865001,4866973,1972,True,94,scaffold_10
0,11001,34000,22999,False,94,scaffold_11
1,40001,92000,51999,False,94,scaffold_11
2,149001,167000,17999,False,94,scaffold_11
3,169001,191000,21999,False,94,scaffold_11
4,214001,235000,20999,False,94,scaffold_11
5,240001,248000,7999,False,94,scaffold_11
6,296001,312000,15999,False,94,scaffold_11
7,419001,431000,11999,False,94,scaffold_11
8,648001,656000,7999,False,94,scaffold_11
9,1025001,1034000,8999,False,94,scaffold_11
10,1423001,1426000,2999,False,94,scaffold_11
11,1474001,1478000,3999,False,94,scaffold_11
12,2701001,2877000,175999,False,94,scaffold_11
13,2983001,3011000,27999,False,94,scaffold_11
14,3092001,3133000,40999,False,94,scaffold_11
15,3189001,3290000,100999,False,94,scaffold_11
16,3329001,3383000,53999,False,94,scaffold_11
17,3553001,3634000,80999,False,94,scaffold_11
18,3702001,3933000,230999,False,94,scaffold_11
19,4008001,4159000,150999,False,94,scaffold_11
20,4189001,4710000,520999,False,94,scaffold_11
21,4713001,4766820,53819,True,94,scaffold_11
0,1,370000,369999,True,94,scaffold_12
1,474001,551000,76999,False,94,scaffold_12
2,578001,857000,278999,False,94,scaffold_12
3,865001,1469000,603999,False,94,scaffold_12
4,1720001,1733000,12999,False,94,scaffold_12
5,2043001,2083000,39999,False,94,scaffold_12
6,2137001,2164000,26999,False,94,scaffold_12
7,2571001,2613000,41999,False,94,scaffold_12
8,2686001,2699000,12999,False,94,scaffold_12
0,1,342000,341999,True,95,scaffold_1
1,483001,498000,14999,False,95,scaffold_1
2,574001,643000,68999,False,95,scaffold_1
3,686001,743000,56999,False,95,scaffold_1
4,1281001,1292000,10999,False,95,scaffold_1
5,1818001,1899000,80999,False,95,scaffold_1
6,1954001,1964000,9999,False,95,scaffold_1
7,1965001,1984000,18999,False,95,scaffold_1
8,2449001,2515000,65999,False,95,scaffold_1
9,2729001,2746000,16999,False,95,scaffold_1
10,3193001,3208000,14999,False,95,scaffold_1
11,3715001,3733000,17999,False,95,scaffold_1
12,3912001,3941000,28999,False,95,scaffold_1
13,4064001,4111000,46999,False,95,scaffold_1
14,4323001,4354000,30999,False,95,scaffold_1
15,4928001,4995000,66999,False,95,scaffold_1
16,5483001,5511000,27999,False,95,scaffold_1
17,6108001,6153000,44999,False,95,scaffold_1
18,6228001,6378000,149999,False,95,scaffold_1
19,6384001,6509000,124999,False,95,scaffold_1
20,6545001,6554000,8999,False,95,scaffold_1
21,7038001,7247000,208999,False,95,scaffold_1
22,7248001,7588000,339999,False,95,scaffold_1
23,7590001,8477000,886999,False,95,scaffold_1
24,8478001,8656000,177999,False,95,scaffold_1
25,8658001,9584000,925999,False,95,scaffold_1
26,9586001,10354000,767999,False,95,scaffold_1
27,10460001,10623000,162999,False,95,scaffold_1
28,10808001,10811000,2999,False,95,scaffold_1
29,10839001,10858000,18999,False,95,scaffold_1
30,11352001,11504000,151999,False,95,scaffold_1
31,11609001,11951000,341999,False,95,scaffold_1
32,12184001,12204000,19999,False,95,scaffold_1
33,12664001,12722000,57999,False,95,scaffold_1
34,12777001,12888000,110999,False,95,scaffold_1
35,13113001,13211000,97999,False,95,scaffold_1
36,13347001,13405000,57999,False,95,scaffold_1
37,14292001,14307000,14999,False,95,scaffold_1
0,21001,48000,26999,False,95,scaffold_2
1,93001,159000,65999,False,95,scaffold_2
2,168001,176000,7999,False,95,scaffold_2
3,303001,318000,14999,False,95,scaffold_2
4,333001,374000,40999,False,95,scaffold_2
5,2336001,2358000,21999,False,95,scaffold_2
6,2405001,2424000,18999,False,95,scaffold_2
7,2441001,2553000,111999,False,95,scaffold_2
8,2660001,2689000,28999,False,95,scaffold_2
9,2694001,2742000,47999,False,95,scaffold_2
10,2841001,2854000,12999,False,95,scaffold_2
11,2995001,3013000,17999,False,95,scaffold_2
12,3454001,3463000,8999,False,95,scaffold_2
13,3769001,3781000,11999,False,95,scaffold_2
14,4385001,4409000,23999,False,95,scaffold_2
15,4426001,4457000,30999,False,95,scaffold_2
16,4524001,4554000,29999,False,95,scaffold_2
17,4592001,4654000,61999,False,95,scaffold_2
18,4920001,4928000,7999,False,95,scaffold_2
19,5022001,5031000,8999,False,95,scaffold_2
20,5033001,5061000,27999,False,95,scaffold_2
21,5491001,5512000,20999,False,95,scaffold_2
22,5672001,5704000,31999,False,95,scaffold_2
23,5719001,5756000,36999,False,95,scaffold_2
24,6261001,6330000,68999,False,95,scaffold_2
25,6331001,6350000,18999,False,95,scaffold_2
26,7439001,7472000,32999,False,95,scaffold_2
27,7563001,7698000,134999,False,95,scaffold_2
28,7786001,7890000,103999,False,95,scaffold_2
29,7934001,7966000,31999,False,95,scaffold_2
30,7984001,8120000,135999,False,95,scaffold_2
31,8261001,8294000,32999,False,95,scaffold_2
32,8331001,8333000,1999,False,95,scaffold_2
33,8340001,8344000,3999,False,95,scaffold_2
34,8346001,8453000,106999,False,95,scaffold_2
35,8509001,8548000,38999,False,95,scaffold_2
36,11367001,11373000,5999,False,95,scaffold_2
37,11520001,11785000,264999,False,95,scaffold_2
0,51001,55000,3999,False,95,scaffold_3
1,102001,104000,1999,False,95,scaffold_3
2,800001,901000,100999,False,95,scaffold_3
3,2085001,2108000,22999,False,95,scaffold_3
4,2110001,2115000,4999,False,95,scaffold_3
5,2291001,2321000,29999,False,95,scaffold_3
6,2487001,2533000,45999,False,95,scaffold_3
7,4108001,4397000,288999,False,95,scaffold_3
8,4418001,4518000,99999,False,95,scaffold_3
9,4547001,4558000,10999,False,95,scaffold_3
10,4654001,4678000,23999,False,95,scaffold_3
11,6910001,6962000,51999,False,95,scaffold_3
12,6979001,7036000,56999,False,95,scaffold_3
13,7538001,7556000,17999,False,95,scaffold_3
14,7692001,7797000,104999,False,95,scaffold_3
15,7822001,7838000,15999,False,95,scaffold_3
16,8177001,8253000,75999,False,95,scaffold_3
17,8462001,8527000,64999,False,95,scaffold_3
18,8575001,8594000,18999,False,95,scaffold_3
19,9968001,9996000,27999,False,95,scaffold_3
20,10461001,10483000,21999,False,95,scaffold_3
21,10587001,11163000,575999,False,95,scaffold_3
0,17001,32000,14999,False,95,scaffold_4
1,48001,88000,39999,False,95,scaffold_4
2,147001,151000,3999,False,95,scaffold_4
3,155001,215000,59999,False,95,scaffold_4
4,217001,226000,8999,False,95,scaffold_4
5,227001,266000,38999,False,95,scaffold_4
6,291001,307000,15999,False,95,scaffold_4
7,313001,344000,30999,False,95,scaffold_4
8,355001,374000,18999,False,95,scaffold_4
9,375001,380000,4999,False,95,scaffold_4
10,389001,425000,35999,False,95,scaffold_4
11,429001,504000,74999,False,95,scaffold_4
12,545001,592000,46999,False,95,scaffold_4
13,593001,606000,12999,False,95,scaffold_4
14,608001,661000,52999,False,95,scaffold_4
15,670001,691000,20999,False,95,scaffold_4
16,701001,727000,25999,False,95,scaffold_4
17,1120001,1136000,15999,False,95,scaffold_4
18,1137001,1198000,60999,False,95,scaffold_4
19,1199001,1208000,8999,False,95,scaffold_4
20,1210001,1226000,15999,False,95,scaffold_4
21,1235001,1246000,10999,False,95,scaffold_4
22,1248001,1253000,4999,False,95,scaffold_4
23,1254001,1262000,7999,False,95,scaffold_4
24,1265001,1279000,13999,False,95,scaffold_4
25,1283001,1337000,53999,False,95,scaffold_4
26,1372001,1597000,224999,False,95,scaffold_4
27,1654001,1869000,214999,False,95,scaffold_4
28,1905001,2004000,98999,False,95,scaffold_4
29,2036001,2068000,31999,False,95,scaffold_4
30,2071001,2095000,23999,False,95,scaffold_4
31,2211001,2218000,6999,False,95,scaffold_4
32,2247001,2268000,20999,False,95,scaffold_4
33,2269001,2279000,9999,False,95,scaffold_4
34,2284001,2340000,55999,False,95,scaffold_4
35,2480001,2533000,52999,False,95,scaffold_4
36,3336001,3633000,296999,False,95,scaffold_4
37,3646001,3762000,115999,False,95,scaffold_4
38,4944001,4985000,40999,False,95,scaffold_4
39,5477001,5506000,28999,False,95,scaffold_4
40,5514001,5620000,105999,False,95,scaffold_4
41,5669001,5784000,114999,False,95,scaffold_4
42,6145001,6190000,44999,False,95,scaffold_4
43,6800001,6817000,16999,False,95,scaffold_4
44,6911001,6924000,12999,False,95,scaffold_4
45,7036001,7062000,25999,False,95,scaffold_4
46,8846001,9699000,852999,False,95,scaffold_4
47,9700001,9845951,145950,True,95,scaffold_4
0,318001,326000,7999,False,95,scaffold_5
1,327001,368000,40999,False,95,scaffold_5
2,464001,523000,58999,False,95,scaffold_5
3,934001,947000,12999,False,95,scaffold_5
4,1062001,1068000,5999,False,95,scaffold_5
5,2565001,2581000,15999,False,95,scaffold_5
6,2625001,2738000,112999,False,95,scaffold_5
7,2816001,2871000,54999,False,95,scaffold_5
8,3138001,3185000,46999,False,95,scaffold_5
9,3322001,3496000,173999,False,95,scaffold_5
10,3962001,4101000,138999,False,95,scaffold_5
11,4121001,4219000,97999,False,95,scaffold_5
12,4246001,4262000,15999,False,95,scaffold_5
13,4446001,4488000,41999,False,95,scaffold_5
14,4601001,4678000,76999,False,95,scaffold_5
15,4691001,4718000,26999,False,95,scaffold_5
16,4789001,4861000,71999,False,95,scaffold_5
17,4904001,4917000,12999,False,95,scaffold_5
18,5318001,5346000,27999,False,95,scaffold_5
19,6540001,6566000,25999,False,95,scaffold_5
20,7580001,7609000,28999,False,95,scaffold_5
21,7622001,7642000,19999,False,95,scaffold_5
22,8730001,9364176,634175,True,95,scaffold_5
0,79001,84000,4999,False,95,scaffold_6
1,86001,112000,25999,False,95,scaffold_6
2,239001,254000,14999,False,95,scaffold_6
3,257001,261000,3999,False,95,scaffold_6
4,267001,283000,15999,False,95,scaffold_6
5,1479001,1546000,66999,False,95,scaffold_6
6,2023001,2087000,63999,False,95,scaffold_6
7,2130001,2191000,60999,False,95,scaffold_6
8,2336001,2595000,258999,False,95,scaffold_6
9,2596001,2653000,56999,False,95,scaffold_6
10,2657001,2691000,33999,False,95,scaffold_6
11,2731001,2851000,119999,False,95,scaffold_6
12,2933001,3014000,80999,False,95,scaffold_6
13,3115001,3149000,33999,False,95,scaffold_6
14,3224001,3301000,76999,False,95,scaffold_6
15,3414001,3427000,12999,False,95,scaffold_6
16,3462001,3766000,303999,False,95,scaffold_6
17,3900001,3912000,11999,False,95,scaffold_6
18,4018001,4066000,47999,False,95,scaffold_6
19,4081001,4193000,111999,False,95,scaffold_6
20,6011001,6060000,48999,False,95,scaffold_6
21,7282001,7337000,54999,False,95,scaffold_6
22,7558001,8268281,710280,True,95,scaffold_6
0,13001,34000,20999,False,95,scaffold_7
1,323001,340000,16999,False,95,scaffold_7
2,342001,508000,165999,False,95,scaffold_7
3,554001,563000,8999,False,95,scaffold_7
4,571001,577000,5999,False,95,scaffold_7
5,706001,736000,29999,False,95,scaffold_7
6,741001,753000,11999,False,95,scaffold_7
7,764001,807000,42999,False,95,scaffold_7
8,859001,864000,4999,False,95,scaffold_7
9,952001,963000,10999,False,95,scaffold_7
10,964001,966000,1999,False,95,scaffold_7
11,968001,980000,11999,False,95,scaffold_7
12,982001,1044000,61999,False,95,scaffold_7
13,1048001,1097000,48999,False,95,scaffold_7
14,1191001,1460000,268999,False,95,scaffold_7
15,1461001,1512000,50999,False,95,scaffold_7
16,1588001,1689000,100999,False,95,scaffold_7
17,3325001,3369000,43999,False,95,scaffold_7
18,3595001,3649000,53999,False,95,scaffold_7
19,4416001,4535000,118999,False,95,scaffold_7
20,4658001,4733000,74999,False,95,scaffold_7
21,4979001,5112000,132999,False,95,scaffold_7
22,6955001,7270000,314999,False,95,scaffold_7
23,7271001,7502216,231215,True,95,scaffold_7
0,67001,85000,17999,False,95,scaffold_8
1,2445001,2470000,24999,False,95,scaffold_8
2,2492001,2512000,19999,False,95,scaffold_8
3,2657001,2683000,25999,False,95,scaffold_8
4,2742001,2757000,14999,False,95,scaffold_8
5,2808001,2844000,35999,False,95,scaffold_8
6,3060001,3525000,464999,False,95,scaffold_8
7,3580001,3612000,31999,False,95,scaffold_8
8,3620001,3913000,292999,False,95,scaffold_8
9,4040001,4081000,40999,False,95,scaffold_8
10,5107001,5136000,28999,False,95,scaffold_8
11,5200001,5241000,40999,False,95,scaffold_8
12,6328001,6334544,6543,True,95,scaffold_8
0,109001,117000,7999,False,95,scaffold_9
1,121001,134000,12999,False,95,scaffold_9
2,301001,315000,13999,False,95,scaffold_9
3,319001,332000,12999,False,95,scaffold_9
4,367001,411000,43999,False,95,scaffold_9
5,413001,434000,20999,False,95,scaffold_9
6,501001,531000,29999,False,95,scaffold_9
7,652001,665000,12999,False,95,scaffold_9
8,670001,697000,26999,False,95,scaffold_9
9,732001,742000,9999,False,95,scaffold_9
10,816001,842000,25999,False,95,scaffold_9
11,850001,862000,11999,False,95,scaffold_9
12,873001,986000,112999,False,95,scaffold_9
13,988001,995000,6999,False,95,scaffold_9
14,1001001,1007000,5999,False,95,scaffold_9
15,1010001,1031000,20999,False,95,scaffold_9
16,1035001,1085000,49999,False,95,scaffold_9
17,1087001,1150000,62999,False,95,scaffold_9
18,1151001,1164000,12999,False,95,scaffold_9
19,1313001,1377000,63999,False,95,scaffold_9
20,1599001,1616000,16999,False,95,scaffold_9
21,1766001,1790000,23999,False,95,scaffold_9
22,2598001,2615000,16999,False,95,scaffold_9
23,2782001,2803000,20999,False,95,scaffold_9
24,2870001,3381000,510999,False,95,scaffold_9
25,3383001,5099000,1715999,False,95,scaffold_9
26,5101001,5107000,5999,False,95,scaffold_9
27,5112001,5115000,2999,False,95,scaffold_9
28,5116001,5238000,121999,False,95,scaffold_9
29,5239001,5298000,58999,False,95,scaffold_9
30,5300001,5490000,189999,False,95,scaffold_9
31,5491001,6331288,840287,True,95,scaffold_9
0,1,198000,197999,True,95,scaffold_10
1,375001,405000,29999,False,95,scaffold_10
2,472001,482000,9999,False,95,scaffold_10
3,483001,581000,97999,False,95,scaffold_10
4,603001,752000,148999,False,95,scaffold_10
5,785001,793000,7999,False,95,scaffold_10
6,888001,917000,28999,False,95,scaffold_10
7,923001,963000,39999,False,95,scaffold_10
8,1087001,1105000,17999,False,95,scaffold_10
9,2346001,2366000,19999,False,95,scaffold_10
10,4051001,4091000,39999,False,95,scaffold_10
11,4154001,4174000,19999,False,95,scaffold_10
12,4443001,4462000,18999,False,95,scaffold_10
13,4467001,4477000,9999,False,95,scaffold_10
14,4506001,4513000,6999,False,95,scaffold_10
15,4515001,4523000,7999,False,95,scaffold_10
16,4526001,4548000,21999,False,95,scaffold_10
17,4576001,4595000,18999,False,95,scaffold_10
18,4679001,4688000,8999,False,95,scaffold_10
19,4734001,4751000,16999,False,95,scaffold_10
20,4752001,4766000,13999,False,95,scaffold_10
21,4768001,4776000,7999,False,95,scaffold_10
22,4798001,4824000,25999,False,95,scaffold_10
23,4827001,4843000,15999,False,95,scaffold_10
24,4848001,4861000,12999,False,95,scaffold_10
25,4865001,4866973,1972,True,95,scaffold_10
0,11001,92000,80999,False,95,scaffold_11
1,149001,167000,17999,False,95,scaffold_11
2,169001,191000,21999,False,95,scaffold_11
3,213001,236000,22999,False,95,scaffold_11
4,240001,248000,7999,False,95,scaffold_11
5,419001,431000,11999,False,95,scaffold_11
6,648001,656000,7999,False,95,scaffold_11
7,1025001,1034000,8999,False,95,scaffold_11
8,1423001,1426000,2999,False,95,scaffold_11
9,1474001,1477000,2999,False,95,scaffold_11
10,2701001,2875000,173999,False,95,scaffold_11
11,3211001,3254000,42999,False,95,scaffold_11
12,3331001,3383000,51999,False,95,scaffold_11
13,3702001,3926000,223999,False,95,scaffold_11
14,4134001,4156000,21999,False,95,scaffold_11
15,4317001,4710000,392999,False,95,scaffold_11
16,4712001,4766820,54819,True,95,scaffold_11
0,1,369000,368999,True,95,scaffold_12
1,404001,538000,133999,False,95,scaffold_12
2,581001,856000,274999,False,95,scaffold_12
3,865001,1450000,584999,False,95,scaffold_12
4,1720001,1733000,12999,False,95,scaffold_12
5,2571001,2618000,46999,False,95,scaffold_12
0,1,342000,341999,True,96,scaffold_1
1,482001,498000,15999,False,96,scaffold_1
2,574001,643000,68999,False,96,scaffold_1
3,686001,713000,26999,False,96,scaffold_1
4,731001,742000,10999,False,96,scaffold_1
5,1281001,1292000,10999,False,96,scaffold_1
6,1954001,1964000,9999,False,96,scaffold_1
7,1965001,1984000,18999,False,96,scaffold_1
8,2449001,2517000,67999,False,96,scaffold_1
9,2729001,2746000,16999,False,96,scaffold_1
10,3181001,3208000,26999,False,96,scaffold_1
11,3715001,3733000,17999,False,96,scaffold_1
12,3916001,3941000,24999,False,96,scaffold_1
13,4066001,4111000,44999,False,96,scaffold_1
14,4322001,4354000,31999,False,96,scaffold_1
15,4928001,4983000,54999,False,96,scaffold_1
16,5484001,5511000,26999,False,96,scaffold_1
17,6108001,6153000,44999,False,96,scaffold_1
18,6228001,6381000,152999,False,96,scaffold_1
19,6384001,6507000,122999,False,96,scaffold_1
20,6545001,6554000,8999,False,96,scaffold_1
21,7038001,7247000,208999,False,96,scaffold_1
22,7248001,7588000,339999,False,96,scaffold_1
23,7590001,8477000,886999,False,96,scaffold_1
24,8478001,8656000,177999,False,96,scaffold_1
25,8658001,9584000,925999,False,96,scaffold_1
26,9586001,10354000,767999,False,96,scaffold_1
27,10461001,10623000,161999,False,96,scaffold_1
28,10808001,10811000,2999,False,96,scaffold_1
29,10839001,10858000,18999,False,96,scaffold_1
30,11351001,11504000,152999,False,96,scaffold_1
31,11615001,11951000,335999,False,96,scaffold_1
32,12184001,12204000,19999,False,96,scaffold_1
33,12678001,12722000,43999,False,96,scaffold_1
34,12777001,12888000,110999,False,96,scaffold_1
35,13114001,13135000,20999,False,96,scaffold_1
36,13179001,13211000,31999,False,96,scaffold_1
37,13347001,13377000,29999,False,96,scaffold_1
0,22001,48000,25999,False,96,scaffold_2
1,93001,159000,65999,False,96,scaffold_2
2,168001,177000,8999,False,96,scaffold_2
3,302001,318000,15999,False,96,scaffold_2
4,331001,374000,42999,False,96,scaffold_2
5,2336001,2358000,21999,False,96,scaffold_2
6,2406001,2423000,16999,False,96,scaffold_2
7,2441001,2553000,111999,False,96,scaffold_2
8,2660001,2689000,28999,False,96,scaffold_2
9,2694001,2742000,47999,False,96,scaffold_2
10,2996001,3011000,14999,False,96,scaffold_2
11,3454001,3463000,8999,False,96,scaffold_2
12,3767001,3781000,13999,False,96,scaffold_2
13,4385001,4409000,23999,False,96,scaffold_2
14,4429001,4456000,26999,False,96,scaffold_2
15,4607001,4656000,48999,False,96,scaffold_2
16,5022001,5031000,8999,False,96,scaffold_2
17,5033001,5061000,27999,False,96,scaffold_2
18,5491001,5511000,19999,False,96,scaffold_2
19,5672001,5704000,31999,False,96,scaffold_2
20,6261001,6330000,68999,False,96,scaffold_2
21,6331001,6342000,10999,False,96,scaffold_2
22,7439001,7472000,32999,False,96,scaffold_2
23,7563001,7697000,133999,False,96,scaffold_2
24,7786001,7890000,103999,False,96,scaffold_2
25,7934001,7965000,30999,False,96,scaffold_2
26,7985001,8088000,102999,False,96,scaffold_2
27,8331001,8333000,1999,False,96,scaffold_2
28,8340001,8344000,3999,False,96,scaffold_2
29,8346001,8389000,42999,False,96,scaffold_2
30,8509001,8535000,25999,False,96,scaffold_2
31,11367001,11371000,3999,False,96,scaffold_2
32,11520001,11785000,264999,False,96,scaffold_2
0,1,2000,1999,True,96,scaffold_3
1,51001,55000,3999,False,96,scaffold_3
2,102001,104000,1999,False,96,scaffold_3
3,799001,900000,100999,False,96,scaffold_3
4,2085001,2108000,22999,False,96,scaffold_3
5,2291001,2321000,29999,False,96,scaffold_3
6,2493001,2533000,39999,False,96,scaffold_3
7,4150001,4383000,232999,False,96,scaffold_3
8,4418001,4518000,99999,False,96,scaffold_3
9,4547001,4558000,10999,False,96,scaffold_3
10,4654001,4678000,23999,False,96,scaffold_3
11,5578001,5581000,2999,False,96,scaffold_3
12,6910001,6962000,51999,False,96,scaffold_3
13,6980001,7036000,55999,False,96,scaffold_3
14,7540001,7556000,15999,False,96,scaffold_3
15,7692001,7725000,32999,False,96,scaffold_3
16,7822001,7838000,15999,False,96,scaffold_3
17,8177001,8255000,77999,False,96,scaffold_3
18,8462001,8527000,64999,False,96,scaffold_3
19,8575001,8594000,18999,False,96,scaffold_3
20,9968001,9996000,27999,False,96,scaffold_3
21,10461001,10483000,21999,False,96,scaffold_3
22,10587001,11164000,576999,False,96,scaffold_3
0,21001,32000,10999,False,96,scaffold_4
1,49001,88000,38999,False,96,scaffold_4
2,155001,160000,4999,False,96,scaffold_4
3,161001,215000,53999,False,96,scaffold_4
4,218001,226000,7999,False,96,scaffold_4
5,227001,266000,38999,False,96,scaffold_4
6,291001,310000,18999,False,96,scaffold_4
7,355001,374000,18999,False,96,scaffold_4
8,375001,380000,4999,False,96,scaffold_4
9,412001,425000,12999,False,96,scaffold_4
10,429001,498000,68999,False,96,scaffold_4
11,546001,606000,59999,False,96,scaffold_4
12,608001,661000,52999,False,96,scaffold_4
13,670001,691000,20999,False,96,scaffold_4
14,701001,714000,12999,False,96,scaffold_4
15,1121001,1136000,14999,False,96,scaffold_4
16,1138001,1179000,40999,False,96,scaffold_4
17,1199001,1208000,8999,False,96,scaffold_4
18,1210001,1226000,15999,False,96,scaffold_4
19,1235001,1253000,17999,False,96,scaffold_4
20,1254001,1262000,7999,False,96,scaffold_4
21,1265001,1279000,13999,False,96,scaffold_4
22,1283001,1315000,31999,False,96,scaffold_4
23,1373001,1591000,217999,False,96,scaffold_4
24,1749001,1815000,65999,False,96,scaffold_4
25,1850001,1868000,17999,False,96,scaffold_4
26,1905001,1957000,51999,False,96,scaffold_4
27,1958001,1994000,35999,False,96,scaffold_4
28,2247001,2279000,31999,False,96,scaffold_4
29,2284001,2340000,55999,False,96,scaffold_4
30,2476001,2533000,56999,False,96,scaffold_4
31,3334001,3632000,297999,False,96,scaffold_4
32,3676001,3759000,82999,False,96,scaffold_4
33,4944001,4984000,39999,False,96,scaffold_4
34,5477001,5506000,28999,False,96,scaffold_4
35,5514001,5620000,105999,False,96,scaffold_4
36,5669001,5784000,114999,False,96,scaffold_4
37,6810001,6817000,6999,False,96,scaffold_4
38,7037001,7062000,24999,False,96,scaffold_4
39,8849001,9699000,849999,False,96,scaffold_4
40,9700001,9845951,145950,True,96,scaffold_4
0,296001,299000,2999,False,96,scaffold_5
1,318001,326000,7999,False,96,scaffold_5
2,327001,368000,40999,False,96,scaffold_5
3,465001,481000,15999,False,96,scaffold_5
4,498001,523000,24999,False,96,scaffold_5
5,933001,947000,13999,False,96,scaffold_5
6,2565001,2581000,15999,False,96,scaffold_5
7,2625001,2732000,106999,False,96,scaffold_5
8,2816001,2871000,54999,False,96,scaffold_5
9,3167001,3184000,16999,False,96,scaffold_5
10,3322001,3437000,114999,False,96,scaffold_5
11,3451001,3494000,42999,False,96,scaffold_5
12,3962001,4101000,138999,False,96,scaffold_5
13,4121001,4142000,20999,False,96,scaffold_5
14,4155001,4219000,63999,False,96,scaffold_5
15,4246001,4263000,16999,False,96,scaffold_5
16,4446001,4488000,41999,False,96,scaffold_5
17,4603001,4650000,46999,False,96,scaffold_5
18,4691001,4718000,26999,False,96,scaffold_5
19,4789001,4861000,71999,False,96,scaffold_5
20,5318001,5346000,27999,False,96,scaffold_5
21,7581001,7609000,27999,False,96,scaffold_5
22,8730001,9364176,634175,True,96,scaffold_5
0,79001,84000,4999,False,96,scaffold_6
1,86001,112000,25999,False,96,scaffold_6
2,239001,253000,13999,False,96,scaffold_6
3,257001,262000,4999,False,96,scaffold_6
4,267001,283000,15999,False,96,scaffold_6
5,1237001,1256000,18999,False,96,scaffold_6
6,1479001,1546000,66999,False,96,scaffold_6
7,2023001,2086000,62999,False,96,scaffold_6
8,2130001,2169000,38999,False,96,scaffold_6
9,2371001,2595000,223999,False,96,scaffold_6
10,2596001,2653000,56999,False,96,scaffold_6
11,2661001,2691000,29999,False,96,scaffold_6
12,2731001,2851000,119999,False,96,scaffold_6
13,2933001,3014000,80999,False,96,scaffold_6
14,3115001,3149000,33999,False,96,scaffold_6
15,3225001,3301000,75999,False,96,scaffold_6
16,3407001,3428000,20999,False,96,scaffold_6
17,3462001,3766000,303999,False,96,scaffold_6
18,3901001,3912000,10999,False,96,scaffold_6
19,4019001,4040000,20999,False,96,scaffold_6
20,4087001,4193000,105999,False,96,scaffold_6
21,6011001,6060000,48999,False,96,scaffold_6
22,7283001,7337000,53999,False,96,scaffold_6
23,7560001,7795000,234999,False,96,scaffold_6
24,7811001,8268281,457280,True,96,scaffold_6
0,1,7000,6999,True,96,scaffold_7
1,13001,31000,17999,False,96,scaffold_7
2,323001,340000,16999,False,96,scaffold_7
3,342001,508000,165999,False,96,scaffold_7
4,554001,563000,8999,False,96,scaffold_7
5,571001,577000,5999,False,96,scaffold_7
6,706001,736000,29999,False,96,scaffold_7
7,741001,753000,11999,False,96,scaffold_7
8,764001,809000,44999,False,96,scaffold_7
9,859001,864000,4999,False,96,scaffold_7
10,982001,1044000,61999,False,96,scaffold_7
11,1191001,1512000,320999,False,96,scaffold_7
12,1588001,1693000,104999,False,96,scaffold_7
13,3326001,3369000,42999,False,96,scaffold_7
14,3595001,3649000,53999,False,96,scaffold_7
15,4418001,4517000,98999,False,96,scaffold_7
16,4658001,4681000,22999,False,96,scaffold_7
17,4979001,5030000,50999,False,96,scaffold_7
18,5077001,5113000,35999,False,96,scaffold_7
19,6954001,7270000,315999,False,96,scaffold_7
20,7271001,7502216,231215,True,96,scaffold_7
0,66001,85000,18999,False,96,scaffold_8
1,722001,724000,1999,False,96,scaffold_8
2,2662001,2683000,20999,False,96,scaffold_8
3,2745001,2756000,10999,False,96,scaffold_8
4,3060001,3525000,464999,False,96,scaffold_8
5,3584001,3612000,27999,False,96,scaffold_8
6,3615001,3913000,297999,False,96,scaffold_8
7,5200001,5241000,40999,False,96,scaffold_8
8,6329001,6334544,5543,True,96,scaffold_8
0,109001,117000,7999,False,96,scaffold_9
1,303001,315000,11999,False,96,scaffold_9
2,319001,332000,12999,False,96,scaffold_9
3,367001,411000,43999,False,96,scaffold_9
4,413001,434000,20999,False,96,scaffold_9
5,436001,441000,4999,False,96,scaffold_9
6,503001,531000,27999,False,96,scaffold_9
7,671001,696000,24999,False,96,scaffold_9
8,732001,742000,9999,False,96,scaffold_9
9,794001,803000,8999,False,96,scaffold_9
10,817001,843000,25999,False,96,scaffold_9
11,850001,862000,11999,False,96,scaffold_9
12,886001,986000,99999,False,96,scaffold_9
13,988001,995000,6999,False,96,scaffold_9
14,1001001,1007000,5999,False,96,scaffold_9
15,1010001,1031000,20999,False,96,scaffold_9
16,1035001,1085000,49999,False,96,scaffold_9
17,1087001,1150000,62999,False,96,scaffold_9
18,1151001,1164000,12999,False,96,scaffold_9
19,1313001,1377000,63999,False,96,scaffold_9
20,1770001,1783000,12999,False,96,scaffold_9
21,2601001,2615000,13999,False,96,scaffold_9
22,2874001,3381000,506999,False,96,scaffold_9
23,3383001,5107000,1723999,False,96,scaffold_9
24,5112001,5115000,2999,False,96,scaffold_9
25,5116001,5238000,121999,False,96,scaffold_9
26,5239001,5298000,58999,False,96,scaffold_9
27,5300001,6331288,1031287,True,96,scaffold_9
0,1,197000,196999,True,96,scaffold_10
1,375001,405000,29999,False,96,scaffold_10
2,472001,482000,9999,False,96,scaffold_10
3,483001,576000,92999,False,96,scaffold_10
4,603001,722000,118999,False,96,scaffold_10
5,735001,739000,3999,False,96,scaffold_10
6,888001,916000,27999,False,96,scaffold_10
7,924001,962000,37999,False,96,scaffold_10
8,1087001,1105000,17999,False,96,scaffold_10
9,2346001,2366000,19999,False,96,scaffold_10
10,3264001,3268000,3999,False,96,scaffold_10
11,4054001,4091000,36999,False,96,scaffold_10
12,4154001,4174000,19999,False,96,scaffold_10
13,4444001,4459000,14999,False,96,scaffold_10
14,4506001,4513000,6999,False,96,scaffold_10
15,4515001,4523000,7999,False,96,scaffold_10
16,4526001,4548000,21999,False,96,scaffold_10
17,4575001,4596000,20999,False,96,scaffold_10
18,4679001,4688000,8999,False,96,scaffold_10
19,4734001,4751000,16999,False,96,scaffold_10
20,4752001,4766000,13999,False,96,scaffold_10
21,4769001,4776000,6999,False,96,scaffold_10
22,4798001,4824000,25999,False,96,scaffold_10
23,4827001,4843000,15999,False,96,scaffold_10
24,4848001,4861000,12999,False,96,scaffold_10
25,4865001,4866973,1972,True,96,scaffold_10
0,10001,91000,80999,False,96,scaffold_11
1,149001,167000,17999,False,96,scaffold_11
2,169001,191000,21999,False,96,scaffold_11
3,213001,236000,22999,False,96,scaffold_11
4,419001,431000,11999,False,96,scaffold_11
5,648001,656000,7999,False,96,scaffold_11
6,1025001,1034000,8999,False,96,scaffold_11
7,1305001,1307000,1999,False,96,scaffold_11
8,1423001,1426000,2999,False,96,scaffold_11
9,2701001,2872000,170999,False,96,scaffold_11
10,3213001,3254000,40999,False,96,scaffold_11
11,3331001,3380000,48999,False,96,scaffold_11
12,3702001,3926000,223999,False,96,scaffold_11
13,4321001,4710000,388999,False,96,scaffold_11
14,4713001,4766820,53819,True,96,scaffold_11
0,1,369000,368999,True,96,scaffold_12
1,474001,537000,62999,False,96,scaffold_12
2,582001,731000,148999,False,96,scaffold_12
3,739001,856000,116999,False,96,scaffold_12
4,865001,1354000,488999,False,96,scaffold_12
5,1720001,1733000,12999,False,96,scaffold_12
6,2571001,2609000,37999,False,96,scaffold_12
0,1,347000,346999,True,97,scaffold_1
1,482001,498000,15999,False,97,scaffold_1
2,571001,660000,88999,False,97,scaffold_1
3,686001,753000,66999,False,97,scaffold_1
4,794001,905000,110999,False,97,scaffold_1
5,906001,942000,35999,False,97,scaffold_1
6,1280001,1292000,11999,False,97,scaffold_1
7,1805001,1938000,132999,False,97,scaffold_1
8,1941001,1964000,22999,False,97,scaffold_1
9,1965001,1984000,18999,False,97,scaffold_1
10,1987001,2015000,27999,False,97,scaffold_1
11,2292001,2304000,11999,False,97,scaffold_1
12,2354001,2419000,64999,False,97,scaffold_1
13,2449001,2517000,67999,False,97,scaffold_1
14,2547001,2621000,73999,False,97,scaffold_1
15,2719001,2746000,26999,False,97,scaffold_1
16,2897001,2925000,27999,False,97,scaffold_1
17,2978001,3024000,45999,False,97,scaffold_1
18,3160001,3210000,49999,False,97,scaffold_1
19,3444001,3520000,75999,False,97,scaffold_1
20,3578001,3622000,43999,False,97,scaffold_1
21,3685001,3941000,255999,False,97,scaffold_1
22,3942001,4113000,170999,False,97,scaffold_1
23,4140001,4163000,22999,False,97,scaffold_1
24,4304001,4514000,209999,False,97,scaffold_1
25,4527001,4551000,23999,False,97,scaffold_1
26,4640001,4790000,149999,False,97,scaffold_1
27,4796001,4896000,99999,False,97,scaffold_1
28,4908001,5025000,116999,False,97,scaffold_1
29,5087001,5120000,32999,False,97,scaffold_1
30,5130001,5181000,50999,False,97,scaffold_1
31,5481001,5521000,39999,False,97,scaffold_1
32,5535001,5596000,60999,False,97,scaffold_1
33,5852001,5916000,63999,False,97,scaffold_1
34,6108001,6153000,44999,False,97,scaffold_1
35,6154001,6380000,225999,False,97,scaffold_1
36,6384001,6575000,190999,False,97,scaffold_1
37,6641001,6658000,16999,False,97,scaffold_1
38,6829001,6862000,32999,False,97,scaffold_1
39,6864001,6878000,13999,False,97,scaffold_1
40,6925001,6953000,27999,False,97,scaffold_1
41,7037001,7247000,209999,False,97,scaffold_1
42,7248001,7583000,334999,False,97,scaffold_1
43,7590001,8656000,1065999,False,97,scaffold_1
44,8658001,9584000,925999,False,97,scaffold_1
45,9586001,10364000,777999,False,97,scaffold_1
46,10460001,10642000,181999,False,97,scaffold_1
47,10656001,10756000,99999,False,97,scaffold_1
48,10837001,10857000,19999,False,97,scaffold_1
49,10920001,10965000,44999,False,97,scaffold_1
50,11014001,11076000,61999,False,97,scaffold_1
51,11141001,11195000,53999,False,97,scaffold_1
52,11278001,11965000,686999,False,97,scaffold_1
53,12184001,12206000,21999,False,97,scaffold_1
54,12329001,12375000,45999,False,97,scaffold_1
55,12423001,12450000,26999,False,97,scaffold_1
56,12483001,12758000,274999,False,97,scaffold_1
57,12775001,12951000,175999,False,97,scaffold_1
58,12963001,13050000,86999,False,97,scaffold_1
59,13113001,13216000,102999,False,97,scaffold_1
60,13322001,13455000,132999,False,97,scaffold_1
61,13474001,13496000,21999,False,97,scaffold_1
62,13517001,13538000,20999,False,97,scaffold_1
63,13557001,13615000,57999,False,97,scaffold_1
64,13668001,13710000,41999,False,97,scaffold_1
65,13813001,13845000,31999,False,97,scaffold_1
66,13913001,13927000,13999,False,97,scaffold_1
67,13958001,13988000,29999,False,97,scaffold_1
68,14285001,14313000,27999,False,97,scaffold_1
69,14578001,14591000,12999,False,97,scaffold_1
70,14595001,14600000,4999,False,97,scaffold_1
0,21001,48000,26999,False,97,scaffold_2
1,67001,91000,23999,False,97,scaffold_2
2,92001,159000,66999,False,97,scaffold_2
3,168001,177000,8999,False,97,scaffold_2
4,253001,288000,34999,False,97,scaffold_2
5,302001,318000,15999,False,97,scaffold_2
6,331001,374000,42999,False,97,scaffold_2
7,735001,739000,3999,False,97,scaffold_2
8,1233001,1256000,22999,False,97,scaffold_2
9,1311001,1332000,20999,False,97,scaffold_2
10,1359001,1422000,62999,False,97,scaffold_2
11,1519001,1557000,37999,False,97,scaffold_2
12,1691001,1718000,26999,False,97,scaffold_2
13,1837001,1861000,23999,False,97,scaffold_2
14,2081001,2133000,51999,False,97,scaffold_2
15,2336001,2609000,272999,False,97,scaffold_2
16,2627001,2638000,10999,False,97,scaffold_2
17,2645001,2689000,43999,False,97,scaffold_2
18,2694001,2746000,51999,False,97,scaffold_2
19,2797001,2855000,57999,False,97,scaffold_2
20,2876001,2905000,28999,False,97,scaffold_2
21,2953001,3021000,67999,False,97,scaffold_2
22,3022001,3047000,24999,False,97,scaffold_2
23,3175001,3185000,9999,False,97,scaffold_2
24,3272001,3284000,11999,False,97,scaffold_2
25,3332001,3390000,57999,False,97,scaffold_2
26,3450001,3548000,97999,False,97,scaffold_2
27,3579001,3694000,114999,False,97,scaffold_2
28,3754001,3803000,48999,False,97,scaffold_2
29,4240001,4409000,168999,False,97,scaffold_2
30,4426001,4790000,363999,False,97,scaffold_2
31,4793001,4803000,9999,False,97,scaffold_2
32,4917001,4970000,52999,False,97,scaffold_2
33,5018001,5104000,85999,False,97,scaffold_2
34,5199001,5224000,24999,False,97,scaffold_2
35,5254001,5274000,19999,False,97,scaffold_2
36,5285001,5563000,277999,False,97,scaffold_2
37,5606001,5764000,157999,False,97,scaffold_2
38,5840001,5892000,51999,False,97,scaffold_2
39,5906001,6058000,151999,False,97,scaffold_2
40,6092001,6145000,52999,False,97,scaffold_2
41,6227001,6330000,102999,False,97,scaffold_2
42,6331001,6351000,19999,False,97,scaffold_2
43,6365001,6483000,117999,False,97,scaffold_2
44,6546001,6628000,81999,False,97,scaffold_2
45,6689001,6761000,71999,False,97,scaffold_2
46,6796001,6862000,65999,False,97,scaffold_2
47,6939001,7221000,281999,False,97,scaffold_2
48,7340001,7472000,131999,False,97,scaffold_2
49,7491001,7518000,26999,False,97,scaffold_2
50,7549001,7561000,11999,False,97,scaffold_2
51,7563001,7917000,353999,False,97,scaffold_2
52,7933001,8328000,394999,False,97,scaffold_2
53,8331001,8333000,1999,False,97,scaffold_2
54,8334001,8345000,10999,False,97,scaffold_2
55,8346001,8494000,147999,False,97,scaffold_2
56,8495001,8563000,67999,False,97,scaffold_2
57,8998001,9051000,52999,False,97,scaffold_2
58,9140001,9457000,316999,False,97,scaffold_2
59,9574001,9636000,61999,False,97,scaffold_2
60,9790001,9828000,37999,False,97,scaffold_2
61,10397001,10504000,106999,False,97,scaffold_2
62,10676001,10708000,31999,False,97,scaffold_2
63,10710001,10736000,25999,False,97,scaffold_2
64,11024001,11070000,45999,False,97,scaffold_2
65,11327001,11381000,53999,False,97,scaffold_2
66,11395001,11425000,29999,False,97,scaffold_2
67,11519001,11786000,266999,False,97,scaffold_2
0,1,2000,1999,True,97,scaffold_3
1,346001,349000,2999,False,97,scaffold_3
2,618001,646000,27999,False,97,scaffold_3
3,798001,900000,101999,False,97,scaffold_3
4,1584001,1664000,79999,False,97,scaffold_3
5,1902001,1979000,76999,False,97,scaffold_3
6,2000001,2126000,125999,False,97,scaffold_3
7,2168001,2336000,167999,False,97,scaffold_3
8,2385001,2428000,42999,False,97,scaffold_3
9,2432001,2532000,99999,False,97,scaffold_3
10,2622001,2760000,137999,False,97,scaffold_3
11,3051001,3062000,10999,False,97,scaffold_3
12,3066001,3277000,210999,False,97,scaffold_3
13,3410001,3440000,29999,False,97,scaffold_3
14,3561001,3821000,259999,False,97,scaffold_3
15,3822001,3891000,68999,False,97,scaffold_3
16,3910001,3921000,10999,False,97,scaffold_3
17,3922001,3948000,25999,False,97,scaffold_3
18,4007001,4036000,28999,False,97,scaffold_3
19,4058001,4403000,344999,False,97,scaffold_3
20,4414001,4520000,105999,False,97,scaffold_3
21,4546001,4558000,11999,False,97,scaffold_3
22,4614001,4686000,71999,False,97,scaffold_3
23,4854001,4914000,59999,False,97,scaffold_3
24,4997001,5125000,127999,False,97,scaffold_3
25,5142001,5222000,79999,False,97,scaffold_3
26,5236001,5297000,60999,False,97,scaffold_3
27,5376001,5509000,132999,False,97,scaffold_3
28,5556001,5676000,119999,False,97,scaffold_3
29,5778001,6030000,251999,False,97,scaffold_3
30,6519001,6577000,57999,False,97,scaffold_3
31,6739001,6807000,67999,False,97,scaffold_3
32,6848001,7157000,308999,False,97,scaffold_3
33,7253001,7328000,74999,False,97,scaffold_3
34,7333001,7445000,111999,False,97,scaffold_3
35,7483001,7563000,79999,False,97,scaffold_3
36,7576001,7624000,47999,False,97,scaffold_3
37,7655001,7935000,279999,False,97,scaffold_3
38,8028001,8156000,127999,False,97,scaffold_3
39,8175001,8278000,102999,False,97,scaffold_3
40,8379001,8627000,247999,False,97,scaffold_3
41,8758001,8771000,12999,False,97,scaffold_3
42,8956001,9169000,212999,False,97,scaffold_3
43,9199001,9248000,48999,False,97,scaffold_3
44,9468001,9493000,24999,False,97,scaffold_3
45,9499001,9534000,34999,False,97,scaffold_3
46,9555001,9580000,24999,False,97,scaffold_3
47,9645001,9687000,41999,False,97,scaffold_3
48,9847001,9854000,6999,False,97,scaffold_3
49,9968001,9996000,27999,False,97,scaffold_3
50,10042001,10147000,104999,False,97,scaffold_3
51,10461001,10509000,47999,False,97,scaffold_3
52,10525001,11182071,657070,True,97,scaffold_3
0,17001,32000,14999,False,97,scaffold_4
1,48001,88000,39999,False,97,scaffold_4
2,120001,146000,25999,False,97,scaffold_4
3,147001,151000,3999,False,97,scaffold_4
4,155001,215000,59999,False,97,scaffold_4
5,217001,226000,8999,False,97,scaffold_4
6,227001,267000,39999,False,97,scaffold_4
7,283001,311000,27999,False,97,scaffold_4
8,312001,353000,40999,False,97,scaffold_4
9,355001,374000,18999,False,97,scaffold_4
10,375001,425000,49999,False,97,scaffold_4
11,429001,505000,75999,False,97,scaffold_4
12,524001,592000,67999,False,97,scaffold_4
13,593001,606000,12999,False,97,scaffold_4
14,608001,691000,82999,False,97,scaffold_4
15,1052001,1081000,28999,False,97,scaffold_4
16,1087001,1097000,9999,False,97,scaffold_4
17,1098001,1109000,10999,False,97,scaffold_4
18,1113001,1136000,22999,False,97,scaffold_4
19,1137001,1198000,60999,False,97,scaffold_4
20,1199001,1226000,26999,False,97,scaffold_4
21,1235001,1279000,43999,False,97,scaffold_4
22,1283001,1605000,321999,False,97,scaffold_4
23,1613001,2218000,604999,False,97,scaffold_4
24,2219001,2268000,48999,False,97,scaffold_4
25,2269001,2280000,10999,False,97,scaffold_4
26,2283001,2461000,177999,False,97,scaffold_4
27,2480001,2675000,194999,False,97,scaffold_4
28,2676001,2815000,138999,False,97,scaffold_4
29,2891001,3138000,246999,False,97,scaffold_4
30,3162001,3329000,166999,False,97,scaffold_4
31,3334001,3839000,504999,False,97,scaffold_4
32,3919001,3953000,33999,False,97,scaffold_4
33,4010001,4046000,35999,False,97,scaffold_4
34,4051001,4144000,92999,False,97,scaffold_4
35,4231001,4307000,75999,False,97,scaffold_4
36,4900001,5102000,201999,False,97,scaffold_4
37,5169001,5244000,74999,False,97,scaffold_4
38,5291001,5506000,214999,False,97,scaffold_4
39,5513001,5784000,270999,False,97,scaffold_4
40,5786001,5828000,41999,False,97,scaffold_4
41,5870001,5993000,122999,False,97,scaffold_4
42,6068001,6113000,44999,False,97,scaffold_4
43,6148001,6434000,285999,False,97,scaffold_4
44,6708001,6817000,108999,False,97,scaffold_4
45,6873001,6924000,50999,False,97,scaffold_4
46,6960001,6995000,34999,False,97,scaffold_4
47,7036001,7429000,392999,False,97,scaffold_4
48,7497001,7570000,72999,False,97,scaffold_4
49,7628001,7665000,36999,False,97,scaffold_4
50,7860001,7918000,57999,False,97,scaffold_4
51,7975001,8016000,40999,False,97,scaffold_4
52,8051001,8126000,74999,False,97,scaffold_4
53,8844001,9699000,854999,False,97,scaffold_4
54,9700001,9845951,145950,True,97,scaffold_4
0,1,4000,3999,True,97,scaffold_5
1,28001,32000,3999,False,97,scaffold_5
2,141001,174000,32999,False,97,scaffold_5
3,189001,204000,14999,False,97,scaffold_5
4,318001,401000,82999,False,97,scaffold_5
5,402001,428000,25999,False,97,scaffold_5
6,445001,526000,80999,False,97,scaffold_5
7,669001,699000,29999,False,97,scaffold_5
8,931001,955000,23999,False,97,scaffold_5
9,1097001,1104000,6999,False,97,scaffold_5
10,1360001,1386000,25999,False,97,scaffold_5
11,1650001,1661000,10999,False,97,scaffold_5
12,2264001,2316000,51999,False,97,scaffold_5
13,2473001,2496000,22999,False,97,scaffold_5
14,2505001,2515000,9999,False,97,scaffold_5
15,2516001,2526000,9999,False,97,scaffold_5
16,2550001,2876000,325999,False,97,scaffold_5
17,2961001,3007000,45999,False,97,scaffold_5
18,3049001,3078000,28999,False,97,scaffold_5
19,3118001,3551000,432999,False,97,scaffold_5
20,3616001,3658000,41999,False,97,scaffold_5
21,3714001,3751000,36999,False,97,scaffold_5
22,3796001,4413000,616999,False,97,scaffold_5
23,4420001,4432000,11999,False,97,scaffold_5
24,4445001,4925000,479999,False,97,scaffold_5
25,4972001,5106000,133999,False,97,scaffold_5
26,5217001,5353000,135999,False,97,scaffold_5
27,5500001,5529000,28999,False,97,scaffold_5
28,5690001,5738000,47999,False,97,scaffold_5
29,6392001,6726000,333999,False,97,scaffold_5
30,6820001,6853000,32999,False,97,scaffold_5
31,6877001,6943000,65999,False,97,scaffold_5
32,7035001,7086000,50999,False,97,scaffold_5
33,7097001,7100000,2999,False,97,scaffold_5
34,7169001,7244000,74999,False,97,scaffold_5
35,7258001,7330000,71999,False,97,scaffold_5
36,7334001,7386000,51999,False,97,scaffold_5
37,7406001,7451000,44999,False,97,scaffold_5
38,7454001,7514000,59999,False,97,scaffold_5
39,7546001,7747000,200999,False,97,scaffold_5
40,7834001,7896000,61999,False,97,scaffold_5
41,8435001,8469000,33999,False,97,scaffold_5
42,8548001,8619000,70999,False,97,scaffold_5
43,8636001,8687000,50999,False,97,scaffold_5
44,8702001,9363000,660999,False,97,scaffold_5
45,9364001,9364176,175,True,97,scaffold_5
0,42001,75000,32999,False,97,scaffold_6
1,78001,85000,6999,False,97,scaffold_6
2,86001,126000,39999,False,97,scaffold_6
3,141001,208000,66999,False,97,scaffold_6
4,239001,360000,120999,False,97,scaffold_6
5,467001,484000,16999,False,97,scaffold_6
6,640001,665000,24999,False,97,scaffold_6
7,707001,760000,52999,False,97,scaffold_6
8,786001,800000,13999,False,97,scaffold_6
9,965001,1039000,73999,False,97,scaffold_6
10,1121001,1263000,141999,False,97,scaffold_6
11,1283001,1311000,27999,False,97,scaffold_6
12,1431001,1598000,166999,False,97,scaffold_6
13,1648001,1906000,257999,False,97,scaffold_6
14,1977001,2019000,41999,False,97,scaffold_6
15,2023001,2104000,80999,False,97,scaffold_6
16,2129001,2213000,83999,False,97,scaffold_6
17,2236001,2284000,47999,False,97,scaffold_6
18,2334001,2872000,537999,False,97,scaffold_6
19,2908001,3350000,441999,False,97,scaffold_6
20,3351001,3806000,454999,False,97,scaffold_6
21,3810001,3848000,37999,False,97,scaffold_6
22,3856001,4206000,349999,False,97,scaffold_6
23,4631001,4668000,36999,False,97,scaffold_6
24,4838001,4869000,30999,False,97,scaffold_6
25,4956001,4996000,39999,False,97,scaffold_6
26,5289001,5314000,24999,False,97,scaffold_6
27,5443001,5471000,27999,False,97,scaffold_6
28,5581001,5739000,157999,False,97,scaffold_6
29,5774001,5798000,23999,False,97,scaffold_6
30,5861001,6084000,222999,False,97,scaffold_6
31,6123001,6190000,66999,False,97,scaffold_6
32,6451001,6511000,59999,False,97,scaffold_6
33,6685001,6716000,30999,False,97,scaffold_6
34,6755001,6804000,48999,False,97,scaffold_6
35,6834001,6854000,19999,False,97,scaffold_6
36,6911001,6942000,30999,False,97,scaffold_6
37,6973001,7009000,35999,False,97,scaffold_6
38,7184001,7476000,291999,False,97,scaffold_6
39,7541001,8268281,727280,True,97,scaffold_6
0,1,8000,7999,True,97,scaffold_7
1,10001,34000,23999,False,97,scaffold_7
2,50001,60000,9999,False,97,scaffold_7
3,307001,340000,32999,False,97,scaffold_7
4,342001,508000,165999,False,97,scaffold_7
5,571001,579000,7999,False,97,scaffold_7
6,622001,641000,18999,False,97,scaffold_7
7,651001,754000,102999,False,97,scaffold_7
8,763001,828000,64999,False,97,scaffold_7
9,876001,948000,71999,False,97,scaffold_7
10,949001,963000,13999,False,97,scaffold_7
11,964001,980000,15999,False,97,scaffold_7
12,982001,1044000,61999,False,97,scaffold_7
13,1048001,1104000,55999,False,97,scaffold_7
14,1191001,1460000,268999,False,97,scaffold_7
15,1461001,1512000,50999,False,97,scaffold_7
16,1588001,1721000,132999,False,97,scaffold_7
17,1738001,1782000,43999,False,97,scaffold_7
18,1848001,1902000,53999,False,97,scaffold_7
19,1975001,2010000,34999,False,97,scaffold_7
20,2223001,2257000,33999,False,97,scaffold_7
21,2541001,2666000,124999,False,97,scaffold_7
22,2682001,2759000,76999,False,97,scaffold_7
23,2803001,2959000,155999,False,97,scaffold_7
24,3037001,3082000,44999,False,97,scaffold_7
25,3097001,3118000,20999,False,97,scaffold_7
26,3203001,3270000,66999,False,97,scaffold_7
27,3325001,3377000,51999,False,97,scaffold_7
28,3498001,3808000,309999,False,97,scaffold_7
29,3915001,3985000,69999,False,97,scaffold_7
30,4021001,4060000,38999,False,97,scaffold_7
31,4324001,4383000,58999,False,97,scaffold_7
32,4415001,4536000,120999,False,97,scaffold_7
33,4547001,4580000,32999,False,97,scaffold_7
34,4631001,4919000,287999,False,97,scaffold_7
35,4932001,5169000,236999,False,97,scaffold_7
36,5392001,5449000,56999,False,97,scaffold_7
37,5467001,5645000,177999,False,97,scaffold_7
38,6049001,6094000,44999,False,97,scaffold_7
39,6096001,6279000,182999,False,97,scaffold_7
40,6297001,6369000,71999,False,97,scaffold_7
41,6564001,6684000,119999,False,97,scaffold_7
42,6695001,6742000,46999,False,97,scaffold_7
43,6746001,6798000,51999,False,97,scaffold_7
44,6953001,7502216,549215,True,97,scaffold_7
0,1,6000,5999,True,97,scaffold_8
1,32001,64000,31999,False,97,scaffold_8
2,66001,85000,18999,False,97,scaffold_8
3,93001,101000,7999,False,97,scaffold_8
4,1021001,1056000,34999,False,97,scaffold_8
5,1363001,1422000,58999,False,97,scaffold_8
6,1740001,1762000,21999,False,97,scaffold_8
7,1858001,1928000,69999,False,97,scaffold_8
8,2005001,2185000,179999,False,97,scaffold_8
9,2229001,2238000,8999,False,97,scaffold_8
10,2355001,2597000,241999,False,97,scaffold_8
11,2610001,2683000,72999,False,97,scaffold_8
12,2684001,2844000,159999,False,97,scaffold_8
13,2846001,2901000,54999,False,97,scaffold_8
14,2947001,3612000,664999,False,97,scaffold_8
15,3615001,3948000,332999,False,97,scaffold_8
16,4035001,4271000,235999,False,97,scaffold_8
17,4330001,4434000,103999,False,97,scaffold_8
18,4609001,4651000,41999,False,97,scaffold_8
19,4716001,4777000,60999,False,97,scaffold_8
20,4892001,4927000,34999,False,97,scaffold_8
21,4982001,5035000,52999,False,97,scaffold_8
22,5088001,5243000,154999,False,97,scaffold_8
23,5386001,5487000,100999,False,97,scaffold_8
24,5501001,5596000,94999,False,97,scaffold_8
25,5651001,5715000,63999,False,97,scaffold_8
26,5726001,5907000,180999,False,97,scaffold_8
27,5928001,5998000,69999,False,97,scaffold_8
28,6025001,6137000,111999,False,97,scaffold_8
29,6217001,6334544,117543,True,97,scaffold_8
0,1,22000,21999,True,97,scaffold_9
1,97001,106000,8999,False,97,scaffold_9
2,109001,117000,7999,False,97,scaffold_9
3,298001,315000,16999,False,97,scaffold_9
4,319001,334000,14999,False,97,scaffold_9
5,366001,411000,44999,False,97,scaffold_9
6,413001,434000,20999,False,97,scaffold_9
7,484001,531000,46999,False,97,scaffold_9
8,557001,560000,2999,False,97,scaffold_9
9,634001,665000,30999,False,97,scaffold_9
10,670001,709000,38999,False,97,scaffold_9
11,731001,742000,10999,False,97,scaffold_9
12,814001,843000,28999,False,97,scaffold_9
13,873001,986000,112999,False,97,scaffold_9
14,988001,995000,6999,False,97,scaffold_9
15,997001,1007000,9999,False,97,scaffold_9
16,1008001,1085000,76999,False,97,scaffold_9
17,1087001,1150000,62999,False,97,scaffold_9
18,1151001,1177000,25999,False,97,scaffold_9
19,1240001,1256000,15999,False,97,scaffold_9
20,1311001,1403000,91999,False,97,scaffold_9
21,1428001,1441000,12999,False,97,scaffold_9
22,1457001,1465000,7999,False,97,scaffold_9
23,1520001,1589000,68999,False,97,scaffold_9
24,1600001,1692000,91999,False,97,scaffold_9
25,1706001,1714000,7999,False,97,scaffold_9
26,1715001,1728000,12999,False,97,scaffold_9
27,1731001,1811000,79999,False,97,scaffold_9
28,1814001,1857000,42999,False,97,scaffold_9
29,1886001,1957000,70999,False,97,scaffold_9
30,1987001,2306000,318999,False,97,scaffold_9
31,2477001,2580000,102999,False,97,scaffold_9
32,2584001,2672000,87999,False,97,scaffold_9
33,2735001,3381000,645999,False,97,scaffold_9
34,3383001,5107000,1723999,False,97,scaffold_9
35,5112001,5115000,2999,False,97,scaffold_9
36,5116001,5238000,121999,False,97,scaffold_9
37,5239001,5298000,58999,False,97,scaffold_9
38,5299001,6331288,1032287,True,97,scaffold_9
0,1,482000,481999,True,97,scaffold_10
1,483001,582000,98999,False,97,scaffold_10
2,596001,877000,280999,False,97,scaffold_10
3,888001,1069000,180999,False,97,scaffold_10
4,1073001,1209000,135999,False,97,scaffold_10
5,1307001,1364000,56999,False,97,scaffold_10
6,1366001,1472000,105999,False,97,scaffold_10
7,1500001,1570000,69999,False,97,scaffold_10
8,1587001,1758000,170999,False,97,scaffold_10
9,1805001,1817000,11999,False,97,scaffold_10
10,1862001,1922000,59999,False,97,scaffold_10
11,2002001,2112000,109999,False,97,scaffold_10
12,2136001,2333000,196999,False,97,scaffold_10
13,2334001,2471000,136999,False,97,scaffold_10
14,2504001,2520000,15999,False,97,scaffold_10
15,2521001,2653000,131999,False,97,scaffold_10
16,2674001,2813000,138999,False,97,scaffold_10
17,2817001,2880000,62999,False,97,scaffold_10
18,2941001,2955000,13999,False,97,scaffold_10
19,3110001,3177000,66999,False,97,scaffold_10
20,3396001,3424000,27999,False,97,scaffold_10
21,3466001,3476000,9999,False,97,scaffold_10
22,3573001,3582000,8999,False,97,scaffold_10
23,3634001,3675000,40999,False,97,scaffold_10
24,3771001,3796000,24999,False,97,scaffold_10
25,4050001,4092000,41999,False,97,scaffold_10
26,4154001,4177000,22999,False,97,scaffold_10
27,4316001,4323000,6999,False,97,scaffold_10
28,4335001,4359000,23999,False,97,scaffold_10
29,4444001,4462000,17999,False,97,scaffold_10
30,4467001,4502000,34999,False,97,scaffold_10
31,4503001,4513000,9999,False,97,scaffold_10
32,4515001,4548000,32999,False,97,scaffold_10
33,4565001,4596000,30999,False,97,scaffold_10
34,4727001,4732000,4999,False,97,scaffold_10
35,4733001,4766000,32999,False,97,scaffold_10
36,4767001,4776000,8999,False,97,scaffold_10
37,4798001,4824000,25999,False,97,scaffold_10
38,4828001,4843000,14999,False,97,scaffold_10
39,4848001,4856000,7999,False,97,scaffold_10
0,11001,93000,81999,False,97,scaffold_11
1,149001,167000,17999,False,97,scaffold_11
2,169001,212000,42999,False,97,scaffold_11
3,213001,236000,22999,False,97,scaffold_11
4,240001,253000,12999,False,97,scaffold_11
5,288001,317000,28999,False,97,scaffold_11
6,419001,431000,11999,False,97,scaffold_11
7,637001,656000,18999,False,97,scaffold_11
8,1115001,1120000,4999,False,97,scaffold_11
9,1219001,1242000,22999,False,97,scaffold_11
10,1315001,1372000,56999,False,97,scaffold_11
11,1423001,1426000,2999,False,97,scaffold_11
12,1432001,1452000,19999,False,97,scaffold_11
13,1474001,1477000,2999,False,97,scaffold_11
14,1853001,1885000,31999,False,97,scaffold_11
15,1903001,1929000,25999,False,97,scaffold_11
16,1966001,1997000,30999,False,97,scaffold_11
17,2014001,2034000,19999,False,97,scaffold_11
18,2035001,2060000,24999,False,97,scaffold_11
19,2061001,2068000,6999,False,97,scaffold_11
20,2087001,2130000,42999,False,97,scaffold_11
21,2131001,2150000,18999,False,97,scaffold_11
22,2202001,2237000,34999,False,97,scaffold_11
23,2701001,2920000,218999,False,97,scaffold_11
24,2950001,3019000,68999,False,97,scaffold_11
25,3060001,3183000,122999,False,97,scaffold_11
26,3184001,3325000,140999,False,97,scaffold_11
27,3327001,3384000,56999,False,97,scaffold_11
28,3423001,3481000,57999,False,97,scaffold_11
29,3518001,3933000,414999,False,97,scaffold_11
30,3944001,3972000,27999,False,97,scaffold_11
31,3985001,4161000,175999,False,97,scaffold_11
32,4179001,4710000,530999,False,97,scaffold_11
33,4713001,4766820,53819,True,97,scaffold_11
0,1,1500000,1499999,True,97,scaffold_12
1,1560001,1585000,24999,False,97,scaffold_12
2,1639001,1656000,16999,False,97,scaffold_12
3,1713001,1754000,40999,False,97,scaffold_12
4,1879001,1952000,72999,False,97,scaffold_12
5,1970001,2005000,34999,False,97,scaffold_12
6,2042001,2103000,60999,False,97,scaffold_12
7,2134001,2179000,44999,False,97,scaffold_12
8,2340001,2378000,37999,False,97,scaffold_12
9,2571001,2609000,37999,False,97,scaffold_12
10,2666001,2682000,15999,False,97,scaffold_12
11,2685001,2698000,12999,False,97,scaffold_12
0,1,323000,322999,True,98,scaffold_1
1,482001,498000,15999,False,98,scaffold_1
2,618001,638000,19999,False,98,scaffold_1
3,721001,743000,21999,False,98,scaffold_1
4,1281001,1292000,10999,False,98,scaffold_1
5,1954001,1964000,9999,False,98,scaffold_1
6,1965001,1984000,18999,False,98,scaffold_1
7,1988001,1993000,4999,False,98,scaffold_1
8,2453001,2458000,4999,False,98,scaffold_1
9,2486001,2515000,28999,False,98,scaffold_1
10,2729001,2746000,16999,False,98,scaffold_1
11,3194001,3207000,12999,False,98,scaffold_1
12,3419001,3425000,5999,False,98,scaffold_1
13,3923001,3941000,17999,False,98,scaffold_1
14,4335001,4353000,17999,False,98,scaffold_1
15,4973001,4981000,7999,False,98,scaffold_1
16,5483001,5511000,27999,False,98,scaffold_1
17,5536001,5569000,32999,False,98,scaffold_1
18,6108001,6153000,44999,False,98,scaffold_1
19,6228001,6243000,14999,False,98,scaffold_1
20,6336001,6379000,42999,False,98,scaffold_1
21,6385001,6498000,112999,False,98,scaffold_1
22,6545001,6554000,8999,False,98,scaffold_1
23,7038001,7247000,208999,False,98,scaffold_1
24,7248001,7584000,335999,False,98,scaffold_1
25,7590001,7631000,40999,False,98,scaffold_1
26,7633001,7880000,246999,False,98,scaffold_1
27,7881001,8477000,595999,False,98,scaffold_1
28,8478001,8490000,11999,False,98,scaffold_1
29,8494001,8656000,161999,False,98,scaffold_1
30,8658001,8839000,180999,False,98,scaffold_1
31,8840001,8924000,83999,False,98,scaffold_1
32,8925001,9329000,403999,False,98,scaffold_1
33,9330001,9344000,13999,False,98,scaffold_1
34,9348001,9541000,192999,False,98,scaffold_1
35,9542001,9583000,40999,False,98,scaffold_1
36,9586001,9785000,198999,False,98,scaffold_1
37,9786001,10354000,567999,False,98,scaffold_1
38,10461001,10541000,79999,False,98,scaffold_1
39,10542001,10627000,84999,False,98,scaffold_1
40,10808001,10811000,2999,False,98,scaffold_1
41,10841001,10858000,16999,False,98,scaffold_1
42,11346001,11431000,84999,False,98,scaffold_1
43,11619001,11746000,126999,False,98,scaffold_1
44,11791001,11821000,29999,False,98,scaffold_1
45,11888001,11914000,25999,False,98,scaffold_1
46,12185001,12202000,16999,False,98,scaffold_1
47,12807001,12888000,80999,False,98,scaffold_1
48,13182001,13211000,28999,False,98,scaffold_1
49,13347001,13404000,56999,False,98,scaffold_1
0,20001,48000,27999,False,98,scaffold_2
1,93001,115000,21999,False,98,scaffold_2
2,145001,159000,13999,False,98,scaffold_2
3,168001,177000,8999,False,98,scaffold_2
4,297001,318000,20999,False,98,scaffold_2
5,338001,374000,35999,False,98,scaffold_2
6,2336001,2358000,21999,False,98,scaffold_2
7,2459001,2553000,93999,False,98,scaffold_2
8,2627001,2639000,11999,False,98,scaffold_2
9,2661001,2689000,27999,False,98,scaffold_2
10,2694001,2742000,47999,False,98,scaffold_2
11,4636001,4671000,34999,False,98,scaffold_2
12,4918001,4947000,28999,False,98,scaffold_2
13,5034001,5061000,26999,False,98,scaffold_2
14,5492001,5509000,16999,False,98,scaffold_2
15,5672001,5704000,31999,False,98,scaffold_2
16,6261001,6277000,15999,False,98,scaffold_2
17,7683001,7695000,11999,False,98,scaffold_2
18,7786001,7849000,62999,False,98,scaffold_2
19,7992001,8036000,43999,False,98,scaffold_2
20,11558001,11759000,200999,False,98,scaffold_2
0,102001,104000,1999,False,98,scaffold_3
1,312001,316000,3999,False,98,scaffold_3
2,849001,896000,46999,False,98,scaffold_3
3,897001,901000,3999,False,98,scaffold_3
4,2085001,2108000,22999,False,98,scaffold_3
5,2291001,2321000,29999,False,98,scaffold_3
6,2510001,2533000,22999,False,98,scaffold_3
7,2717001,2730000,12999,False,98,scaffold_3
8,4151001,4236000,84999,False,98,scaffold_3
9,4238001,4397000,158999,False,98,scaffold_3
10,4422001,4506000,83999,False,98,scaffold_3
11,4567001,4575000,7999,False,98,scaffold_3
12,4659001,4682000,22999,False,98,scaffold_3
13,5496001,5509000,12999,False,98,scaffold_3
14,5996001,6007000,10999,False,98,scaffold_3
15,6914001,6962000,47999,False,98,scaffold_3
16,6983001,7046000,62999,False,98,scaffold_3
17,7451001,7458000,6999,False,98,scaffold_3
18,7522001,7556000,33999,False,98,scaffold_3
19,7693001,7840000,146999,False,98,scaffold_3
20,8235001,8252000,16999,False,98,scaffold_3
21,8462001,8509000,46999,False,98,scaffold_3
22,8516001,8526000,9999,False,98,scaffold_3
23,8575001,8593000,17999,False,98,scaffold_3
24,9972001,9995000,22999,False,98,scaffold_3
25,10574001,11165000,590999,False,98,scaffold_3
0,17001,32000,14999,False,98,scaffold_4
1,49001,88000,38999,False,98,scaffold_4
2,155001,167000,11999,False,98,scaffold_4
3,169001,215000,45999,False,98,scaffold_4
4,218001,226000,7999,False,98,scaffold_4
5,248001,266000,17999,False,98,scaffold_4
6,296001,308000,11999,False,98,scaffold_4
7,355001,374000,18999,False,98,scaffold_4
8,375001,380000,4999,False,98,scaffold_4
9,411001,425000,13999,False,98,scaffold_4
10,429001,498000,68999,False,98,scaffold_4
11,548001,592000,43999,False,98,scaffold_4
12,608001,660000,51999,False,98,scaffold_4
13,674001,691000,16999,False,98,scaffold_4
14,701001,712000,10999,False,98,scaffold_4
15,1121001,1136000,14999,False,98,scaffold_4
16,1137001,1198000,60999,False,98,scaffold_4
17,1199001,1208000,8999,False,98,scaffold_4
18,1210001,1226000,15999,False,98,scaffold_4
19,1268001,1279000,10999,False,98,scaffold_4
20,1283001,1337000,53999,False,98,scaffold_4
21,1395001,1597000,201999,False,98,scaffold_4
22,1681001,2004000,322999,False,98,scaffold_4
23,2033001,2095000,61999,False,98,scaffold_4
24,2211001,2218000,6999,False,98,scaffold_4
25,2219001,2246000,26999,False,98,scaffold_4
26,2247001,2279000,31999,False,98,scaffold_4
27,2283001,2340000,56999,False,98,scaffold_4
28,2398001,2442000,43999,False,98,scaffold_4
29,2480001,2581000,100999,False,98,scaffold_4
30,3385001,3542000,156999,False,98,scaffold_4
31,3543001,3600000,56999,False,98,scaffold_4
32,3686001,3696000,9999,False,98,scaffold_4
33,3698001,3760000,61999,False,98,scaffold_4
34,5475001,5506000,30999,False,98,scaffold_4
35,5528001,5620000,91999,False,98,scaffold_4
36,5728001,5744000,15999,False,98,scaffold_4
37,5745001,5784000,38999,False,98,scaffold_4
38,7230001,7272000,41999,False,98,scaffold_4
39,8846001,9081000,234999,False,98,scaffold_4
40,9082001,9698000,615999,False,98,scaffold_4
41,9700001,9845951,145950,True,98,scaffold_4
0,508001,523000,14999,False,98,scaffold_5
1,760001,763000,2999,False,98,scaffold_5
2,933001,947000,13999,False,98,scaffold_5
3,2563001,2581000,17999,False,98,scaffold_5
4,2627001,2732000,104999,False,98,scaffold_5
5,2813001,2871000,57999,False,98,scaffold_5
6,3325001,3498000,172999,False,98,scaffold_5
7,3962001,3972000,9999,False,98,scaffold_5
8,3975001,3995000,19999,False,98,scaffold_5
9,3996001,4085000,88999,False,98,scaffold_5
10,4121001,4219000,97999,False,98,scaffold_5
11,4246001,4261000,14999,False,98,scaffold_5
12,4446001,4488000,41999,False,98,scaffold_5
13,4602001,4665000,62999,False,98,scaffold_5
14,4691001,4715000,23999,False,98,scaffold_5
15,4820001,4857000,36999,False,98,scaffold_5
16,6508001,6566000,57999,False,98,scaffold_5
17,6589001,6597000,7999,False,98,scaffold_5
18,7622001,7653000,30999,False,98,scaffold_5
19,8730001,9031000,300999,False,98,scaffold_5
20,9033001,9363000,329999,False,98,scaffold_5
0,65001,75000,9999,False,98,scaffold_6
1,79001,84000,4999,False,98,scaffold_6
2,86001,114000,27999,False,98,scaffold_6
3,241001,253000,11999,False,98,scaffold_6
4,1479001,1546000,66999,False,98,scaffold_6
5,2041001,2080000,38999,False,98,scaffold_6
6,2371001,2595000,223999,False,98,scaffold_6
7,2596001,2653000,56999,False,98,scaffold_6
8,2661001,2691000,29999,False,98,scaffold_6
9,2732001,2825000,92999,False,98,scaffold_6
10,2934001,3014000,79999,False,98,scaffold_6
11,3115001,3150000,34999,False,98,scaffold_6
12,3224001,3272000,47999,False,98,scaffold_6
13,3408001,3427000,18999,False,98,scaffold_6
14,3462001,3516000,53999,False,98,scaffold_6
15,3530001,3691000,160999,False,98,scaffold_6
16,3717001,3766000,48999,False,98,scaffold_6
17,3900001,3913000,12999,False,98,scaffold_6
18,4018001,4072000,53999,False,98,scaffold_6
19,4081001,4195000,113999,False,98,scaffold_6
20,6020001,6060000,39999,False,98,scaffold_6
21,7574001,7630000,55999,False,98,scaffold_6
22,7631001,7673000,41999,False,98,scaffold_6
23,7739001,7795000,55999,False,98,scaffold_6
24,7831001,7912000,80999,False,98,scaffold_6
25,7913001,8220000,306999,False,98,scaffold_6
26,8221001,8268281,47280,True,98,scaffold_6
0,323001,340000,16999,False,98,scaffold_7
1,342001,414000,71999,False,98,scaffold_7
2,415001,508000,92999,False,98,scaffold_7
3,706001,753000,46999,False,98,scaffold_7
4,764001,809000,44999,False,98,scaffold_7
5,859001,864000,4999,False,98,scaffold_7
6,964001,980000,15999,False,98,scaffold_7
7,982001,1044000,61999,False,98,scaffold_7
8,1071001,1098000,26999,False,98,scaffold_7
9,1204001,1477000,272999,False,98,scaffold_7
10,1478001,1512000,33999,False,98,scaffold_7
11,1588001,1693000,104999,False,98,scaffold_7
12,2753001,2759000,5999,False,98,scaffold_7
13,3337001,3369000,31999,False,98,scaffold_7
14,3595001,3649000,53999,False,98,scaffold_7
15,4434001,4492000,57999,False,98,scaffold_7
16,4660001,4679000,18999,False,98,scaffold_7
17,4979001,5029000,49999,False,98,scaffold_7
18,5078001,5114000,35999,False,98,scaffold_7
19,5473001,5515000,41999,False,98,scaffold_7
20,6954001,7047000,92999,False,98,scaffold_7
21,7049001,7270000,220999,False,98,scaffold_7
22,7271001,7418000,146999,False,98,scaffold_7
23,7420001,7457000,36999,False,98,scaffold_7
24,7458001,7502216,44215,True,98,scaffold_7
0,67001,85000,17999,False,98,scaffold_8
1,2536001,2551000,14999,False,98,scaffold_8
2,2742001,2757000,14999,False,98,scaffold_8
3,3060001,3268000,207999,False,98,scaffold_8
4,3269001,3525000,255999,False,98,scaffold_8
5,3589001,3612000,22999,False,98,scaffold_8
6,3615001,3804000,188999,False,98,scaffold_8
7,3805001,3837000,31999,False,98,scaffold_8
8,3850001,3913000,62999,False,98,scaffold_8
9,6320001,6334544,14543,True,98,scaffold_8
0,109001,117000,7999,False,98,scaffold_9
1,303001,316000,12999,False,98,scaffold_9
2,319001,332000,12999,False,98,scaffold_9
3,367001,411000,43999,False,98,scaffold_9
4,413001,434000,20999,False,98,scaffold_9
5,511001,531000,19999,False,98,scaffold_9
6,671001,697000,25999,False,98,scaffold_9
7,822001,842000,19999,False,98,scaffold_9
8,898001,986000,87999,False,98,scaffold_9
9,988001,995000,6999,False,98,scaffold_9
10,1001001,1007000,5999,False,98,scaffold_9
11,1010001,1031000,20999,False,98,scaffold_9
12,1035001,1085000,49999,False,98,scaffold_9
13,1087001,1150000,62999,False,98,scaffold_9
14,1151001,1165000,13999,False,98,scaffold_9
15,1312001,1377000,64999,False,98,scaffold_9
16,1487001,1499000,11999,False,98,scaffold_9
17,2731001,2756000,24999,False,98,scaffold_9
18,2874001,2997000,122999,False,98,scaffold_9
19,2998001,3381000,382999,False,98,scaffold_9
20,3383001,5107000,1723999,False,98,scaffold_9
21,5112001,5238000,125999,False,98,scaffold_9
22,5239001,5298000,58999,False,98,scaffold_9
23,5300001,5618000,317999,False,98,scaffold_9
24,5619001,6331288,712287,True,98,scaffold_9
0,1,203000,202999,True,98,scaffold_10
1,375001,404000,28999,False,98,scaffold_10
2,472001,482000,9999,False,98,scaffold_10
3,530001,564000,33999,False,98,scaffold_10
4,603001,717000,113999,False,98,scaffold_10
5,888001,916000,27999,False,98,scaffold_10
6,924001,961000,36999,False,98,scaffold_10
7,4067001,4088000,20999,False,98,scaffold_10
8,4154001,4184000,29999,False,98,scaffold_10
9,4443001,4462000,18999,False,98,scaffold_10
10,4527001,4548000,20999,False,98,scaffold_10
11,4734001,4776000,41999,False,98,scaffold_10
12,4798001,4824000,25999,False,98,scaffold_10
13,4827001,4843000,15999,False,98,scaffold_10
14,4848001,4854000,5999,False,98,scaffold_10
15,4865001,4866973,1972,True,98,scaffold_10
0,10001,93000,82999,False,98,scaffold_11
1,149001,167000,17999,False,98,scaffold_11
2,171001,191000,19999,False,98,scaffold_11
3,213001,235000,21999,False,98,scaffold_11
4,240001,247000,6999,False,98,scaffold_11
5,297001,311000,13999,False,98,scaffold_11
6,419001,431000,11999,False,98,scaffold_11
7,638001,642000,3999,False,98,scaffold_11
8,648001,656000,7999,False,98,scaffold_11
9,781001,785000,3999,False,98,scaffold_11
10,1025001,1034000,8999,False,98,scaffold_11
11,2714001,2772000,57999,False,98,scaffold_11
12,2811001,2825000,13999,False,98,scaffold_11
13,2836001,2873000,36999,False,98,scaffold_11
14,3212001,3246000,33999,False,98,scaffold_11
15,3702001,3721000,18999,False,98,scaffold_11
16,3779001,3858000,78999,False,98,scaffold_11
17,4317001,4379000,61999,False,98,scaffold_11
18,4395001,4479000,83999,False,98,scaffold_11
19,4493001,4605000,111999,False,98,scaffold_11
20,4606001,4710000,103999,False,98,scaffold_11
21,4713001,4766820,53819,True,98,scaffold_11
0,1,13000,12999,True,98,scaffold_12
1,14001,300000,285999,False,98,scaffold_12
2,314001,369000,54999,False,98,scaffold_12
3,474001,494000,19999,False,98,scaffold_12
4,582001,856000,273999,False,98,scaffold_12
5,866001,1237000,370999,False,98,scaffold_12
6,1238001,1405000,166999,False,98,scaffold_12
7,1720001,1733000,12999,False,98,scaffold_12
8,2571001,2610000,38999,False,98,scaffold_12
0,1,334000,333999,True,99,scaffold_1
1,482001,498000,15999,False,99,scaffold_1
2,571001,643000,71999,False,99,scaffold_1
3,686001,743000,56999,False,99,scaffold_1
4,1281001,1292000,10999,False,99,scaffold_1
5,1954001,1964000,9999,False,99,scaffold_1
6,1965001,1984000,18999,False,99,scaffold_1
7,2449001,2517000,67999,False,99,scaffold_1
8,2729001,2746000,16999,False,99,scaffold_1
9,3181001,3208000,26999,False,99,scaffold_1
10,3715001,3733000,17999,False,99,scaffold_1
11,3916001,3941000,24999,False,99,scaffold_1
12,4065001,4111000,45999,False,99,scaffold_1
13,4322001,4354000,31999,False,99,scaffold_1
14,4929001,4959000,29999,False,99,scaffold_1
15,4971001,4983000,11999,False,99,scaffold_1
16,5484001,5511000,26999,False,99,scaffold_1
17,6108001,6153000,44999,False,99,scaffold_1
18,6228001,6381000,152999,False,99,scaffold_1
19,6384001,6507000,122999,False,99,scaffold_1
20,6545001,6554000,8999,False,99,scaffold_1
21,7038001,7247000,208999,False,99,scaffold_1
22,7248001,7584000,335999,False,99,scaffold_1
23,7590001,8656000,1065999,False,99,scaffold_1
24,8658001,9584000,925999,False,99,scaffold_1
25,9586001,10354000,767999,False,99,scaffold_1
26,10461001,10623000,161999,False,99,scaffold_1
27,10808001,10811000,2999,False,99,scaffold_1
28,10839001,10858000,18999,False,99,scaffold_1
29,11351001,11504000,152999,False,99,scaffold_1
30,11615001,11951000,335999,False,99,scaffold_1
31,12184001,12204000,19999,False,99,scaffold_1
32,12664001,12722000,57999,False,99,scaffold_1
33,12777001,12888000,110999,False,99,scaffold_1
34,13114001,13135000,20999,False,99,scaffold_1
35,13178001,13211000,32999,False,99,scaffold_1
36,13347001,13377000,29999,False,99,scaffold_1
37,14560001,14562000,1999,False,99,scaffold_1
38,14605001,14610000,4999,False,99,scaffold_1
0,22001,48000,25999,False,99,scaffold_2
1,93001,159000,65999,False,99,scaffold_2
2,168001,177000,8999,False,99,scaffold_2
3,303001,318000,14999,False,99,scaffold_2
4,333001,374000,40999,False,99,scaffold_2
5,2336001,2358000,21999,False,99,scaffold_2
6,2404001,2424000,19999,False,99,scaffold_2
7,2441001,2553000,111999,False,99,scaffold_2
8,2660001,2689000,28999,False,99,scaffold_2
9,2694001,2742000,47999,False,99,scaffold_2
10,2777001,2788000,10999,False,99,scaffold_2
11,3454001,3463000,8999,False,99,scaffold_2
12,3767001,3782000,14999,False,99,scaffold_2
13,4388001,4409000,20999,False,99,scaffold_2
14,4429001,4456000,26999,False,99,scaffold_2
15,4608001,4653000,44999,False,99,scaffold_2
16,5022001,5031000,8999,False,99,scaffold_2
17,5033001,5061000,27999,False,99,scaffold_2
18,5491001,5512000,20999,False,99,scaffold_2
19,5672001,5704000,31999,False,99,scaffold_2
20,6261001,6330000,68999,False,99,scaffold_2
21,6331001,6342000,10999,False,99,scaffold_2
22,7439001,7472000,32999,False,99,scaffold_2
23,7563001,7697000,133999,False,99,scaffold_2
24,7786001,7890000,103999,False,99,scaffold_2
25,7934001,7965000,30999,False,99,scaffold_2
26,7985001,8088000,102999,False,99,scaffold_2
27,8331001,8333000,1999,False,99,scaffold_2
28,8346001,8389000,42999,False,99,scaffold_2
29,8509001,8535000,25999,False,99,scaffold_2
30,11367001,11371000,3999,False,99,scaffold_2
31,11520001,11785000,264999,False,99,scaffold_2
0,1,2000,1999,True,99,scaffold_3
1,51001,55000,3999,False,99,scaffold_3
2,102001,104000,1999,False,99,scaffold_3
3,799001,900000,100999,False,99,scaffold_3
4,2085001,2108000,22999,False,99,scaffold_3
5,2291001,2321000,29999,False,99,scaffold_3
6,2488001,2533000,44999,False,99,scaffold_3
7,4150001,4403000,252999,False,99,scaffold_3
8,4410001,4518000,107999,False,99,scaffold_3
9,4547001,4558000,10999,False,99,scaffold_3
10,4653001,4680000,26999,False,99,scaffold_3
11,6911001,6962000,50999,False,99,scaffold_3
12,6980001,7046000,65999,False,99,scaffold_3
13,7540001,7556000,15999,False,99,scaffold_3
14,7692001,7726000,33999,False,99,scaffold_3
15,7822001,7838000,15999,False,99,scaffold_3
16,8207001,8253000,45999,False,99,scaffold_3
17,8462001,8527000,64999,False,99,scaffold_3
18,8575001,8594000,18999,False,99,scaffold_3
19,9968001,9996000,27999,False,99,scaffold_3
20,10461001,10483000,21999,False,99,scaffold_3
21,10587001,11162000,574999,False,99,scaffold_3
0,3001,7000,3999,False,99,scaffold_4
1,17001,32000,14999,False,99,scaffold_4
2,48001,88000,39999,False,99,scaffold_4
3,147001,151000,3999,False,99,scaffold_4
4,155001,160000,4999,False,99,scaffold_4
5,161001,215000,53999,False,99,scaffold_4
6,217001,226000,8999,False,99,scaffold_4
7,227001,266000,38999,False,99,scaffold_4
8,291001,310000,18999,False,99,scaffold_4
9,313001,353000,39999,False,99,scaffold_4
10,355001,374000,18999,False,99,scaffold_4
11,375001,380000,4999,False,99,scaffold_4
12,389001,410000,20999,False,99,scaffold_4
13,412001,425000,12999,False,99,scaffold_4
14,429001,500000,70999,False,99,scaffold_4
15,546001,592000,45999,False,99,scaffold_4
16,608001,661000,52999,False,99,scaffold_4
17,670001,691000,20999,False,99,scaffold_4
18,701001,713000,11999,False,99,scaffold_4
19,1121001,1136000,14999,False,99,scaffold_4
20,1137001,1179000,41999,False,99,scaffold_4
21,1199001,1208000,8999,False,99,scaffold_4
22,1210001,1226000,15999,False,99,scaffold_4
23,1229001,1231000,1999,False,99,scaffold_4
24,1254001,1262000,7999,False,99,scaffold_4
25,1265001,1279000,13999,False,99,scaffold_4
26,1283001,1314000,30999,False,99,scaffold_4
27,1372001,1595000,222999,False,99,scaffold_4
28,1749001,1849000,99999,False,99,scaffold_4
29,1850001,1868000,17999,False,99,scaffold_4
30,1905001,1957000,51999,False,99,scaffold_4
31,1958001,1989000,30999,False,99,scaffold_4
32,2037001,2064000,26999,False,99,scaffold_4
33,2247001,2268000,20999,False,99,scaffold_4
34,2269001,2279000,9999,False,99,scaffold_4
35,2284001,2310000,25999,False,99,scaffold_4
36,2312001,2340000,27999,False,99,scaffold_4
37,2480001,2533000,52999,False,99,scaffold_4
38,3334001,3633000,298999,False,99,scaffold_4
39,3676001,3759000,82999,False,99,scaffold_4
40,4944001,4984000,39999,False,99,scaffold_4
41,5477001,5506000,28999,False,99,scaffold_4
42,5514001,5620000,105999,False,99,scaffold_4
43,5669001,5784000,114999,False,99,scaffold_4
44,6177001,6190000,12999,False,99,scaffold_4
45,6804001,6817000,12999,False,99,scaffold_4
46,7037001,7062000,24999,False,99,scaffold_4
47,8846001,9699000,852999,False,99,scaffold_4
48,9700001,9845951,145950,True,99,scaffold_4
0,189001,204000,14999,False,99,scaffold_5
1,318001,326000,7999,False,99,scaffold_5
2,327001,368000,40999,False,99,scaffold_5
3,464001,480000,15999,False,99,scaffold_5
4,500001,523000,22999,False,99,scaffold_5
5,933001,947000,13999,False,99,scaffold_5
6,2565001,2581000,15999,False,99,scaffold_5
7,2625001,2732000,106999,False,99,scaffold_5
8,2816001,2871000,54999,False,99,scaffold_5
9,3167001,3184000,16999,False,99,scaffold_5
10,3322001,3437000,114999,False,99,scaffold_5
11,3451001,3497000,45999,False,99,scaffold_5
12,3962001,4101000,138999,False,99,scaffold_5
13,4121001,4142000,20999,False,99,scaffold_5
14,4155001,4219000,63999,False,99,scaffold_5
15,4246001,4262000,15999,False,99,scaffold_5
16,4446001,4488000,41999,False,99,scaffold_5
17,4603001,4650000,46999,False,99,scaffold_5
18,4691001,4717000,25999,False,99,scaffold_5
19,4816001,4861000,44999,False,99,scaffold_5
20,5318001,5346000,27999,False,99,scaffold_5
21,7097001,7100000,2999,False,99,scaffold_5
22,7622001,7636000,13999,False,99,scaffold_5
23,8730001,9364176,634175,True,99,scaffold_5
0,79001,113000,33999,False,99,scaffold_6
1,239001,253000,13999,False,99,scaffold_6
2,267001,283000,15999,False,99,scaffold_6
3,1238001,1255000,16999,False,99,scaffold_6
4,1479001,1546000,66999,False,99,scaffold_6
5,2023001,2086000,62999,False,99,scaffold_6
6,2130001,2169000,38999,False,99,scaffold_6
7,2371001,2595000,223999,False,99,scaffold_6
8,2596001,2653000,56999,False,99,scaffold_6
9,2655001,2691000,35999,False,99,scaffold_6
10,2731001,2852000,120999,False,99,scaffold_6
11,2933001,3014000,80999,False,99,scaffold_6
12,3115001,3149000,33999,False,99,scaffold_6
13,3224001,3301000,76999,False,99,scaffold_6
14,3408001,3427000,18999,False,99,scaffold_6
15,3462001,3766000,303999,False,99,scaffold_6
16,3899001,3913000,13999,False,99,scaffold_6
17,4087001,4193000,105999,False,99,scaffold_6
18,6011001,6060000,48999,False,99,scaffold_6
19,7283001,7336000,52999,False,99,scaffold_6
20,7560001,7795000,234999,False,99,scaffold_6
21,7811001,8263000,451999,False,99,scaffold_6
0,1,7000,6999,True,99,scaffold_7
1,13001,31000,17999,False,99,scaffold_7
2,323001,340000,16999,False,99,scaffold_7
3,342001,508000,165999,False,99,scaffold_7
4,554001,563000,8999,False,99,scaffold_7
5,571001,577000,5999,False,99,scaffold_7
6,706001,736000,29999,False,99,scaffold_7
7,741001,753000,11999,False,99,scaffold_7
8,764001,809000,44999,False,99,scaffold_7
9,859001,864000,4999,False,99,scaffold_7
10,964001,966000,1999,False,99,scaffold_7
11,968001,980000,11999,False,99,scaffold_7
12,982001,1044000,61999,False,99,scaffold_7
13,1192001,1512000,319999,False,99,scaffold_7
14,1588001,1687000,98999,False,99,scaffold_7
15,3325001,3369000,43999,False,99,scaffold_7
16,3595001,3649000,53999,False,99,scaffold_7
17,4418001,4517000,98999,False,99,scaffold_7
18,4658001,4681000,22999,False,99,scaffold_7
19,4982001,4996000,13999,False,99,scaffold_7
20,5003001,5018000,14999,False,99,scaffold_7
21,5077001,5145000,67999,False,99,scaffold_7
22,6955001,7270000,314999,False,99,scaffold_7
23,7271001,7502216,231215,True,99,scaffold_7
0,67001,85000,17999,False,99,scaffold_8
1,93001,101000,7999,False,99,scaffold_8
2,722001,723000,999,False,99,scaffold_8
3,2662001,2683000,20999,False,99,scaffold_8
4,2745001,2756000,10999,False,99,scaffold_8
5,3060001,3525000,464999,False,99,scaffold_8
6,3584001,3612000,27999,False,99,scaffold_8
7,3615001,3913000,297999,False,99,scaffold_8
8,5126001,5133000,6999,False,99,scaffold_8
9,5200001,5241000,40999,False,99,scaffold_8
10,6329001,6334544,5543,True,99,scaffold_8
0,109001,117000,7999,False,99,scaffold_9
1,303001,315000,11999,False,99,scaffold_9
2,319001,332000,12999,False,99,scaffold_9
3,367001,411000,43999,False,99,scaffold_9
4,413001,434000,20999,False,99,scaffold_9
5,502001,531000,28999,False,99,scaffold_9
6,548001,563000,14999,False,99,scaffold_9
7,652001,665000,12999,False,99,scaffold_9
8,671001,697000,25999,False,99,scaffold_9
9,732001,742000,9999,False,99,scaffold_9
10,794001,803000,8999,False,99,scaffold_9
11,814001,843000,28999,False,99,scaffold_9
12,873001,986000,112999,False,99,scaffold_9
13,988001,995000,6999,False,99,scaffold_9
14,1001001,1007000,5999,False,99,scaffold_9
15,1010001,1031000,20999,False,99,scaffold_9
16,1035001,1085000,49999,False,99,scaffold_9
17,1087001,1150000,62999,False,99,scaffold_9
18,1151001,1161000,9999,False,99,scaffold_9
19,1312001,1377000,64999,False,99,scaffold_9
20,1770001,1783000,12999,False,99,scaffold_9
21,2601001,2616000,14999,False,99,scaffold_9
22,2874001,3381000,506999,False,99,scaffold_9
23,3383001,5107000,1723999,False,99,scaffold_9
24,5112001,5115000,2999,False,99,scaffold_9
25,5116001,5238000,121999,False,99,scaffold_9
26,5239001,5298000,58999,False,99,scaffold_9
27,5300001,5491000,190999,False,99,scaffold_9
28,5493001,6331288,838287,True,99,scaffold_9
0,1,197000,196999,True,99,scaffold_10
1,373001,405000,31999,False,99,scaffold_10
2,472001,482000,9999,False,99,scaffold_10
3,483001,576000,92999,False,99,scaffold_10
4,603001,748000,144999,False,99,scaffold_10
5,888001,916000,27999,False,99,scaffold_10
6,924001,962000,37999,False,99,scaffold_10
7,1087001,1105000,17999,False,99,scaffold_10
8,2346001,2366000,19999,False,99,scaffold_10
9,3264001,3268000,3999,False,99,scaffold_10
10,4054001,4091000,36999,False,99,scaffold_10
11,4142001,4149000,6999,False,99,scaffold_10
12,4154001,4174000,19999,False,99,scaffold_10
13,4444001,4457000,12999,False,99,scaffold_10
14,4527001,4548000,20999,False,99,scaffold_10
15,4576001,4596000,19999,False,99,scaffold_10
16,4681001,4688000,6999,False,99,scaffold_10
17,4734001,4766000,31999,False,99,scaffold_10
18,4769001,4776000,6999,False,99,scaffold_10
19,4798001,4824000,25999,False,99,scaffold_10
20,4827001,4843000,15999,False,99,scaffold_10
21,4848001,4861000,12999,False,99,scaffold_10
22,4865001,4866973,1972,True,99,scaffold_10
0,10001,37000,26999,False,99,scaffold_11
1,38001,91000,52999,False,99,scaffold_11
2,149001,167000,17999,False,99,scaffold_11
3,169001,191000,21999,False,99,scaffold_11
4,214001,235000,20999,False,99,scaffold_11
5,240001,248000,7999,False,99,scaffold_11
6,419001,431000,11999,False,99,scaffold_11
7,648001,656000,7999,False,99,scaffold_11
8,1025001,1034000,8999,False,99,scaffold_11
9,1305001,1307000,1999,False,99,scaffold_11
10,1423001,1426000,2999,False,99,scaffold_11
11,2701001,2872000,170999,False,99,scaffold_11
12,3205001,3251000,45999,False,99,scaffold_11
13,3331001,3383000,51999,False,99,scaffold_11
14,3702001,3926000,223999,False,99,scaffold_11
15,4321001,4710000,388999,False,99,scaffold_11
16,4713001,4766820,53819,True,99,scaffold_11
0,1,240000,239999,True,99,scaffold_12
1,290001,369000,78999,False,99,scaffold_12
2,474001,511000,36999,False,99,scaffold_12
3,582001,738000,155999,False,99,scaffold_12
4,739001,856000,116999,False,99,scaffold_12
5,865001,1354000,488999,False,99,scaffold_12
6,1720001,1733000,12999,False,99,scaffold_12
7,2571001,2617000,45999,False,99,scaffold_12
0,1,341000,340999,True,100,scaffold_1
1,482001,498000,15999,False,100,scaffold_1
2,571001,643000,71999,False,100,scaffold_1
3,686001,748000,61999,False,100,scaffold_1
4,1954001,1964000,9999,False,100,scaffold_1
5,1965001,1984000,18999,False,100,scaffold_1
6,2449001,2517000,67999,False,100,scaffold_1
7,2729001,2746000,16999,False,100,scaffold_1
8,3181001,3208000,26999,False,100,scaffold_1
9,3715001,3733000,17999,False,100,scaffold_1
10,3916001,3941000,24999,False,100,scaffold_1
11,4079001,4110000,30999,False,100,scaffold_1
12,4315001,4354000,38999,False,100,scaffold_1
13,4929001,4962000,32999,False,100,scaffold_1
14,4969001,4997000,27999,False,100,scaffold_1
15,5483001,5511000,27999,False,100,scaffold_1
16,5537001,5569000,31999,False,100,scaffold_1
17,6108001,6153000,44999,False,100,scaffold_1
18,6228001,6504000,275999,False,100,scaffold_1
19,6545001,6554000,8999,False,100,scaffold_1
20,7038001,7247000,208999,False,100,scaffold_1
21,7248001,7588000,339999,False,100,scaffold_1
22,7590001,8640000,1049999,False,100,scaffold_1
23,8644001,8656000,11999,False,100,scaffold_1
24,8658001,9584000,925999,False,100,scaffold_1
25,9586001,10354000,767999,False,100,scaffold_1
26,10461001,10623000,161999,False,100,scaffold_1
27,10808001,10811000,2999,False,100,scaffold_1
28,10839001,10858000,18999,False,100,scaffold_1
29,11346001,11504000,157999,False,100,scaffold_1
30,11609001,11949000,339999,False,100,scaffold_1
31,12184001,12204000,19999,False,100,scaffold_1
32,12654001,12722000,67999,False,100,scaffold_1
33,12777001,12888000,110999,False,100,scaffold_1
34,13114001,13135000,20999,False,100,scaffold_1
35,13179001,13211000,31999,False,100,scaffold_1
36,13347001,13377000,29999,False,100,scaffold_1
37,14560001,14562000,1999,False,100,scaffold_1
0,22001,48000,25999,False,100,scaffold_2
1,93001,159000,65999,False,100,scaffold_2
2,168001,176000,7999,False,100,scaffold_2
3,313001,318000,4999,False,100,scaffold_2
4,333001,374000,40999,False,100,scaffold_2
5,2336001,2358000,21999,False,100,scaffold_2
6,2410001,2415000,4999,False,100,scaffold_2
7,2416001,2421000,4999,False,100,scaffold_2
8,2441001,2553000,111999,False,100,scaffold_2
9,2660001,2689000,28999,False,100,scaffold_2
10,2694001,2742000,47999,False,100,scaffold_2
11,2868001,2899000,30999,False,100,scaffold_2
12,2994001,3013000,18999,False,100,scaffold_2
13,3174001,3185000,10999,False,100,scaffold_2
14,3454001,3463000,8999,False,100,scaffold_2
15,3759001,3783000,23999,False,100,scaffold_2
16,4386001,4409000,22999,False,100,scaffold_2
17,4428001,4455000,26999,False,100,scaffold_2
18,4524001,4554000,29999,False,100,scaffold_2
19,4607001,4653000,45999,False,100,scaffold_2
20,4918001,4936000,17999,False,100,scaffold_2
21,5022001,5031000,8999,False,100,scaffold_2
22,5033001,5061000,27999,False,100,scaffold_2
23,5456001,5475000,18999,False,100,scaffold_2
24,5491001,5511000,19999,False,100,scaffold_2
25,5672001,5704000,31999,False,100,scaffold_2
26,6261001,6330000,68999,False,100,scaffold_2
27,6331001,6350000,18999,False,100,scaffold_2
28,7439001,7472000,32999,False,100,scaffold_2
29,7563001,7697000,133999,False,100,scaffold_2
30,7786001,7890000,103999,False,100,scaffold_2
31,7934001,7965000,30999,False,100,scaffold_2
32,7985001,8089000,103999,False,100,scaffold_2
33,8331001,8333000,1999,False,100,scaffold_2
34,8346001,8389000,42999,False,100,scaffold_2
35,8509001,8536000,26999,False,100,scaffold_2
36,11367001,11371000,3999,False,100,scaffold_2
37,11520001,11786000,265999,False,100,scaffold_2
0,1,2000,1999,True,100,scaffold_3
1,51001,55000,3999,False,100,scaffold_3
2,102001,104000,1999,False,100,scaffold_3
3,797001,900000,102999,False,100,scaffold_3
4,2085001,2108000,22999,False,100,scaffold_3
5,2291001,2321000,29999,False,100,scaffold_3
6,2492001,2531000,38999,False,100,scaffold_3
7,4150001,4400000,249999,False,100,scaffold_3
8,4420001,4518000,97999,False,100,scaffold_3
9,4547001,4558000,10999,False,100,scaffold_3
10,4652001,4680000,27999,False,100,scaffold_3
11,6911001,6962000,50999,False,100,scaffold_3
12,6963001,6968000,4999,False,100,scaffold_3
13,6979001,7075000,95999,False,100,scaffold_3
14,7451001,7458000,6999,False,100,scaffold_3
15,7540001,7556000,15999,False,100,scaffold_3
16,7692001,7729000,36999,False,100,scaffold_3
17,7822001,7838000,15999,False,100,scaffold_3
18,8209001,8252000,42999,False,100,scaffold_3
19,8462001,8527000,64999,False,100,scaffold_3
20,8575001,8594000,18999,False,100,scaffold_3
21,9968001,9996000,27999,False,100,scaffold_3
22,10461001,10484000,22999,False,100,scaffold_3
23,10587001,11166000,578999,False,100,scaffold_3
0,17001,32000,14999,False,100,scaffold_4
1,49001,88000,38999,False,100,scaffold_4
2,121001,146000,24999,False,100,scaffold_4
3,147001,151000,3999,False,100,scaffold_4
4,155001,215000,59999,False,100,scaffold_4
5,217001,226000,8999,False,100,scaffold_4
6,227001,241000,13999,False,100,scaffold_4
7,242001,266000,23999,False,100,scaffold_4
8,291001,310000,18999,False,100,scaffold_4
9,313001,344000,30999,False,100,scaffold_4
10,345001,353000,7999,False,100,scaffold_4
11,355001,374000,18999,False,100,scaffold_4
12,375001,380000,4999,False,100,scaffold_4
13,384001,410000,25999,False,100,scaffold_4
14,412001,425000,12999,False,100,scaffold_4
15,429001,505000,75999,False,100,scaffold_4
16,547001,606000,58999,False,100,scaffold_4
17,608001,661000,52999,False,100,scaffold_4
18,670001,691000,20999,False,100,scaffold_4
19,701001,714000,12999,False,100,scaffold_4
20,1137001,1179000,41999,False,100,scaffold_4
21,1199001,1208000,8999,False,100,scaffold_4
22,1210001,1226000,15999,False,100,scaffold_4
23,1235001,1253000,17999,False,100,scaffold_4
24,1268001,1279000,10999,False,100,scaffold_4
25,1283001,1337000,53999,False,100,scaffold_4
26,1354001,1591000,236999,False,100,scaffold_4
27,1721001,1866000,144999,False,100,scaffold_4
28,1904001,1957000,52999,False,100,scaffold_4
29,1958001,1997000,38999,False,100,scaffold_4
30,2036001,2065000,28999,False,100,scaffold_4
31,2211001,2246000,34999,False,100,scaffold_4
32,2247001,2279000,31999,False,100,scaffold_4
33,2284001,2339000,54999,False,100,scaffold_4
34,2428001,2461000,32999,False,100,scaffold_4
35,2476001,2533000,56999,False,100,scaffold_4
36,3334001,3633000,298999,False,100,scaffold_4
37,3676001,3760000,83999,False,100,scaffold_4
38,4941001,4984000,42999,False,100,scaffold_4
39,5477001,5506000,28999,False,100,scaffold_4
40,5514001,5620000,105999,False,100,scaffold_4
41,5669001,5784000,114999,False,100,scaffold_4
42,7039001,7061000,21999,False,100,scaffold_4
43,8846001,9699000,852999,False,100,scaffold_4
44,9700001,9845951,145950,True,100,scaffold_4
0,194001,204000,9999,False,100,scaffold_5
1,318001,326000,7999,False,100,scaffold_5
2,327001,368000,40999,False,100,scaffold_5
3,463001,523000,59999,False,100,scaffold_5
4,933001,947000,13999,False,100,scaffold_5
5,2565001,2582000,16999,False,100,scaffold_5
6,2624001,2732000,107999,False,100,scaffold_5
7,2816001,2871000,54999,False,100,scaffold_5
8,3167001,3184000,16999,False,100,scaffold_5
9,3322001,3437000,114999,False,100,scaffold_5
10,3451001,3497000,45999,False,100,scaffold_5
11,3962001,4101000,138999,False,100,scaffold_5
12,4121001,4219000,97999,False,100,scaffold_5
13,4246001,4263000,16999,False,100,scaffold_5
14,4446001,4483000,36999,False,100,scaffold_5
15,4600001,4658000,57999,False,100,scaffold_5
16,4691001,4718000,26999,False,100,scaffold_5
17,4793001,4801000,7999,False,100,scaffold_5
18,4811001,4857000,45999,False,100,scaffold_5
19,5318001,5346000,27999,False,100,scaffold_5
20,8674001,8688000,13999,False,100,scaffold_5
21,8730001,9363000,632999,False,100,scaffold_5
0,79001,84000,4999,False,100,scaffold_6
1,86001,112000,25999,False,100,scaffold_6
2,240001,254000,13999,False,100,scaffold_6
3,256001,262000,5999,False,100,scaffold_6
4,267001,283000,15999,False,100,scaffold_6
5,1246001,1255000,8999,False,100,scaffold_6
6,1479001,1546000,66999,False,100,scaffold_6
7,2023001,2086000,62999,False,100,scaffold_6
8,2130001,2169000,38999,False,100,scaffold_6
9,2371001,2653000,281999,False,100,scaffold_6
10,2658001,2691000,32999,False,100,scaffold_6
11,2731001,2852000,120999,False,100,scaffold_6
12,2928001,3014000,85999,False,100,scaffold_6
13,3115001,3149000,33999,False,100,scaffold_6
14,3224001,3301000,76999,False,100,scaffold_6
15,3406001,3428000,21999,False,100,scaffold_6
16,3462001,3767000,304999,False,100,scaffold_6
17,3901001,3912000,10999,False,100,scaffold_6
18,4018001,4066000,47999,False,100,scaffold_6
19,4085001,4193000,107999,False,100,scaffold_6
20,6010001,6060000,49999,False,100,scaffold_6
21,7264001,7337000,72999,False,100,scaffold_6
22,7560001,7796000,235999,False,100,scaffold_6
23,7812001,8268281,456280,True,100,scaffold_6
0,1,7000,6999,True,100,scaffold_7
1,13001,31000,17999,False,100,scaffold_7
2,323001,340000,16999,False,100,scaffold_7
3,342001,508000,165999,False,100,scaffold_7
4,554001,563000,8999,False,100,scaffold_7
5,706001,736000,29999,False,100,scaffold_7
6,764001,809000,44999,False,100,scaffold_7
7,859001,864000,4999,False,100,scaffold_7
8,868001,885000,16999,False,100,scaffold_7
9,953001,963000,9999,False,100,scaffold_7
10,964001,966000,1999,False,100,scaffold_7
11,982001,1044000,61999,False,100,scaffold_7
12,1048001,1104000,55999,False,100,scaffold_7
13,1191001,1512000,320999,False,100,scaffold_7
14,1588001,1688000,99999,False,100,scaffold_7
15,3326001,3369000,42999,False,100,scaffold_7
16,3594001,3650000,55999,False,100,scaffold_7
17,4418001,4517000,98999,False,100,scaffold_7
18,4658001,4681000,22999,False,100,scaffold_7
19,4978001,5114000,135999,False,100,scaffold_7
20,6955001,7270000,314999,False,100,scaffold_7
21,7271001,7502216,231215,True,100,scaffold_7
0,67001,85000,17999,False,100,scaffold_8
1,91001,101000,9999,False,100,scaffold_8
2,2445001,2470000,24999,False,100,scaffold_8
3,2492001,2512000,19999,False,100,scaffold_8
4,2661001,2683000,21999,False,100,scaffold_8
5,2741001,2757000,15999,False,100,scaffold_8
6,3059001,3525000,465999,False,100,scaffold_8
7,3584001,3612000,27999,False,100,scaffold_8
8,3615001,3913000,297999,False,100,scaffold_8
9,5200001,5241000,40999,False,100,scaffold_8
10,6330001,6334544,4543,True,100,scaffold_8
0,109001,117000,7999,False,100,scaffold_9
1,303001,315000,11999,False,100,scaffold_9
2,319001,332000,12999,False,100,scaffold_9
3,367001,411000,43999,False,100,scaffold_9
4,413001,439000,25999,False,100,scaffold_9
5,502001,531000,28999,False,100,scaffold_9
6,671001,696000,24999,False,100,scaffold_9
7,733001,741000,7999,False,100,scaffold_9
8,794001,803000,8999,False,100,scaffold_9
9,815001,842000,26999,False,100,scaffold_9
10,872001,986000,113999,False,100,scaffold_9
11,988001,995000,6999,False,100,scaffold_9
12,1001001,1007000,5999,False,100,scaffold_9
13,1009001,1031000,21999,False,100,scaffold_9
14,1035001,1085000,49999,False,100,scaffold_9
15,1087001,1150000,62999,False,100,scaffold_9
16,1151001,1164000,12999,False,100,scaffold_9
17,1311001,1377000,65999,False,100,scaffold_9
18,1766001,1791000,24999,False,100,scaffold_9
19,2601001,2616000,14999,False,100,scaffold_9
20,2782001,2808000,25999,False,100,scaffold_9
21,2874001,3381000,506999,False,100,scaffold_9
22,3383001,5107000,1723999,False,100,scaffold_9
23,5112001,5115000,2999,False,100,scaffold_9
24,5116001,5238000,121999,False,100,scaffold_9
25,5239001,5298000,58999,False,100,scaffold_9
26,5300001,5490000,189999,False,100,scaffold_9
27,5492001,6331288,839287,True,100,scaffold_9
0,1,198000,197999,True,100,scaffold_10
1,375001,414000,38999,False,100,scaffold_10
2,472001,482000,9999,False,100,scaffold_10
3,483001,576000,92999,False,100,scaffold_10
4,603001,745000,141999,False,100,scaffold_10
5,888001,916000,27999,False,100,scaffold_10
6,924001,962000,37999,False,100,scaffold_10
7,1087001,1105000,17999,False,100,scaffold_10
8,2346001,2367000,20999,False,100,scaffold_10
9,4053001,4091000,37999,False,100,scaffold_10
10,4154001,4174000,19999,False,100,scaffold_10
11,4443001,4462000,18999,False,100,scaffold_10
12,4467001,4476000,8999,False,100,scaffold_10
13,4503001,4513000,9999,False,100,scaffold_10
14,4515001,4523000,7999,False,100,scaffold_10
15,4526001,4548000,21999,False,100,scaffold_10
16,4554001,4562000,7999,False,100,scaffold_10
17,4576001,4595000,18999,False,100,scaffold_10
18,4680001,4688000,7999,False,100,scaffold_10
19,4734001,4766000,31999,False,100,scaffold_10
20,4769001,4776000,6999,False,100,scaffold_10
21,4798001,4824000,25999,False,100,scaffold_10
22,4828001,4843000,14999,False,100,scaffold_10
23,4848001,4861000,12999,False,100,scaffold_10
24,4865001,4866973,1972,True,100,scaffold_10
0,10001,34000,23999,False,100,scaffold_11
1,40001,90000,49999,False,100,scaffold_11
2,149001,167000,17999,False,100,scaffold_11
3,169001,191000,21999,False,100,scaffold_11
4,213001,236000,22999,False,100,scaffold_11
5,240001,248000,7999,False,100,scaffold_11
6,419001,431000,11999,False,100,scaffold_11
7,648001,656000,7999,False,100,scaffold_11
8,1025001,1034000,8999,False,100,scaffold_11
9,1423001,1426000,2999,False,100,scaffold_11
10,2701001,2873000,171999,False,100,scaffold_11
11,3188001,3260000,71999,False,100,scaffold_11
12,3331001,3383000,51999,False,100,scaffold_11
13,3702001,3926000,223999,False,100,scaffold_11
14,4321001,4710000,388999,False,100,scaffold_11
15,4713001,4766820,53819,True,100,scaffold_11
0,1,369000,368999,True,100,scaffold_12
1,474001,537000,62999,False,100,scaffold_12
2,582001,730000,147999,False,100,scaffold_12
3,739001,856000,116999,False,100,scaffold_12
4,865001,1354000,488999,False,100,scaffold_12
5,1720001,1733000,12999,False,100,scaffold_12
6,2571001,2610000,38999,False,100,scaffold_12
7,2747001,2747968,967,True,100,scaffold_12
0,1,439000,438999,True,101,scaffold_1
1,481001,498000,16999,False,101,scaffold_1
2,572001,643000,70999,False,101,scaffold_1
3,686001,761000,74999,False,101,scaffold_1
4,763001,945000,181999,False,101,scaffold_1
5,1067001,1080000,12999,False,101,scaffold_1
6,1168001,1292000,123999,False,101,scaffold_1
7,1310001,1333000,22999,False,101,scaffold_1
8,1615001,1660000,44999,False,101,scaffold_1
9,1725001,1762000,36999,False,101,scaffold_1
10,1769001,1964000,194999,False,101,scaffold_1
11,1965001,1984000,18999,False,101,scaffold_1
12,1986001,2019000,32999,False,101,scaffold_1
13,2345001,2417000,71999,False,101,scaffold_1
14,2449001,2520000,70999,False,101,scaffold_1
15,2555001,2626000,70999,False,101,scaffold_1
16,2725001,2746000,20999,False,101,scaffold_1
17,2900001,2921000,20999,False,101,scaffold_1
18,2961001,3026000,64999,False,101,scaffold_1
19,3072001,3143000,70999,False,101,scaffold_1
20,3170001,3240000,69999,False,101,scaffold_1
21,3304001,3371000,66999,False,101,scaffold_1
22,3442001,3655000,212999,False,101,scaffold_1
23,3703001,4179000,475999,False,101,scaffold_1
24,4213001,4559000,345999,False,101,scaffold_1
25,4642001,4794000,151999,False,101,scaffold_1
26,4796001,5066000,269999,False,101,scaffold_1
27,5087001,5201000,113999,False,101,scaffold_1
28,5387001,5410000,22999,False,101,scaffold_1
29,5431001,5512000,80999,False,101,scaffold_1
30,5535001,5580000,44999,False,101,scaffold_1
31,5852001,5875000,22999,False,101,scaffold_1
32,5898001,5918000,19999,False,101,scaffold_1
33,6108001,6178000,69999,False,101,scaffold_1
34,6201001,6575000,373999,False,101,scaffold_1
35,6639001,6656000,16999,False,101,scaffold_1
36,6811001,6862000,50999,False,101,scaffold_1
37,6864001,6878000,13999,False,101,scaffold_1
38,6931001,6953000,21999,False,101,scaffold_1
39,7038001,7247000,208999,False,101,scaffold_1
40,7248001,7583000,334999,False,101,scaffold_1
41,7590001,8477000,886999,False,101,scaffold_1
42,8478001,8656000,177999,False,101,scaffold_1
43,8658001,9584000,925999,False,101,scaffold_1
44,9586001,10372000,785999,False,101,scaffold_1
45,10445001,10640000,194999,False,101,scaffold_1
46,10656001,10757000,100999,False,101,scaffold_1
47,10838001,10857000,18999,False,101,scaffold_1
48,10916001,10991000,74999,False,101,scaffold_1
49,11013001,11072000,58999,False,101,scaffold_1
50,11123001,11217000,93999,False,101,scaffold_1
51,11259001,11964000,704999,False,101,scaffold_1
52,12146001,12245000,98999,False,101,scaffold_1
53,12329001,12368000,38999,False,101,scaffold_1
54,12400001,13075000,674999,False,101,scaffold_1
55,13095001,13216000,120999,False,101,scaffold_1
56,13322001,13332000,9999,False,101,scaffold_1
57,13339001,13455000,115999,False,101,scaffold_1
58,13517001,13537000,19999,False,101,scaffold_1
59,13550001,13590000,39999,False,101,scaffold_1
60,13591001,13608000,16999,False,101,scaffold_1
61,13668001,13709000,40999,False,101,scaffold_1
62,13787001,13845000,57999,False,101,scaffold_1
63,13959001,13977000,17999,False,101,scaffold_1
64,14022001,14063000,40999,False,101,scaffold_1
65,14112001,14121000,8999,False,101,scaffold_1
66,14289001,14309000,19999,False,101,scaffold_1
67,14530001,14558000,27999,False,101,scaffold_1
68,14595001,14611000,15999,False,101,scaffold_1
69,14648001,14664000,15999,False,101,scaffold_1
70,14789001,14794116,5115,True,101,scaffold_1
0,21001,48000,26999,False,101,scaffold_2
1,93001,159000,65999,False,101,scaffold_2
2,165001,177000,11999,False,101,scaffold_2
3,254001,288000,33999,False,101,scaffold_2
4,297001,318000,20999,False,101,scaffold_2
5,332001,374000,41999,False,101,scaffold_2
6,387001,412000,24999,False,101,scaffold_2
7,731001,739000,7999,False,101,scaffold_2
8,1165001,1193000,27999,False,101,scaffold_2
9,1228001,1255000,26999,False,101,scaffold_2
10,1311001,1344000,32999,False,101,scaffold_2
11,1347001,1416000,68999,False,101,scaffold_2
12,1453001,1468000,14999,False,101,scaffold_2
13,1470001,1550000,79999,False,101,scaffold_2
14,1626001,1677000,50999,False,101,scaffold_2
15,1689001,1717000,27999,False,101,scaffold_2
16,1838001,1900000,61999,False,101,scaffold_2
17,1920001,1959000,38999,False,101,scaffold_2
18,2055001,2151000,95999,False,101,scaffold_2
19,2302001,2334000,31999,False,101,scaffold_2
20,2336001,2639000,302999,False,101,scaffold_2
21,2654001,2689000,34999,False,101,scaffold_2
22,2694001,2746000,51999,False,101,scaffold_2
23,2766001,2788000,21999,False,101,scaffold_2
24,2805001,2855000,49999,False,101,scaffold_2
25,2878001,3021000,142999,False,101,scaffold_2
26,3022001,3047000,24999,False,101,scaffold_2
27,3330001,3344000,13999,False,101,scaffold_2
28,3363001,3413000,49999,False,101,scaffold_2
29,3450001,3713000,262999,False,101,scaffold_2
30,3754001,3765000,10999,False,101,scaffold_2
31,3766001,3794000,27999,False,101,scaffold_2
32,3814001,3930000,115999,False,101,scaffold_2
33,4108001,4149000,40999,False,101,scaffold_2
34,4239001,4409000,169999,False,101,scaffold_2
35,4425001,4790000,364999,False,101,scaffold_2
36,4793001,4805000,11999,False,101,scaffold_2
37,4917001,4958000,40999,False,101,scaffold_2
38,5016001,5104000,87999,False,101,scaffold_2
39,5187001,5279000,91999,False,101,scaffold_2
40,5285001,5779000,493999,False,101,scaffold_2
41,5829001,5889000,59999,False,101,scaffold_2
42,5909001,6079000,169999,False,101,scaffold_2
43,6119001,6185000,65999,False,101,scaffold_2
44,6228001,6350000,121999,False,101,scaffold_2
45,6365001,6468000,102999,False,101,scaffold_2
46,6576001,6629000,52999,False,101,scaffold_2
47,6693001,6767000,73999,False,101,scaffold_2
48,6802001,6890000,87999,False,101,scaffold_2
49,6940001,7048000,107999,False,101,scaffold_2
50,7049001,7097000,47999,False,101,scaffold_2
51,7109001,7220000,110999,False,101,scaffold_2
52,7338001,7473000,134999,False,101,scaffold_2
53,7491001,7518000,26999,False,101,scaffold_2
54,7548001,7561000,12999,False,101,scaffold_2
55,7563001,8328000,764999,False,101,scaffold_2
56,8331001,8333000,1999,False,101,scaffold_2
57,8334001,8344000,9999,False,101,scaffold_2
58,8346001,8455000,108999,False,101,scaffold_2
59,8461001,8494000,32999,False,101,scaffold_2
60,8495001,8563000,67999,False,101,scaffold_2
61,8998001,9051000,52999,False,101,scaffold_2
62,9138001,9382000,243999,False,101,scaffold_2
63,9419001,9471000,51999,False,101,scaffold_2
64,9566001,9636000,69999,False,101,scaffold_2
65,9673001,9743000,69999,False,101,scaffold_2
66,9752001,9828000,75999,False,101,scaffold_2
67,10332001,10350000,17999,False,101,scaffold_2
68,10404001,10422000,17999,False,101,scaffold_2
69,10444001,10502000,57999,False,101,scaffold_2
70,10629001,10695000,65999,False,101,scaffold_2
71,10710001,10736000,25999,False,101,scaffold_2
72,10929001,10962000,32999,False,101,scaffold_2
73,11366001,11502000,135999,False,101,scaffold_2
74,11518001,11786000,267999,False,101,scaffold_2
75,11799001,11802476,3475,True,101,scaffold_2
0,352001,362000,9999,False,101,scaffold_3
1,618001,647000,28999,False,101,scaffold_3
2,799001,923000,123999,False,101,scaffold_3
3,1634001,1672000,37999,False,101,scaffold_3
4,1760001,1787000,26999,False,101,scaffold_3
5,1896001,1981000,84999,False,101,scaffold_3
6,1996001,2147000,150999,False,101,scaffold_3
7,2256001,2336000,79999,False,101,scaffold_3
8,2377001,2428000,50999,False,101,scaffold_3
9,2432001,2558000,125999,False,101,scaffold_3
10,2623001,2761000,137999,False,101,scaffold_3
11,3055001,3062000,6999,False,101,scaffold_3
12,3066001,3197000,130999,False,101,scaffold_3
13,3212001,3278000,65999,False,101,scaffold_3
14,3483001,3557000,73999,False,101,scaffold_3
15,3558001,3891000,332999,False,101,scaffold_3
16,3926001,3947000,20999,False,101,scaffold_3
17,3995001,4090000,94999,False,101,scaffold_3
18,4091001,4404000,312999,False,101,scaffold_3
19,4416001,4519000,102999,False,101,scaffold_3
20,4547001,4558000,10999,False,101,scaffold_3
21,4646001,4684000,37999,False,101,scaffold_3
22,4844001,4924000,79999,False,101,scaffold_3
23,4997001,5036000,38999,False,101,scaffold_3
24,5065001,5278000,212999,False,101,scaffold_3
25,5375001,5538000,162999,False,101,scaffold_3
26,5561001,5676000,114999,False,101,scaffold_3
27,5678001,5685000,6999,False,101,scaffold_3
28,5702001,6033000,330999,False,101,scaffold_3
29,6067001,6093000,25999,False,101,scaffold_3
30,6518001,6582000,63999,False,101,scaffold_3
31,6710001,6807000,96999,False,101,scaffold_3
32,6859001,7100000,240999,False,101,scaffold_3
33,7109001,7157000,47999,False,101,scaffold_3
34,7222001,7327000,104999,False,101,scaffold_3
35,7332001,7445000,112999,False,101,scaffold_3
36,7449001,7460000,10999,False,101,scaffold_3
37,7462001,7556000,93999,False,101,scaffold_3
38,7576001,7638000,61999,False,101,scaffold_3
39,7657001,7895000,237999,False,101,scaffold_3
40,7916001,7941000,24999,False,101,scaffold_3
41,8035001,8116000,80999,False,101,scaffold_3
42,8121001,8157000,35999,False,101,scaffold_3
43,8179001,8277000,97999,False,101,scaffold_3
44,8334001,8362000,27999,False,101,scaffold_3
45,8395001,8449000,53999,False,101,scaffold_3
46,8459001,8563000,103999,False,101,scaffold_3
47,8575001,8594000,18999,False,101,scaffold_3
48,8604001,8627000,22999,False,101,scaffold_3
49,8783001,8803000,19999,False,101,scaffold_3
50,8956001,9081000,124999,False,101,scaffold_3
51,9106001,9248000,141999,False,101,scaffold_3
52,9480001,9578000,97999,False,101,scaffold_3
53,9645001,9692000,46999,False,101,scaffold_3
54,9732001,9759000,26999,False,101,scaffold_3
55,9769001,9812000,42999,False,101,scaffold_3
56,9840001,9857000,16999,False,101,scaffold_3
57,9967001,9999000,31999,False,101,scaffold_3
58,10042001,10090000,47999,False,101,scaffold_3
59,10461001,10486000,24999,False,101,scaffold_3
60,10550001,11167000,616999,False,101,scaffold_3
0,11001,13000,1999,False,101,scaffold_4
1,17001,32000,14999,False,101,scaffold_4
2,48001,88000,39999,False,101,scaffold_4
3,120001,151000,30999,False,101,scaffold_4
4,155001,160000,4999,False,101,scaffold_4
5,161001,174000,12999,False,101,scaffold_4
6,175001,216000,40999,False,101,scaffold_4
7,218001,226000,7999,False,101,scaffold_4
8,227001,267000,39999,False,101,scaffold_4
9,283001,311000,27999,False,101,scaffold_4
10,313001,342000,28999,False,101,scaffold_4
11,355001,374000,18999,False,101,scaffold_4
12,375001,410000,34999,False,101,scaffold_4
13,412001,425000,12999,False,101,scaffold_4
14,429001,498000,68999,False,101,scaffold_4
15,542001,606000,63999,False,101,scaffold_4
16,608001,691000,82999,False,101,scaffold_4
17,695001,697000,1999,False,101,scaffold_4
18,701001,725000,23999,False,101,scaffold_4
19,1087001,1097000,9999,False,101,scaffold_4
20,1098001,1110000,11999,False,101,scaffold_4
21,1113001,1136000,22999,False,101,scaffold_4
22,1139001,1198000,58999,False,101,scaffold_4
23,1199001,1226000,26999,False,101,scaffold_4
24,1229001,1234000,4999,False,101,scaffold_4
25,1235001,1253000,17999,False,101,scaffold_4
26,1254001,1279000,24999,False,101,scaffold_4
27,1283001,1604000,320999,False,101,scaffold_4
28,1613001,2206000,592999,False,101,scaffold_4
29,2210001,2218000,7999,False,101,scaffold_4
30,2219001,2280000,60999,False,101,scaffold_4
31,2284001,2352000,67999,False,101,scaffold_4
32,2353001,2461000,107999,False,101,scaffold_4
33,2476001,2675000,198999,False,101,scaffold_4
34,2676001,2817000,140999,False,101,scaffold_4
35,2896001,3132000,235999,False,101,scaffold_4
36,3205001,3331000,125999,False,101,scaffold_4
37,3334001,3880000,545999,False,101,scaffold_4
38,3917001,4045000,127999,False,101,scaffold_4
39,4055001,4197000,141999,False,101,scaffold_4
40,4231001,4308000,76999,False,101,scaffold_4
41,4900001,5103000,202999,False,101,scaffold_4
42,5170001,5225000,54999,False,101,scaffold_4
43,5292001,5506000,213999,False,101,scaffold_4
44,5513001,5784000,270999,False,101,scaffold_4
45,5786001,5856000,69999,False,101,scaffold_4
46,5919001,5968000,48999,False,101,scaffold_4
47,6014001,6123000,108999,False,101,scaffold_4
48,6145001,6522000,376999,False,101,scaffold_4
49,6550001,6612000,61999,False,101,scaffold_4
50,6620001,6703000,82999,False,101,scaffold_4
51,6705001,6817000,111999,False,101,scaffold_4
52,6841001,6924000,82999,False,101,scaffold_4
53,6950001,6995000,44999,False,101,scaffold_4
54,7036001,7124000,87999,False,101,scaffold_4
55,7126001,7429000,302999,False,101,scaffold_4
56,7457001,7571000,113999,False,101,scaffold_4
57,7628001,7665000,36999,False,101,scaffold_4
58,7838001,7923000,84999,False,101,scaffold_4
59,7975001,7999000,23999,False,101,scaffold_4
60,8051001,8126000,74999,False,101,scaffold_4
61,8800001,8815000,14999,False,101,scaffold_4
62,8844001,9699000,854999,False,101,scaffold_4
63,9700001,9845951,145950,True,101,scaffold_4
0,1,6000,5999,True,101,scaffold_5
1,154001,163000,8999,False,101,scaffold_5
2,318001,421000,102999,False,101,scaffold_5
3,442001,525000,82999,False,101,scaffold_5
4,624001,638000,13999,False,101,scaffold_5
5,639001,649000,9999,False,101,scaffold_5
6,669001,697000,27999,False,101,scaffold_5
7,803001,824000,20999,False,101,scaffold_5
8,835001,843000,7999,False,101,scaffold_5
9,922001,947000,24999,False,101,scaffold_5
10,1081001,1105000,23999,False,101,scaffold_5
11,1262001,1284000,21999,False,101,scaffold_5
12,1355001,1392000,36999,False,101,scaffold_5
13,1626001,1661000,34999,False,101,scaffold_5
14,1667001,1684000,16999,False,101,scaffold_5
15,2089001,2104000,14999,False,101,scaffold_5
16,2255001,2305000,49999,False,101,scaffold_5
17,2472001,2494000,21999,False,101,scaffold_5
18,2506001,2515000,8999,False,101,scaffold_5
19,2516001,2903000,386999,False,101,scaffold_5
20,2924001,3035000,110999,False,101,scaffold_5
21,3050001,3080000,29999,False,101,scaffold_5
22,3128001,3514000,385999,False,101,scaffold_5
23,3532001,3563000,30999,False,101,scaffold_5
24,3616001,3661000,44999,False,101,scaffold_5
25,3783001,4101000,317999,False,101,scaffold_5
26,4117001,4861000,743999,False,101,scaffold_5
27,4883001,4925000,41999,False,101,scaffold_5
28,4963001,4992000,28999,False,101,scaffold_5
29,5056001,5122000,65999,False,101,scaffold_5
30,5197001,5346000,148999,False,101,scaffold_5
31,5490001,5528000,37999,False,101,scaffold_5
32,5695001,5738000,42999,False,101,scaffold_5
33,6391001,6726000,334999,False,101,scaffold_5
34,6775001,6854000,78999,False,101,scaffold_5
35,6878001,6931000,52999,False,101,scaffold_5
36,7043001,7083000,39999,False,101,scaffold_5
37,7167001,7248000,80999,False,101,scaffold_5
38,7256001,7328000,71999,False,101,scaffold_5
39,7335001,7386000,50999,False,101,scaffold_5
40,7411001,7443000,31999,False,101,scaffold_5
41,7454001,7512000,57999,False,101,scaffold_5
42,7523001,7806000,282999,False,101,scaffold_5
43,7844001,7878000,33999,False,101,scaffold_5
44,8415001,8470000,54999,False,101,scaffold_5
45,8548001,8616000,67999,False,101,scaffold_5
46,8636001,9364176,728175,True,101,scaffold_5
0,42001,75000,32999,False,101,scaffold_6
1,79001,85000,5999,False,101,scaffold_6
2,86001,114000,27999,False,101,scaffold_6
3,134001,211000,76999,False,101,scaffold_6
4,239001,255000,15999,False,101,scaffold_6
5,458001,497000,38999,False,101,scaffold_6
6,553001,580000,26999,False,101,scaffold_6
7,618001,663000,44999,False,101,scaffold_6
8,731001,800000,68999,False,101,scaffold_6
9,914001,1048000,133999,False,101,scaffold_6
10,1120001,1226000,105999,False,101,scaffold_6
11,1229001,1266000,36999,False,101,scaffold_6
12,1284001,1310000,25999,False,101,scaffold_6
13,1408001,1597000,188999,False,101,scaffold_6
14,1657001,1756000,98999,False,101,scaffold_6
15,1832001,1906000,73999,False,101,scaffold_6
16,1907001,1935000,27999,False,101,scaffold_6
17,1977001,1993000,15999,False,101,scaffold_6
18,2025001,2103000,77999,False,101,scaffold_6
19,2124001,2215000,90999,False,101,scaffold_6
20,2236001,2283000,46999,False,101,scaffold_6
21,2310001,2654000,343999,False,101,scaffold_6
22,2655001,2872000,216999,False,101,scaffold_6
23,2933001,3806000,872999,False,101,scaffold_6
24,3810001,4204000,393999,False,101,scaffold_6
25,4778001,4829000,50999,False,101,scaffold_6
26,4836001,4916000,79999,False,101,scaffold_6
27,4924001,5006000,81999,False,101,scaffold_6
28,5572001,5788000,215999,False,101,scaffold_6
29,5861001,6277000,415999,False,101,scaffold_6
30,6469001,6505000,35999,False,101,scaffold_6
31,6586001,6590000,3999,False,101,scaffold_6
32,6685001,6715000,29999,False,101,scaffold_6
33,6764001,6860000,95999,False,101,scaffold_6
34,6911001,6942000,30999,False,101,scaffold_6
35,7178001,7338000,159999,False,101,scaffold_6
36,7389001,7530000,140999,False,101,scaffold_6
37,7531001,8268281,737280,True,101,scaffold_6
0,14001,34000,19999,False,101,scaffold_7
1,323001,340000,16999,False,101,scaffold_7
2,342001,508000,165999,False,101,scaffold_7
3,571001,577000,5999,False,101,scaffold_7
4,580001,592000,11999,False,101,scaffold_7
5,654001,677000,22999,False,101,scaffold_7
6,706001,753000,46999,False,101,scaffold_7
7,760001,829000,68999,False,101,scaffold_7
8,833001,843000,9999,False,101,scaffold_7
9,859001,864000,4999,False,101,scaffold_7
10,865001,872000,6999,False,101,scaffold_7
11,875001,948000,72999,False,101,scaffold_7
12,951001,963000,11999,False,101,scaffold_7
13,964001,966000,1999,False,101,scaffold_7
14,968001,981000,12999,False,101,scaffold_7
15,982001,1044000,61999,False,101,scaffold_7
16,1048001,1104000,55999,False,101,scaffold_7
17,1194001,1460000,265999,False,101,scaffold_7
18,1461001,1512000,50999,False,101,scaffold_7
19,1588001,1717000,128999,False,101,scaffold_7
20,1740001,1782000,41999,False,101,scaffold_7
21,1849001,1901000,51999,False,101,scaffold_7
22,1908001,1939000,30999,False,101,scaffold_7
23,1974001,2017000,42999,False,101,scaffold_7
24,2223001,2273000,49999,False,101,scaffold_7
25,2367001,2409000,41999,False,101,scaffold_7
26,2543001,2593000,49999,False,101,scaffold_7
27,2607001,2735000,127999,False,101,scaffold_7
28,2804001,2850000,45999,False,101,scaffold_7
29,2851001,2952000,100999,False,101,scaffold_7
30,3128001,3152000,23999,False,101,scaffold_7
31,3198001,3271000,72999,False,101,scaffold_7
32,3293001,3413000,119999,False,101,scaffold_7
33,3517001,3932000,414999,False,101,scaffold_7
34,3953001,3968000,14999,False,101,scaffold_7
35,4021001,4066000,44999,False,101,scaffold_7
36,4296001,4365000,68999,False,101,scaffold_7
37,4410001,4580000,169999,False,101,scaffold_7
38,4630001,5205000,574999,False,101,scaffold_7
39,5400001,5645000,244999,False,101,scaffold_7
40,5778001,5837000,58999,False,101,scaffold_7
41,6049001,6094000,44999,False,101,scaffold_7
42,6096001,6251000,154999,False,101,scaffold_7
43,6558001,6722000,163999,False,101,scaffold_7
44,6747001,6799000,51999,False,101,scaffold_7
45,6945001,7502216,557215,True,101,scaffold_7
0,1,6000,5999,True,101,scaffold_8
1,32001,63000,30999,False,101,scaffold_8
2,66001,87000,20999,False,101,scaffold_8
3,722001,725000,2999,False,101,scaffold_8
4,1021001,1054000,32999,False,101,scaffold_8
5,1364001,1424000,59999,False,101,scaffold_8
6,1566001,1583000,16999,False,101,scaffold_8
7,1733001,1754000,20999,False,101,scaffold_8
8,1858001,1964000,105999,False,101,scaffold_8
9,2088001,2156000,67999,False,101,scaffold_8
10,2263001,2282000,18999,False,101,scaffold_8
11,2333001,2596000,262999,False,101,scaffold_8
12,2612001,2844000,231999,False,101,scaffold_8
13,2847001,3189000,341999,False,101,scaffold_8
14,3190001,3949000,758999,False,101,scaffold_8
15,4010001,4195000,184999,False,101,scaffold_8
16,4196001,4270000,73999,False,101,scaffold_8
17,4330001,4429000,98999,False,101,scaffold_8
18,4470001,4485000,14999,False,101,scaffold_8
19,4566001,4646000,79999,False,101,scaffold_8
20,4720001,4777000,56999,False,101,scaffold_8
21,4799001,4916000,116999,False,101,scaffold_8
22,4983001,5058000,74999,False,101,scaffold_8
23,5067001,5246000,178999,False,101,scaffold_8
24,5401001,5475000,73999,False,101,scaffold_8
25,5523001,5597000,73999,False,101,scaffold_8
26,5651001,5712000,60999,False,101,scaffold_8
27,5728001,5774000,45999,False,101,scaffold_8
28,5776001,5995000,218999,False,101,scaffold_8
29,6025001,6118000,92999,False,101,scaffold_8
30,6213001,6308000,94999,False,101,scaffold_8
31,6317001,6334544,17543,True,101,scaffold_8
0,2001,20000,17999,False,101,scaffold_9
1,109001,117000,7999,False,101,scaffold_9
2,121001,138000,16999,False,101,scaffold_9
3,366001,411000,44999,False,101,scaffold_9
4,413001,434000,20999,False,101,scaffold_9
5,484001,531000,46999,False,101,scaffold_9
6,547001,563000,15999,False,101,scaffold_9
7,660001,665000,4999,False,101,scaffold_9
8,670001,696000,25999,False,101,scaffold_9
9,732001,741000,8999,False,101,scaffold_9
10,757001,777000,19999,False,101,scaffold_9
11,779001,782000,2999,False,101,scaffold_9
12,815001,845000,29999,False,101,scaffold_9
13,873001,986000,112999,False,101,scaffold_9
14,988001,995000,6999,False,101,scaffold_9
15,1001001,1085000,83999,False,101,scaffold_9
16,1087001,1196000,108999,False,101,scaffold_9
17,1203001,1257000,53999,False,101,scaffold_9
18,1312001,1383000,70999,False,101,scaffold_9
19,1457001,1465000,7999,False,101,scaffold_9
20,1520001,1592000,71999,False,101,scaffold_9
21,1599001,1700000,100999,False,101,scaffold_9
22,1730001,1811000,80999,False,101,scaffold_9
23,1814001,1856000,41999,False,101,scaffold_9
24,1868001,1959000,90999,False,101,scaffold_9
25,1970001,2067000,96999,False,101,scaffold_9
26,2071001,2135000,63999,False,101,scaffold_9
27,2136001,2429000,292999,False,101,scaffold_9
28,2483001,2579000,95999,False,101,scaffold_9
29,2598001,2673000,74999,False,101,scaffold_9
30,2674001,2701000,26999,False,101,scaffold_9
31,2704001,2721000,16999,False,101,scaffold_9
32,2735001,3381000,645999,False,101,scaffold_9
33,3383001,5107000,1723999,False,101,scaffold_9
34,5112001,5114000,1999,False,101,scaffold_9
35,5116001,5238000,121999,False,101,scaffold_9
36,5239001,5298000,58999,False,101,scaffold_9
37,5299001,5490000,190999,False,101,scaffold_9
38,5493001,6331288,838287,True,101,scaffold_9
0,1,414000,413999,True,101,scaffold_10
1,415001,482000,66999,False,101,scaffold_10
2,483001,877000,393999,False,101,scaffold_10
3,888001,1069000,180999,False,101,scaffold_10
4,1072001,1212000,139999,False,101,scaffold_10
5,1313001,1336000,22999,False,101,scaffold_10
6,1348001,1470000,121999,False,101,scaffold_10
7,1488001,1570000,81999,False,101,scaffold_10
8,1603001,1676000,72999,False,101,scaffold_10
9,1695001,1762000,66999,False,101,scaffold_10
10,1802001,1831000,28999,False,101,scaffold_10
11,1862001,1923000,60999,False,101,scaffold_10
12,2013001,2103000,89999,False,101,scaffold_10
13,2140001,2476000,335999,False,101,scaffold_10
14,2509001,2520000,10999,False,101,scaffold_10
15,2521001,2653000,131999,False,101,scaffold_10
16,2673001,2812000,138999,False,101,scaffold_10
17,2817001,2861000,43999,False,101,scaffold_10
18,2941001,2954000,12999,False,101,scaffold_10
19,2962001,3017000,54999,False,101,scaffold_10
20,3068001,3137000,68999,False,101,scaffold_10
21,3162001,3179000,16999,False,101,scaffold_10
22,3394001,3423000,28999,False,101,scaffold_10
23,3559001,3583000,23999,False,101,scaffold_10
24,3647001,3653000,5999,False,101,scaffold_10
25,3779001,3795000,15999,False,101,scaffold_10
26,4053001,4093000,39999,False,101,scaffold_10
27,4154001,4179000,24999,False,101,scaffold_10
28,4335001,4364000,28999,False,101,scaffold_10
29,4467001,4491000,23999,False,101,scaffold_10
30,4493001,4502000,8999,False,101,scaffold_10
31,4503001,4513000,9999,False,101,scaffold_10
32,4515001,4523000,7999,False,101,scaffold_10
33,4526001,4548000,21999,False,101,scaffold_10
34,4565001,4597000,31999,False,101,scaffold_10
35,4734001,4776000,41999,False,101,scaffold_10
36,4798001,4824000,25999,False,101,scaffold_10
37,4828001,4843000,14999,False,101,scaffold_10
38,4848001,4861000,12999,False,101,scaffold_10
39,4865001,4866973,1972,True,101,scaffold_10
0,10001,99000,88999,False,101,scaffold_11
1,132001,167000,34999,False,101,scaffold_11
2,169001,212000,42999,False,101,scaffold_11
3,213001,235000,21999,False,101,scaffold_11
4,240001,252000,11999,False,101,scaffold_11
5,289001,312000,22999,False,101,scaffold_11
6,419001,431000,11999,False,101,scaffold_11
7,648001,656000,7999,False,101,scaffold_11
8,1102001,1113000,10999,False,101,scaffold_11
9,1236001,1241000,4999,False,101,scaffold_11
10,1474001,1478000,3999,False,101,scaffold_11
11,1524001,1544000,19999,False,101,scaffold_11
12,1572001,1585000,12999,False,101,scaffold_11
13,1773001,1805000,31999,False,101,scaffold_11
14,1853001,1916000,62999,False,101,scaffold_11
15,1966001,2007000,40999,False,101,scaffold_11
16,2008001,2034000,25999,False,101,scaffold_11
17,2035001,2058000,22999,False,101,scaffold_11
18,2115001,2172000,56999,False,101,scaffold_11
19,2176001,2230000,53999,False,101,scaffold_11
20,2674001,3029000,354999,False,101,scaffold_11
21,3081001,3183000,101999,False,101,scaffold_11
22,3184001,3514000,329999,False,101,scaffold_11
23,3517001,3972000,454999,False,101,scaffold_11
24,3980001,4162000,181999,False,101,scaffold_11
25,4181001,4710000,528999,False,101,scaffold_11
26,4713001,4766820,53819,True,101,scaffold_11
0,1,1109000,1108999,True,101,scaffold_12
1,1110001,1498000,387999,False,101,scaffold_12
2,1574001,1587000,12999,False,101,scaffold_12
3,1717001,1746000,28999,False,101,scaffold_12
4,1786001,1811000,24999,False,101,scaffold_12
5,1835001,1837000,1999,False,101,scaffold_12
6,1838001,2005000,166999,False,101,scaffold_12
7,2023001,2103000,79999,False,101,scaffold_12
8,2136001,2178000,41999,False,101,scaffold_12
9,2340001,2377000,36999,False,101,scaffold_12
10,2562001,2566000,3999,False,101,scaffold_12
11,2571001,2611000,39999,False,101,scaffold_12
12,2659001,2682000,22999,False,101,scaffold_12
13,2685001,2698000,12999,False,101,scaffold_12
0,1,342000,341999,True,102,scaffold_1
1,482001,498000,15999,False,102,scaffold_1
2,571001,643000,71999,False,102,scaffold_1
3,686001,749000,62999,False,102,scaffold_1
4,1281001,1292000,10999,False,102,scaffold_1
5,1814001,1899000,84999,False,102,scaffold_1
6,1954001,1964000,9999,False,102,scaffold_1
7,1965001,1984000,18999,False,102,scaffold_1
8,1988001,1999000,10999,False,102,scaffold_1
9,2449001,2519000,69999,False,102,scaffold_1
10,2565001,2579000,13999,False,102,scaffold_1
11,2729001,2746000,16999,False,102,scaffold_1
12,3181001,3208000,26999,False,102,scaffold_1
13,3714001,3741000,26999,False,102,scaffold_1
14,3904001,3941000,36999,False,102,scaffold_1
15,4003001,4027000,23999,False,102,scaffold_1
16,4061001,4111000,49999,False,102,scaffold_1
17,4322001,4354000,31999,False,102,scaffold_1
18,4927001,5001000,73999,False,102,scaffold_1
19,5482001,5511000,28999,False,102,scaffold_1
20,5537001,5568000,30999,False,102,scaffold_1
21,6108001,6153000,44999,False,102,scaffold_1
22,6201001,6381000,179999,False,102,scaffold_1
23,6384001,6507000,122999,False,102,scaffold_1
24,6543001,6559000,15999,False,102,scaffold_1
25,7038001,7247000,208999,False,102,scaffold_1
26,7248001,7583000,334999,False,102,scaffold_1
27,7590001,8477000,886999,False,102,scaffold_1
28,8478001,8656000,177999,False,102,scaffold_1
29,8658001,9352000,693999,False,102,scaffold_1
30,9353001,9584000,230999,False,102,scaffold_1
31,9586001,10356000,769999,False,102,scaffold_1
32,10461001,10626000,164999,False,102,scaffold_1
33,10808001,10811000,2999,False,102,scaffold_1
34,10843001,10850000,6999,False,102,scaffold_1
35,11351001,11504000,152999,False,102,scaffold_1
36,11609001,11956000,346999,False,102,scaffold_1
37,12184001,12204000,19999,False,102,scaffold_1
38,12655001,12723000,67999,False,102,scaffold_1
39,12777001,12888000,110999,False,102,scaffold_1
40,13113001,13212000,98999,False,102,scaffold_1
41,13347001,13406000,58999,False,102,scaffold_1
42,13818001,13837000,18999,False,102,scaffold_1
43,14290001,14309000,18999,False,102,scaffold_1
44,14471001,14476000,4999,False,102,scaffold_1
45,14605001,14611000,5999,False,102,scaffold_1
46,14690001,14692000,1999,False,102,scaffold_1
0,22001,48000,25999,False,102,scaffold_2
1,93001,159000,65999,False,102,scaffold_2
2,168001,177000,8999,False,102,scaffold_2
3,332001,374000,41999,False,102,scaffold_2
4,2336001,2358000,21999,False,102,scaffold_2
5,2404001,2427000,22999,False,102,scaffold_2
6,2436001,2579000,142999,False,102,scaffold_2
7,2627001,2639000,11999,False,102,scaffold_2
8,2658001,2689000,30999,False,102,scaffold_2
9,2694001,2742000,47999,False,102,scaffold_2
10,2777001,2788000,10999,False,102,scaffold_2
11,2868001,2899000,30999,False,102,scaffold_2
12,3454001,3463000,8999,False,102,scaffold_2
13,3767001,3782000,14999,False,102,scaffold_2
14,4382001,4409000,26999,False,102,scaffold_2
15,4426001,4457000,30999,False,102,scaffold_2
16,4521001,4656000,134999,False,102,scaffold_2
17,4918001,4939000,20999,False,102,scaffold_2
18,5020001,5031000,10999,False,102,scaffold_2
19,5033001,5063000,29999,False,102,scaffold_2
20,5080001,5103000,22999,False,102,scaffold_2
21,5491001,5512000,20999,False,102,scaffold_2
22,5658001,5704000,45999,False,102,scaffold_2
23,5719001,5756000,36999,False,102,scaffold_2
24,6261001,6330000,68999,False,102,scaffold_2
25,6331001,6350000,18999,False,102,scaffold_2
26,6413001,6449000,35999,False,102,scaffold_2
27,7005001,7038000,32999,False,102,scaffold_2
28,7064001,7088000,23999,False,102,scaffold_2
29,7439001,7472000,32999,False,102,scaffold_2
30,7563001,7697000,133999,False,102,scaffold_2
31,7785001,7891000,105999,False,102,scaffold_2
32,7934001,8092000,157999,False,102,scaffold_2
33,8265001,8294000,28999,False,102,scaffold_2
34,8331001,8333000,1999,False,102,scaffold_2
35,8334001,8344000,9999,False,102,scaffold_2
36,8346001,8454000,107999,False,102,scaffold_2
37,8509001,8563000,53999,False,102,scaffold_2
38,10710001,10730000,19999,False,102,scaffold_2
39,11366001,11374000,7999,False,102,scaffold_2
40,11520001,11786000,265999,False,102,scaffold_2
0,618001,646000,27999,False,102,scaffold_3
1,799001,900000,100999,False,102,scaffold_3
2,2042001,2108000,65999,False,102,scaffold_3
3,2109001,2115000,5999,False,102,scaffold_3
4,2291001,2321000,29999,False,102,scaffold_3
5,2487001,2533000,45999,False,102,scaffold_3
6,2719001,2729000,9999,False,102,scaffold_3
7,3826001,3890000,63999,False,102,scaffold_3
8,4108001,4403000,294999,False,102,scaffold_3
9,4410001,4518000,107999,False,102,scaffold_3
10,4547001,4558000,10999,False,102,scaffold_3
11,4653001,4679000,25999,False,102,scaffold_3
12,5988001,6026000,37999,False,102,scaffold_3
13,6892001,6972000,79999,False,102,scaffold_3
14,6979001,7088000,108999,False,102,scaffold_3
15,7147001,7157000,9999,False,102,scaffold_3
16,7340001,7358000,17999,False,102,scaffold_3
17,7524001,7556000,31999,False,102,scaffold_3
18,7691001,7799000,107999,False,102,scaffold_3
19,7818001,7854000,35999,False,102,scaffold_3
20,8175001,8253000,77999,False,102,scaffold_3
21,8462001,8527000,64999,False,102,scaffold_3
22,8575001,8594000,18999,False,102,scaffold_3
23,9968001,9996000,27999,False,102,scaffold_3
24,10461001,10484000,22999,False,102,scaffold_3
25,10587001,11165000,577999,False,102,scaffold_3
0,17001,32000,14999,False,102,scaffold_4
1,48001,88000,39999,False,102,scaffold_4
2,107001,115000,7999,False,102,scaffold_4
3,155001,160000,4999,False,102,scaffold_4
4,161001,215000,53999,False,102,scaffold_4
5,217001,226000,8999,False,102,scaffold_4
6,227001,241000,13999,False,102,scaffold_4
7,242001,266000,23999,False,102,scaffold_4
8,288001,310000,21999,False,102,scaffold_4
9,313001,344000,30999,False,102,scaffold_4
10,355001,374000,18999,False,102,scaffold_4
11,405001,410000,4999,False,102,scaffold_4
12,412001,425000,12999,False,102,scaffold_4
13,429001,498000,68999,False,102,scaffold_4
14,546001,592000,45999,False,102,scaffold_4
15,608001,661000,52999,False,102,scaffold_4
16,670001,691000,20999,False,102,scaffold_4
17,701001,714000,12999,False,102,scaffold_4
18,1121001,1136000,14999,False,102,scaffold_4
19,1137001,1198000,60999,False,102,scaffold_4
20,1199001,1226000,26999,False,102,scaffold_4
21,1254001,1262000,7999,False,102,scaffold_4
22,1265001,1279000,13999,False,102,scaffold_4
23,1283001,1320000,36999,False,102,scaffold_4
24,1372001,1604000,231999,False,102,scaffold_4
25,1613001,1849000,235999,False,102,scaffold_4
26,1850001,1898000,47999,False,102,scaffold_4
27,1904001,2005000,100999,False,102,scaffold_4
28,2021001,2065000,43999,False,102,scaffold_4
29,2073001,2117000,43999,False,102,scaffold_4
30,2119001,2129000,9999,False,102,scaffold_4
31,2145001,2185000,39999,False,102,scaffold_4
32,2188001,2209000,20999,False,102,scaffold_4
33,2210001,2246000,35999,False,102,scaffold_4
34,2284001,2340000,55999,False,102,scaffold_4
35,2398001,2462000,63999,False,102,scaffold_4
36,2477001,2635000,157999,False,102,scaffold_4
37,3334001,3635000,300999,False,102,scaffold_4
38,3645001,3760000,114999,False,102,scaffold_4
39,4057001,4074000,16999,False,102,scaffold_4
40,4900001,4996000,95999,False,102,scaffold_4
41,5172001,5223000,50999,False,102,scaffold_4
42,5476001,5506000,29999,False,102,scaffold_4
43,5514001,5631000,116999,False,102,scaffold_4
44,5662001,5784000,121999,False,102,scaffold_4
45,5786001,5824000,37999,False,102,scaffold_4
46,6145001,6191000,45999,False,102,scaffold_4
47,6764001,6788000,23999,False,102,scaffold_4
48,6789001,6817000,27999,False,102,scaffold_4
49,6903001,6924000,20999,False,102,scaffold_4
50,6970001,6995000,24999,False,102,scaffold_4
51,7036001,7062000,25999,False,102,scaffold_4
52,7229001,7268000,38999,False,102,scaffold_4
53,8846001,9699000,852999,False,102,scaffold_4
54,9700001,9845951,145950,True,102,scaffold_4
0,195001,204000,8999,False,102,scaffold_5
1,318001,368000,49999,False,102,scaffold_5
2,463001,483000,19999,False,102,scaffold_5
3,495001,523000,27999,False,102,scaffold_5
4,933001,947000,13999,False,102,scaffold_5
5,2565001,2582000,16999,False,102,scaffold_5
6,2621001,2740000,118999,False,102,scaffold_5
7,2813001,2871000,57999,False,102,scaffold_5
8,3166001,3184000,17999,False,102,scaffold_5
9,3217001,3253000,35999,False,102,scaffold_5
10,3322001,3511000,188999,False,102,scaffold_5
11,3962001,4101000,138999,False,102,scaffold_5
12,4121001,4219000,97999,False,102,scaffold_5
13,4246001,4263000,16999,False,102,scaffold_5
14,4446001,4506000,59999,False,102,scaffold_5
15,4602001,4681000,78999,False,102,scaffold_5
16,4691001,4749000,57999,False,102,scaffold_5
17,4760001,4861000,100999,False,102,scaffold_5
18,5261001,5272000,10999,False,102,scaffold_5
19,5295001,5312000,16999,False,102,scaffold_5
20,5314001,5346000,31999,False,102,scaffold_5
21,6498001,6580000,81999,False,102,scaffold_5
22,6589001,6652000,62999,False,102,scaffold_5
23,7097001,7100000,2999,False,102,scaffold_5
24,7454001,7483000,28999,False,102,scaffold_5
25,7581001,7609000,27999,False,102,scaffold_5
26,7622001,7654000,31999,False,102,scaffold_5
27,8672001,8689000,16999,False,102,scaffold_5
28,8715001,9363000,647999,False,102,scaffold_5
29,9364001,9364176,175,True,102,scaffold_5
0,79001,84000,4999,False,102,scaffold_6
1,86001,113000,26999,False,102,scaffold_6
2,240001,254000,13999,False,102,scaffold_6
3,257001,262000,4999,False,102,scaffold_6
4,267001,275000,7999,False,102,scaffold_6
5,1148001,1192000,43999,False,102,scaffold_6
6,1229001,1258000,28999,False,102,scaffold_6
7,1479001,1547000,67999,False,102,scaffold_6
8,1860001,1906000,45999,False,102,scaffold_6
9,2023001,2087000,63999,False,102,scaffold_6
10,2129001,2188000,58999,False,102,scaffold_6
11,2336001,2595000,258999,False,102,scaffold_6
12,2596001,2616000,19999,False,102,scaffold_6
13,2617001,2653000,35999,False,102,scaffold_6
14,2655001,2691000,35999,False,102,scaffold_6
15,2711001,2852000,140999,False,102,scaffold_6
16,2934001,3015000,80999,False,102,scaffold_6
17,3113001,3179000,65999,False,102,scaffold_6
18,3223001,3315000,91999,False,102,scaffold_6
19,3394001,3432000,37999,False,102,scaffold_6
20,3451001,3766000,314999,False,102,scaffold_6
21,3901001,3912000,10999,False,102,scaffold_6
22,4018001,4072000,53999,False,102,scaffold_6
23,4073001,4192000,118999,False,102,scaffold_6
24,6010001,6068000,57999,False,102,scaffold_6
25,7269001,7337000,67999,False,102,scaffold_6
26,7389001,7436000,46999,False,102,scaffold_6
27,7548001,8268281,720280,True,102,scaffold_6
0,13001,34000,20999,False,102,scaffold_7
1,50001,60000,9999,False,102,scaffold_7
2,323001,340000,16999,False,102,scaffold_7
3,342001,409000,66999,False,102,scaffold_7
4,410001,508000,97999,False,102,scaffold_7
5,554001,563000,8999,False,102,scaffold_7
6,571001,577000,5999,False,102,scaffold_7
7,706001,736000,29999,False,102,scaffold_7
8,741001,753000,11999,False,102,scaffold_7
9,764001,822000,57999,False,102,scaffold_7
10,859001,864000,4999,False,102,scaffold_7
11,964001,966000,1999,False,102,scaffold_7
12,968001,980000,11999,False,102,scaffold_7
13,982001,1044000,61999,False,102,scaffold_7
14,1048001,1095000,46999,False,102,scaffold_7
15,1194001,1512000,317999,False,102,scaffold_7
16,1588001,1689000,100999,False,102,scaffold_7
17,3325001,3369000,43999,False,102,scaffold_7
18,3522001,3550000,27999,False,102,scaffold_7
19,3595001,3766000,170999,False,102,scaffold_7
20,4416001,4517000,100999,False,102,scaffold_7
21,4658001,4733000,74999,False,102,scaffold_7
22,4978001,5149000,170999,False,102,scaffold_7
23,5482001,5536000,53999,False,102,scaffold_7
24,6955001,7502216,547215,True,102,scaffold_7
0,1,6000,5999,True,102,scaffold_8
1,67001,85000,17999,False,102,scaffold_8
2,2432001,2470000,37999,False,102,scaffold_8
3,2652001,2683000,30999,False,102,scaffold_8
4,2736001,2760000,23999,False,102,scaffold_8
5,2812001,2844000,31999,False,102,scaffold_8
6,3058001,3125000,66999,False,102,scaffold_8
7,3126001,3525000,398999,False,102,scaffold_8
8,3584001,3612000,27999,False,102,scaffold_8
9,3615001,3934000,318999,False,102,scaffold_8
10,4038001,4104000,65999,False,102,scaffold_8
11,4400001,4431000,30999,False,102,scaffold_8
12,5124001,5135000,10999,False,102,scaffold_8
13,5171001,5241000,69999,False,102,scaffold_8
14,6320001,6334544,14543,True,102,scaffold_8
0,109001,117000,7999,False,102,scaffold_9
1,367001,411000,43999,False,102,scaffold_9
2,413001,434000,20999,False,102,scaffold_9
3,501001,531000,29999,False,102,scaffold_9
4,547001,561000,13999,False,102,scaffold_9
5,671001,696000,24999,False,102,scaffold_9
6,732001,742000,9999,False,102,scaffold_9
7,794001,803000,8999,False,102,scaffold_9
8,815001,842000,26999,False,102,scaffold_9
9,850001,862000,11999,False,102,scaffold_9
10,886001,986000,99999,False,102,scaffold_9
11,987001,995000,7999,False,102,scaffold_9
12,1010001,1031000,20999,False,102,scaffold_9
13,1036001,1085000,48999,False,102,scaffold_9
14,1087001,1150000,62999,False,102,scaffold_9
15,1151001,1165000,13999,False,102,scaffold_9
16,1312001,1377000,64999,False,102,scaffold_9
17,1487001,1499000,11999,False,102,scaffold_9
18,1599001,1615000,15999,False,102,scaffold_9
19,1749001,1791000,41999,False,102,scaffold_9
20,2147001,2168000,20999,False,102,scaffold_9
21,2599001,2616000,16999,False,102,scaffold_9
22,2737001,2803000,65999,False,102,scaffold_9
23,2870001,3381000,510999,False,102,scaffold_9
24,3383001,5099000,1715999,False,102,scaffold_9
25,5101001,5107000,5999,False,102,scaffold_9
26,5112001,5114000,1999,False,102,scaffold_9
27,5116001,5237000,120999,False,102,scaffold_9
28,5239001,5298000,58999,False,102,scaffold_9
29,5300001,5490000,189999,False,102,scaffold_9
30,5493001,6331288,838287,True,102,scaffold_9
0,1,237000,236999,True,102,scaffold_10
1,269001,406000,136999,False,102,scaffold_10
2,419001,482000,62999,False,102,scaffold_10
3,483001,576000,92999,False,102,scaffold_10
4,603001,756000,152999,False,102,scaffold_10
5,888001,921000,32999,False,102,scaffold_10
6,923001,963000,39999,False,102,scaffold_10
7,1087001,1112000,24999,False,102,scaffold_10
8,2140001,2170000,29999,False,102,scaffold_10
9,2346001,2397000,50999,False,102,scaffold_10
10,2601001,2616000,14999,False,102,scaffold_10
11,2674001,2694000,19999,False,102,scaffold_10
12,4054001,4091000,36999,False,102,scaffold_10
13,4154001,4174000,19999,False,102,scaffold_10
14,4443001,4462000,18999,False,102,scaffold_10
15,4467001,4477000,9999,False,102,scaffold_10
16,4515001,4523000,7999,False,102,scaffold_10
17,4526001,4548000,21999,False,102,scaffold_10
18,4574001,4596000,21999,False,102,scaffold_10
19,4680001,4688000,7999,False,102,scaffold_10
20,4734001,4766000,31999,False,102,scaffold_10
21,4769001,4776000,6999,False,102,scaffold_10
22,4798001,4824000,25999,False,102,scaffold_10
23,4828001,4843000,14999,False,102,scaffold_10
24,4848001,4861000,12999,False,102,scaffold_10
25,4865001,4866973,1972,True,102,scaffold_10
0,10001,34000,23999,False,102,scaffold_11
1,40001,93000,52999,False,102,scaffold_11
2,149001,167000,17999,False,102,scaffold_11
3,169001,191000,21999,False,102,scaffold_11
4,214001,236000,21999,False,102,scaffold_11
5,240001,247000,6999,False,102,scaffold_11
6,419001,431000,11999,False,102,scaffold_11
7,648001,656000,7999,False,102,scaffold_11
8,1025001,1034000,8999,False,102,scaffold_11
9,1423001,1427000,3999,False,102,scaffold_11
10,2701001,2877000,175999,False,102,scaffold_11
11,2982001,3018000,35999,False,102,scaffold_11
12,3086001,3142000,55999,False,102,scaffold_11
13,3187001,3292000,104999,False,102,scaffold_11
14,3331001,3383000,51999,False,102,scaffold_11
15,3521001,3613000,91999,False,102,scaffold_11
16,3702001,3929000,226999,False,102,scaffold_11
17,4008001,4159000,150999,False,102,scaffold_11
18,4301001,4710000,408999,False,102,scaffold_11
19,4713001,4766820,53819,True,102,scaffold_11
0,1,540000,539999,True,102,scaffold_12
1,581001,1468000,886999,False,102,scaffold_12
2,1720001,1733000,12999,False,102,scaffold_12
3,2043001,2097000,53999,False,102,scaffold_12
4,2571001,2617000,45999,False,102,scaffold_12
5,2747001,2747968,967,True,102,scaffold_12
0,1,393000,392999,True,103,scaffold_1
1,482001,498000,15999,False,103,scaffold_1
2,570001,661000,90999,False,103,scaffold_1
3,686001,754000,67999,False,103,scaffold_1
4,794001,900000,105999,False,103,scaffold_1
5,1178001,1195000,16999,False,103,scaffold_1
6,1244001,1292000,47999,False,103,scaffold_1
7,1615001,1660000,44999,False,103,scaffold_1
8,1725001,1964000,238999,False,103,scaffold_1
9,1965001,2021000,55999,False,103,scaffold_1
10,2344001,2415000,70999,False,103,scaffold_1
11,2449001,2520000,70999,False,103,scaffold_1
12,2555001,2582000,26999,False,103,scaffold_1
13,2725001,2746000,20999,False,103,scaffold_1
14,2996001,3023000,26999,False,103,scaffold_1
15,3172001,3212000,39999,False,103,scaffold_1
16,3304001,3366000,61999,False,103,scaffold_1
17,3443001,3620000,176999,False,103,scaffold_1
18,3704001,3941000,236999,False,103,scaffold_1
19,3951001,4153000,201999,False,103,scaffold_1
20,4307001,4435000,127999,False,103,scaffold_1
21,4466001,4572000,105999,False,103,scaffold_1
22,4640001,4669000,28999,False,103,scaffold_1
23,4683001,4790000,106999,False,103,scaffold_1
24,4796001,5067000,270999,False,103,scaffold_1
25,5087001,5121000,33999,False,103,scaffold_1
26,5136001,5202000,65999,False,103,scaffold_1
27,5436001,5461000,24999,False,103,scaffold_1
28,5481001,5521000,39999,False,103,scaffold_1
29,5535001,5593000,57999,False,103,scaffold_1
30,5853001,5946000,92999,False,103,scaffold_1
31,6108001,6143000,34999,False,103,scaffold_1
32,6144001,6178000,33999,False,103,scaffold_1
33,6201001,6575000,373999,False,103,scaffold_1
34,6722001,6761000,38999,False,103,scaffold_1
35,6837001,6862000,24999,False,103,scaffold_1
36,6864001,6879000,14999,False,103,scaffold_1
37,6931001,6953000,21999,False,103,scaffold_1
38,7038001,7247000,208999,False,103,scaffold_1
39,7248001,7589000,340999,False,103,scaffold_1
40,7590001,8656000,1065999,False,103,scaffold_1
41,8658001,9584000,925999,False,103,scaffold_1
42,9586001,10364000,777999,False,103,scaffold_1
43,10438001,10639000,200999,False,103,scaffold_1
44,10808001,10811000,2999,False,103,scaffold_1
45,10832001,10857000,24999,False,103,scaffold_1
46,10897001,10991000,93999,False,103,scaffold_1
47,11013001,11077000,63999,False,103,scaffold_1
48,11123001,11223000,99999,False,103,scaffold_1
49,11273001,11510000,236999,False,103,scaffold_1
50,11550001,11951000,400999,False,103,scaffold_1
51,12184001,12243000,58999,False,103,scaffold_1
52,12330001,12373000,42999,False,103,scaffold_1
53,12382001,12396000,13999,False,103,scaffold_1
54,12400001,12450000,49999,False,103,scaffold_1
55,12492001,12950000,457999,False,103,scaffold_1
56,12964001,13042000,77999,False,103,scaffold_1
57,13101001,13216000,114999,False,103,scaffold_1
58,13343001,13456000,112999,False,103,scaffold_1
59,13478001,13496000,17999,False,103,scaffold_1
60,13517001,13537000,19999,False,103,scaffold_1
61,13552001,13581000,28999,False,103,scaffold_1
62,13668001,13710000,41999,False,103,scaffold_1
63,13796001,13845000,48999,False,103,scaffold_1
64,13847001,13876000,28999,False,103,scaffold_1
65,13917001,13927000,9999,False,103,scaffold_1
66,13928001,13955000,26999,False,103,scaffold_1
67,13959001,13977000,17999,False,103,scaffold_1
68,14285001,14310000,24999,False,103,scaffold_1
69,14530001,14575000,44999,False,103,scaffold_1
70,14647001,14664000,16999,False,103,scaffold_1
71,14671001,14674000,2999,False,103,scaffold_1
0,20001,48000,27999,False,103,scaffold_2
1,93001,159000,65999,False,103,scaffold_2
2,165001,177000,11999,False,103,scaffold_2
3,301001,318000,16999,False,103,scaffold_2
4,332001,374000,41999,False,103,scaffold_2
5,387001,403000,15999,False,103,scaffold_2
6,732001,739000,6999,False,103,scaffold_2
7,1232001,1258000,25999,False,103,scaffold_2
8,1347001,1415000,67999,False,103,scaffold_2
9,1470001,1554000,83999,False,103,scaffold_2
10,1626001,1654000,27999,False,103,scaffold_2
11,1805001,1861000,55999,False,103,scaffold_2
12,1877001,1897000,19999,False,103,scaffold_2
13,1933001,1959000,25999,False,103,scaffold_2
14,2085001,2132000,46999,False,103,scaffold_2
15,2336001,2424000,87999,False,103,scaffold_2
16,2437001,2639000,201999,False,103,scaffold_2
17,2659001,2689000,29999,False,103,scaffold_2
18,2694001,2749000,54999,False,103,scaffold_2
19,2766001,2788000,21999,False,103,scaffold_2
20,2803001,2857000,53999,False,103,scaffold_2
21,2868001,2912000,43999,False,103,scaffold_2
22,2972001,3012000,39999,False,103,scaffold_2
23,3022001,3057000,34999,False,103,scaffold_2
24,3262001,3284000,21999,False,103,scaffold_2
25,3297001,3346000,48999,False,103,scaffold_2
26,3359001,3390000,30999,False,103,scaffold_2
27,3448001,3602000,153999,False,103,scaffold_2
28,3614001,3713000,98999,False,103,scaffold_2
29,3754001,3948000,193999,False,103,scaffold_2
30,4097001,4148000,50999,False,103,scaffold_2
31,4242001,4409000,166999,False,103,scaffold_2
32,4426001,4462000,35999,False,103,scaffold_2
33,4473001,4790000,316999,False,103,scaffold_2
34,4793001,4814000,20999,False,103,scaffold_2
35,4918001,4971000,52999,False,103,scaffold_2
36,5018001,5104000,85999,False,103,scaffold_2
37,5198001,5268000,69999,False,103,scaffold_2
38,5285001,5315000,29999,False,103,scaffold_2
39,5335001,5564000,228999,False,103,scaffold_2
40,5618001,5759000,140999,False,103,scaffold_2
41,5827001,5892000,64999,False,103,scaffold_2
42,5907001,6058000,150999,False,103,scaffold_2
43,6088001,6185000,96999,False,103,scaffold_2
44,6232001,6350000,117999,False,103,scaffold_2
45,6373001,6471000,97999,False,103,scaffold_2
46,6576001,6628000,51999,False,103,scaffold_2
47,6810001,6863000,52999,False,103,scaffold_2
48,6945001,6979000,33999,False,103,scaffold_2
49,7005001,7039000,33999,False,103,scaffold_2
50,7063001,7097000,33999,False,103,scaffold_2
51,7436001,7473000,36999,False,103,scaffold_2
52,7491001,7518000,26999,False,103,scaffold_2
53,7548001,7561000,12999,False,103,scaffold_2
54,7563001,7923000,359999,False,103,scaffold_2
55,7933001,8233000,299999,False,103,scaffold_2
56,8260001,8328000,67999,False,103,scaffold_2
57,8334001,8344000,9999,False,103,scaffold_2
58,8346001,8493000,146999,False,103,scaffold_2
59,8495001,8563000,67999,False,103,scaffold_2
60,8999001,9052000,52999,False,103,scaffold_2
61,9139001,9392000,252999,False,103,scaffold_2
62,9601001,9636000,34999,False,103,scaffold_2
63,9868001,9900000,31999,False,103,scaffold_2
64,10675001,10708000,32999,False,103,scaffold_2
65,10710001,10731000,20999,False,103,scaffold_2
66,11315001,11387000,71999,False,103,scaffold_2
67,11394001,11424000,29999,False,103,scaffold_2
68,11520001,11786000,265999,False,103,scaffold_2
69,11797001,11802476,5475,True,103,scaffold_2
0,1,2000,1999,True,103,scaffold_3
1,218001,232000,13999,False,103,scaffold_3
2,618001,646000,27999,False,103,scaffold_3
3,798001,900000,101999,False,103,scaffold_3
4,960001,965000,4999,False,103,scaffold_3
5,1584001,1617000,32999,False,103,scaffold_3
6,1635001,1672000,36999,False,103,scaffold_3
7,1851001,1888000,36999,False,103,scaffold_3
8,1899001,1929000,29999,False,103,scaffold_3
9,1957001,1979000,21999,False,103,scaffold_3
10,1993001,2179000,185999,False,103,scaffold_3
11,2209001,2246000,36999,False,103,scaffold_3
12,2287001,2342000,54999,False,103,scaffold_3
13,2377001,2428000,50999,False,103,scaffold_3
14,2433001,2533000,99999,False,103,scaffold_3
15,2646001,2761000,114999,False,103,scaffold_3
16,2825001,2837000,11999,False,103,scaffold_3
17,2855001,2875000,19999,False,103,scaffold_3
18,2891001,2933000,41999,False,103,scaffold_3
19,3043001,3062000,18999,False,103,scaffold_3
20,3066001,3281000,214999,False,103,scaffold_3
21,3498001,3517000,18999,False,103,scaffold_3
22,3559001,3737000,177999,False,103,scaffold_3
23,3768001,3821000,52999,False,103,scaffold_3
24,3822001,3891000,68999,False,103,scaffold_3
25,3909001,3921000,11999,False,103,scaffold_3
26,3922001,3946000,23999,False,103,scaffold_3
27,3994001,4039000,44999,False,103,scaffold_3
28,4040001,4403000,362999,False,103,scaffold_3
29,4406001,4519000,112999,False,103,scaffold_3
30,4546001,4558000,11999,False,103,scaffold_3
31,4660001,4673000,12999,False,103,scaffold_3
32,4854001,4926000,71999,False,103,scaffold_3
33,4997001,5037000,39999,False,103,scaffold_3
34,5082001,5127000,44999,False,103,scaffold_3
35,5145001,5279000,133999,False,103,scaffold_3
36,5349001,5509000,159999,False,103,scaffold_3
37,5511001,5675000,163999,False,103,scaffold_3
38,5701001,5766000,64999,False,103,scaffold_3
39,5768001,6123000,354999,False,103,scaffold_3
40,6230001,6242000,11999,False,103,scaffold_3
41,6710001,6783000,72999,False,103,scaffold_3
42,6887001,7097000,209999,False,103,scaffold_3
43,7111001,7157000,45999,False,103,scaffold_3
44,7225001,7317000,91999,False,103,scaffold_3
45,7333001,7445000,111999,False,103,scaffold_3
46,7483001,7556000,72999,False,103,scaffold_3
47,7589001,7867000,277999,False,103,scaffold_3
48,7915001,7954000,38999,False,103,scaffold_3
49,8028001,8108000,79999,False,103,scaffold_3
50,8121001,8159000,37999,False,103,scaffold_3
51,8183001,8255000,71999,False,103,scaffold_3
52,8378001,8449000,70999,False,103,scaffold_3
53,8462001,8555000,92999,False,103,scaffold_3
54,8574001,8594000,19999,False,103,scaffold_3
55,8956001,9080000,123999,False,103,scaffold_3
56,9106001,9254000,147999,False,103,scaffold_3
57,9459001,9579000,119999,False,103,scaffold_3
58,9645001,9687000,41999,False,103,scaffold_3
59,9968001,9995000,26999,False,103,scaffold_3
60,10042001,10087000,44999,False,103,scaffold_3
61,10448001,10458000,9999,False,103,scaffold_3
62,10461001,10486000,24999,False,103,scaffold_3
63,10574001,11165000,590999,False,103,scaffold_3
0,11001,13000,1999,False,103,scaffold_4
1,17001,32000,14999,False,103,scaffold_4
2,49001,88000,38999,False,103,scaffold_4
3,132001,146000,13999,False,103,scaffold_4
4,147001,151000,3999,False,103,scaffold_4
5,155001,215000,59999,False,103,scaffold_4
6,217001,226000,8999,False,103,scaffold_4
7,227001,241000,13999,False,103,scaffold_4
8,242001,266000,23999,False,103,scaffold_4
9,288001,309000,20999,False,103,scaffold_4
10,318001,344000,25999,False,103,scaffold_4
11,355001,374000,18999,False,103,scaffold_4
12,375001,410000,34999,False,103,scaffold_4
13,412001,425000,12999,False,103,scaffold_4
14,426001,498000,71999,False,103,scaffold_4
15,543001,592000,48999,False,103,scaffold_4
16,608001,660000,51999,False,103,scaffold_4
17,672001,691000,18999,False,103,scaffold_4
18,701001,727000,25999,False,103,scaffold_4
19,1102001,1105000,2999,False,103,scaffold_4
20,1121001,1136000,14999,False,103,scaffold_4
21,1137001,1226000,88999,False,103,scaffold_4
22,1229001,1234000,4999,False,103,scaffold_4
23,1235001,1253000,17999,False,103,scaffold_4
24,1254001,1279000,24999,False,103,scaffold_4
25,1284001,1605000,320999,False,103,scaffold_4
26,1609001,1611000,1999,False,103,scaffold_4
27,1613001,1957000,343999,False,103,scaffold_4
28,1958001,2069000,110999,False,103,scaffold_4
29,2071001,2205000,133999,False,103,scaffold_4
30,2207001,2461000,253999,False,103,scaffold_4
31,2476001,2635000,158999,False,103,scaffold_4
32,2647001,2675000,27999,False,103,scaffold_4
33,2676001,2813000,136999,False,103,scaffold_4
34,2891001,3146000,254999,False,103,scaffold_4
35,3189001,3820000,630999,False,103,scaffold_4
36,4007001,4045000,37999,False,103,scaffold_4
37,4055001,4105000,49999,False,103,scaffold_4
38,4250001,4308000,57999,False,103,scaffold_4
39,4706001,4719000,12999,False,103,scaffold_4
40,4893001,5098000,204999,False,103,scaffold_4
41,5169001,5224000,54999,False,103,scaffold_4
42,5291001,5506000,214999,False,103,scaffold_4
43,5514001,5784000,269999,False,103,scaffold_4
44,5785001,5982000,196999,False,103,scaffold_4
45,6048001,6114000,65999,False,103,scaffold_4
46,6145001,6377000,231999,False,103,scaffold_4
47,6404001,6445000,40999,False,103,scaffold_4
48,6460001,6538000,77999,False,103,scaffold_4
49,6620001,6684000,63999,False,103,scaffold_4
50,6758001,6817000,58999,False,103,scaffold_4
51,6839001,6924000,84999,False,103,scaffold_4
52,6926001,6931000,4999,False,103,scaffold_4
53,6950001,6995000,44999,False,103,scaffold_4
54,7036001,7174000,137999,False,103,scaffold_4
55,7208001,7429000,220999,False,103,scaffold_4
56,7497001,7571000,73999,False,103,scaffold_4
57,7628001,7667000,38999,False,103,scaffold_4
58,7837001,7925000,87999,False,103,scaffold_4
59,7974001,7999000,24999,False,103,scaffold_4
60,8051001,8139000,87999,False,103,scaffold_4
61,8520001,8528000,7999,False,103,scaffold_4
62,8844001,9699000,854999,False,103,scaffold_4
63,9700001,9845951,145950,True,103,scaffold_4
0,1,4000,3999,True,103,scaffold_5
1,189001,207000,17999,False,103,scaffold_5
2,319001,326000,6999,False,103,scaffold_5
3,327001,419000,91999,False,103,scaffold_5
4,462001,523000,60999,False,103,scaffold_5
5,669001,699000,29999,False,103,scaffold_5
6,803001,832000,28999,False,103,scaffold_5
7,932001,947000,14999,False,103,scaffold_5
8,1167001,1182000,14999,False,103,scaffold_5
9,1360001,1387000,26999,False,103,scaffold_5
10,1643001,1661000,17999,False,103,scaffold_5
11,1947001,1968000,20999,False,103,scaffold_5
12,2095001,2104000,8999,False,103,scaffold_5
13,2257001,2303000,45999,False,103,scaffold_5
14,2474001,2515000,40999,False,103,scaffold_5
15,2516001,2897000,380999,False,103,scaffold_5
16,3133001,3519000,385999,False,103,scaffold_5
17,3532001,3550000,17999,False,103,scaffold_5
18,3616001,3661000,44999,False,103,scaffold_5
19,3828001,3946000,117999,False,103,scaffold_5
20,3962001,4101000,138999,False,103,scaffold_5
21,4118001,4222000,103999,False,103,scaffold_5
22,4226001,4389000,162999,False,103,scaffold_5
23,4444001,4918000,473999,False,103,scaffold_5
24,4968001,4992000,23999,False,103,scaffold_5
25,5051001,5106000,54999,False,103,scaffold_5
26,5249001,5346000,96999,False,103,scaffold_5
27,5516001,5528000,11999,False,103,scaffold_5
28,6391001,6438000,46999,False,103,scaffold_5
29,6451001,6726000,274999,False,103,scaffold_5
30,6811001,6853000,41999,False,103,scaffold_5
31,6882001,6921000,38999,False,103,scaffold_5
32,7046001,7085000,38999,False,103,scaffold_5
33,7170001,7330000,159999,False,103,scaffold_5
34,7334001,7364000,29999,False,103,scaffold_5
35,7406001,7442000,35999,False,103,scaffold_5
36,7454001,7514000,59999,False,103,scaffold_5
37,7542001,7619000,76999,False,103,scaffold_5
38,7621001,7758000,136999,False,103,scaffold_5
39,7760001,7775000,14999,False,103,scaffold_5
40,7781001,7806000,24999,False,103,scaffold_5
41,8413001,8461000,47999,False,103,scaffold_5
42,8552001,8616000,63999,False,103,scaffold_5
43,8634001,8689000,54999,False,103,scaffold_5
44,8703001,9364176,661175,True,103,scaffold_5
0,65001,75000,9999,False,103,scaffold_6
1,86001,115000,28999,False,103,scaffold_6
2,149001,209000,59999,False,103,scaffold_6
3,239001,318000,78999,False,103,scaffold_6
4,378001,381000,2999,False,103,scaffold_6
5,467001,485000,17999,False,103,scaffold_6
6,642001,663000,20999,False,103,scaffold_6
7,700001,757000,56999,False,103,scaffold_6
8,786001,797000,10999,False,103,scaffold_6
9,833001,845000,11999,False,103,scaffold_6
10,923001,956000,32999,False,103,scaffold_6
11,959001,1039000,79999,False,103,scaffold_6
12,1120001,1226000,105999,False,103,scaffold_6
13,1228001,1264000,35999,False,103,scaffold_6
14,1284001,1311000,26999,False,103,scaffold_6
15,1430001,1548000,117999,False,103,scaffold_6
16,1557001,1605000,47999,False,103,scaffold_6
17,1657001,1736000,78999,False,103,scaffold_6
18,1843001,1906000,62999,False,103,scaffold_6
19,1977001,2019000,41999,False,103,scaffold_6
20,2023001,2213000,189999,False,103,scaffold_6
21,2237001,2284000,46999,False,103,scaffold_6
22,2305001,2595000,289999,False,103,scaffold_6
23,2596001,2654000,57999,False,103,scaffold_6
24,2655001,2872000,216999,False,103,scaffold_6
25,2932001,3350000,417999,False,103,scaffold_6
26,3351001,3793000,441999,False,103,scaffold_6
27,3810001,3849000,38999,False,103,scaffold_6
28,3900001,3926000,25999,False,103,scaffold_6
29,3965001,4206000,240999,False,103,scaffold_6
30,4617001,4672000,54999,False,103,scaffold_6
31,4704001,4719000,14999,False,103,scaffold_6
32,4736001,4755000,18999,False,103,scaffold_6
33,4811001,4918000,106999,False,103,scaffold_6
34,4925001,4996000,70999,False,103,scaffold_6
35,5291001,5312000,20999,False,103,scaffold_6
36,5618001,5771000,152999,False,103,scaffold_6
37,5774001,5789000,14999,False,103,scaffold_6
38,5862001,5972000,109999,False,103,scaffold_6
39,6004001,6092000,87999,False,103,scaffold_6
40,6123001,6191000,67999,False,103,scaffold_6
41,6237001,6276000,38999,False,103,scaffold_6
42,6473001,6503000,29999,False,103,scaffold_6
43,6759001,6804000,44999,False,103,scaffold_6
44,6832001,6862000,29999,False,103,scaffold_6
45,6911001,6942000,30999,False,103,scaffold_6
46,6978001,6996000,17999,False,103,scaffold_6
47,7184001,7248000,63999,False,103,scaffold_6
48,7256001,7341000,84999,False,103,scaffold_6
49,7388001,7490000,101999,False,103,scaffold_6
50,7532001,8268281,736280,True,103,scaffold_6
0,1,8000,7999,True,103,scaffold_7
1,10001,34000,23999,False,103,scaffold_7
2,50001,60000,9999,False,103,scaffold_7
3,192001,204000,11999,False,103,scaffold_7
4,321001,340000,18999,False,103,scaffold_7
5,342001,509000,166999,False,103,scaffold_7
6,571001,577000,5999,False,103,scaffold_7
7,614001,642000,27999,False,103,scaffold_7
8,646001,676000,29999,False,103,scaffold_7
9,706001,736000,29999,False,103,scaffold_7
10,764001,829000,64999,False,103,scaffold_7
11,859001,864000,4999,False,103,scaffold_7
12,868001,872000,3999,False,103,scaffold_7
13,875001,938000,62999,False,103,scaffold_7
14,960001,966000,5999,False,103,scaffold_7
15,968001,980000,11999,False,103,scaffold_7
16,982001,1044000,61999,False,103,scaffold_7
17,1048001,1099000,50999,False,103,scaffold_7
18,1191001,1513000,321999,False,103,scaffold_7
19,1588001,1720000,131999,False,103,scaffold_7
20,1740001,1782000,41999,False,103,scaffold_7
21,1848001,1930000,81999,False,103,scaffold_7
22,1965001,2015000,49999,False,103,scaffold_7
23,2367001,2410000,42999,False,103,scaffold_7
24,2538001,2600000,61999,False,103,scaffold_7
25,2607001,2759000,151999,False,103,scaffold_7
26,3007001,3024000,16999,False,103,scaffold_7
27,3238001,3271000,32999,False,103,scaffold_7
28,3297001,3370000,72999,False,103,scaffold_7
29,3521001,3886000,364999,False,103,scaffold_7
30,4021001,4066000,44999,False,103,scaffold_7
31,4324001,4361000,36999,False,103,scaffold_7
32,4414001,4515000,100999,False,103,scaffold_7
33,4529001,4580000,50999,False,103,scaffold_7
34,4630001,4924000,293999,False,103,scaffold_7
35,4931001,4962000,30999,False,103,scaffold_7
36,4978001,5169000,190999,False,103,scaffold_7
37,5472001,5645000,172999,False,103,scaffold_7
38,5916001,5932000,15999,False,103,scaffold_7
39,5933001,5944000,10999,False,103,scaffold_7
40,6050001,6095000,44999,False,103,scaffold_7
41,6096001,6249000,152999,False,103,scaffold_7
42,6569001,6798000,228999,False,103,scaffold_7
43,6953001,7502216,549215,True,103,scaffold_7
0,1,6000,5999,True,103,scaffold_8
1,67001,87000,19999,False,103,scaffold_8
2,1017001,1042000,24999,False,103,scaffold_8
3,1858001,1932000,73999,False,103,scaffold_8
4,2071001,2154000,82999,False,103,scaffold_8
5,2335001,2601000,265999,False,103,scaffold_8
6,2649001,2844000,194999,False,103,scaffold_8
7,2845001,2923000,77999,False,103,scaffold_8
8,2951001,3125000,173999,False,103,scaffold_8
9,3126001,3612000,485999,False,103,scaffold_8
10,3615001,3939000,323999,False,103,scaffold_8
11,4009001,4221000,211999,False,103,scaffold_8
12,4244001,4254000,9999,False,103,scaffold_8
13,4329001,4432000,102999,False,103,scaffold_8
14,4470001,4492000,21999,False,103,scaffold_8
15,4565001,4647000,81999,False,103,scaffold_8
16,4717001,4777000,59999,False,103,scaffold_8
17,4797001,4928000,130999,False,103,scaffold_8
18,5000001,5018000,17999,False,103,scaffold_8
19,5083001,5245000,161999,False,103,scaffold_8
20,5452001,5475000,22999,False,103,scaffold_8
21,5524001,5597000,72999,False,103,scaffold_8
22,5652001,5723000,70999,False,103,scaffold_8
23,5727001,5775000,47999,False,103,scaffold_8
24,5776001,5804000,27999,False,103,scaffold_8
25,5837001,5944000,106999,False,103,scaffold_8
26,5964001,6159000,194999,False,103,scaffold_8
27,6218001,6304000,85999,False,103,scaffold_8
28,6320001,6334544,14543,True,103,scaffold_8
0,1,22000,21999,True,103,scaffold_9
1,109001,117000,7999,False,103,scaffold_9
2,366001,411000,44999,False,103,scaffold_9
3,413001,434000,20999,False,103,scaffold_9
4,484001,531000,46999,False,103,scaffold_9
5,653001,659000,5999,False,103,scaffold_9
6,660001,665000,4999,False,103,scaffold_9
7,670001,697000,26999,False,103,scaffold_9
8,731001,741000,9999,False,103,scaffold_9
9,816001,843000,26999,False,103,scaffold_9
10,850001,862000,11999,False,103,scaffold_9
11,873001,986000,112999,False,103,scaffold_9
12,987001,995000,7999,False,103,scaffold_9
13,1001001,1007000,5999,False,103,scaffold_9
14,1008001,1085000,76999,False,103,scaffold_9
15,1087001,1150000,62999,False,103,scaffold_9
16,1151001,1179000,27999,False,103,scaffold_9
17,1202001,1231000,28999,False,103,scaffold_9
18,1312001,1383000,70999,False,103,scaffold_9
19,1413001,1423000,9999,False,103,scaffold_9
20,1428001,1441000,12999,False,103,scaffold_9
21,1457001,1465000,7999,False,103,scaffold_9
22,1486001,1586000,99999,False,103,scaffold_9
23,1587001,1624000,36999,False,103,scaffold_9
24,1637001,1692000,54999,False,103,scaffold_9
25,1748001,1811000,62999,False,103,scaffold_9
26,1815001,1857000,41999,False,103,scaffold_9
27,1885001,1954000,68999,False,103,scaffold_9
28,1987001,2135000,147999,False,103,scaffold_9
29,2137001,2171000,33999,False,103,scaffold_9
30,2173001,2354000,180999,False,103,scaffold_9
31,2392001,2579000,186999,False,103,scaffold_9
32,2594001,2673000,78999,False,103,scaffold_9
33,2674001,2696000,21999,False,103,scaffold_9
34,2735001,3381000,645999,False,103,scaffold_9
35,3383001,5107000,1723999,False,103,scaffold_9
36,5112001,5238000,125999,False,103,scaffold_9
37,5239001,5298000,58999,False,103,scaffold_9
38,5300001,6331288,1031287,True,103,scaffold_9
0,1,136000,135999,True,103,scaffold_10
1,137001,414000,276999,False,103,scaffold_10
2,415001,877000,461999,False,103,scaffold_10
3,888001,1069000,180999,False,103,scaffold_10
4,1073001,1154000,80999,False,103,scaffold_10
5,1312001,1337000,24999,False,103,scaffold_10
6,1370001,1473000,102999,False,103,scaffold_10
7,1512001,1568000,55999,False,103,scaffold_10
8,1591001,1675000,83999,False,103,scaffold_10
9,1695001,1760000,64999,False,103,scaffold_10
10,1805001,1835000,29999,False,103,scaffold_10
11,1862001,1923000,60999,False,103,scaffold_10
12,2035001,2111000,75999,False,103,scaffold_10
13,2131001,2471000,339999,False,103,scaffold_10
14,2512001,2520000,7999,False,103,scaffold_10
15,2521001,2653000,131999,False,103,scaffold_10
16,2673001,2707000,33999,False,103,scaffold_10
17,2714001,2816000,101999,False,103,scaffold_10
18,2817001,2861000,43999,False,103,scaffold_10
19,2918001,2954000,35999,False,103,scaffold_10
20,3153001,3177000,23999,False,103,scaffold_10
21,3394001,3423000,28999,False,103,scaffold_10
22,3467001,3476000,8999,False,103,scaffold_10
23,3570001,3583000,12999,False,103,scaffold_10
24,3780001,3795000,14999,False,103,scaffold_10
25,3801001,3814000,12999,False,103,scaffold_10
26,4051001,4091000,39999,False,103,scaffold_10
27,4154001,4177000,22999,False,103,scaffold_10
28,4316001,4323000,6999,False,103,scaffold_10
29,4335001,4359000,23999,False,103,scaffold_10
30,4443001,4462000,18999,False,103,scaffold_10
31,4467001,4502000,34999,False,103,scaffold_10
32,4503001,4513000,9999,False,103,scaffold_10
33,4515001,4523000,7999,False,103,scaffold_10
34,4526001,4548000,21999,False,103,scaffold_10
35,4554001,4562000,7999,False,103,scaffold_10
36,4565001,4596000,30999,False,103,scaffold_10
37,4679001,4688000,8999,False,103,scaffold_10
38,4734001,4751000,16999,False,103,scaffold_10
39,4752001,4776000,23999,False,103,scaffold_10
40,4798001,4824000,25999,False,103,scaffold_10
41,4827001,4843000,15999,False,103,scaffold_10
42,4848001,4861000,12999,False,103,scaffold_10
43,4865001,4866973,1972,True,103,scaffold_10
0,10001,93000,82999,False,103,scaffold_11
1,132001,167000,34999,False,103,scaffold_11
2,169001,191000,21999,False,103,scaffold_11
3,213001,235000,21999,False,103,scaffold_11
4,240001,248000,7999,False,103,scaffold_11
5,288001,312000,23999,False,103,scaffold_11
6,419001,431000,11999,False,103,scaffold_11
7,649001,656000,6999,False,103,scaffold_11
8,1025001,1034000,8999,False,103,scaffold_11
9,1219001,1242000,22999,False,103,scaffold_11
10,1304001,1314000,9999,False,103,scaffold_11
11,1315001,1373000,57999,False,103,scaffold_11
12,1374001,1398000,23999,False,103,scaffold_11
13,1432001,1469000,36999,False,103,scaffold_11
14,1474001,1478000,3999,False,103,scaffold_11
15,1525001,1547000,21999,False,103,scaffold_11
16,1571001,1600000,28999,False,103,scaffold_11
17,1853001,2056000,202999,False,103,scaffold_11
18,2087001,2172000,84999,False,103,scaffold_11
19,2176001,2233000,56999,False,103,scaffold_11
20,2659001,2909000,249999,False,103,scaffold_11
21,2951001,3026000,74999,False,103,scaffold_11
22,3083001,3383000,299999,False,103,scaffold_11
23,3422001,3483000,60999,False,103,scaffold_11
24,3521001,4160000,638999,False,103,scaffold_11
25,4179001,4710000,530999,False,103,scaffold_11
26,4713001,4766820,53819,True,103,scaffold_11
0,1,1498000,1497999,True,103,scaffold_12
1,1643001,1667000,23999,False,103,scaffold_12
2,1718001,1733000,14999,False,103,scaffold_12
3,1784001,1812000,27999,False,103,scaffold_12
4,1882001,2005000,122999,False,103,scaffold_12
5,2024001,2041000,16999,False,103,scaffold_12
6,2043001,2103000,59999,False,103,scaffold_12
7,2136001,2180000,43999,False,103,scaffold_12
8,2336001,2378000,41999,False,103,scaffold_12
9,2571001,2609000,37999,False,103,scaffold_12
10,2685001,2699000,13999,False,103,scaffold_12
11,2747001,2747968,967,True,103,scaffold_12
0,1,344000,343999,True,104,scaffold_1
1,482001,498000,15999,False,104,scaffold_1
2,572001,604000,31999,False,104,scaffold_1
3,617001,634000,16999,False,104,scaffold_1
4,1281001,1292000,10999,False,104,scaffold_1
5,1830001,1900000,69999,False,104,scaffold_1
6,1965001,1984000,18999,False,104,scaffold_1
7,1987001,2016000,28999,False,104,scaffold_1
8,2449001,2464000,14999,False,104,scaffold_1
9,2477001,2517000,39999,False,104,scaffold_1
10,2556001,2580000,23999,False,104,scaffold_1
11,2727001,2746000,18999,False,104,scaffold_1
12,3715001,3734000,18999,False,104,scaffold_1
13,3802001,3834000,31999,False,104,scaffold_1
14,3927001,3937000,9999,False,104,scaffold_1
15,3961001,4030000,68999,False,104,scaffold_1
16,4323001,4351000,27999,False,104,scaffold_1
17,4708001,4736000,27999,False,104,scaffold_1
18,4920001,5010000,89999,False,104,scaffold_1
19,5481001,5521000,39999,False,104,scaffold_1
20,5898001,5915000,16999,False,104,scaffold_1
21,6108001,6153000,44999,False,104,scaffold_1
22,6228001,6253000,24999,False,104,scaffold_1
23,6274001,6318000,43999,False,104,scaffold_1
24,6385001,6506000,120999,False,104,scaffold_1
25,6939001,6954000,14999,False,104,scaffold_1
26,7037001,7069000,31999,False,104,scaffold_1
27,7070001,7247000,176999,False,104,scaffold_1
28,7248001,7580000,331999,False,104,scaffold_1
29,7581001,7589000,7999,False,104,scaffold_1
30,7590001,7677000,86999,False,104,scaffold_1
31,7678001,7682000,3999,False,104,scaffold_1
32,7684001,7903000,218999,False,104,scaffold_1
33,7904001,8477000,572999,False,104,scaffold_1
34,8478001,8488000,9999,False,104,scaffold_1
35,8489001,8656000,166999,False,104,scaffold_1
36,8658001,9564000,905999,False,104,scaffold_1
37,9565001,9581000,15999,False,104,scaffold_1
38,9586001,9657000,70999,False,104,scaffold_1
39,9658001,10351000,692999,False,104,scaffold_1
40,10462001,10474000,11999,False,104,scaffold_1
41,10516001,10608000,91999,False,104,scaffold_1
42,10808001,10811000,2999,False,104,scaffold_1
43,10846001,10851000,4999,False,104,scaffold_1
44,10920001,10966000,45999,False,104,scaffold_1
45,11279001,11330000,50999,False,104,scaffold_1
46,11338001,11465000,126999,False,104,scaffold_1
47,11466001,11500000,33999,False,104,scaffold_1
48,11560001,11578000,17999,False,104,scaffold_1
49,11591001,11752000,160999,False,104,scaffold_1
50,11788001,11834000,45999,False,104,scaffold_1
51,12184001,12203000,18999,False,104,scaffold_1
52,12427001,12450000,22999,False,104,scaffold_1
53,12649001,12716000,66999,False,104,scaffold_1
54,12796001,12888000,91999,False,104,scaffold_1
55,13191001,13216000,24999,False,104,scaffold_1
56,13346001,13399000,52999,False,104,scaffold_1
57,13400001,13446000,45999,False,104,scaffold_1
58,13792001,13845000,52999,False,104,scaffold_1
59,14301001,14313000,11999,False,104,scaffold_1
60,14653001,14663000,9999,False,104,scaffold_1
0,121001,159000,37999,False,104,scaffold_2
1,168001,177000,8999,False,104,scaffold_2
2,302001,318000,15999,False,104,scaffold_2
3,335001,374000,38999,False,104,scaffold_2
4,2461001,2481000,19999,False,104,scaffold_2
5,2482001,2600000,117999,False,104,scaffold_2
6,2677001,2688000,10999,False,104,scaffold_2
7,2694001,2742000,47999,False,104,scaffold_2
8,2892001,2897000,4999,False,104,scaffold_2
9,2994001,3012000,17999,False,104,scaffold_2
10,3022001,3055000,32999,False,104,scaffold_2
11,3320001,3344000,23999,False,104,scaffold_2
12,3369001,3388000,18999,False,104,scaffold_2
13,3449001,3476000,26999,False,104,scaffold_2
14,3669001,3691000,21999,False,104,scaffold_2
15,4243001,4278000,34999,False,104,scaffold_2
16,4334001,4407000,72999,False,104,scaffold_2
17,4513001,4646000,132999,False,104,scaffold_2
18,4698001,4776000,77999,False,104,scaffold_2
19,4793001,4801000,7999,False,104,scaffold_2
20,4917001,4937000,19999,False,104,scaffold_2
21,5027001,5054000,26999,False,104,scaffold_2
22,5074001,5104000,29999,False,104,scaffold_2
23,5257001,5267000,9999,False,104,scaffold_2
24,5371001,5395000,23999,False,104,scaffold_2
25,5413001,5483000,69999,False,104,scaffold_2
26,5491001,5564000,72999,False,104,scaffold_2
27,5682001,5704000,21999,False,104,scaffold_2
28,5717001,5759000,41999,False,104,scaffold_2
29,5834001,5853000,18999,False,104,scaffold_2
30,5865001,5892000,26999,False,104,scaffold_2
31,5942001,5986000,43999,False,104,scaffold_2
32,6105001,6144000,38999,False,104,scaffold_2
33,6305001,6330000,24999,False,104,scaffold_2
34,6331001,6350000,18999,False,104,scaffold_2
35,6592001,6628000,35999,False,104,scaffold_2
36,7005001,7038000,32999,False,104,scaffold_2
37,7586001,7640000,53999,False,104,scaffold_2
38,7686001,7699000,12999,False,104,scaffold_2
39,7786001,7847000,60999,False,104,scaffold_2
40,7848001,7902000,53999,False,104,scaffold_2
41,7936001,8007000,70999,False,104,scaffold_2
42,8008001,8057000,48999,False,104,scaffold_2
43,8260001,8327000,66999,False,104,scaffold_2
44,8331001,8333000,1999,False,104,scaffold_2
45,8346001,8383000,36999,False,104,scaffold_2
46,8415001,8452000,36999,False,104,scaffold_2
47,8508001,8563000,54999,False,104,scaffold_2
48,9147001,9168000,20999,False,104,scaffold_2
49,10758001,10766000,7999,False,104,scaffold_2
50,11609001,11786000,176999,False,104,scaffold_2
51,11797001,11802476,5475,True,104,scaffold_2
0,642001,646000,3999,False,104,scaffold_3
1,806001,900000,93999,False,104,scaffold_3
2,1085001,1087000,1999,False,104,scaffold_3
3,2007001,2107000,99999,False,104,scaffold_3
4,2253001,2336000,82999,False,104,scaffold_3
5,2411001,2426000,14999,False,104,scaffold_3
6,2487001,2533000,45999,False,104,scaffold_3
7,2653001,2759000,105999,False,104,scaffold_3
8,3066001,3123000,56999,False,104,scaffold_3
9,3133001,3140000,6999,False,104,scaffold_3
10,4071001,4399000,327999,False,104,scaffold_3
11,4420001,4517000,96999,False,104,scaffold_3
12,4637001,4687000,49999,False,104,scaffold_3
13,5167001,5209000,41999,False,104,scaffold_3
14,5493001,5509000,15999,False,104,scaffold_3
15,5631001,5676000,44999,False,104,scaffold_3
16,5880001,5946000,65999,False,104,scaffold_3
17,5970001,6015000,44999,False,104,scaffold_3
18,6762001,6789000,26999,False,104,scaffold_3
19,6892001,6962000,69999,False,104,scaffold_3
20,6979001,7019000,39999,False,104,scaffold_3
21,7050001,7098000,47999,False,104,scaffold_3
22,7288001,7300000,11999,False,104,scaffold_3
23,7369001,7397000,27999,False,104,scaffold_3
24,7506001,7556000,49999,False,104,scaffold_3
25,7692001,7766000,73999,False,104,scaffold_3
26,7830001,7853000,22999,False,104,scaffold_3
27,8080001,8115000,34999,False,104,scaffold_3
28,8183001,8253000,69999,False,104,scaffold_3
29,8462001,8515000,52999,False,104,scaffold_3
30,8516001,8527000,10999,False,104,scaffold_3
31,8576001,8590000,13999,False,104,scaffold_3
32,9006001,9048000,41999,False,104,scaffold_3
33,9967001,9995000,27999,False,104,scaffold_3
34,10277001,10304000,26999,False,104,scaffold_3
35,10552001,10571000,18999,False,104,scaffold_3
36,10601001,11182071,581070,True,104,scaffold_3
0,1,7000,6999,True,104,scaffold_4
1,17001,32000,14999,False,104,scaffold_4
2,48001,88000,39999,False,104,scaffold_4
3,147001,151000,3999,False,104,scaffold_4
4,155001,160000,4999,False,104,scaffold_4
5,161001,215000,53999,False,104,scaffold_4
6,217001,226000,8999,False,104,scaffold_4
7,227001,238000,10999,False,104,scaffold_4
8,243001,264000,20999,False,104,scaffold_4
9,290001,308000,17999,False,104,scaffold_4
10,355001,374000,18999,False,104,scaffold_4
11,375001,380000,4999,False,104,scaffold_4
12,392001,410000,17999,False,104,scaffold_4
13,412001,425000,12999,False,104,scaffold_4
14,429001,498000,68999,False,104,scaffold_4
15,560001,592000,31999,False,104,scaffold_4
16,593001,606000,12999,False,104,scaffold_4
17,608001,620000,11999,False,104,scaffold_4
18,629001,663000,33999,False,104,scaffold_4
19,701001,717000,15999,False,104,scaffold_4
20,1113001,1136000,22999,False,104,scaffold_4
21,1137001,1226000,88999,False,104,scaffold_4
22,1243001,1257000,13999,False,104,scaffold_4
23,1268001,1279000,10999,False,104,scaffold_4
24,1283001,1291000,7999,False,104,scaffold_4
25,1292001,1484000,191999,False,104,scaffold_4
26,1485001,1601000,115999,False,104,scaffold_4
27,1613001,1730000,116999,False,104,scaffold_4
28,1731001,1967000,235999,False,104,scaffold_4
29,1969001,2006000,36999,False,104,scaffold_4
30,2007001,2117000,109999,False,104,scaffold_4
31,2119001,2187000,67999,False,104,scaffold_4
32,2190001,2206000,15999,False,104,scaffold_4
33,2207001,2218000,10999,False,104,scaffold_4
34,2219001,2280000,60999,False,104,scaffold_4
35,2282001,2460000,177999,False,104,scaffold_4
36,2477001,2583000,105999,False,104,scaffold_4
37,2676001,2716000,39999,False,104,scaffold_4
38,2735001,2809000,73999,False,104,scaffold_4
39,3334001,3373000,38999,False,104,scaffold_4
40,3374001,3632000,257999,False,104,scaffold_4
41,3650001,3766000,115999,False,104,scaffold_4
42,4057001,4083000,25999,False,104,scaffold_4
43,4871001,5012000,140999,False,104,scaffold_4
44,5029001,5061000,31999,False,104,scaffold_4
45,5173001,5187000,13999,False,104,scaffold_4
46,5430001,5506000,75999,False,104,scaffold_4
47,5548001,5562000,13999,False,104,scaffold_4
48,5563001,5620000,56999,False,104,scaffold_4
49,5662001,5694000,31999,False,104,scaffold_4
50,5697001,5784000,86999,False,104,scaffold_4
51,5786001,5800000,13999,False,104,scaffold_4
52,6146001,6168000,21999,False,104,scaffold_4
53,6764001,6817000,52999,False,104,scaffold_4
54,6904001,6931000,26999,False,104,scaffold_4
55,6969001,6995000,25999,False,104,scaffold_4
56,7040001,7061000,20999,False,104,scaffold_4
57,7229001,7277000,47999,False,104,scaffold_4
58,7387001,7427000,39999,False,104,scaffold_4
59,7860001,7889000,28999,False,104,scaffold_4
60,8846001,9294000,447999,False,104,scaffold_4
61,9295001,9489000,193999,False,104,scaffold_4
62,9490001,9622000,131999,False,104,scaffold_4
63,9623001,9698000,74999,False,104,scaffold_4
64,9700001,9845951,145950,True,104,scaffold_4
0,318001,326000,7999,False,104,scaffold_5
1,327001,383000,55999,False,104,scaffold_5
2,463001,526000,62999,False,104,scaffold_5
3,933001,947000,13999,False,104,scaffold_5
4,1651001,1661000,9999,False,104,scaffold_5
5,1719001,1729000,9999,False,104,scaffold_5
6,2478001,2492000,13999,False,104,scaffold_5
7,2619001,2692000,72999,False,104,scaffold_5
8,2702001,2730000,27999,False,104,scaffold_5
9,2813001,2870000,56999,False,104,scaffold_5
10,3131001,3213000,81999,False,104,scaffold_5
11,3216001,3248000,31999,False,104,scaffold_5
12,3322001,3350000,27999,False,104,scaffold_5
13,3353001,3416000,62999,False,104,scaffold_5
14,3420001,3519000,98999,False,104,scaffold_5
15,3988001,4062000,73999,False,104,scaffold_5
16,4126001,4222000,95999,False,104,scaffold_5
17,4246001,4291000,44999,False,104,scaffold_5
18,4446001,4501000,54999,False,104,scaffold_5
19,4600001,4680000,79999,False,104,scaffold_5
20,4691001,4862000,170999,False,104,scaffold_5
21,4892001,4920000,27999,False,104,scaffold_5
22,5250001,5274000,23999,False,104,scaffold_5
23,5318001,5346000,27999,False,104,scaffold_5
24,5726001,5738000,11999,False,104,scaffold_5
25,6410001,6419000,8999,False,104,scaffold_5
26,6518001,6653000,134999,False,104,scaffold_5
27,6882001,6906000,23999,False,104,scaffold_5
28,7580001,7656000,75999,False,104,scaffold_5
29,8553001,8616000,62999,False,104,scaffold_5
30,8666001,8690000,23999,False,104,scaffold_5
31,8702001,8817000,114999,False,104,scaffold_5
32,8818001,8981000,162999,False,104,scaffold_5
33,8983001,9364176,381175,True,104,scaffold_5
0,78001,84000,5999,False,104,scaffold_6
1,86001,113000,26999,False,104,scaffold_6
2,171001,209000,37999,False,104,scaffold_6
3,242001,254000,11999,False,104,scaffold_6
4,267001,319000,51999,False,104,scaffold_6
5,733001,751000,17999,False,104,scaffold_6
6,1119001,1137000,17999,False,104,scaffold_6
7,1146001,1226000,79999,False,104,scaffold_6
8,1228001,1263000,34999,False,104,scaffold_6
9,1478001,1499000,20999,False,104,scaffold_6
10,1500001,1546000,45999,False,104,scaffold_6
11,1868001,1902000,33999,False,104,scaffold_6
12,2031001,2082000,50999,False,104,scaffold_6
13,2128001,2197000,68999,False,104,scaffold_6
14,2334001,2521000,186999,False,104,scaffold_6
15,2522001,2595000,72999,False,104,scaffold_6
16,2596001,2692000,95999,False,104,scaffold_6
17,2712001,2824000,111999,False,104,scaffold_6
18,2934001,3015000,80999,False,104,scaffold_6
19,3096001,3193000,96999,False,104,scaffold_6
20,3224001,3350000,125999,False,104,scaffold_6
21,3390001,3424000,33999,False,104,scaffold_6
22,3438001,3488000,49999,False,104,scaffold_6
23,3490001,3695000,204999,False,104,scaffold_6
24,3719001,3765000,45999,False,104,scaffold_6
25,3897001,3913000,15999,False,104,scaffold_6
26,4036001,4069000,32999,False,104,scaffold_6
27,4108001,4195000,86999,False,104,scaffold_6
28,4838001,4870000,31999,False,104,scaffold_6
29,6010001,6091000,80999,False,104,scaffold_6
30,6123001,6167000,43999,False,104,scaffold_6
31,6486001,6503000,16999,False,104,scaffold_6
32,7257001,7337000,79999,False,104,scaffold_6
33,7389001,7430000,40999,False,104,scaffold_6
34,7560001,7668000,107999,False,104,scaffold_6
35,7684001,7714000,29999,False,104,scaffold_6
36,7735001,7789000,53999,False,104,scaffold_6
37,7813001,7847000,33999,False,104,scaffold_6
38,7849001,7925000,75999,False,104,scaffold_6
39,7926001,8129000,202999,False,104,scaffold_6
40,8193001,8204000,10999,False,104,scaffold_6
41,8205001,8229000,23999,False,104,scaffold_6
42,8230001,8268281,38280,True,104,scaffold_6
0,310001,340000,29999,False,104,scaffold_7
1,342001,420000,77999,False,104,scaffold_7
2,421001,508000,86999,False,104,scaffold_7
3,706001,735000,28999,False,104,scaffold_7
4,764001,822000,57999,False,104,scaffold_7
5,859001,864000,4999,False,104,scaffold_7
6,887001,942000,54999,False,104,scaffold_7
7,949001,963000,13999,False,104,scaffold_7
8,964001,966000,1999,False,104,scaffold_7
9,967001,1036000,68999,False,104,scaffold_7
10,1048001,1066000,17999,False,104,scaffold_7
11,1071001,1104000,32999,False,104,scaffold_7
12,1191001,1217000,25999,False,104,scaffold_7
13,1218001,1518000,299999,False,104,scaffold_7
14,1588001,1694000,105999,False,104,scaffold_7
15,1741001,1782000,40999,False,104,scaffold_7
16,1979001,2009000,29999,False,104,scaffold_7
17,3354001,3370000,15999,False,104,scaffold_7
18,3593001,3617000,23999,False,104,scaffold_7
19,4415001,4484000,68999,False,104,scaffold_7
20,4658001,4679000,20999,False,104,scaffold_7
21,4981001,5020000,38999,False,104,scaffold_7
22,5034001,5094000,59999,False,104,scaffold_7
23,5095001,5149000,53999,False,104,scaffold_7
24,5472001,5536000,63999,False,104,scaffold_7
25,6075001,6093000,17999,False,104,scaffold_7
26,6953001,7046000,92999,False,104,scaffold_7
27,7047001,7221000,173999,False,104,scaffold_7
28,7222001,7237000,14999,False,104,scaffold_7
29,7238001,7269000,30999,False,104,scaffold_7
30,7271001,7370000,98999,False,104,scaffold_7
31,7371001,7401000,29999,False,104,scaffold_7
32,7402001,7502216,100215,True,104,scaffold_7
0,1,6000,5999,True,104,scaffold_8
1,75001,85000,9999,False,104,scaffold_8
2,2491001,2527000,35999,False,104,scaffold_8
3,2741001,2844000,102999,False,104,scaffold_8
4,3033001,3189000,155999,False,104,scaffold_8
5,3192001,3393000,200999,False,104,scaffold_8
6,3394001,3525000,130999,False,104,scaffold_8
7,3578001,3614000,35999,False,104,scaffold_8
8,3615001,3888000,272999,False,104,scaffold_8
9,3889001,3913000,23999,False,104,scaffold_8
10,4021001,4108000,86999,False,104,scaffold_8
11,4400001,4432000,31999,False,104,scaffold_8
12,4946001,4960000,13999,False,104,scaffold_8
13,5203001,5217000,13999,False,104,scaffold_8
14,5580001,5596000,15999,False,104,scaffold_8
15,5654001,5709000,54999,False,104,scaffold_8
16,5750001,5801000,50999,False,104,scaffold_8
17,5810001,5879000,68999,False,104,scaffold_8
18,6320001,6334544,14543,True,104,scaffold_8
0,109001,117000,7999,False,104,scaffold_9
1,121001,137000,15999,False,104,scaffold_9
2,236001,242000,5999,False,104,scaffold_9
3,271001,276000,4999,False,104,scaffold_9
4,374001,411000,36999,False,104,scaffold_9
5,413001,434000,20999,False,104,scaffold_9
6,516001,531000,14999,False,104,scaffold_9
7,548001,563000,14999,False,104,scaffold_9
8,652001,666000,13999,False,104,scaffold_9
9,670001,697000,26999,False,104,scaffold_9
10,822001,843000,20999,False,104,scaffold_9
11,850001,862000,11999,False,104,scaffold_9
12,873001,894000,20999,False,104,scaffold_9
13,895001,986000,90999,False,104,scaffold_9
14,987001,995000,7999,False,104,scaffold_9
15,998001,1007000,8999,False,104,scaffold_9
16,1009001,1083000,73999,False,104,scaffold_9
17,1087001,1150000,62999,False,104,scaffold_9
18,1151001,1160000,8999,False,104,scaffold_9
19,1314001,1377000,62999,False,104,scaffold_9
20,1428001,1439000,10999,False,104,scaffold_9
21,1456001,1464000,7999,False,104,scaffold_9
22,1486001,1499000,12999,False,104,scaffold_9
23,1546001,1592000,45999,False,104,scaffold_9
24,1593001,1612000,18999,False,104,scaffold_9
25,1760001,1773000,12999,False,104,scaffold_9
26,1823001,1853000,29999,False,104,scaffold_9
27,1987001,2066000,78999,False,104,scaffold_9
28,2076001,2133000,56999,False,104,scaffold_9
29,2147001,2172000,24999,False,104,scaffold_9
30,2174001,2196000,21999,False,104,scaffold_9
31,2594001,2618000,23999,False,104,scaffold_9
32,2768001,2824000,55999,False,104,scaffold_9
33,2844001,3381000,536999,False,104,scaffold_9
34,3383001,4542000,1158999,False,104,scaffold_9
35,4543001,5100000,556999,False,104,scaffold_9
36,5101001,5107000,5999,False,104,scaffold_9
37,5112001,5115000,2999,False,104,scaffold_9
38,5116001,5238000,121999,False,104,scaffold_9
39,5239001,5298000,58999,False,104,scaffold_9
40,5300001,5491000,190999,False,104,scaffold_9
41,5493001,6061000,567999,False,104,scaffold_9
42,6063001,6331288,268287,True,104,scaffold_9
0,1,233000,232999,True,104,scaffold_10
1,257001,405000,147999,False,104,scaffold_10
2,427001,482000,54999,False,104,scaffold_10
3,483001,581000,97999,False,104,scaffold_10
4,603001,741000,137999,False,104,scaffold_10
5,785001,798000,12999,False,104,scaffold_10
6,812001,833000,20999,False,104,scaffold_10
7,888001,916000,27999,False,104,scaffold_10
8,938001,963000,24999,False,104,scaffold_10
9,1075001,1112000,36999,False,104,scaffold_10
10,1389001,1437000,47999,False,104,scaffold_10
11,2090001,2103000,12999,False,104,scaffold_10
12,2140001,2170000,29999,False,104,scaffold_10
13,2269001,2398000,128999,False,104,scaffold_10
14,2436001,2471000,34999,False,104,scaffold_10
15,2554001,2653000,98999,False,104,scaffold_10
16,2671001,2693000,21999,False,104,scaffold_10
17,2735001,2745000,9999,False,104,scaffold_10
18,2805001,2812000,6999,False,104,scaffold_10
19,3467001,3476000,8999,False,104,scaffold_10
20,4057001,4085000,27999,False,104,scaffold_10
21,4154001,4177000,22999,False,104,scaffold_10
22,4275001,4278000,2999,False,104,scaffold_10
23,4316001,4326000,9999,False,104,scaffold_10
24,4444001,4463000,18999,False,104,scaffold_10
25,4467001,4502000,34999,False,104,scaffold_10
26,4503001,4513000,9999,False,104,scaffold_10
27,4515001,4523000,7999,False,104,scaffold_10
28,4526001,4548000,21999,False,104,scaffold_10
29,4554001,4562000,7999,False,104,scaffold_10
30,4583001,4596000,12999,False,104,scaffold_10
31,4681001,4687000,5999,False,104,scaffold_10
32,4734001,4776000,41999,False,104,scaffold_10
33,4798001,4824000,25999,False,104,scaffold_10
34,4827001,4843000,15999,False,104,scaffold_10
35,4848001,4861000,12999,False,104,scaffold_10
36,4865001,4866973,1972,True,104,scaffold_10
0,10001,63000,52999,False,104,scaffold_11
1,149001,167000,17999,False,104,scaffold_11
2,169001,191000,21999,False,104,scaffold_11
3,213001,223000,9999,False,104,scaffold_11
4,224001,235000,10999,False,104,scaffold_11
5,240001,252000,11999,False,104,scaffold_11
6,419001,431000,11999,False,104,scaffold_11
7,1025001,1034000,8999,False,104,scaffold_11
8,1315001,1338000,22999,False,104,scaffold_11
9,1362001,1372000,9999,False,104,scaffold_11
10,1474001,1478000,3999,False,104,scaffold_11
11,1970001,1989000,18999,False,104,scaffold_11
12,1992001,2057000,64999,False,104,scaffold_11
13,2201001,2223000,21999,False,104,scaffold_11
14,2701001,2800000,98999,False,104,scaffold_11
15,2807001,2877000,69999,False,104,scaffold_11
16,2952001,3000000,47999,False,104,scaffold_11
17,3001001,3006000,4999,False,104,scaffold_11
18,3007001,3019000,11999,False,104,scaffold_11
19,3188001,3254000,65999,False,104,scaffold_11
20,3277001,3293000,15999,False,104,scaffold_11
21,3299001,3383000,83999,False,104,scaffold_11
22,3521001,3621000,99999,False,104,scaffold_11
23,3704001,3721000,16999,False,104,scaffold_11
24,3788001,3918000,129999,False,104,scaffold_11
25,4046001,4159000,112999,False,104,scaffold_11
26,4189001,4613000,423999,False,104,scaffold_11
27,4614001,4633000,18999,False,104,scaffold_11
28,4634001,4710000,75999,False,104,scaffold_11
29,4713001,4766820,53819,True,104,scaffold_11
0,1,29000,28999,True,104,scaffold_12
1,31001,539000,507999,False,104,scaffold_12
2,581001,856000,274999,False,104,scaffold_12
3,866001,1085000,218999,False,104,scaffold_12
4,1087001,1143000,55999,False,104,scaffold_12
5,1151001,1221000,69999,False,104,scaffold_12
6,1230001,1315000,84999,False,104,scaffold_12
7,1316001,1449000,132999,False,104,scaffold_12
8,1720001,1735000,14999,False,104,scaffold_12
9,1787001,1807000,19999,False,104,scaffold_12
10,1968001,2015000,46999,False,104,scaffold_12
11,2050001,2087000,36999,False,104,scaffold_12
12,2088001,2097000,8999,False,104,scaffold_12
13,2130001,2155000,24999,False,104,scaffold_12
14,2203001,2205000,1999,False,104,scaffold_12
15,2342001,2377000,34999,False,104,scaffold_12
16,2571001,2609000,37999,False,104,scaffold_12
17,2674001,2682000,7999,False,104,scaffold_12
0,1,342000,341999,True,105,scaffold_1
1,482001,498000,15999,False,105,scaffold_1
2,574001,643000,68999,False,105,scaffold_1
3,686001,742000,55999,False,105,scaffold_1
4,1828001,1891000,62999,False,105,scaffold_1
5,1954001,1964000,9999,False,105,scaffold_1
6,1965001,1984000,18999,False,105,scaffold_1
7,2449001,2519000,69999,False,105,scaffold_1
8,2569001,2579000,9999,False,105,scaffold_1
9,2729001,2746000,16999,False,105,scaffold_1
10,3193001,3208000,14999,False,105,scaffold_1
11,3714001,3735000,20999,False,105,scaffold_1
12,3915001,3938000,22999,False,105,scaffold_1
13,4003001,4027000,23999,False,105,scaffold_1
14,4063001,4112000,48999,False,105,scaffold_1
15,4315001,4354000,38999,False,105,scaffold_1
16,4928001,5020000,91999,False,105,scaffold_1
17,5091001,5102000,10999,False,105,scaffold_1
18,5482001,5511000,28999,False,105,scaffold_1
19,5536001,5577000,40999,False,105,scaffold_1
20,6108001,6153000,44999,False,105,scaffold_1
21,6163001,6176000,12999,False,105,scaffold_1
22,6228001,6382000,153999,False,105,scaffold_1
23,6384001,6507000,122999,False,105,scaffold_1
24,6544001,6554000,9999,False,105,scaffold_1
25,7038001,7247000,208999,False,105,scaffold_1
26,7248001,7588000,339999,False,105,scaffold_1
27,7590001,8477000,886999,False,105,scaffold_1
28,8478001,8656000,177999,False,105,scaffold_1
29,8658001,9584000,925999,False,105,scaffold_1
30,9586001,10356000,769999,False,105,scaffold_1
31,10461001,10631000,169999,False,105,scaffold_1
32,10808001,10811000,2999,False,105,scaffold_1
33,10840001,10856000,15999,False,105,scaffold_1
34,11344001,11504000,159999,False,105,scaffold_1
35,11609001,11918000,308999,False,105,scaffold_1
36,12184001,12205000,20999,False,105,scaffold_1
37,12653001,12722000,68999,False,105,scaffold_1
38,12785001,12888000,102999,False,105,scaffold_1
39,13113001,13213000,99999,False,105,scaffold_1
40,13347001,13405000,57999,False,105,scaffold_1
41,14285001,14309000,23999,False,105,scaffold_1
42,14471001,14479000,7999,False,105,scaffold_1
43,14595001,14599000,3999,False,105,scaffold_1
44,14605001,14610000,4999,False,105,scaffold_1
0,22001,48000,25999,False,105,scaffold_2
1,93001,159000,65999,False,105,scaffold_2
2,168001,177000,8999,False,105,scaffold_2
3,302001,318000,15999,False,105,scaffold_2
4,333001,374000,40999,False,105,scaffold_2
5,2336001,2358000,21999,False,105,scaffold_2
6,2404001,2415000,10999,False,105,scaffold_2
7,2416001,2424000,7999,False,105,scaffold_2
8,2437001,2554000,116999,False,105,scaffold_2
9,2627001,2639000,11999,False,105,scaffold_2
10,2660001,2689000,28999,False,105,scaffold_2
11,2694001,2746000,51999,False,105,scaffold_2
12,2868001,2899000,30999,False,105,scaffold_2
13,3452001,3465000,12999,False,105,scaffold_2
14,3754001,3783000,28999,False,105,scaffold_2
15,4385001,4409000,23999,False,105,scaffold_2
16,4427001,4457000,29999,False,105,scaffold_2
17,4520001,4655000,134999,False,105,scaffold_2
18,4918001,4946000,27999,False,105,scaffold_2
19,5022001,5061000,38999,False,105,scaffold_2
20,5370001,5393000,22999,False,105,scaffold_2
21,5419001,5479000,59999,False,105,scaffold_2
22,5491001,5511000,19999,False,105,scaffold_2
23,5667001,5705000,37999,False,105,scaffold_2
24,6261001,6330000,68999,False,105,scaffold_2
25,6331001,6349000,17999,False,105,scaffold_2
26,7020001,7033000,12999,False,105,scaffold_2
27,7439001,7472000,32999,False,105,scaffold_2
28,7563001,7698000,134999,False,105,scaffold_2
29,7785001,7891000,105999,False,105,scaffold_2
30,7934001,8088000,153999,False,105,scaffold_2
31,8265001,8297000,31999,False,105,scaffold_2
32,8331001,8333000,1999,False,105,scaffold_2
33,8342001,8344000,1999,False,105,scaffold_2
34,8346001,8389000,42999,False,105,scaffold_2
35,8416001,8454000,37999,False,105,scaffold_2
36,8509001,8560000,50999,False,105,scaffold_2
37,11367001,11380000,12999,False,105,scaffold_2
38,11520001,11786000,265999,False,105,scaffold_2
0,796001,900000,103999,False,105,scaffold_3
1,2041001,2108000,66999,False,105,scaffold_3
2,2291001,2321000,29999,False,105,scaffold_3
3,2487001,2533000,45999,False,105,scaffold_3
4,3827001,3874000,46999,False,105,scaffold_3
5,4150001,4403000,252999,False,105,scaffold_3
6,4410001,4518000,107999,False,105,scaffold_3
7,4547001,4558000,10999,False,105,scaffold_3
8,4653001,4678000,24999,False,105,scaffold_3
9,5977001,6023000,45999,False,105,scaffold_3
10,6762001,6781000,18999,False,105,scaffold_3
11,6910001,6966000,55999,False,105,scaffold_3
12,6980001,7087000,106999,False,105,scaffold_3
13,7149001,7157000,7999,False,105,scaffold_3
14,7371001,7397000,25999,False,105,scaffold_3
15,7522001,7556000,33999,False,105,scaffold_3
16,7692001,7839000,146999,False,105,scaffold_3
17,8047001,8068000,20999,False,105,scaffold_3
18,8176001,8253000,76999,False,105,scaffold_3
19,8462001,8527000,64999,False,105,scaffold_3
20,8575001,8594000,18999,False,105,scaffold_3
21,9968001,9995000,26999,False,105,scaffold_3
22,10461001,10484000,22999,False,105,scaffold_3
23,10602001,11167000,564999,False,105,scaffold_3
0,17001,32000,14999,False,105,scaffold_4
1,49001,88000,38999,False,105,scaffold_4
2,136001,146000,9999,False,105,scaffold_4
3,147001,151000,3999,False,105,scaffold_4
4,155001,160000,4999,False,105,scaffold_4
5,161001,215000,53999,False,105,scaffold_4
6,217001,226000,8999,False,105,scaffold_4
7,248001,266000,17999,False,105,scaffold_4
8,294001,311000,16999,False,105,scaffold_4
9,320001,344000,23999,False,105,scaffold_4
10,355001,374000,18999,False,105,scaffold_4
11,375001,380000,4999,False,105,scaffold_4
12,393001,410000,16999,False,105,scaffold_4
13,412001,425000,12999,False,105,scaffold_4
14,429001,498000,68999,False,105,scaffold_4
15,608001,667000,58999,False,105,scaffold_4
16,668001,691000,22999,False,105,scaffold_4
17,701001,714000,12999,False,105,scaffold_4
18,1121001,1136000,14999,False,105,scaffold_4
19,1137001,1178000,40999,False,105,scaffold_4
20,1199001,1226000,26999,False,105,scaffold_4
21,1272001,1279000,6999,False,105,scaffold_4
22,1283001,1336000,52999,False,105,scaffold_4
23,1372001,1591000,218999,False,105,scaffold_4
24,1613001,2117000,503999,False,105,scaffold_4
25,2144001,2185000,40999,False,105,scaffold_4
26,2188001,2208000,19999,False,105,scaffold_4
27,2264001,2279000,14999,False,105,scaffold_4
28,2284001,2340000,55999,False,105,scaffold_4
29,2477001,2610000,132999,False,105,scaffold_4
30,3336001,3765000,428999,False,105,scaffold_4
31,4057001,4072000,14999,False,105,scaffold_4
32,4944001,5000000,55999,False,105,scaffold_4
33,5477001,5506000,28999,False,105,scaffold_4
34,5514001,5620000,105999,False,105,scaffold_4
35,5661001,5784000,122999,False,105,scaffold_4
36,6765001,6817000,51999,False,105,scaffold_4
37,6902001,6924000,21999,False,105,scaffold_4
38,7036001,7062000,25999,False,105,scaffold_4
39,8846001,9699000,852999,False,105,scaffold_4
40,9700001,9845951,145950,True,105,scaffold_4
0,178001,180000,1999,False,105,scaffold_5
1,194001,204000,9999,False,105,scaffold_5
2,318001,326000,7999,False,105,scaffold_5
3,327001,368000,40999,False,105,scaffold_5
4,463001,525000,61999,False,105,scaffold_5
5,933001,947000,13999,False,105,scaffold_5
6,2565001,2581000,15999,False,105,scaffold_5
7,2619001,2737000,117999,False,105,scaffold_5
8,2816001,2871000,54999,False,105,scaffold_5
9,3134001,3185000,50999,False,105,scaffold_5
10,3217001,3253000,35999,False,105,scaffold_5
11,3310001,3512000,201999,False,105,scaffold_5
12,3962001,4101000,138999,False,105,scaffold_5
13,4120001,4219000,98999,False,105,scaffold_5
14,4229001,4262000,32999,False,105,scaffold_5
15,4446001,4498000,51999,False,105,scaffold_5
16,4600001,4680000,79999,False,105,scaffold_5
17,4691001,4717000,25999,False,105,scaffold_5
18,4793001,4861000,67999,False,105,scaffold_5
19,4904001,4917000,12999,False,105,scaffold_5
20,5256001,5274000,17999,False,105,scaffold_5
21,5318001,5346000,27999,False,105,scaffold_5
22,6481001,6652000,170999,False,105,scaffold_5
23,7373001,7387000,13999,False,105,scaffold_5
24,7621001,7655000,33999,False,105,scaffold_5
25,8666001,8689000,22999,False,105,scaffold_5
26,8730001,9364176,634175,True,105,scaffold_5
0,66001,75000,8999,False,105,scaffold_6
1,79001,85000,5999,False,105,scaffold_6
2,86001,113000,26999,False,105,scaffold_6
3,240001,254000,13999,False,105,scaffold_6
4,257001,262000,4999,False,105,scaffold_6
5,267001,278000,10999,False,105,scaffold_6
6,1236001,1257000,20999,False,105,scaffold_6
7,1479001,1546000,66999,False,105,scaffold_6
8,1564001,1595000,30999,False,105,scaffold_6
9,2023001,2087000,63999,False,105,scaffold_6
10,2153001,2168000,14999,False,105,scaffold_6
11,2347001,2531000,183999,False,105,scaffold_6
12,2532001,2653000,120999,False,105,scaffold_6
13,2656001,2695000,38999,False,105,scaffold_6
14,2711001,2852000,140999,False,105,scaffold_6
15,2927001,3016000,88999,False,105,scaffold_6
16,3116001,3149000,32999,False,105,scaffold_6
17,3224001,3301000,76999,False,105,scaffold_6
18,3406001,3428000,21999,False,105,scaffold_6
19,3458001,3607000,148999,False,105,scaffold_6
20,3608001,3768000,159999,False,105,scaffold_6
21,3770001,3784000,13999,False,105,scaffold_6
22,3900001,3913000,12999,False,105,scaffold_6
23,4018001,4064000,45999,False,105,scaffold_6
24,4106001,4195000,88999,False,105,scaffold_6
25,6011001,6062000,50999,False,105,scaffold_6
26,7264001,7337000,72999,False,105,scaffold_6
27,7550001,7681000,130999,False,105,scaffold_6
28,7683001,7796000,112999,False,105,scaffold_6
29,7811001,8268281,457280,True,105,scaffold_6
0,1,8000,7999,True,105,scaffold_7
1,13001,34000,20999,False,105,scaffold_7
2,323001,340000,16999,False,105,scaffold_7
3,342001,508000,165999,False,105,scaffold_7
4,554001,563000,8999,False,105,scaffold_7
5,571001,577000,5999,False,105,scaffold_7
6,706001,736000,29999,False,105,scaffold_7
7,741001,753000,11999,False,105,scaffold_7
8,764001,809000,44999,False,105,scaffold_7
9,859001,864000,4999,False,105,scaffold_7
10,968001,980000,11999,False,105,scaffold_7
11,982001,1044000,61999,False,105,scaffold_7
12,1048001,1104000,55999,False,105,scaffold_7
13,1183001,1187000,3999,False,105,scaffold_7
14,1191001,1460000,268999,False,105,scaffold_7
15,1461001,1512000,50999,False,105,scaffold_7
16,1588001,1696000,107999,False,105,scaffold_7
17,3326001,3369000,42999,False,105,scaffold_7
18,3535001,3550000,14999,False,105,scaffold_7
19,3596001,3649000,52999,False,105,scaffold_7
20,4415001,4535000,119999,False,105,scaffold_7
21,4658001,4733000,74999,False,105,scaffold_7
22,4978001,5030000,51999,False,105,scaffold_7
23,5068001,5149000,80999,False,105,scaffold_7
24,5480001,5536000,55999,False,105,scaffold_7
25,5609001,5628000,18999,False,105,scaffold_7
26,6955001,7270000,314999,False,105,scaffold_7
27,7271001,7502216,231215,True,105,scaffold_7
0,67001,85000,17999,False,105,scaffold_8
1,93001,101000,7999,False,105,scaffold_8
2,2444001,2470000,25999,False,105,scaffold_8
3,2492001,2513000,20999,False,105,scaffold_8
4,2539001,2547000,7999,False,105,scaffold_8
5,2652001,2683000,30999,False,105,scaffold_8
6,2742001,2757000,14999,False,105,scaffold_8
7,2799001,2844000,44999,False,105,scaffold_8
8,3059001,3529000,469999,False,105,scaffold_8
9,3584001,3612000,27999,False,105,scaffold_8
10,3615001,3913000,297999,False,105,scaffold_8
11,4038001,4108000,69999,False,105,scaffold_8
12,4207001,4221000,13999,False,105,scaffold_8
13,4404001,4426000,21999,False,105,scaffold_8
14,5085001,5136000,50999,False,105,scaffold_8
15,5198001,5241000,42999,False,105,scaffold_8
16,6329001,6334544,5543,True,105,scaffold_8
0,109001,118000,8999,False,105,scaffold_9
1,236001,242000,5999,False,105,scaffold_9
2,366001,411000,44999,False,105,scaffold_9
3,413001,434000,20999,False,105,scaffold_9
4,504001,531000,26999,False,105,scaffold_9
5,670001,697000,26999,False,105,scaffold_9
6,731001,742000,10999,False,105,scaffold_9
7,815001,843000,27999,False,105,scaffold_9
8,873001,986000,112999,False,105,scaffold_9
9,988001,995000,6999,False,105,scaffold_9
10,1001001,1007000,5999,False,105,scaffold_9
11,1009001,1085000,75999,False,105,scaffold_9
12,1087001,1150000,62999,False,105,scaffold_9
13,1151001,1175000,23999,False,105,scaffold_9
14,1312001,1377000,64999,False,105,scaffold_9
15,1751001,1791000,39999,False,105,scaffold_9
16,2598001,2616000,17999,False,105,scaffold_9
17,2781001,2803000,21999,False,105,scaffold_9
18,2870001,3381000,510999,False,105,scaffold_9
19,3383001,5107000,1723999,False,105,scaffold_9
20,5112001,5114000,1999,False,105,scaffold_9
21,5116001,5238000,121999,False,105,scaffold_9
22,5239001,5298000,58999,False,105,scaffold_9
23,5300001,6331288,1031287,True,105,scaffold_9
0,1,235000,234999,True,105,scaffold_10
1,269001,403000,133999,False,105,scaffold_10
2,415001,482000,66999,False,105,scaffold_10
3,483001,576000,92999,False,105,scaffold_10
4,603001,754000,150999,False,105,scaffold_10
5,783001,794000,10999,False,105,scaffold_10
6,888001,921000,32999,False,105,scaffold_10
7,923001,962000,38999,False,105,scaffold_10
8,1087001,1110000,22999,False,105,scaffold_10
9,2140001,2170000,29999,False,105,scaffold_10
10,2273001,2296000,22999,False,105,scaffold_10
11,2346001,2367000,20999,False,105,scaffold_10
12,4053001,4091000,37999,False,105,scaffold_10
13,4154001,4174000,19999,False,105,scaffold_10
14,4443001,4462000,18999,False,105,scaffold_10
15,4467001,4477000,9999,False,105,scaffold_10
16,4506001,4513000,6999,False,105,scaffold_10
17,4515001,4523000,7999,False,105,scaffold_10
18,4526001,4548000,21999,False,105,scaffold_10
19,4575001,4596000,20999,False,105,scaffold_10
20,4681001,4688000,6999,False,105,scaffold_10
21,4735001,4776000,40999,False,105,scaffold_10
22,4798001,4824000,25999,False,105,scaffold_10
23,4828001,4843000,14999,False,105,scaffold_10
24,4848001,4861000,12999,False,105,scaffold_10
25,4865001,4866973,1972,True,105,scaffold_10
0,10001,34000,23999,False,105,scaffold_11
1,38001,93000,54999,False,105,scaffold_11
2,149001,167000,17999,False,105,scaffold_11
3,169001,191000,21999,False,105,scaffold_11
4,214001,235000,20999,False,105,scaffold_11
5,240001,248000,7999,False,105,scaffold_11
6,419001,431000,11999,False,105,scaffold_11
7,648001,656000,7999,False,105,scaffold_11
8,1025001,1034000,8999,False,105,scaffold_11
9,1423001,1426000,2999,False,105,scaffold_11
10,2701001,2873000,171999,False,105,scaffold_11
11,3092001,3144000,51999,False,105,scaffold_11
12,3185001,3292000,106999,False,105,scaffold_11
13,3328001,3383000,54999,False,105,scaffold_11
14,3702001,3926000,223999,False,105,scaffold_11
15,4008001,4071000,62999,False,105,scaffold_11
16,4256001,4710000,453999,False,105,scaffold_11
17,4713001,4766820,53819,True,105,scaffold_11
0,1,183000,182999,True,105,scaffold_12
1,184001,302000,117999,False,105,scaffold_12
2,304001,370000,65999,False,105,scaffold_12
3,404001,551000,146999,False,105,scaffold_12
4,580001,856000,275999,False,105,scaffold_12
5,865001,1450000,584999,False,105,scaffold_12
6,1720001,1733000,12999,False,105,scaffold_12
7,2056001,2087000,30999,False,105,scaffold_12
8,2088001,2103000,14999,False,105,scaffold_12
9,2571001,2609000,37999,False,105,scaffold_12
10,2747001,2747968,967,True,105,scaffold_12
0,1,390000,389999,True,106,scaffold_1
1,412001,446000,33999,False,106,scaffold_1
2,482001,498000,15999,False,106,scaffold_1
3,511001,543000,31999,False,106,scaffold_1
4,553001,657000,103999,False,106,scaffold_1
5,686001,757000,70999,False,106,scaffold_1
6,795001,840000,44999,False,106,scaffold_1
7,872001,910000,37999,False,106,scaffold_1
8,1185001,1195000,9999,False,106,scaffold_1
9,1280001,1292000,11999,False,106,scaffold_1
10,1604001,1696000,91999,False,106,scaffold_1
11,1728001,1964000,235999,False,106,scaffold_1
12,1965001,1984000,18999,False,106,scaffold_1
13,1986001,2016000,29999,False,106,scaffold_1
14,2344001,2387000,42999,False,106,scaffold_1
15,2449001,2519000,69999,False,106,scaffold_1
16,2563001,2583000,19999,False,106,scaffold_1
17,2596001,2621000,24999,False,106,scaffold_1
18,2718001,2746000,27999,False,106,scaffold_1
19,2960001,3023000,62999,False,106,scaffold_1
20,3172001,3209000,36999,False,106,scaffold_1
21,3444001,3640000,195999,False,106,scaffold_1
22,3703001,3941000,237999,False,106,scaffold_1
23,3946001,4112000,165999,False,106,scaffold_1
24,4309001,4545000,235999,False,106,scaffold_1
25,4708001,4790000,81999,False,106,scaffold_1
26,4796001,4896000,99999,False,106,scaffold_1
27,4906001,5028000,121999,False,106,scaffold_1
28,5037001,5065000,27999,False,106,scaffold_1
29,5087001,5115000,27999,False,106,scaffold_1
30,5140001,5199000,58999,False,106,scaffold_1
31,5344001,5377000,32999,False,106,scaffold_1
32,5436001,5456000,19999,False,106,scaffold_1
33,5481001,5514000,32999,False,106,scaffold_1
34,5535001,5594000,58999,False,106,scaffold_1
35,5852001,5917000,64999,False,106,scaffold_1
36,6108001,6153000,44999,False,106,scaffold_1
37,6154001,6178000,23999,False,106,scaffold_1
38,6201001,6379000,177999,False,106,scaffold_1
39,6384001,6575000,190999,False,106,scaffold_1
40,6641001,6658000,16999,False,106,scaffold_1
41,6838001,6877000,38999,False,106,scaffold_1
42,7038001,7247000,208999,False,106,scaffold_1
43,7248001,7589000,340999,False,106,scaffold_1
44,7590001,8656000,1065999,False,106,scaffold_1
45,8658001,9584000,925999,False,106,scaffold_1
46,9586001,10363000,776999,False,106,scaffold_1
47,10448001,10618000,169999,False,106,scaffold_1
48,10808001,10811000,2999,False,106,scaffold_1
49,10832001,10857000,24999,False,106,scaffold_1
50,10916001,10940000,23999,False,106,scaffold_1
51,11014001,11070000,55999,False,106,scaffold_1
52,11123001,11249000,125999,False,106,scaffold_1
53,11274001,11963000,688999,False,106,scaffold_1
54,12147001,12211000,63999,False,106,scaffold_1
55,12329001,12368000,38999,False,106,scaffold_1
56,12425001,12450000,24999,False,106,scaffold_1
57,12491001,12589000,97999,False,106,scaffold_1
58,12598001,12606000,7999,False,106,scaffold_1
59,12616001,12888000,271999,False,106,scaffold_1
60,12965001,13067000,101999,False,106,scaffold_1
61,13094001,13216000,121999,False,106,scaffold_1
62,13339001,13447000,107999,False,106,scaffold_1
63,13557001,13609000,51999,False,106,scaffold_1
64,13668001,13710000,41999,False,106,scaffold_1
65,13810001,13845000,34999,False,106,scaffold_1
66,13958001,13967000,8999,False,106,scaffold_1
67,14285001,14310000,24999,False,106,scaffold_1
68,14383001,14392000,8999,False,106,scaffold_1
69,14605001,14612000,6999,False,106,scaffold_1
70,14648001,14664000,15999,False,106,scaffold_1
0,1,48000,47999,True,106,scaffold_2
1,93001,159000,65999,False,106,scaffold_2
2,165001,177000,11999,False,106,scaffold_2
3,297001,318000,20999,False,106,scaffold_2
4,333001,374000,40999,False,106,scaffold_2
5,732001,739000,6999,False,106,scaffold_2
6,1164001,1186000,21999,False,106,scaffold_2
7,1310001,1338000,27999,False,106,scaffold_2
8,1368001,1416000,47999,False,106,scaffold_2
9,1518001,1554000,35999,False,106,scaffold_2
10,1840001,1854000,13999,False,106,scaffold_2
11,1885001,1896000,10999,False,106,scaffold_2
12,1927001,1958000,30999,False,106,scaffold_2
13,2083001,2124000,40999,False,106,scaffold_2
14,2303001,2334000,30999,False,106,scaffold_2
15,2336001,2603000,266999,False,106,scaffold_2
16,2660001,2689000,28999,False,106,scaffold_2
17,2694001,2746000,51999,False,106,scaffold_2
18,2766001,2856000,89999,False,106,scaffold_2
19,2876001,3021000,144999,False,106,scaffold_2
20,3022001,3047000,24999,False,106,scaffold_2
21,3174001,3185000,10999,False,106,scaffold_2
22,3274001,3283000,8999,False,106,scaffold_2
23,3331001,3348000,16999,False,106,scaffold_2
24,3362001,3389000,26999,False,106,scaffold_2
25,3449001,3559000,109999,False,106,scaffold_2
26,3643001,3712000,68999,False,106,scaffold_2
27,3754001,3790000,35999,False,106,scaffold_2
28,4009001,4038000,28999,False,106,scaffold_2
29,4094001,4121000,26999,False,106,scaffold_2
30,4242001,4287000,44999,False,106,scaffold_2
31,4292001,4409000,116999,False,106,scaffold_2
32,4426001,4790000,363999,False,106,scaffold_2
33,4793001,4814000,20999,False,106,scaffold_2
34,4891001,4955000,63999,False,106,scaffold_2
35,5021001,5104000,82999,False,106,scaffold_2
36,5186001,5224000,37999,False,106,scaffold_2
37,5347001,5488000,140999,False,106,scaffold_2
38,5490001,5590000,99999,False,106,scaffold_2
39,5605001,5762000,156999,False,106,scaffold_2
40,5836001,5995000,158999,False,106,scaffold_2
41,6004001,6058000,53999,False,106,scaffold_2
42,6091001,6349000,257999,False,106,scaffold_2
43,6365001,6473000,107999,False,106,scaffold_2
44,6590001,6628000,37999,False,106,scaffold_2
45,6801001,6871000,69999,False,106,scaffold_2
46,6940001,7097000,156999,False,106,scaffold_2
47,7163001,7205000,41999,False,106,scaffold_2
48,7340001,7472000,131999,False,106,scaffold_2
49,7491001,7518000,26999,False,106,scaffold_2
50,7547001,7561000,13999,False,106,scaffold_2
51,7563001,7698000,134999,False,106,scaffold_2
52,7720001,7920000,199999,False,106,scaffold_2
53,7933001,8234000,300999,False,106,scaffold_2
54,8260001,8328000,67999,False,106,scaffold_2
55,8331001,8333000,1999,False,106,scaffold_2
56,8335001,8344000,8999,False,106,scaffold_2
57,8346001,8454000,107999,False,106,scaffold_2
58,8465001,8493000,27999,False,106,scaffold_2
59,8495001,8564000,68999,False,106,scaffold_2
60,8985001,9047000,61999,False,106,scaffold_2
61,9146001,9202000,55999,False,106,scaffold_2
62,9238001,9382000,143999,False,106,scaffold_2
63,9564001,9628000,63999,False,106,scaffold_2
64,9672001,9742000,69999,False,106,scaffold_2
65,9752001,9828000,75999,False,106,scaffold_2
66,9830001,9905000,74999,False,106,scaffold_2
67,10016001,10049000,32999,False,106,scaffold_2
68,10330001,10354000,23999,False,106,scaffold_2
69,10401001,10466000,64999,False,106,scaffold_2
70,10676001,10708000,31999,False,106,scaffold_2
71,10710001,10742000,31999,False,106,scaffold_2
72,10745001,10766000,20999,False,106,scaffold_2
73,10995001,10998000,2999,False,106,scaffold_2
74,11025001,11175000,149999,False,106,scaffold_2
75,11368001,11379000,10999,False,106,scaffold_2
76,11471001,11502000,30999,False,106,scaffold_2
77,11520001,11786000,265999,False,106,scaffold_2
0,618001,646000,27999,False,106,scaffold_3
1,798001,901000,102999,False,106,scaffold_3
2,1086001,1093000,6999,False,106,scaffold_3
3,1936001,1980000,43999,False,106,scaffold_3
4,2000001,2147000,146999,False,106,scaffold_3
5,2287001,2336000,48999,False,106,scaffold_3
6,2377001,2428000,50999,False,106,scaffold_3
7,2433001,2533000,99999,False,106,scaffold_3
8,2656001,2761000,104999,False,106,scaffold_3
9,2892001,2934000,41999,False,106,scaffold_3
10,3066001,3344000,277999,False,106,scaffold_3
11,3409001,3435000,25999,False,106,scaffold_3
12,3498001,3514000,15999,False,106,scaffold_3
13,3558001,3892000,333999,False,106,scaffold_3
14,3909001,3921000,11999,False,106,scaffold_3
15,3922001,4039000,116999,False,106,scaffold_3
16,4040001,4403000,362999,False,106,scaffold_3
17,4410001,4520000,109999,False,106,scaffold_3
18,4546001,4558000,11999,False,106,scaffold_3
19,4584001,4599000,14999,False,106,scaffold_3
20,4646001,4678000,31999,False,106,scaffold_3
21,4854001,4926000,71999,False,106,scaffold_3
22,4996001,5036000,39999,False,106,scaffold_3
23,5047001,5125000,77999,False,106,scaffold_3
24,5155001,5272000,116999,False,106,scaffold_3
25,5376001,5453000,76999,False,106,scaffold_3
26,5489001,5509000,19999,False,106,scaffold_3
27,5511001,5535000,23999,False,106,scaffold_3
28,5560001,5674000,113999,False,106,scaffold_3
29,5707001,5729000,21999,False,106,scaffold_3
30,5804001,6032000,227999,False,106,scaffold_3
31,6040001,6117000,76999,False,106,scaffold_3
32,6218001,6246000,27999,False,106,scaffold_3
33,6740001,6807000,66999,False,106,scaffold_3
34,6887001,7156000,268999,False,106,scaffold_3
35,7230001,7326000,95999,False,106,scaffold_3
36,7332001,7445000,112999,False,106,scaffold_3
37,7461001,7480000,18999,False,106,scaffold_3
38,7483001,7556000,72999,False,106,scaffold_3
39,7575001,7622000,46999,False,106,scaffold_3
40,7661001,7895000,233999,False,106,scaffold_3
41,8028001,8116000,87999,False,106,scaffold_3
42,8176001,8281000,104999,False,106,scaffold_3
43,8402001,8553000,150999,False,106,scaffold_3
44,8575001,8594000,18999,False,106,scaffold_3
45,8758001,8771000,12999,False,106,scaffold_3
46,8780001,8805000,24999,False,106,scaffold_3
47,8956001,9102000,145999,False,106,scaffold_3
48,9105001,9171000,65999,False,106,scaffold_3
49,9199001,9240000,40999,False,106,scaffold_3
50,9460001,9578000,117999,False,106,scaffold_3
51,9652001,9687000,34999,False,106,scaffold_3
52,9777001,9800000,22999,False,106,scaffold_3
53,9967001,9996000,28999,False,106,scaffold_3
54,10042001,10088000,45999,False,106,scaffold_3
55,10446001,10458000,11999,False,106,scaffold_3
56,10461001,10486000,24999,False,106,scaffold_3
57,10550001,10571000,20999,False,106,scaffold_3
58,10574001,11168000,593999,False,106,scaffold_3
0,11001,13000,1999,False,106,scaffold_4
1,17001,32000,14999,False,106,scaffold_4
2,49001,88000,38999,False,106,scaffold_4
3,91001,115000,23999,False,106,scaffold_4
4,133001,146000,12999,False,106,scaffold_4
5,147001,151000,3999,False,106,scaffold_4
6,155001,215000,59999,False,106,scaffold_4
7,217001,226000,8999,False,106,scaffold_4
8,227001,241000,13999,False,106,scaffold_4
9,242001,278000,35999,False,106,scaffold_4
10,288001,310000,21999,False,106,scaffold_4
11,355001,374000,18999,False,106,scaffold_4
12,389001,410000,20999,False,106,scaffold_4
13,412001,425000,12999,False,106,scaffold_4
14,429001,502000,72999,False,106,scaffold_4
15,543001,606000,62999,False,106,scaffold_4
16,608001,691000,82999,False,106,scaffold_4
17,1121001,1136000,14999,False,106,scaffold_4
18,1137001,1208000,70999,False,106,scaffold_4
19,1210001,1226000,15999,False,106,scaffold_4
20,1269001,1279000,9999,False,106,scaffold_4
21,1283001,1336000,52999,False,106,scaffold_4
22,1372001,1475000,102999,False,106,scaffold_4
23,1476001,1605000,128999,False,106,scaffold_4
24,1613001,2185000,571999,False,106,scaffold_4
25,2188001,2280000,91999,False,106,scaffold_4
26,2283001,2461000,177999,False,106,scaffold_4
27,2475001,2635000,159999,False,106,scaffold_4
28,2649001,2675000,25999,False,106,scaffold_4
29,2676001,2817000,140999,False,106,scaffold_4
30,2890001,3133000,242999,False,106,scaffold_4
31,3157001,3776000,618999,False,106,scaffold_4
32,3997001,4044000,46999,False,106,scaffold_4
33,4055001,4078000,22999,False,106,scaffold_4
34,4182001,4197000,14999,False,106,scaffold_4
35,4242001,4306000,63999,False,106,scaffold_4
36,4822001,4876000,53999,False,106,scaffold_4
37,4900001,5091000,190999,False,106,scaffold_4
38,5169001,5225000,55999,False,106,scaffold_4
39,5292001,5506000,213999,False,106,scaffold_4
40,5514001,5784000,269999,False,106,scaffold_4
41,5786001,5976000,189999,False,106,scaffold_4
42,6028001,6117000,88999,False,106,scaffold_4
43,6148001,6306000,157999,False,106,scaffold_4
44,6326001,6468000,141999,False,106,scaffold_4
45,6571001,6580000,8999,False,106,scaffold_4
46,6599001,6612000,12999,False,106,scaffold_4
47,6762001,6817000,54999,False,106,scaffold_4
48,6878001,6924000,45999,False,106,scaffold_4
49,6926001,6934000,7999,False,106,scaffold_4
50,6950001,6995000,44999,False,106,scaffold_4
51,7036001,7403000,366999,False,106,scaffold_4
52,7498001,7557000,58999,False,106,scaffold_4
53,7628001,7667000,38999,False,106,scaffold_4
54,7859001,7917000,57999,False,106,scaffold_4
55,7985001,7997000,11999,False,106,scaffold_4
56,8051001,8080000,28999,False,106,scaffold_4
57,8745001,8768000,22999,False,106,scaffold_4
58,8844001,9699000,854999,False,106,scaffold_4
59,9700001,9845951,145950,True,106,scaffold_4
0,1,4000,3999,True,106,scaffold_5
1,151001,173000,21999,False,106,scaffold_5
2,189001,204000,14999,False,106,scaffold_5
3,318001,383000,64999,False,106,scaffold_5
4,452001,524000,71999,False,106,scaffold_5
5,639001,656000,16999,False,106,scaffold_5
6,669001,697000,27999,False,106,scaffold_5
7,924001,947000,22999,False,106,scaffold_5
8,1667001,1684000,16999,False,106,scaffold_5
9,2087001,2104000,16999,False,106,scaffold_5
10,2255001,2300000,44999,False,106,scaffold_5
11,2381001,2405000,23999,False,106,scaffold_5
12,2472001,2494000,21999,False,106,scaffold_5
13,2509001,2515000,5999,False,106,scaffold_5
14,2516001,2897000,380999,False,106,scaffold_5
15,3133001,3519000,385999,False,106,scaffold_5
16,3599001,3663000,63999,False,106,scaffold_5
17,3725001,3744000,18999,False,106,scaffold_5
18,3834001,3945000,110999,False,106,scaffold_5
19,3962001,4222000,259999,False,106,scaffold_5
20,4228001,4408000,179999,False,106,scaffold_5
21,4445001,4926000,480999,False,106,scaffold_5
22,4937001,5111000,173999,False,106,scaffold_5
23,5132001,5346000,213999,False,106,scaffold_5
24,5491001,5528000,36999,False,106,scaffold_5
25,5698001,5738000,39999,False,106,scaffold_5
26,5870001,5888000,17999,False,106,scaffold_5
27,6391001,6689000,297999,False,106,scaffold_5
28,6780001,6851000,70999,False,106,scaffold_5
29,6881001,6908000,26999,False,106,scaffold_5
30,7172001,7329000,156999,False,106,scaffold_5
31,7334001,7386000,51999,False,106,scaffold_5
32,7406001,7441000,34999,False,106,scaffold_5
33,7454001,7619000,164999,False,106,scaffold_5
34,7620001,7749000,128999,False,106,scaffold_5
35,7854001,7909000,54999,False,106,scaffold_5
36,7946001,8001000,54999,False,106,scaffold_5
37,8077001,8106000,28999,False,106,scaffold_5
38,8130001,8170000,39999,False,106,scaffold_5
39,8258001,8261000,2999,False,106,scaffold_5
40,8408001,8461000,52999,False,106,scaffold_5
41,8540001,8616000,75999,False,106,scaffold_5
42,8636001,8689000,52999,False,106,scaffold_5
43,8702001,9364176,662175,True,106,scaffold_5
0,79001,84000,4999,False,106,scaffold_6
1,86001,114000,27999,False,106,scaffold_6
2,143001,208000,64999,False,106,scaffold_6
3,239001,254000,14999,False,106,scaffold_6
4,467001,497000,29999,False,106,scaffold_6
5,782001,801000,18999,False,106,scaffold_6
6,922001,943000,20999,False,106,scaffold_6
7,966001,1039000,72999,False,106,scaffold_6
8,1120001,1226000,105999,False,106,scaffold_6
9,1229001,1265000,35999,False,106,scaffold_6
10,1284001,1311000,26999,False,106,scaffold_6
11,1421001,1597000,175999,False,106,scaffold_6
12,1658001,1712000,53999,False,106,scaffold_6
13,1803001,1906000,102999,False,106,scaffold_6
14,1907001,1939000,31999,False,106,scaffold_6
15,1977001,2019000,41999,False,106,scaffold_6
16,2023001,2104000,80999,False,106,scaffold_6
17,2124001,2217000,92999,False,106,scaffold_6
18,2237001,2284000,46999,False,106,scaffold_6
19,2317001,2595000,277999,False,106,scaffold_6
20,2596001,2872000,275999,False,106,scaffold_6
21,2927001,3211000,283999,False,106,scaffold_6
22,3222001,3350000,127999,False,106,scaffold_6
23,3351001,3767000,415999,False,106,scaffold_6
24,3810001,3928000,117999,False,106,scaffold_6
25,3966001,4204000,237999,False,106,scaffold_6
26,4774001,4918000,143999,False,106,scaffold_6
27,4924001,5006000,81999,False,106,scaffold_6
28,5119001,5184000,64999,False,106,scaffold_6
29,5289001,5320000,30999,False,106,scaffold_6
30,5721001,5745000,23999,False,106,scaffold_6
31,5863001,5972000,108999,False,106,scaffold_6
32,6008001,6090000,81999,False,106,scaffold_6
33,6123001,6190000,66999,False,106,scaffold_6
34,6220001,6277000,56999,False,106,scaffold_6
35,6585001,6594000,8999,False,106,scaffold_6
36,6684001,6714000,29999,False,106,scaffold_6
37,6765001,6804000,38999,False,106,scaffold_6
38,6911001,6942000,30999,False,106,scaffold_6
39,7187001,7247000,59999,False,106,scaffold_6
40,7255001,7337000,81999,False,106,scaffold_6
41,7389001,7436000,46999,False,106,scaffold_6
42,7513001,8268281,755280,True,106,scaffold_6
0,1,8000,7999,True,106,scaffold_7
1,11001,34000,22999,False,106,scaffold_7
2,310001,340000,29999,False,106,scaffold_7
3,342001,508000,165999,False,106,scaffold_7
4,571001,577000,5999,False,106,scaffold_7
5,689001,736000,46999,False,106,scaffold_7
6,740001,753000,12999,False,106,scaffold_7
7,764001,843000,78999,False,106,scaffold_7
8,859001,864000,4999,False,106,scaffold_7
9,868001,872000,3999,False,106,scaffold_7
10,875001,938000,62999,False,106,scaffold_7
11,964001,966000,1999,False,106,scaffold_7
12,968001,980000,11999,False,106,scaffold_7
13,982001,1044000,61999,False,106,scaffold_7
14,1048001,1101000,52999,False,106,scaffold_7
15,1166001,1187000,20999,False,106,scaffold_7
16,1191001,1460000,268999,False,106,scaffold_7
17,1461001,1513000,51999,False,106,scaffold_7
18,1588001,1696000,107999,False,106,scaffold_7
19,1730001,1782000,51999,False,106,scaffold_7
20,1863001,1896000,32999,False,106,scaffold_7
21,1972001,2010000,37999,False,106,scaffold_7
22,2516001,2735000,218999,False,106,scaffold_7
23,3006001,3023000,16999,False,106,scaffold_7
24,3297001,3408000,110999,False,106,scaffold_7
25,3499001,3809000,309999,False,106,scaffold_7
26,3865001,3969000,103999,False,106,scaffold_7
27,4021001,4060000,38999,False,106,scaffold_7
28,4298001,4376000,77999,False,106,scaffold_7
29,4406001,4515000,108999,False,106,scaffold_7
30,4527001,4918000,390999,False,106,scaffold_7
31,4979001,5202000,222999,False,106,scaffold_7
32,5472001,5536000,63999,False,106,scaffold_7
33,5549001,5645000,95999,False,106,scaffold_7
34,5666001,5685000,18999,False,106,scaffold_7
35,6052001,6094000,41999,False,106,scaffold_7
36,6096001,6250000,153999,False,106,scaffold_7
37,6557001,6675000,117999,False,106,scaffold_7
38,6694001,6799000,104999,False,106,scaffold_7
39,6948001,7270000,321999,False,106,scaffold_7
40,7271001,7502216,231215,True,106,scaffold_7
0,1,7000,6999,True,106,scaffold_8
1,66001,85000,18999,False,106,scaffold_8
2,93001,102000,8999,False,106,scaffold_8
3,1363001,1422000,58999,False,106,scaffold_8
4,1562001,1583000,20999,False,106,scaffold_8
5,1858001,1931000,72999,False,106,scaffold_8
6,2069001,2156000,86999,False,106,scaffold_8
7,2255001,2284000,28999,False,106,scaffold_8
8,2340001,2600000,259999,False,106,scaffold_8
9,2648001,2845000,196999,False,106,scaffold_8
10,2846001,2934000,87999,False,106,scaffold_8
11,2946001,3612000,665999,False,106,scaffold_8
12,3615001,3954000,338999,False,106,scaffold_8
13,4010001,4268000,257999,False,106,scaffold_8
14,4400001,4431000,30999,False,106,scaffold_8
15,4606001,4645000,38999,False,106,scaffold_8
16,4717001,4776000,58999,False,106,scaffold_8
17,4797001,4931000,133999,False,106,scaffold_8
18,4987001,5037000,49999,False,106,scaffold_8
19,5068001,5247000,178999,False,106,scaffold_8
20,5456001,5471000,14999,False,106,scaffold_8
21,5524001,5596000,71999,False,106,scaffold_8
22,5650001,5710000,59999,False,106,scaffold_8
23,5750001,5775000,24999,False,106,scaffold_8
24,5776001,5801000,24999,False,106,scaffold_8
25,5837001,5996000,158999,False,106,scaffold_8
26,6026001,6089000,62999,False,106,scaffold_8
27,6229001,6308000,78999,False,106,scaffold_8
28,6320001,6334544,14543,True,106,scaffold_8
0,1001,22000,20999,False,106,scaffold_9
1,109001,118000,8999,False,106,scaffold_9
2,303001,316000,12999,False,106,scaffold_9
3,319001,332000,12999,False,106,scaffold_9
4,366001,411000,44999,False,106,scaffold_9
5,413001,434000,20999,False,106,scaffold_9
6,486001,531000,44999,False,106,scaffold_9
7,670001,696000,25999,False,106,scaffold_9
8,815001,842000,26999,False,106,scaffold_9
9,873001,986000,112999,False,106,scaffold_9
10,987001,995000,7999,False,106,scaffold_9
11,1009001,1085000,75999,False,106,scaffold_9
12,1087001,1150000,62999,False,106,scaffold_9
13,1151001,1160000,8999,False,106,scaffold_9
14,1312001,1387000,74999,False,106,scaffold_9
15,1427001,1438000,10999,False,106,scaffold_9
16,1457001,1464000,6999,False,106,scaffold_9
17,1516001,1591000,74999,False,106,scaffold_9
18,1596001,1621000,24999,False,106,scaffold_9
19,1652001,1691000,38999,False,106,scaffold_9
20,1749001,1795000,45999,False,106,scaffold_9
21,1830001,1855000,24999,False,106,scaffold_9
22,1889001,1956000,66999,False,106,scaffold_9
23,1987001,2135000,147999,False,106,scaffold_9
24,2136001,2171000,34999,False,106,scaffold_9
25,2174001,2374000,199999,False,106,scaffold_9
26,2390001,2467000,76999,False,106,scaffold_9
27,2511001,2582000,70999,False,106,scaffold_9
28,2584001,2673000,88999,False,106,scaffold_9
29,2674001,2721000,46999,False,106,scaffold_9
30,2735001,3381000,645999,False,106,scaffold_9
31,3383001,5107000,1723999,False,106,scaffold_9
32,5112001,5238000,125999,False,106,scaffold_9
33,5239001,5298000,58999,False,106,scaffold_9
34,5300001,5491000,190999,False,106,scaffold_9
35,5492001,6331288,839287,True,106,scaffold_9
0,1,414000,413999,True,106,scaffold_10
1,416001,482000,65999,False,106,scaffold_10
2,483001,585000,101999,False,106,scaffold_10
3,596001,1069000,472999,False,106,scaffold_10
4,1072001,1165000,92999,False,106,scaffold_10
5,1276001,1337000,60999,False,106,scaffold_10
6,1371001,1472000,100999,False,106,scaffold_10
7,1500001,1546000,45999,False,106,scaffold_10
8,1601001,1675000,73999,False,106,scaffold_10
9,1696001,1728000,31999,False,106,scaffold_10
10,1805001,1817000,11999,False,106,scaffold_10
11,1861001,1918000,56999,False,106,scaffold_10
12,2040001,2056000,15999,False,106,scaffold_10
13,2076001,2113000,36999,False,106,scaffold_10
14,2137001,2177000,39999,False,106,scaffold_10
15,2198001,2333000,134999,False,106,scaffold_10
16,2334001,2425000,90999,False,106,scaffold_10
17,2437001,2475000,37999,False,106,scaffold_10
18,2521001,2640000,118999,False,106,scaffold_10
19,2641001,2653000,11999,False,106,scaffold_10
20,2669001,2812000,142999,False,106,scaffold_10
21,2817001,2860000,42999,False,106,scaffold_10
22,2930001,2954000,23999,False,106,scaffold_10
23,3119001,3133000,13999,False,106,scaffold_10
24,3155001,3177000,21999,False,106,scaffold_10
25,4053001,4091000,37999,False,106,scaffold_10
26,4156001,4175000,18999,False,106,scaffold_10
27,4335001,4365000,29999,False,106,scaffold_10
28,4443001,4462000,18999,False,106,scaffold_10
29,4467001,4477000,9999,False,106,scaffold_10
30,4503001,4513000,9999,False,106,scaffold_10
31,4515001,4523000,7999,False,106,scaffold_10
32,4526001,4547000,20999,False,106,scaffold_10
33,4574001,4596000,21999,False,106,scaffold_10
34,4734001,4776000,41999,False,106,scaffold_10
35,4798001,4824000,25999,False,106,scaffold_10
36,4827001,4843000,15999,False,106,scaffold_10
37,4848001,4861000,12999,False,106,scaffold_10
38,4865001,4866973,1972,True,106,scaffold_10
0,10001,34000,23999,False,106,scaffold_11
1,38001,99000,60999,False,106,scaffold_11
2,148001,167000,18999,False,106,scaffold_11
3,169001,235000,65999,False,106,scaffold_11
4,240001,246000,5999,False,106,scaffold_11
5,296001,312000,15999,False,106,scaffold_11
6,419001,431000,11999,False,106,scaffold_11
7,637001,656000,18999,False,106,scaffold_11
8,781001,785000,3999,False,106,scaffold_11
9,1025001,1034000,8999,False,106,scaffold_11
10,1219001,1243000,23999,False,106,scaffold_11
11,1304001,1314000,9999,False,106,scaffold_11
12,1315001,1339000,23999,False,106,scaffold_11
13,1385001,1398000,12999,False,106,scaffold_11
14,1423001,1426000,2999,False,106,scaffold_11
15,1432001,1451000,18999,False,106,scaffold_11
16,1474001,1478000,3999,False,106,scaffold_11
17,1525001,1544000,18999,False,106,scaffold_11
18,1904001,1984000,79999,False,106,scaffold_11
19,2090001,2172000,81999,False,106,scaffold_11
20,2176001,2191000,14999,False,106,scaffold_11
21,2192001,2224000,31999,False,106,scaffold_11
22,2701001,2920000,218999,False,106,scaffold_11
23,2952001,3030000,77999,False,106,scaffold_11
24,3061001,3181000,119999,False,106,scaffold_11
25,3184001,3383000,198999,False,106,scaffold_11
26,3399001,3478000,78999,False,106,scaffold_11
27,3520001,4161000,640999,False,106,scaffold_11
28,4180001,4710000,529999,False,106,scaffold_11
29,4713001,4766820,53819,True,106,scaffold_11
0,1,1496000,1495999,True,106,scaffold_12
1,1570001,1589000,18999,False,106,scaffold_12
2,1638001,1666000,27999,False,106,scaffold_12
3,1713001,1733000,19999,False,106,scaffold_12
4,1783001,1810000,26999,False,106,scaffold_12
5,1882001,1933000,50999,False,106,scaffold_12
6,1938001,1960000,21999,False,106,scaffold_12
7,1971001,2000000,28999,False,106,scaffold_12
8,2024001,2041000,16999,False,106,scaffold_12
9,2043001,2103000,59999,False,106,scaffold_12
10,2129001,2180000,50999,False,106,scaffold_12
11,2340001,2379000,38999,False,106,scaffold_12
12,2571001,2612000,40999,False,106,scaffold_12
0,1,342000,341999,True,107,scaffold_1
1,482001,498000,15999,False,107,scaffold_1
2,571001,643000,71999,False,107,scaffold_1
3,686001,759000,72999,False,107,scaffold_1
4,1821001,1897000,75999,False,107,scaffold_1
5,1954001,1964000,9999,False,107,scaffold_1
6,1965001,1984000,18999,False,107,scaffold_1
7,2449001,2517000,67999,False,107,scaffold_1
8,2729001,2746000,16999,False,107,scaffold_1
9,3179001,3208000,28999,False,107,scaffold_1
10,3715001,3733000,17999,False,107,scaffold_1
11,3925001,3934000,8999,False,107,scaffold_1
12,4065001,4111000,45999,False,107,scaffold_1
13,4322001,4354000,31999,False,107,scaffold_1
14,4927001,4997000,69999,False,107,scaffold_1
15,5483001,5511000,27999,False,107,scaffold_1
16,5536001,5572000,35999,False,107,scaffold_1
17,6108001,6153000,44999,False,107,scaffold_1
18,6228001,6376000,147999,False,107,scaffold_1
19,6384001,6507000,122999,False,107,scaffold_1
20,6544001,6555000,10999,False,107,scaffold_1
21,7038001,7247000,208999,False,107,scaffold_1
22,7248001,7588000,339999,False,107,scaffold_1
23,7590001,8477000,886999,False,107,scaffold_1
24,8478001,8656000,177999,False,107,scaffold_1
25,8658001,9584000,925999,False,107,scaffold_1
26,9586001,10354000,767999,False,107,scaffold_1
27,10461001,10630000,168999,False,107,scaffold_1
28,10808001,10811000,2999,False,107,scaffold_1
29,10839001,10858000,18999,False,107,scaffold_1
30,11347001,11504000,156999,False,107,scaffold_1
31,11614001,11924000,309999,False,107,scaffold_1
32,12184001,12204000,19999,False,107,scaffold_1
33,12666001,12722000,55999,False,107,scaffold_1
34,12777001,12888000,110999,False,107,scaffold_1
35,13113001,13211000,97999,False,107,scaffold_1
36,13347001,13404000,56999,False,107,scaffold_1
37,14295001,14307000,11999,False,107,scaffold_1
0,21001,48000,26999,False,107,scaffold_2
1,93001,159000,65999,False,107,scaffold_2
2,168001,177000,8999,False,107,scaffold_2
3,333001,374000,40999,False,107,scaffold_2
4,2336001,2358000,21999,False,107,scaffold_2
5,2405001,2424000,18999,False,107,scaffold_2
6,2441001,2553000,111999,False,107,scaffold_2
7,2660001,2689000,28999,False,107,scaffold_2
8,2694001,2742000,47999,False,107,scaffold_2
9,2868001,2899000,30999,False,107,scaffold_2
10,2996001,3011000,14999,False,107,scaffold_2
11,3336001,3341000,4999,False,107,scaffold_2
12,3454001,3464000,9999,False,107,scaffold_2
13,3767001,3782000,14999,False,107,scaffold_2
14,4383001,4409000,25999,False,107,scaffold_2
15,4437001,4445000,7999,False,107,scaffold_2
16,4521001,4655000,133999,False,107,scaffold_2
17,4919001,4935000,15999,False,107,scaffold_2
18,5022001,5031000,8999,False,107,scaffold_2
19,5033001,5061000,27999,False,107,scaffold_2
20,5491001,5512000,20999,False,107,scaffold_2
21,5667001,5704000,36999,False,107,scaffold_2
22,6261001,6330000,68999,False,107,scaffold_2
23,6331001,6342000,10999,False,107,scaffold_2
24,6430001,6447000,16999,False,107,scaffold_2
25,7439001,7472000,32999,False,107,scaffold_2
26,7563001,7697000,133999,False,107,scaffold_2
27,7786001,7891000,104999,False,107,scaffold_2
28,7934001,8161000,226999,False,107,scaffold_2
29,8267001,8294000,26999,False,107,scaffold_2
30,8331001,8333000,1999,False,107,scaffold_2
31,8340001,8345000,4999,False,107,scaffold_2
32,8346001,8389000,42999,False,107,scaffold_2
33,8436001,8454000,17999,False,107,scaffold_2
34,8509001,8535000,25999,False,107,scaffold_2
35,11367001,11374000,6999,False,107,scaffold_2
36,11520001,11785000,264999,False,107,scaffold_2
0,51001,55000,3999,False,107,scaffold_3
1,528001,539000,10999,False,107,scaffold_3
2,799001,900000,100999,False,107,scaffold_3
3,2079001,2108000,28999,False,107,scaffold_3
4,2291001,2321000,29999,False,107,scaffold_3
5,2487001,2533000,45999,False,107,scaffold_3
6,4108001,4403000,294999,False,107,scaffold_3
7,4410001,4518000,107999,False,107,scaffold_3
8,4547001,4558000,10999,False,107,scaffold_3
9,4652001,4680000,27999,False,107,scaffold_3
10,6911001,6962000,50999,False,107,scaffold_3
11,6963001,6970000,6999,False,107,scaffold_3
12,6979001,7078000,98999,False,107,scaffold_3
13,7540001,7556000,15999,False,107,scaffold_3
14,7692001,7798000,105999,False,107,scaffold_3
15,7823001,7839000,15999,False,107,scaffold_3
16,8177001,8253000,75999,False,107,scaffold_3
17,8462001,8527000,64999,False,107,scaffold_3
18,8575001,8594000,18999,False,107,scaffold_3
19,9968001,9995000,26999,False,107,scaffold_3
20,10461001,10484000,22999,False,107,scaffold_3
21,10587001,11165000,577999,False,107,scaffold_3
0,17001,32000,14999,False,107,scaffold_4
1,48001,88000,39999,False,107,scaffold_4
2,132001,146000,13999,False,107,scaffold_4
3,147001,151000,3999,False,107,scaffold_4
4,155001,215000,59999,False,107,scaffold_4
5,217001,226000,8999,False,107,scaffold_4
6,228001,266000,37999,False,107,scaffold_4
7,291001,311000,19999,False,107,scaffold_4
8,331001,344000,12999,False,107,scaffold_4
9,346001,353000,6999,False,107,scaffold_4
10,355001,374000,18999,False,107,scaffold_4
11,375001,380000,4999,False,107,scaffold_4
12,412001,425000,12999,False,107,scaffold_4
13,429001,498000,68999,False,107,scaffold_4
14,543001,592000,48999,False,107,scaffold_4
15,600001,606000,5999,False,107,scaffold_4
16,608001,691000,82999,False,107,scaffold_4
17,701001,714000,12999,False,107,scaffold_4
18,1121001,1136000,14999,False,107,scaffold_4
19,1137001,1178000,40999,False,107,scaffold_4
20,1199001,1208000,8999,False,107,scaffold_4
21,1210001,1226000,15999,False,107,scaffold_4
22,1254001,1262000,7999,False,107,scaffold_4
23,1265001,1279000,13999,False,107,scaffold_4
24,1283001,1335000,51999,False,107,scaffold_4
25,1372001,1591000,218999,False,107,scaffold_4
26,1613001,1696000,82999,False,107,scaffold_4
27,1728001,1817000,88999,False,107,scaffold_4
28,1852001,1897000,44999,False,107,scaffold_4
29,1904001,2000000,95999,False,107,scaffold_4
30,2036001,2065000,28999,False,107,scaffold_4
31,2247001,2279000,31999,False,107,scaffold_4
32,2284001,2310000,25999,False,107,scaffold_4
33,2312001,2339000,26999,False,107,scaffold_4
34,2396001,2461000,64999,False,107,scaffold_4
35,2476001,2533000,56999,False,107,scaffold_4
36,2600001,2635000,34999,False,107,scaffold_4
37,3336001,3633000,296999,False,107,scaffold_4
38,3676001,3760000,83999,False,107,scaffold_4
39,4944001,4984000,39999,False,107,scaffold_4
40,5477001,5506000,28999,False,107,scaffold_4
41,5514001,5620000,105999,False,107,scaffold_4
42,5659001,5784000,124999,False,107,scaffold_4
43,6805001,6817000,11999,False,107,scaffold_4
44,7036001,7062000,25999,False,107,scaffold_4
45,8846001,9699000,852999,False,107,scaffold_4
46,9700001,9845951,145950,True,107,scaffold_4
0,1,4000,3999,True,107,scaffold_5
1,28001,32000,3999,False,107,scaffold_5
2,190001,204000,13999,False,107,scaffold_5
3,318001,326000,7999,False,107,scaffold_5
4,327001,368000,40999,False,107,scaffold_5
5,464001,523000,58999,False,107,scaffold_5
6,933001,947000,13999,False,107,scaffold_5
7,2565001,2581000,15999,False,107,scaffold_5
8,2625001,2732000,106999,False,107,scaffold_5
9,2815001,2871000,55999,False,107,scaffold_5
10,3136001,3185000,48999,False,107,scaffold_5
11,3322001,3496000,173999,False,107,scaffold_5
12,3962001,4101000,138999,False,107,scaffold_5
13,4121001,4219000,97999,False,107,scaffold_5
14,4246001,4265000,18999,False,107,scaffold_5
15,4446001,4483000,36999,False,107,scaffold_5
16,4602001,4679000,76999,False,107,scaffold_5
17,4691001,4718000,26999,False,107,scaffold_5
18,4819001,4861000,41999,False,107,scaffold_5
19,4904001,4917000,12999,False,107,scaffold_5
20,5318001,5346000,27999,False,107,scaffold_5
21,6534001,6566000,31999,False,107,scaffold_5
22,7623001,7637000,13999,False,107,scaffold_5
23,8730001,9364176,634175,True,107,scaffold_5
0,79001,85000,5999,False,107,scaffold_6
1,86001,114000,27999,False,107,scaffold_6
2,240001,254000,13999,False,107,scaffold_6
3,267001,278000,10999,False,107,scaffold_6
4,1241001,1256000,14999,False,107,scaffold_6
5,1479001,1546000,66999,False,107,scaffold_6
6,1869001,1906000,36999,False,107,scaffold_6
7,2023001,2087000,63999,False,107,scaffold_6
8,2130001,2178000,47999,False,107,scaffold_6
9,2371001,2595000,223999,False,107,scaffold_6
10,2596001,2653000,56999,False,107,scaffold_6
11,2661001,2691000,29999,False,107,scaffold_6
12,2731001,2851000,119999,False,107,scaffold_6
13,2933001,3014000,80999,False,107,scaffold_6
14,3115001,3150000,34999,False,107,scaffold_6
15,3224001,3301000,76999,False,107,scaffold_6
16,3407001,3428000,20999,False,107,scaffold_6
17,3461001,3766000,304999,False,107,scaffold_6
18,3901001,3912000,10999,False,107,scaffold_6
19,4018001,4072000,53999,False,107,scaffold_6
20,4073001,4192000,118999,False,107,scaffold_6
21,6011001,6060000,48999,False,107,scaffold_6
22,7269001,7337000,67999,False,107,scaffold_6
23,7560001,7796000,235999,False,107,scaffold_6
24,7811001,8268281,457280,True,107,scaffold_6
0,1,7000,6999,True,107,scaffold_7
1,13001,34000,20999,False,107,scaffold_7
2,169001,171000,1999,False,107,scaffold_7
3,323001,340000,16999,False,107,scaffold_7
4,342001,508000,165999,False,107,scaffold_7
5,554001,563000,8999,False,107,scaffold_7
6,571001,577000,5999,False,107,scaffold_7
7,706001,736000,29999,False,107,scaffold_7
8,764001,809000,44999,False,107,scaffold_7
9,859001,864000,4999,False,107,scaffold_7
10,949001,963000,13999,False,107,scaffold_7
11,964001,966000,1999,False,107,scaffold_7
12,982001,1044000,61999,False,107,scaffold_7
13,1191001,1512000,320999,False,107,scaffold_7
14,1588001,1688000,99999,False,107,scaffold_7
15,3326001,3369000,42999,False,107,scaffold_7
16,3524001,3550000,25999,False,107,scaffold_7
17,3597001,3766000,168999,False,107,scaffold_7
18,4415001,4517000,101999,False,107,scaffold_7
19,4658001,4733000,74999,False,107,scaffold_7
20,4979001,5111000,131999,False,107,scaffold_7
21,5484001,5515000,30999,False,107,scaffold_7
22,6954001,7502216,548215,True,107,scaffold_7
0,3001,6000,2999,False,107,scaffold_8
1,67001,85000,17999,False,107,scaffold_8
2,93001,101000,7999,False,107,scaffold_8
3,2446001,2469000,22999,False,107,scaffold_8
4,2492001,2514000,21999,False,107,scaffold_8
5,2661001,2683000,21999,False,107,scaffold_8
6,2742001,2757000,14999,False,107,scaffold_8
7,2827001,2844000,16999,False,107,scaffold_8
8,3059001,3525000,465999,False,107,scaffold_8
9,3584001,3612000,27999,False,107,scaffold_8
10,3615001,3913000,297999,False,107,scaffold_8
11,5124001,5135000,10999,False,107,scaffold_8
12,5198001,5241000,42999,False,107,scaffold_8
13,6322001,6334544,12543,True,107,scaffold_8
0,1001,22000,20999,False,107,scaffold_9
1,109001,117000,7999,False,107,scaffold_9
2,121001,134000,12999,False,107,scaffold_9
3,319001,332000,12999,False,107,scaffold_9
4,367001,411000,43999,False,107,scaffold_9
5,413001,434000,20999,False,107,scaffold_9
6,436001,441000,4999,False,107,scaffold_9
7,502001,531000,28999,False,107,scaffold_9
8,671001,696000,24999,False,107,scaffold_9
9,731001,742000,10999,False,107,scaffold_9
10,816001,843000,26999,False,107,scaffold_9
11,850001,854000,3999,False,107,scaffold_9
12,886001,986000,99999,False,107,scaffold_9
13,987001,995000,7999,False,107,scaffold_9
14,1001001,1007000,5999,False,107,scaffold_9
15,1010001,1031000,20999,False,107,scaffold_9
16,1035001,1085000,49999,False,107,scaffold_9
17,1087001,1150000,62999,False,107,scaffold_9
18,1151001,1165000,13999,False,107,scaffold_9
19,1313001,1377000,63999,False,107,scaffold_9
20,1766001,1791000,24999,False,107,scaffold_9
21,2601001,2616000,14999,False,107,scaffold_9
22,2783001,2802000,18999,False,107,scaffold_9
23,2871001,3381000,509999,False,107,scaffold_9
24,3383001,5107000,1723999,False,107,scaffold_9
25,5112001,5238000,125999,False,107,scaffold_9
26,5239001,5298000,58999,False,107,scaffold_9
27,5300001,5490000,189999,False,107,scaffold_9
28,5493001,6331288,838287,True,107,scaffold_9
0,1,235000,234999,True,107,scaffold_10
1,336001,405000,68999,False,107,scaffold_10
2,472001,482000,9999,False,107,scaffold_10
3,483001,576000,92999,False,107,scaffold_10
4,603001,749000,145999,False,107,scaffold_10
5,888001,917000,28999,False,107,scaffold_10
6,923001,962000,38999,False,107,scaffold_10
7,1087001,1105000,17999,False,107,scaffold_10
8,3264001,3268000,3999,False,107,scaffold_10
9,3272001,3274000,1999,False,107,scaffold_10
10,4053001,4091000,37999,False,107,scaffold_10
11,4154001,4174000,19999,False,107,scaffold_10
12,4444001,4460000,15999,False,107,scaffold_10
13,4467001,4476000,8999,False,107,scaffold_10
14,4506001,4513000,6999,False,107,scaffold_10
15,4515001,4523000,7999,False,107,scaffold_10
16,4526001,4548000,21999,False,107,scaffold_10
17,4565001,4596000,30999,False,107,scaffold_10
18,4680001,4688000,7999,False,107,scaffold_10
19,4734001,4751000,16999,False,107,scaffold_10
20,4752001,4766000,13999,False,107,scaffold_10
21,4769001,4776000,6999,False,107,scaffold_10
22,4798001,4824000,25999,False,107,scaffold_10
23,4827001,4843000,15999,False,107,scaffold_10
24,4848001,4861000,12999,False,107,scaffold_10
25,4865001,4866973,1972,True,107,scaffold_10
0,10001,34000,23999,False,107,scaffold_11
1,40001,93000,52999,False,107,scaffold_11
2,149001,168000,18999,False,107,scaffold_11
3,169001,191000,21999,False,107,scaffold_11
4,213001,235000,21999,False,107,scaffold_11
5,240001,248000,7999,False,107,scaffold_11
6,419001,431000,11999,False,107,scaffold_11
7,648001,656000,7999,False,107,scaffold_11
8,949001,951000,1999,False,107,scaffold_11
9,1025001,1034000,8999,False,107,scaffold_11
10,1403001,1409000,5999,False,107,scaffold_11
11,1423001,1426000,2999,False,107,scaffold_11
12,1474001,1477000,2999,False,107,scaffold_11
13,2701001,2876000,174999,False,107,scaffold_11
14,3188001,3254000,65999,False,107,scaffold_11
15,3331001,3383000,51999,False,107,scaffold_11
16,3702001,3933000,230999,False,107,scaffold_11
17,4318001,4710000,391999,False,107,scaffold_11
18,4713001,4766820,53819,True,107,scaffold_11
0,1,370000,369999,True,107,scaffold_12
1,474001,537000,62999,False,107,scaffold_12
2,581001,738000,156999,False,107,scaffold_12
3,739001,856000,116999,False,107,scaffold_12
4,865001,1430000,564999,False,107,scaffold_12
5,1720001,1733000,12999,False,107,scaffold_12
6,2571001,2610000,38999,False,107,scaffold_12
0,1,342000,341999,True,108,scaffold_1
1,482001,498000,15999,False,108,scaffold_1
2,571001,643000,71999,False,108,scaffold_1
3,686001,748000,61999,False,108,scaffold_1
4,1280001,1292000,11999,False,108,scaffold_1
5,1615001,1660000,44999,False,108,scaffold_1
6,1819001,1899000,79999,False,108,scaffold_1
7,1954001,1984000,29999,False,108,scaffold_1
8,1987001,1996000,8999,False,108,scaffold_1
9,2449001,2517000,67999,False,108,scaffold_1
10,2729001,2746000,16999,False,108,scaffold_1
11,3180001,3209000,28999,False,108,scaffold_1
12,3714001,3735000,20999,False,108,scaffold_1
13,3916001,3941000,24999,False,108,scaffold_1
14,4003001,4030000,26999,False,108,scaffold_1
15,4061001,4111000,49999,False,108,scaffold_1
16,4315001,4354000,38999,False,108,scaffold_1
17,4928001,5022000,93999,False,108,scaffold_1
18,5481001,5511000,29999,False,108,scaffold_1
19,5535001,5570000,34999,False,108,scaffold_1
20,6108001,6153000,44999,False,108,scaffold_1
21,6154001,6176000,21999,False,108,scaffold_1
22,6202001,6380000,177999,False,108,scaffold_1
23,6384001,6509000,124999,False,108,scaffold_1
24,6543001,6558000,14999,False,108,scaffold_1
25,7038001,7247000,208999,False,108,scaffold_1
26,7248001,7583000,334999,False,108,scaffold_1
27,7590001,8656000,1065999,False,108,scaffold_1
28,8658001,9584000,925999,False,108,scaffold_1
29,9586001,10355000,768999,False,108,scaffold_1
30,10460001,10628000,167999,False,108,scaffold_1
31,10808001,10811000,2999,False,108,scaffold_1
32,10839001,10856000,16999,False,108,scaffold_1
33,11344001,11504000,159999,False,108,scaffold_1
34,11614001,11951000,336999,False,108,scaffold_1
35,12184001,12204000,19999,False,108,scaffold_1
36,12661001,12722000,60999,False,108,scaffold_1
37,12775001,12888000,112999,False,108,scaffold_1
38,13113001,13212000,98999,False,108,scaffold_1
39,13347001,13403000,55999,False,108,scaffold_1
40,14290001,14307000,16999,False,108,scaffold_1
41,14455001,14457000,1999,False,108,scaffold_1
42,14471001,14476000,4999,False,108,scaffold_1
43,14742001,14752000,9999,False,108,scaffold_1
0,21001,48000,26999,False,108,scaffold_2
1,93001,159000,65999,False,108,scaffold_2
2,168001,177000,8999,False,108,scaffold_2
3,302001,318000,15999,False,108,scaffold_2
4,333001,374000,40999,False,108,scaffold_2
5,2336001,2358000,21999,False,108,scaffold_2
6,2405001,2424000,18999,False,108,scaffold_2
7,2436001,2600000,163999,False,108,scaffold_2
8,2660001,2689000,28999,False,108,scaffold_2
9,2694001,2745000,50999,False,108,scaffold_2
10,2993001,3017000,23999,False,108,scaffold_2
11,3333001,3344000,10999,False,108,scaffold_2
12,3454001,3464000,9999,False,108,scaffold_2
13,3759001,3783000,23999,False,108,scaffold_2
14,4383001,4409000,25999,False,108,scaffold_2
15,4430001,4455000,24999,False,108,scaffold_2
16,4521001,4655000,133999,False,108,scaffold_2
17,4918001,4954000,35999,False,108,scaffold_2
18,5021001,5061000,39999,False,108,scaffold_2
19,5370001,5394000,23999,False,108,scaffold_2
20,5491001,5512000,20999,False,108,scaffold_2
21,5658001,5704000,45999,False,108,scaffold_2
22,5840001,5887000,46999,False,108,scaffold_2
23,6261001,6330000,68999,False,108,scaffold_2
24,6331001,6351000,19999,False,108,scaffold_2
25,6407001,6449000,41999,False,108,scaffold_2
26,6593001,6628000,34999,False,108,scaffold_2
27,7007001,7038000,30999,False,108,scaffold_2
28,7064001,7096000,31999,False,108,scaffold_2
29,7429001,7477000,47999,False,108,scaffold_2
30,7549001,7561000,11999,False,108,scaffold_2
31,7563001,7697000,133999,False,108,scaffold_2
32,7782001,7890000,107999,False,108,scaffold_2
33,7933001,8163000,229999,False,108,scaffold_2
34,8167001,8169000,1999,False,108,scaffold_2
35,8185001,8200000,14999,False,108,scaffold_2
36,8201001,8202000,999,False,108,scaffold_2
37,8261001,8294000,32999,False,108,scaffold_2
38,8331001,8333000,1999,False,108,scaffold_2
39,8346001,8453000,106999,False,108,scaffold_2
40,8495001,8562000,66999,False,108,scaffold_2
41,11366001,11374000,7999,False,108,scaffold_2
42,11520001,11786000,265999,False,108,scaffold_2
0,1,2000,1999,True,108,scaffold_3
1,3001,6000,2999,False,108,scaffold_3
2,51001,55000,3999,False,108,scaffold_3
3,102001,104000,1999,False,108,scaffold_3
4,799001,901000,101999,False,108,scaffold_3
5,2044001,2108000,63999,False,108,scaffold_3
6,2109001,2115000,5999,False,108,scaffold_3
7,2291001,2335000,43999,False,108,scaffold_3
8,2487001,2531000,43999,False,108,scaffold_3
9,3768001,3821000,52999,False,108,scaffold_3
10,3822001,3891000,68999,False,108,scaffold_3
11,4108001,4398000,289999,False,108,scaffold_3
12,4416001,4518000,101999,False,108,scaffold_3
13,4546001,4558000,11999,False,108,scaffold_3
14,4651001,4686000,34999,False,108,scaffold_3
15,5989001,6024000,34999,False,108,scaffold_3
16,6744001,6782000,37999,False,108,scaffold_3
17,6909001,6962000,52999,False,108,scaffold_3
18,6980001,7089000,108999,False,108,scaffold_3
19,7336001,7399000,62999,False,108,scaffold_3
20,7524001,7556000,31999,False,108,scaffold_3
21,7692001,7854000,161999,False,108,scaffold_3
22,8177001,8253000,75999,False,108,scaffold_3
23,8462001,8527000,64999,False,108,scaffold_3
24,8575001,8594000,18999,False,108,scaffold_3
25,9064001,9075000,10999,False,108,scaffold_3
26,9968001,9996000,27999,False,108,scaffold_3
27,10461001,10484000,22999,False,108,scaffold_3
28,10587001,11165000,577999,False,108,scaffold_3
0,17001,32000,14999,False,108,scaffold_4
1,48001,88000,39999,False,108,scaffold_4
2,155001,160000,4999,False,108,scaffold_4
3,161001,215000,53999,False,108,scaffold_4
4,218001,226000,7999,False,108,scaffold_4
5,227001,266000,38999,False,108,scaffold_4
6,290001,307000,16999,False,108,scaffold_4
7,313001,344000,30999,False,108,scaffold_4
8,355001,374000,18999,False,108,scaffold_4
9,375001,380000,4999,False,108,scaffold_4
10,412001,425000,12999,False,108,scaffold_4
11,429001,498000,68999,False,108,scaffold_4
12,545001,592000,46999,False,108,scaffold_4
13,608001,691000,82999,False,108,scaffold_4
14,695001,697000,1999,False,108,scaffold_4
15,701001,717000,15999,False,108,scaffold_4
16,1121001,1136000,14999,False,108,scaffold_4
17,1138001,1178000,39999,False,108,scaffold_4
18,1199001,1208000,8999,False,108,scaffold_4
19,1210001,1226000,15999,False,108,scaffold_4
20,1235001,1246000,10999,False,108,scaffold_4
21,1254001,1262000,7999,False,108,scaffold_4
22,1265001,1279000,13999,False,108,scaffold_4
23,1283001,1315000,31999,False,108,scaffold_4
24,1357001,1598000,240999,False,108,scaffold_4
25,1613001,1957000,343999,False,108,scaffold_4
26,1958001,2005000,46999,False,108,scaffold_4
27,2026001,2117000,90999,False,108,scaffold_4
28,2219001,2246000,26999,False,108,scaffold_4
29,2247001,2279000,31999,False,108,scaffold_4
30,2284001,2340000,55999,False,108,scaffold_4
31,2477001,2582000,104999,False,108,scaffold_4
32,2599001,2635000,35999,False,108,scaffold_4
33,3095001,3123000,27999,False,108,scaffold_4
34,3335001,3760000,424999,False,108,scaffold_4
35,4941001,4985000,43999,False,108,scaffold_4
36,4987001,5000000,12999,False,108,scaffold_4
37,5176001,5187000,10999,False,108,scaffold_4
38,5477001,5506000,28999,False,108,scaffold_4
39,5514001,5620000,105999,False,108,scaffold_4
40,5658001,5784000,125999,False,108,scaffold_4
41,5786001,5825000,38999,False,108,scaffold_4
42,6145001,6195000,49999,False,108,scaffold_4
43,6796001,6817000,20999,False,108,scaffold_4
44,6901001,6924000,22999,False,108,scaffold_4
45,7036001,7062000,25999,False,108,scaffold_4
46,7227001,7268000,40999,False,108,scaffold_4
47,8846001,9699000,852999,False,108,scaffold_4
48,9700001,9845951,145950,True,108,scaffold_4
0,318001,368000,49999,False,108,scaffold_5
1,463001,523000,59999,False,108,scaffold_5
2,836001,842000,5999,False,108,scaffold_5
3,933001,947000,13999,False,108,scaffold_5
4,2475001,2493000,17999,False,108,scaffold_5
5,2556001,2582000,25999,False,108,scaffold_5
6,2623001,2740000,116999,False,108,scaffold_5
7,2814001,2874000,59999,False,108,scaffold_5
8,3133001,3185000,51999,False,108,scaffold_5
9,3216001,3256000,39999,False,108,scaffold_5
10,3322001,3514000,191999,False,108,scaffold_5
11,3962001,4101000,138999,False,108,scaffold_5
12,4121001,4219000,97999,False,108,scaffold_5
13,4246001,4272000,25999,False,108,scaffold_5
14,4446001,4535000,88999,False,108,scaffold_5
15,4603001,4681000,77999,False,108,scaffold_5
16,4690001,4717000,26999,False,108,scaffold_5
17,4760001,4861000,100999,False,108,scaffold_5
18,4892001,4919000,26999,False,108,scaffold_5
19,5258001,5274000,15999,False,108,scaffold_5
20,5287001,5312000,24999,False,108,scaffold_5
21,5314001,5344000,29999,False,108,scaffold_5
22,6410001,6418000,7999,False,108,scaffold_5
23,6454001,6651000,196999,False,108,scaffold_5
24,7454001,7483000,28999,False,108,scaffold_5
25,7559001,7610000,50999,False,108,scaffold_5
26,7621001,7657000,35999,False,108,scaffold_5
27,8554001,8599000,44999,False,108,scaffold_5
28,8666001,8689000,22999,False,108,scaffold_5
29,8730001,9363000,632999,False,108,scaffold_5
0,79001,84000,4999,False,108,scaffold_6
1,86001,112000,25999,False,108,scaffold_6
2,174001,185000,10999,False,108,scaffold_6
3,240001,254000,13999,False,108,scaffold_6
4,256001,262000,5999,False,108,scaffold_6
5,267001,297000,29999,False,108,scaffold_6
6,1235001,1256000,20999,False,108,scaffold_6
7,1478001,1546000,67999,False,108,scaffold_6
8,1868001,1906000,37999,False,108,scaffold_6
9,2023001,2101000,77999,False,108,scaffold_6
10,2130001,2179000,48999,False,108,scaffold_6
11,2336001,2595000,258999,False,108,scaffold_6
12,2596001,2691000,94999,False,108,scaffold_6
13,2712001,2852000,139999,False,108,scaffold_6
14,2934001,2981000,46999,False,108,scaffold_6
15,2982001,3014000,31999,False,108,scaffold_6
16,3098001,3177000,78999,False,108,scaffold_6
17,3224001,3306000,81999,False,108,scaffold_6
18,3400001,3429000,28999,False,108,scaffold_6
19,3462001,3786000,323999,False,108,scaffold_6
20,4018001,4072000,53999,False,108,scaffold_6
21,4073001,4121000,47999,False,108,scaffold_6
22,4136001,4193000,56999,False,108,scaffold_6
23,6004001,6063000,58999,False,108,scaffold_6
24,7263001,7337000,73999,False,108,scaffold_6
25,7388001,7436000,47999,False,108,scaffold_6
26,7547001,8268281,721280,True,108,scaffold_6
0,13001,34000,20999,False,108,scaffold_7
1,323001,340000,16999,False,108,scaffold_7
2,342001,508000,165999,False,108,scaffold_7
3,554001,563000,8999,False,108,scaffold_7
4,571001,577000,5999,False,108,scaffold_7
5,706001,724000,17999,False,108,scaffold_7
6,725001,736000,10999,False,108,scaffold_7
7,764001,822000,57999,False,108,scaffold_7
8,859001,864000,4999,False,108,scaffold_7
9,868001,872000,3999,False,108,scaffold_7
10,876001,901000,24999,False,108,scaffold_7
11,982001,1044000,61999,False,108,scaffold_7
12,1048001,1101000,52999,False,108,scaffold_7
13,1204001,1512000,307999,False,108,scaffold_7
14,1588001,1688000,99999,False,108,scaffold_7
15,3292001,3312000,19999,False,108,scaffold_7
16,3325001,3369000,43999,False,108,scaffold_7
17,3537001,3547000,9999,False,108,scaffold_7
18,3593001,3766000,172999,False,108,scaffold_7
19,4415001,4475000,59999,False,108,scaffold_7
20,4477001,4517000,39999,False,108,scaffold_7
21,4658001,4737000,78999,False,108,scaffold_7
22,4979001,5149000,169999,False,108,scaffold_7
23,5496001,5512000,15999,False,108,scaffold_7
24,6954001,7270000,315999,False,108,scaffold_7
25,7271001,7502216,231215,True,108,scaffold_7
0,1,6000,5999,True,108,scaffold_8
1,66001,85000,18999,False,108,scaffold_8
2,2443001,2530000,86999,False,108,scaffold_8
3,2536001,2551000,14999,False,108,scaffold_8
4,2653001,2683000,29999,False,108,scaffold_8
5,2742001,2761000,18999,False,108,scaffold_8
6,2798001,2844000,45999,False,108,scaffold_8
7,3058001,3525000,466999,False,108,scaffold_8
8,3577001,3612000,34999,False,108,scaffold_8
9,3615001,3937000,321999,False,108,scaffold_8
10,4038001,4099000,60999,False,108,scaffold_8
11,5088001,5136000,47999,False,108,scaffold_8
12,5189001,5241000,51999,False,108,scaffold_8
13,6323001,6334544,11543,True,108,scaffold_8
0,1001,22000,20999,False,108,scaffold_9
1,109001,117000,7999,False,108,scaffold_9
2,319001,327000,7999,False,108,scaffold_9
3,366001,411000,44999,False,108,scaffold_9
4,413001,434000,20999,False,108,scaffold_9
5,501001,531000,29999,False,108,scaffold_9
6,548001,563000,14999,False,108,scaffold_9
7,656001,664000,7999,False,108,scaffold_9
8,671001,696000,24999,False,108,scaffold_9
9,732001,742000,9999,False,108,scaffold_9
10,817001,843000,25999,False,108,scaffold_9
11,850001,862000,11999,False,108,scaffold_9
12,886001,986000,99999,False,108,scaffold_9
13,988001,995000,6999,False,108,scaffold_9
14,1001001,1007000,5999,False,108,scaffold_9
15,1010001,1031000,20999,False,108,scaffold_9
16,1035001,1085000,49999,False,108,scaffold_9
17,1087001,1150000,62999,False,108,scaffold_9
18,1151001,1177000,25999,False,108,scaffold_9
19,1312001,1377000,64999,False,108,scaffold_9
20,1599001,1615000,15999,False,108,scaffold_9
21,1752001,1791000,38999,False,108,scaffold_9
22,2598001,2616000,17999,False,108,scaffold_9
23,2735001,2837000,101999,False,108,scaffold_9
24,2844001,3381000,536999,False,108,scaffold_9
25,3383001,5107000,1723999,False,108,scaffold_9
26,5112001,5115000,2999,False,108,scaffold_9
27,5116001,5238000,121999,False,108,scaffold_9
28,5239001,5298000,58999,False,108,scaffold_9
29,5299001,5490000,190999,False,108,scaffold_9
30,5493001,6331288,838287,True,108,scaffold_9
0,1,235000,234999,True,108,scaffold_10
1,280001,414000,133999,False,108,scaffold_10
2,415001,482000,66999,False,108,scaffold_10
3,483001,582000,98999,False,108,scaffold_10
4,601001,755000,153999,False,108,scaffold_10
5,786001,793000,6999,False,108,scaffold_10
6,812001,840000,27999,False,108,scaffold_10
7,888001,963000,74999,False,108,scaffold_10
8,1073001,1133000,59999,False,108,scaffold_10
9,2092001,2101000,8999,False,108,scaffold_10
10,2141001,2171000,29999,False,108,scaffold_10
11,2346001,2368000,21999,False,108,scaffold_10
12,4054001,4091000,36999,False,108,scaffold_10
13,4154001,4174000,19999,False,108,scaffold_10
14,4443001,4462000,18999,False,108,scaffold_10
15,4467001,4476000,8999,False,108,scaffold_10
16,4515001,4523000,7999,False,108,scaffold_10
17,4526001,4548000,21999,False,108,scaffold_10
18,4554001,4562000,7999,False,108,scaffold_10
19,4575001,4596000,20999,False,108,scaffold_10
20,4681001,4688000,6999,False,108,scaffold_10
21,4735001,4766000,30999,False,108,scaffold_10
22,4769001,4776000,6999,False,108,scaffold_10
23,4798001,4824000,25999,False,108,scaffold_10
24,4828001,4843000,14999,False,108,scaffold_10
25,4848001,4861000,12999,False,108,scaffold_10
26,4865001,4866973,1972,True,108,scaffold_10
0,10001,93000,82999,False,108,scaffold_11
1,149001,167000,17999,False,108,scaffold_11
2,169001,191000,21999,False,108,scaffold_11
3,214001,236000,21999,False,108,scaffold_11
4,240001,247000,6999,False,108,scaffold_11
5,419001,431000,11999,False,108,scaffold_11
6,648001,656000,7999,False,108,scaffold_11
7,1025001,1034000,8999,False,108,scaffold_11
8,1423001,1426000,2999,False,108,scaffold_11
9,2701001,2877000,175999,False,108,scaffold_11
10,2982001,3018000,35999,False,108,scaffold_11
11,3091001,3134000,42999,False,108,scaffold_11
12,3217001,3293000,75999,False,108,scaffold_11
13,3329001,3383000,53999,False,108,scaffold_11
14,3558001,3605000,46999,False,108,scaffold_11
15,3702001,3926000,223999,False,108,scaffold_11
16,4005001,4159000,153999,False,108,scaffold_11
17,4252001,4710000,457999,False,108,scaffold_11
18,4713001,4766820,53819,True,108,scaffold_11
0,1,373000,372999,True,108,scaffold_12
1,402001,543000,140999,False,108,scaffold_12
2,589001,856000,266999,False,108,scaffold_12
3,865001,1467000,601999,False,108,scaffold_12
4,1720001,1733000,12999,False,108,scaffold_12
5,2072001,2087000,14999,False,108,scaffold_12
6,2088001,2103000,14999,False,108,scaffold_12
7,2345001,2377000,31999,False,108,scaffold_12
8,2571001,2610000,38999,False,108,scaffold_12
9,2685001,2699000,13999,False,108,scaffold_12
10,2700001,2708000,7999,False,108,scaffold_12
0,1,342000,341999,True,109,scaffold_1
1,482001,498000,15999,False,109,scaffold_1
2,572001,643000,70999,False,109,scaffold_1
3,686001,743000,56999,False,109,scaffold_1
4,1281001,1292000,10999,False,109,scaffold_1
5,1619001,1660000,40999,False,109,scaffold_1
6,1817001,1898000,80999,False,109,scaffold_1
7,1954001,1964000,9999,False,109,scaffold_1
8,1965001,1984000,18999,False,109,scaffold_1
9,2449001,2517000,67999,False,109,scaffold_1
10,2729001,2746000,16999,False,109,scaffold_1
11,3180001,3208000,27999,False,109,scaffold_1
12,3715001,3735000,19999,False,109,scaffold_1
13,3912001,3941000,28999,False,109,scaffold_1
14,4005001,4025000,19999,False,109,scaffold_1
15,4063001,4115000,51999,False,109,scaffold_1
16,4315001,4354000,38999,False,109,scaffold_1
17,4927001,4983000,55999,False,109,scaffold_1
18,5483001,5511000,27999,False,109,scaffold_1
19,5535001,5570000,34999,False,109,scaffold_1
20,5856001,5874000,17999,False,109,scaffold_1
21,6108001,6153000,44999,False,109,scaffold_1
22,6228001,6380000,151999,False,109,scaffold_1
23,6384001,6507000,122999,False,109,scaffold_1
24,6545001,6554000,8999,False,109,scaffold_1
25,7038001,7247000,208999,False,109,scaffold_1
26,7248001,7583000,334999,False,109,scaffold_1
27,7590001,8477000,886999,False,109,scaffold_1
28,8478001,8656000,177999,False,109,scaffold_1
29,8658001,9584000,925999,False,109,scaffold_1
30,9586001,10354000,767999,False,109,scaffold_1
31,10461001,10632000,170999,False,109,scaffold_1
32,10808001,10811000,2999,False,109,scaffold_1
33,10839001,10857000,17999,False,109,scaffold_1
34,11347001,11505000,157999,False,109,scaffold_1
35,11614001,11951000,336999,False,109,scaffold_1
36,12184001,12204000,19999,False,109,scaffold_1
37,12666001,12722000,55999,False,109,scaffold_1
38,12775001,12888000,112999,False,109,scaffold_1
39,12976001,12992000,15999,False,109,scaffold_1
40,13113001,13211000,97999,False,109,scaffold_1
41,13347001,13377000,29999,False,109,scaffold_1
42,14471001,14479000,7999,False,109,scaffold_1
43,14605001,14609000,3999,False,109,scaffold_1
0,95001,159000,63999,False,109,scaffold_2
1,168001,177000,8999,False,109,scaffold_2
2,303001,318000,14999,False,109,scaffold_2
3,330001,374000,43999,False,109,scaffold_2
4,2336001,2358000,21999,False,109,scaffold_2
5,2437001,2553000,115999,False,109,scaffold_2
6,2627001,2639000,11999,False,109,scaffold_2
7,2660001,2689000,28999,False,109,scaffold_2
8,2694001,2742000,47999,False,109,scaffold_2
9,2994001,3012000,17999,False,109,scaffold_2
10,3453001,3465000,11999,False,109,scaffold_2
11,3766001,3782000,15999,False,109,scaffold_2
12,4385001,4409000,23999,False,109,scaffold_2
13,4428001,4457000,28999,False,109,scaffold_2
14,4521001,4657000,135999,False,109,scaffold_2
15,4918001,4938000,19999,False,109,scaffold_2
16,5022001,5031000,8999,False,109,scaffold_2
17,5033001,5061000,27999,False,109,scaffold_2
18,5460001,5471000,10999,False,109,scaffold_2
19,5490001,5512000,21999,False,109,scaffold_2
20,5668001,5704000,35999,False,109,scaffold_2
21,6261001,6330000,68999,False,109,scaffold_2
22,6331001,6343000,11999,False,109,scaffold_2
23,6429001,6448000,18999,False,109,scaffold_2
24,7018001,7036000,17999,False,109,scaffold_2
25,7439001,7473000,33999,False,109,scaffold_2
26,7563001,7697000,133999,False,109,scaffold_2
27,7786001,7898000,111999,False,109,scaffold_2
28,7933001,8160000,226999,False,109,scaffold_2
29,8331001,8333000,1999,False,109,scaffold_2
30,8346001,8454000,107999,False,109,scaffold_2
31,8509001,8562000,52999,False,109,scaffold_2
32,9141001,9167000,25999,False,109,scaffold_2
33,9929001,9944000,14999,False,109,scaffold_2
34,11520001,11786000,265999,False,109,scaffold_2
0,1,2000,1999,True,109,scaffold_3
1,51001,55000,3999,False,109,scaffold_3
2,204001,207000,2999,False,109,scaffold_3
3,799001,901000,101999,False,109,scaffold_3
4,2084001,2108000,23999,False,109,scaffold_3
5,2110001,2116000,5999,False,109,scaffold_3
6,2291001,2321000,29999,False,109,scaffold_3
7,2494001,2533000,38999,False,109,scaffold_3
8,3769001,3891000,121999,False,109,scaffold_3
9,4110001,4398000,287999,False,109,scaffold_3
10,4418001,4519000,100999,False,109,scaffold_3
11,4547001,4558000,10999,False,109,scaffold_3
12,4646001,4686000,39999,False,109,scaffold_3
13,6910001,6962000,51999,False,109,scaffold_3
14,6979001,7083000,103999,False,109,scaffold_3
15,7522001,7556000,33999,False,109,scaffold_3
16,7692001,7838000,145999,False,109,scaffold_3
17,8208001,8253000,44999,False,109,scaffold_3
18,8462001,8527000,64999,False,109,scaffold_3
19,8575001,8594000,18999,False,109,scaffold_3
20,9968001,9995000,26999,False,109,scaffold_3
21,10461001,10484000,22999,False,109,scaffold_3
22,10587001,11166000,578999,False,109,scaffold_3
0,17001,32000,14999,False,109,scaffold_4
1,48001,88000,39999,False,109,scaffold_4
2,155001,160000,4999,False,109,scaffold_4
3,161001,215000,53999,False,109,scaffold_4
4,217001,226000,8999,False,109,scaffold_4
5,227001,266000,38999,False,109,scaffold_4
6,336001,344000,7999,False,109,scaffold_4
7,355001,374000,18999,False,109,scaffold_4
8,393001,410000,16999,False,109,scaffold_4
9,411001,425000,13999,False,109,scaffold_4
10,429001,502000,72999,False,109,scaffold_4
11,543001,592000,48999,False,109,scaffold_4
12,608001,691000,82999,False,109,scaffold_4
13,701001,714000,12999,False,109,scaffold_4
14,1087001,1097000,9999,False,109,scaffold_4
15,1099001,1109000,9999,False,109,scaffold_4
16,1121001,1136000,14999,False,109,scaffold_4
17,1137001,1198000,60999,False,109,scaffold_4
18,1199001,1208000,8999,False,109,scaffold_4
19,1210001,1226000,15999,False,109,scaffold_4
20,1265001,1279000,13999,False,109,scaffold_4
21,1283001,1313000,29999,False,109,scaffold_4
22,1372001,1591000,218999,False,109,scaffold_4
23,1613001,1641000,27999,False,109,scaffold_4
24,1749001,1849000,99999,False,109,scaffold_4
25,1850001,1866000,15999,False,109,scaffold_4
26,1904001,2002000,97999,False,109,scaffold_4
27,2211001,2218000,6999,False,109,scaffold_4
28,2219001,2246000,26999,False,109,scaffold_4
29,2247001,2279000,31999,False,109,scaffold_4
30,2284001,2340000,55999,False,109,scaffold_4
31,2428001,2461000,32999,False,109,scaffold_4
32,2480001,2567000,86999,False,109,scaffold_4
33,2599001,2635000,35999,False,109,scaffold_4
34,3335001,3633000,297999,False,109,scaffold_4
35,3676001,3760000,83999,False,109,scaffold_4
36,4058001,4071000,12999,False,109,scaffold_4
37,4912001,4985000,72999,False,109,scaffold_4
38,5476001,5506000,29999,False,109,scaffold_4
39,5514001,5621000,106999,False,109,scaffold_4
40,5658001,5784000,125999,False,109,scaffold_4
41,6145001,6197000,51999,False,109,scaffold_4
42,6615001,6617000,1999,False,109,scaffold_4
43,6801001,6817000,15999,False,109,scaffold_4
44,7036001,7062000,25999,False,109,scaffold_4
45,8846001,9699000,852999,False,109,scaffold_4
46,9700001,9845951,145950,True,109,scaffold_4
0,321001,326000,4999,False,109,scaffold_5
1,327001,368000,40999,False,109,scaffold_5
2,462001,523000,60999,False,109,scaffold_5
3,933001,947000,13999,False,109,scaffold_5
4,2562001,2582000,19999,False,109,scaffold_5
5,2618001,2738000,119999,False,109,scaffold_5
6,2816001,2872000,55999,False,109,scaffold_5
7,3133001,3185000,51999,False,109,scaffold_5
8,3322001,3438000,115999,False,109,scaffold_5
9,3449001,3498000,48999,False,109,scaffold_5
10,3962001,4101000,138999,False,109,scaffold_5
11,4121001,4219000,97999,False,109,scaffold_5
12,4234001,4265000,30999,False,109,scaffold_5
13,4445001,4498000,52999,False,109,scaffold_5
14,4601001,4661000,59999,False,109,scaffold_5
15,4690001,4717000,26999,False,109,scaffold_5
16,4788001,4861000,72999,False,109,scaffold_5
17,4892001,4920000,27999,False,109,scaffold_5
18,5318001,5346000,27999,False,109,scaffold_5
19,6505001,6566000,60999,False,109,scaffold_5
20,7454001,7483000,28999,False,109,scaffold_5
21,7581001,7609000,27999,False,109,scaffold_5
22,8258001,8263000,4999,False,109,scaffold_5
23,8556001,8591000,34999,False,109,scaffold_5
24,8730001,9363000,632999,False,109,scaffold_5
0,86001,112000,25999,False,109,scaffold_6
1,240001,253000,12999,False,109,scaffold_6
2,264001,283000,18999,False,109,scaffold_6
3,1236001,1257000,20999,False,109,scaffold_6
4,1479001,1546000,66999,False,109,scaffold_6
5,2026001,2087000,60999,False,109,scaffold_6
6,2127001,2169000,41999,False,109,scaffold_6
7,2236001,2265000,28999,False,109,scaffold_6
8,2350001,2595000,244999,False,109,scaffold_6
9,2596001,2653000,56999,False,109,scaffold_6
10,2657001,2691000,33999,False,109,scaffold_6
11,2712001,2872000,159999,False,109,scaffold_6
12,2928001,3014000,85999,False,109,scaffold_6
13,3115001,3172000,56999,False,109,scaffold_6
14,3224001,3311000,86999,False,109,scaffold_6
15,3404001,3430000,25999,False,109,scaffold_6
16,3458001,3784000,325999,False,109,scaffold_6
17,3899001,3913000,13999,False,109,scaffold_6
18,4018001,4067000,48999,False,109,scaffold_6
19,4081001,4194000,112999,False,109,scaffold_6
20,6008001,6060000,51999,False,109,scaffold_6
21,7282001,7337000,54999,False,109,scaffold_6
22,7560001,8268281,708280,True,109,scaffold_6
0,1,8000,7999,True,109,scaffold_7
1,13001,34000,20999,False,109,scaffold_7
2,323001,340000,16999,False,109,scaffold_7
3,342001,508000,165999,False,109,scaffold_7
4,554001,563000,8999,False,109,scaffold_7
5,571001,577000,5999,False,109,scaffold_7
6,706001,736000,29999,False,109,scaffold_7
7,764001,809000,44999,False,109,scaffold_7
8,859001,864000,4999,False,109,scaffold_7
9,964001,966000,1999,False,109,scaffold_7
10,968001,981000,12999,False,109,scaffold_7
11,982001,1044000,61999,False,109,scaffold_7
12,1048001,1088000,39999,False,109,scaffold_7
13,1204001,1512000,307999,False,109,scaffold_7
14,1588001,1692000,103999,False,109,scaffold_7
15,3326001,3370000,43999,False,109,scaffold_7
16,3595001,3765000,169999,False,109,scaffold_7
17,4326001,4360000,33999,False,109,scaffold_7
18,4416001,4518000,101999,False,109,scaffold_7
19,4640001,4652000,11999,False,109,scaffold_7
20,4656001,4734000,77999,False,109,scaffold_7
21,4979001,5147000,167999,False,109,scaffold_7
22,5484001,5536000,51999,False,109,scaffold_7
23,6955001,7270000,314999,False,109,scaffold_7
24,7271001,7502216,231215,True,109,scaffold_7
0,67001,85000,17999,False,109,scaffold_8
1,93001,101000,7999,False,109,scaffold_8
2,2444001,2530000,85999,False,109,scaffold_8
3,2536001,2551000,14999,False,109,scaffold_8
4,2656001,2683000,26999,False,109,scaffold_8
5,2742001,2756000,13999,False,109,scaffold_8
6,2798001,2844000,45999,False,109,scaffold_8
7,3058001,3125000,66999,False,109,scaffold_8
8,3126001,3525000,398999,False,109,scaffold_8
9,3580001,3612000,31999,False,109,scaffold_8
10,3615001,3934000,318999,False,109,scaffold_8
11,4204001,4220000,15999,False,109,scaffold_8
12,5184001,5241000,56999,False,109,scaffold_8
13,6326001,6334544,8543,True,109,scaffold_8
0,109001,117000,7999,False,109,scaffold_9
1,121001,136000,14999,False,109,scaffold_9
2,303001,315000,11999,False,109,scaffold_9
3,319001,331000,11999,False,109,scaffold_9
4,367001,411000,43999,False,109,scaffold_9
5,413001,434000,20999,False,109,scaffold_9
6,501001,531000,29999,False,109,scaffold_9
7,660001,665000,4999,False,109,scaffold_9
8,671001,696000,24999,False,109,scaffold_9
9,814001,842000,27999,False,109,scaffold_9
10,886001,986000,99999,False,109,scaffold_9
11,988001,995000,6999,False,109,scaffold_9
12,1001001,1007000,5999,False,109,scaffold_9
13,1009001,1031000,21999,False,109,scaffold_9
14,1035001,1085000,49999,False,109,scaffold_9
15,1087001,1160000,72999,False,109,scaffold_9
16,1313001,1377000,63999,False,109,scaffold_9
17,1767001,1791000,23999,False,109,scaffold_9
18,2601001,2616000,14999,False,109,scaffold_9
19,2870001,3381000,510999,False,109,scaffold_9
20,3383001,5107000,1723999,False,109,scaffold_9
21,5112001,5237000,124999,False,109,scaffold_9
22,5239001,5298000,58999,False,109,scaffold_9
23,5300001,5490000,189999,False,109,scaffold_9
24,5493001,6331288,838287,True,109,scaffold_9
0,1,136000,135999,True,109,scaffold_10
1,137001,198000,60999,False,109,scaffold_10
2,373001,405000,31999,False,109,scaffold_10
3,472001,482000,9999,False,109,scaffold_10
4,483001,582000,98999,False,109,scaffold_10
5,603001,755000,151999,False,109,scaffold_10
6,783001,795000,11999,False,109,scaffold_10
7,860001,877000,16999,False,109,scaffold_10
8,888001,917000,28999,False,109,scaffold_10
9,923001,962000,38999,False,109,scaffold_10
10,1073001,1112000,38999,False,109,scaffold_10
11,2346001,2368000,21999,False,109,scaffold_10
12,4052001,4092000,39999,False,109,scaffold_10
13,4154001,4174000,19999,False,109,scaffold_10
14,4503001,4513000,9999,False,109,scaffold_10
15,4527001,4548000,20999,False,109,scaffold_10
16,4554001,4562000,7999,False,109,scaffold_10
17,4574001,4596000,21999,False,109,scaffold_10
18,4679001,4688000,8999,False,109,scaffold_10
19,4734001,4766000,31999,False,109,scaffold_10
20,4769001,4776000,6999,False,109,scaffold_10
21,4798001,4824000,25999,False,109,scaffold_10
22,4828001,4843000,14999,False,109,scaffold_10
23,4848001,4861000,12999,False,109,scaffold_10
24,4865001,4866973,1972,True,109,scaffold_10
0,10001,34000,23999,False,109,scaffold_11
1,39001,93000,53999,False,109,scaffold_11
2,132001,168000,35999,False,109,scaffold_11
3,169001,191000,21999,False,109,scaffold_11
4,213001,235000,21999,False,109,scaffold_11
5,240001,252000,11999,False,109,scaffold_11
6,419001,431000,11999,False,109,scaffold_11
7,648001,656000,7999,False,109,scaffold_11
8,1025001,1034000,8999,False,109,scaffold_11
9,1423001,1427000,3999,False,109,scaffold_11
10,1474001,1477000,2999,False,109,scaffold_11
11,2701001,2874000,172999,False,109,scaffold_11
12,3188001,3255000,66999,False,109,scaffold_11
13,3329001,3383000,53999,False,109,scaffold_11
14,3702001,3927000,224999,False,109,scaffold_11
15,4011001,4071000,59999,False,109,scaffold_11
16,4134001,4159000,24999,False,109,scaffold_11
17,4320001,4710000,389999,False,109,scaffold_11
18,4713001,4766820,53819,True,109,scaffold_11
0,1,370000,369999,True,109,scaffold_12
1,474001,537000,62999,False,109,scaffold_12
2,581001,856000,274999,False,109,scaffold_12
3,865001,1429000,563999,False,109,scaffold_12
4,1720001,1733000,12999,False,109,scaffold_12
5,2571001,2618000,46999,False,109,scaffold_12
0,1,330000,329999,True,110,scaffold_1
1,482001,498000,15999,False,110,scaffold_1
2,569001,643000,73999,False,110,scaffold_1
3,686001,759000,72999,False,110,scaffold_1
4,1281001,1292000,10999,False,110,scaffold_1
5,1607001,1660000,52999,False,110,scaffold_1
6,1811001,1899000,87999,False,110,scaffold_1
7,1952001,1964000,11999,False,110,scaffold_1
8,1965001,1984000,18999,False,110,scaffold_1
9,1987001,1993000,5999,False,110,scaffold_1
10,2355001,2387000,31999,False,110,scaffold_1
11,2449001,2517000,67999,False,110,scaffold_1
12,2727001,2746000,18999,False,110,scaffold_1
13,3180001,3209000,28999,False,110,scaffold_1
14,3715001,3735000,19999,False,110,scaffold_1
15,3916001,3941000,24999,False,110,scaffold_1
16,4003001,4029000,25999,False,110,scaffold_1
17,4062001,4112000,49999,False,110,scaffold_1
18,4323001,4354000,30999,False,110,scaffold_1
19,4796001,4811000,14999,False,110,scaffold_1
20,4927001,5014000,86999,False,110,scaffold_1
21,5087001,5110000,22999,False,110,scaffold_1
22,5484001,5512000,27999,False,110,scaffold_1
23,5536001,5569000,32999,False,110,scaffold_1
24,6108001,6153000,44999,False,110,scaffold_1
25,6154001,6177000,22999,False,110,scaffold_1
26,6228001,6379000,150999,False,110,scaffold_1
27,6384001,6509000,124999,False,110,scaffold_1
28,6543001,6555000,11999,False,110,scaffold_1
29,7037001,7247000,209999,False,110,scaffold_1
30,7248001,7588000,339999,False,110,scaffold_1
31,7590001,8656000,1065999,False,110,scaffold_1
32,8658001,9584000,925999,False,110,scaffold_1
33,9586001,10356000,769999,False,110,scaffold_1
34,10460001,10637000,176999,False,110,scaffold_1
35,10841001,10855000,13999,False,110,scaffold_1
36,11347001,11509000,161999,False,110,scaffold_1
37,11609001,11957000,347999,False,110,scaffold_1
38,12184001,12204000,19999,False,110,scaffold_1
39,12661001,12722000,60999,False,110,scaffold_1
40,12777001,12888000,110999,False,110,scaffold_1
41,12965001,13001000,35999,False,110,scaffold_1
42,13113001,13212000,98999,False,110,scaffold_1
43,13347001,13405000,57999,False,110,scaffold_1
44,14290001,14310000,19999,False,110,scaffold_1
45,14595001,14598000,2999,False,110,scaffold_1
46,14605001,14610000,4999,False,110,scaffold_1
0,1,48000,47999,True,110,scaffold_2
1,95001,159000,63999,False,110,scaffold_2
2,168001,177000,8999,False,110,scaffold_2
3,303001,318000,14999,False,110,scaffold_2
4,333001,374000,40999,False,110,scaffold_2
5,2336001,2358000,21999,False,110,scaffold_2
6,2404001,2424000,19999,False,110,scaffold_2
7,2437001,2554000,116999,False,110,scaffold_2
8,2627001,2639000,11999,False,110,scaffold_2
9,2660001,2689000,28999,False,110,scaffold_2
10,2694001,2744000,49999,False,110,scaffold_2
11,2766001,2788000,21999,False,110,scaffold_2
12,2973001,3017000,43999,False,110,scaffold_2
13,3451001,3465000,13999,False,110,scaffold_2
14,3758001,3783000,24999,False,110,scaffold_2
15,4335001,4409000,73999,False,110,scaffold_2
16,4426001,4457000,30999,False,110,scaffold_2
17,4520001,4656000,135999,False,110,scaffold_2
18,5021001,5031000,9999,False,110,scaffold_2
19,5033001,5104000,70999,False,110,scaffold_2
20,5368001,5394000,25999,False,110,scaffold_2
21,5491001,5515000,23999,False,110,scaffold_2
22,5659001,5757000,97999,False,110,scaffold_2
23,5840001,5887000,46999,False,110,scaffold_2
24,6261001,6330000,68999,False,110,scaffold_2
25,6331001,6352000,20999,False,110,scaffold_2
26,6396001,6449000,52999,False,110,scaffold_2
27,6593001,6628000,34999,False,110,scaffold_2
28,7005001,7037000,31999,False,110,scaffold_2
29,7049001,7097000,47999,False,110,scaffold_2
30,7162001,7198000,35999,False,110,scaffold_2
31,7400001,7476000,75999,False,110,scaffold_2
32,7491001,7518000,26999,False,110,scaffold_2
33,7549001,7561000,11999,False,110,scaffold_2
34,7563001,7697000,133999,False,110,scaffold_2
35,7780001,7917000,136999,False,110,scaffold_2
36,7934001,8161000,226999,False,110,scaffold_2
37,8260001,8313000,52999,False,110,scaffold_2
38,8331001,8333000,1999,False,110,scaffold_2
39,8335001,8345000,9999,False,110,scaffold_2
40,8346001,8455000,108999,False,110,scaffold_2
41,8495001,8562000,66999,False,110,scaffold_2
42,9140001,9174000,33999,False,110,scaffold_2
43,11366001,11381000,14999,False,110,scaffold_2
44,11520001,11786000,265999,False,110,scaffold_2
0,1,2000,1999,True,110,scaffold_3
1,3001,6000,2999,False,110,scaffold_3
2,51001,55000,3999,False,110,scaffold_3
3,204001,207000,2999,False,110,scaffold_3
4,618001,646000,27999,False,110,scaffold_3
5,799001,901000,101999,False,110,scaffold_3
6,2041001,2108000,66999,False,110,scaffold_3
7,2290001,2322000,31999,False,110,scaffold_3
8,2487001,2533000,45999,False,110,scaffold_3
9,3768001,3891000,122999,False,110,scaffold_3
10,4108001,4403000,294999,False,110,scaffold_3
11,4406001,4520000,113999,False,110,scaffold_3
12,4546001,4558000,11999,False,110,scaffold_3
13,4652001,4681000,28999,False,110,scaffold_3
14,5990001,6022000,31999,False,110,scaffold_3
15,6743001,6783000,39999,False,110,scaffold_3
16,6907001,7098000,190999,False,110,scaffold_3
17,7522001,7556000,33999,False,110,scaffold_3
18,7690001,7838000,147999,False,110,scaffold_3
19,8176001,8253000,76999,False,110,scaffold_3
20,8425001,8446000,20999,False,110,scaffold_3
21,8462001,8527000,64999,False,110,scaffold_3
22,8575001,8594000,18999,False,110,scaffold_3
23,9968001,9995000,26999,False,110,scaffold_3
24,10461001,10484000,22999,False,110,scaffold_3
25,10587001,11165000,577999,False,110,scaffold_3
0,3001,7000,3999,False,110,scaffold_4
1,17001,32000,14999,False,110,scaffold_4
2,48001,88000,39999,False,110,scaffold_4
3,136001,146000,9999,False,110,scaffold_4
4,147001,151000,3999,False,110,scaffold_4
5,155001,215000,59999,False,110,scaffold_4
6,217001,226000,8999,False,110,scaffold_4
7,227001,241000,13999,False,110,scaffold_4
8,242001,266000,23999,False,110,scaffold_4
9,289001,310000,20999,False,110,scaffold_4
10,319001,344000,24999,False,110,scaffold_4
11,355001,374000,18999,False,110,scaffold_4
12,375001,380000,4999,False,110,scaffold_4
13,392001,410000,17999,False,110,scaffold_4
14,412001,425000,12999,False,110,scaffold_4
15,429001,498000,68999,False,110,scaffold_4
16,548001,592000,43999,False,110,scaffold_4
17,593001,606000,12999,False,110,scaffold_4
18,608001,691000,82999,False,110,scaffold_4
19,701001,714000,12999,False,110,scaffold_4
20,1121001,1136000,14999,False,110,scaffold_4
21,1137001,1198000,60999,False,110,scaffold_4
22,1199001,1226000,26999,False,110,scaffold_4
23,1254001,1262000,7999,False,110,scaffold_4
24,1265001,1279000,13999,False,110,scaffold_4
25,1284001,1336000,51999,False,110,scaffold_4
26,1372001,1591000,218999,False,110,scaffold_4
27,1613001,1647000,33999,False,110,scaffold_4
28,1734001,1849000,114999,False,110,scaffold_4
29,1850001,1957000,106999,False,110,scaffold_4
30,1958001,1992000,33999,False,110,scaffold_4
31,2035001,2066000,30999,False,110,scaffold_4
32,2073001,2099000,25999,False,110,scaffold_4
33,2237001,2246000,8999,False,110,scaffold_4
34,2247001,2279000,31999,False,110,scaffold_4
35,2283001,2339000,55999,False,110,scaffold_4
36,2434001,2443000,8999,False,110,scaffold_4
37,2476001,2538000,61999,False,110,scaffold_4
38,2539001,2635000,95999,False,110,scaffold_4
39,3091001,3128000,36999,False,110,scaffold_4
40,3336001,3637000,300999,False,110,scaffold_4
41,3645001,3762000,116999,False,110,scaffold_4
42,4930001,4985000,54999,False,110,scaffold_4
43,5174001,5208000,33999,False,110,scaffold_4
44,5303001,5325000,21999,False,110,scaffold_4
45,5476001,5506000,29999,False,110,scaffold_4
46,5514001,5784000,269999,False,110,scaffold_4
47,5786001,5823000,36999,False,110,scaffold_4
48,6145001,6194000,48999,False,110,scaffold_4
49,6286001,6297000,10999,False,110,scaffold_4
50,6901001,6924000,22999,False,110,scaffold_4
51,7036001,7079000,42999,False,110,scaffold_4
52,7200001,7270000,69999,False,110,scaffold_4
53,7986001,7996000,9999,False,110,scaffold_4
54,8846001,9699000,852999,False,110,scaffold_4
55,9700001,9845951,145950,True,110,scaffold_4
0,1,4000,3999,True,110,scaffold_5
1,190001,204000,13999,False,110,scaffold_5
2,318001,385000,66999,False,110,scaffold_5
3,445001,523000,77999,False,110,scaffold_5
4,933001,947000,13999,False,110,scaffold_5
5,2510001,2515000,4999,False,110,scaffold_5
6,2552001,2741000,188999,False,110,scaffold_5
7,2766001,2787000,20999,False,110,scaffold_5
8,2812001,2871000,58999,False,110,scaffold_5
9,3133001,3255000,121999,False,110,scaffold_5
10,3278001,3512000,233999,False,110,scaffold_5
11,3962001,4101000,138999,False,110,scaffold_5
12,4119001,4220000,100999,False,110,scaffold_5
13,4228001,4284000,55999,False,110,scaffold_5
14,4446001,4505000,58999,False,110,scaffold_5
15,4600001,4680000,79999,False,110,scaffold_5
16,4690001,4924000,233999,False,110,scaffold_5
17,4974001,4990000,15999,False,110,scaffold_5
18,5250001,5275000,24999,False,110,scaffold_5
19,5283001,5344000,60999,False,110,scaffold_5
20,6405001,6437000,31999,False,110,scaffold_5
21,6481001,6653000,171999,False,110,scaffold_5
22,7406001,7438000,31999,False,110,scaffold_5
23,7454001,7484000,29999,False,110,scaffold_5
24,7580001,7619000,38999,False,110,scaffold_5
25,7622001,7656000,33999,False,110,scaffold_5
26,8553001,8615000,61999,False,110,scaffold_5
27,8674001,8689000,14999,False,110,scaffold_5
28,8713001,9364176,651175,True,110,scaffold_5
0,78001,85000,6999,False,110,scaffold_6
1,86001,114000,27999,False,110,scaffold_6
2,172001,208000,35999,False,110,scaffold_6
3,239001,254000,14999,False,110,scaffold_6
4,267001,285000,17999,False,110,scaffold_6
5,1237001,1258000,20999,False,110,scaffold_6
6,1478001,1546000,67999,False,110,scaffold_6
7,1866001,1906000,39999,False,110,scaffold_6
8,2023001,2088000,64999,False,110,scaffold_6
9,2130001,2196000,65999,False,110,scaffold_6
10,2336001,2595000,258999,False,110,scaffold_6
11,2596001,2692000,95999,False,110,scaffold_6
12,2715001,2848000,132999,False,110,scaffold_6
13,2928001,3018000,89999,False,110,scaffold_6
14,3105001,3176000,70999,False,110,scaffold_6
15,3224001,3315000,90999,False,110,scaffold_6
16,3400001,3432000,31999,False,110,scaffold_6
17,3458001,3767000,308999,False,110,scaffold_6
18,3900001,3912000,11999,False,110,scaffold_6
19,4018001,4066000,47999,False,110,scaffold_6
20,4080001,4193000,112999,False,110,scaffold_6
21,6010001,6062000,51999,False,110,scaffold_6
22,7263001,7337000,73999,False,110,scaffold_6
23,7392001,7435000,42999,False,110,scaffold_6
24,7541001,8268281,727280,True,110,scaffold_6
0,13001,34000,20999,False,110,scaffold_7
1,323001,340000,16999,False,110,scaffold_7
2,342001,508000,165999,False,110,scaffold_7
3,571001,577000,5999,False,110,scaffold_7
4,706001,736000,29999,False,110,scaffold_7
5,764001,827000,62999,False,110,scaffold_7
6,859001,864000,4999,False,110,scaffold_7
7,964001,966000,1999,False,110,scaffold_7
8,968001,980000,11999,False,110,scaffold_7
9,982001,1044000,61999,False,110,scaffold_7
10,1048001,1101000,52999,False,110,scaffold_7
11,1191001,1512000,320999,False,110,scaffold_7
12,1588001,1690000,101999,False,110,scaffold_7
13,3326001,3372000,45999,False,110,scaffold_7
14,3526001,3767000,240999,False,110,scaffold_7
15,4415001,4517000,101999,False,110,scaffold_7
16,4657001,4820000,162999,False,110,scaffold_7
17,4978001,5147000,168999,False,110,scaffold_7
18,5484001,5536000,51999,False,110,scaffold_7
19,6954001,7270000,315999,False,110,scaffold_7
20,7271001,7502216,231215,True,110,scaffold_7
0,67001,85000,17999,False,110,scaffold_8
1,93001,101000,7999,False,110,scaffold_8
2,722001,724000,1999,False,110,scaffold_8
3,1859001,1927000,67999,False,110,scaffold_8
4,2442001,2533000,90999,False,110,scaffold_8
5,2534001,2552000,17999,False,110,scaffold_8
6,2651001,2683000,31999,False,110,scaffold_8
7,2739001,2758000,18999,False,110,scaffold_8
8,2798001,2844000,45999,False,110,scaffold_8
9,3058001,3125000,66999,False,110,scaffold_8
10,3126001,3525000,398999,False,110,scaffold_8
11,3577001,3612000,34999,False,110,scaffold_8
12,3615001,3938000,322999,False,110,scaffold_8
13,5086001,5137000,50999,False,110,scaffold_8
14,5196001,5242000,45999,False,110,scaffold_8
15,5677001,5695000,17999,False,110,scaffold_8
16,6322001,6334544,12543,True,110,scaffold_8
0,1,21000,20999,True,110,scaffold_9
1,109001,117000,7999,False,110,scaffold_9
2,121001,140000,18999,False,110,scaffold_9
3,144001,148000,3999,False,110,scaffold_9
4,189001,194000,4999,False,110,scaffold_9
5,303001,315000,11999,False,110,scaffold_9
6,319001,327000,7999,False,110,scaffold_9
7,366001,411000,44999,False,110,scaffold_9
8,413001,434000,20999,False,110,scaffold_9
9,502001,531000,28999,False,110,scaffold_9
10,547001,561000,13999,False,110,scaffold_9
11,652001,665000,12999,False,110,scaffold_9
12,671001,697000,25999,False,110,scaffold_9
13,732001,742000,9999,False,110,scaffold_9
14,815001,842000,26999,False,110,scaffold_9
15,850001,854000,3999,False,110,scaffold_9
16,873001,986000,112999,False,110,scaffold_9
17,987001,995000,7999,False,110,scaffold_9
18,1001001,1007000,5999,False,110,scaffold_9
19,1009001,1031000,21999,False,110,scaffold_9
20,1035001,1085000,49999,False,110,scaffold_9
21,1087001,1165000,77999,False,110,scaffold_9
22,1312001,1378000,65999,False,110,scaffold_9
23,1766001,1791000,24999,False,110,scaffold_9
24,2152001,2171000,18999,False,110,scaffold_9
25,2595001,2616000,20999,False,110,scaffold_9
26,2737001,2824000,86999,False,110,scaffold_9
27,2870001,3381000,510999,False,110,scaffold_9
28,3383001,5100000,1716999,False,110,scaffold_9
29,5101001,5107000,5999,False,110,scaffold_9
30,5112001,5115000,2999,False,110,scaffold_9
31,5116001,5298000,181999,False,110,scaffold_9
32,5300001,5490000,189999,False,110,scaffold_9
33,5493001,6331288,838287,True,110,scaffold_9
0,1,414000,413999,True,110,scaffold_10
1,418001,482000,63999,False,110,scaffold_10
2,483001,582000,98999,False,110,scaffold_10
3,603001,794000,190999,False,110,scaffold_10
4,888001,917000,28999,False,110,scaffold_10
5,923001,962000,38999,False,110,scaffold_10
6,1073001,1113000,39999,False,110,scaffold_10
7,1120001,1132000,11999,False,110,scaffold_10
8,2141001,2170000,28999,False,110,scaffold_10
9,2346001,2367000,20999,False,110,scaffold_10
10,4052001,4092000,39999,False,110,scaffold_10
11,4156001,4174000,17999,False,110,scaffold_10
12,4335001,4359000,23999,False,110,scaffold_10
13,4446001,4462000,15999,False,110,scaffold_10
14,4467001,4477000,9999,False,110,scaffold_10
15,4486001,4502000,15999,False,110,scaffold_10
16,4503001,4513000,9999,False,110,scaffold_10
17,4515001,4523000,7999,False,110,scaffold_10
18,4526001,4548000,21999,False,110,scaffold_10
19,4575001,4596000,20999,False,110,scaffold_10
20,4681001,4687000,5999,False,110,scaffold_10
21,4734001,4766000,31999,False,110,scaffold_10
22,4768001,4776000,7999,False,110,scaffold_10
23,4798001,4824000,25999,False,110,scaffold_10
24,4828001,4843000,14999,False,110,scaffold_10
25,4848001,4861000,12999,False,110,scaffold_10
26,4865001,4866973,1972,True,110,scaffold_10
0,12001,37000,24999,False,110,scaffold_11
1,38001,93000,54999,False,110,scaffold_11
2,149001,167000,17999,False,110,scaffold_11
3,169001,191000,21999,False,110,scaffold_11
4,213001,236000,22999,False,110,scaffold_11
5,240001,248000,7999,False,110,scaffold_11
6,419001,431000,11999,False,110,scaffold_11
7,649001,656000,6999,False,110,scaffold_11
8,1025001,1034000,8999,False,110,scaffold_11
9,1423001,1426000,2999,False,110,scaffold_11
10,2701001,2873000,171999,False,110,scaffold_11
11,2984001,3010000,25999,False,110,scaffold_11
12,3095001,3134000,38999,False,110,scaffold_11
13,3187001,3264000,76999,False,110,scaffold_11
14,3329001,3383000,53999,False,110,scaffold_11
15,3560001,3651000,90999,False,110,scaffold_11
16,3702001,3928000,225999,False,110,scaffold_11
17,4009001,4159000,149999,False,110,scaffold_11
18,4265001,4710000,444999,False,110,scaffold_11
19,4712001,4766820,54819,True,110,scaffold_11
0,1,858000,857999,True,110,scaffold_12
1,864001,1449000,584999,False,110,scaffold_12
2,1720001,1733000,12999,False,110,scaffold_12
3,2571001,2617000,45999,False,110,scaffold_12
4,2726001,2730000,3999,False,110,scaffold_12
0,1,342000,341999,True,111,scaffold_1
1,482001,498000,15999,False,111,scaffold_1
2,516001,538000,21999,False,111,scaffold_1
3,571001,643000,71999,False,111,scaffold_1
4,686001,750000,63999,False,111,scaffold_1
5,1179001,1193000,13999,False,111,scaffold_1
6,1281001,1292000,10999,False,111,scaffold_1
7,1612001,1660000,47999,False,111,scaffold_1
8,1813001,1899000,85999,False,111,scaffold_1
9,1953001,1964000,10999,False,111,scaffold_1
10,1965001,1984000,18999,False,111,scaffold_1
11,1986001,2015000,28999,False,111,scaffold_1
12,2365001,2387000,21999,False,111,scaffold_1
13,2449001,2517000,67999,False,111,scaffold_1
14,2566001,2582000,15999,False,111,scaffold_1
15,2729001,2746000,16999,False,111,scaffold_1
16,3173001,3209000,35999,False,111,scaffold_1
17,3712001,3749000,36999,False,111,scaffold_1
18,3827001,3876000,48999,False,111,scaffold_1
19,3908001,3941000,32999,False,111,scaffold_1
20,3960001,4030000,69999,False,111,scaffold_1
21,4064001,4115000,50999,False,111,scaffold_1
22,4315001,4375000,59999,False,111,scaffold_1
23,4645001,4671000,25999,False,111,scaffold_1
24,4707001,4741000,33999,False,111,scaffold_1
25,4796001,4815000,18999,False,111,scaffold_1
26,4927001,5025000,97999,False,111,scaffold_1
27,5087001,5118000,30999,False,111,scaffold_1
28,5481001,5521000,39999,False,111,scaffold_1
29,5533001,5573000,39999,False,111,scaffold_1
30,6107001,6153000,45999,False,111,scaffold_1
31,6154001,6177000,22999,False,111,scaffold_1
32,6201001,6508000,306999,False,111,scaffold_1
33,6543001,6555000,11999,False,111,scaffold_1
34,7038001,7247000,208999,False,111,scaffold_1
35,7248001,8656000,1407999,False,111,scaffold_1
36,8658001,9584000,925999,False,111,scaffold_1
37,9586001,10356000,769999,False,111,scaffold_1
38,10460001,10636000,175999,False,111,scaffold_1
39,10808001,10811000,2999,False,111,scaffold_1
40,10839001,10857000,17999,False,111,scaffold_1
41,10917001,10940000,22999,False,111,scaffold_1
42,11263001,11507000,243999,False,111,scaffold_1
43,11560001,11951000,390999,False,111,scaffold_1
44,12184001,12204000,19999,False,111,scaffold_1
45,12425001,12448000,22999,False,111,scaffold_1
46,12636001,12722000,85999,False,111,scaffold_1
47,12774001,12888000,113999,False,111,scaffold_1
48,12976001,12991000,14999,False,111,scaffold_1
49,13113001,13212000,98999,False,111,scaffold_1
50,13344001,13454000,109999,False,111,scaffold_1
51,13559001,13590000,30999,False,111,scaffold_1
52,13811001,13845000,33999,False,111,scaffold_1
53,13846001,13854000,7999,False,111,scaffold_1
54,13928001,13954000,25999,False,111,scaffold_1
55,14285001,14313000,27999,False,111,scaffold_1
56,14647001,14663000,15999,False,111,scaffold_1
0,21001,48000,26999,False,111,scaffold_2
1,93001,159000,65999,False,111,scaffold_2
2,165001,177000,11999,False,111,scaffold_2
3,253001,288000,34999,False,111,scaffold_2
4,296001,318000,21999,False,111,scaffold_2
5,333001,374000,40999,False,111,scaffold_2
6,1360001,1414000,53999,False,111,scaffold_2
7,2085001,2101000,15999,False,111,scaffold_2
8,2336001,2389000,52999,False,111,scaffold_2
9,2404001,2424000,19999,False,111,scaffold_2
10,2437001,2603000,165999,False,111,scaffold_2
11,2627001,2639000,11999,False,111,scaffold_2
12,2645001,2691000,45999,False,111,scaffold_2
13,2693001,2747000,53999,False,111,scaffold_2
14,2766001,2787000,20999,False,111,scaffold_2
15,2832001,2856000,23999,False,111,scaffold_2
16,2878001,2902000,23999,False,111,scaffold_2
17,2993001,3012000,18999,False,111,scaffold_2
18,3174001,3185000,10999,False,111,scaffold_2
19,3331001,3344000,12999,False,111,scaffold_2
20,3450001,3466000,15999,False,111,scaffold_2
21,3669001,3691000,21999,False,111,scaffold_2
22,3755001,3783000,27999,False,111,scaffold_2
23,4244001,4262000,17999,False,111,scaffold_2
24,4337001,4409000,71999,False,111,scaffold_2
25,4426001,4457000,30999,False,111,scaffold_2
26,4516001,4670000,153999,False,111,scaffold_2
27,4712001,4790000,77999,False,111,scaffold_2
28,4793001,4812000,18999,False,111,scaffold_2
29,4918001,4956000,37999,False,111,scaffold_2
30,5021001,5067000,45999,False,111,scaffold_2
31,5080001,5104000,23999,False,111,scaffold_2
32,5370001,5394000,23999,False,111,scaffold_2
33,5491001,5519000,27999,False,111,scaffold_2
34,5659001,5753000,93999,False,111,scaffold_2
35,5840001,5887000,46999,False,111,scaffold_2
36,6245001,6330000,84999,False,111,scaffold_2
37,6331001,6351000,19999,False,111,scaffold_2
38,6429001,6448000,18999,False,111,scaffold_2
39,6612001,6618000,5999,False,111,scaffold_2
40,6620001,6623000,2999,False,111,scaffold_2
41,7005001,7038000,32999,False,111,scaffold_2
42,7079001,7087000,7999,False,111,scaffold_2
43,7439001,7473000,33999,False,111,scaffold_2
44,7549001,7561000,11999,False,111,scaffold_2
45,7563001,7697000,133999,False,111,scaffold_2
46,7785001,7916000,130999,False,111,scaffold_2
47,7933001,8217000,283999,False,111,scaffold_2
48,8260001,8297000,36999,False,111,scaffold_2
49,8331001,8333000,1999,False,111,scaffold_2
50,8346001,8454000,107999,False,111,scaffold_2
51,8508001,8562000,53999,False,111,scaffold_2
52,9144001,9168000,23999,False,111,scaffold_2
53,9604001,9620000,15999,False,111,scaffold_2
54,10445001,10466000,20999,False,111,scaffold_2
55,10710001,10730000,19999,False,111,scaffold_2
56,11520001,11786000,265999,False,111,scaffold_2
0,218001,232000,13999,False,111,scaffold_3
1,618001,646000,27999,False,111,scaffold_3
2,799001,901000,101999,False,111,scaffold_3
3,1936001,1980000,43999,False,111,scaffold_3
4,2010001,2108000,97999,False,111,scaffold_3
5,2109001,2115000,5999,False,111,scaffold_3
6,2291001,2321000,29999,False,111,scaffold_3
7,2487001,2532000,44999,False,111,scaffold_3
8,2653001,2686000,32999,False,111,scaffold_3
9,2716001,2739000,22999,False,111,scaffold_3
10,3110001,3144000,33999,False,111,scaffold_3
11,3666001,3683000,16999,False,111,scaffold_3
12,3771001,3821000,49999,False,111,scaffold_3
13,3822001,3892000,69999,False,111,scaffold_3
14,4068001,4404000,335999,False,111,scaffold_3
15,4417001,4519000,101999,False,111,scaffold_3
16,4546001,4558000,11999,False,111,scaffold_3
17,4641001,4686000,44999,False,111,scaffold_3
18,5158001,5210000,51999,False,111,scaffold_3
19,5238001,5279000,40999,False,111,scaffold_3
20,5623001,5675000,51999,False,111,scaffold_3
21,5805001,5942000,136999,False,111,scaffold_3
22,5973001,6020000,46999,False,111,scaffold_3
23,6759001,6782000,22999,False,111,scaffold_3
24,6909001,7087000,177999,False,111,scaffold_3
25,7260001,7269000,8999,False,111,scaffold_3
26,7284001,7300000,15999,False,111,scaffold_3
27,7337001,7362000,24999,False,111,scaffold_3
28,7369001,7397000,27999,False,111,scaffold_3
29,7484001,7493000,8999,False,111,scaffold_3
30,7502001,7557000,54999,False,111,scaffold_3
31,7692001,7852000,159999,False,111,scaffold_3
32,8050001,8108000,57999,False,111,scaffold_3
33,8121001,8156000,34999,False,111,scaffold_3
34,8177001,8253000,75999,False,111,scaffold_3
35,8427001,8527000,99999,False,111,scaffold_3
36,8575001,8594000,18999,False,111,scaffold_3
37,9006001,9077000,70999,False,111,scaffold_3
38,9121001,9166000,44999,False,111,scaffold_3
39,9968001,9995000,26999,False,111,scaffold_3
40,10461001,10484000,22999,False,111,scaffold_3
41,10587001,11165000,577999,False,111,scaffold_3
0,11001,13000,1999,False,111,scaffold_4
1,14001,16000,1999,False,111,scaffold_4
2,17001,32000,14999,False,111,scaffold_4
3,48001,88000,39999,False,111,scaffold_4
4,132001,146000,13999,False,111,scaffold_4
5,147001,151000,3999,False,111,scaffold_4
6,155001,216000,60999,False,111,scaffold_4
7,217001,226000,8999,False,111,scaffold_4
8,227001,266000,38999,False,111,scaffold_4
9,289001,311000,21999,False,111,scaffold_4
10,312001,344000,31999,False,111,scaffold_4
11,345001,353000,7999,False,111,scaffold_4
12,355001,374000,18999,False,111,scaffold_4
13,375001,380000,4999,False,111,scaffold_4
14,412001,425000,12999,False,111,scaffold_4
15,429001,498000,68999,False,111,scaffold_4
16,543001,606000,62999,False,111,scaffold_4
17,608001,691000,82999,False,111,scaffold_4
18,695001,697000,1999,False,111,scaffold_4
19,700001,727000,26999,False,111,scaffold_4
20,1113001,1136000,22999,False,111,scaffold_4
21,1137001,1226000,88999,False,111,scaffold_4
22,1269001,1279000,9999,False,111,scaffold_4
23,1283001,1602000,318999,False,111,scaffold_4
24,1613001,2185000,571999,False,111,scaffold_4
25,2213001,2268000,54999,False,111,scaffold_4
26,2269001,2281000,11999,False,111,scaffold_4
27,2284001,2340000,55999,False,111,scaffold_4
28,2342001,2461000,118999,False,111,scaffold_4
29,2476001,2635000,158999,False,111,scaffold_4
30,2678001,2800000,121999,False,111,scaffold_4
31,2925001,2956000,30999,False,111,scaffold_4
32,3032001,3127000,94999,False,111,scaffold_4
33,3335001,3768000,432999,False,111,scaffold_4
34,4054001,4077000,22999,False,111,scaffold_4
35,4900001,5050000,149999,False,111,scaffold_4
36,5173001,5224000,50999,False,111,scaffold_4
37,5476001,5506000,29999,False,111,scaffold_4
38,5514001,5620000,105999,False,111,scaffold_4
39,5657001,5784000,126999,False,111,scaffold_4
40,5786001,5826000,39999,False,111,scaffold_4
41,6145001,6191000,45999,False,111,scaffold_4
42,6764001,6817000,52999,False,111,scaffold_4
43,6897001,6924000,26999,False,111,scaffold_4
44,6950001,6995000,44999,False,111,scaffold_4
45,7036001,7062000,25999,False,111,scaffold_4
46,7227001,7289000,61999,False,111,scaffold_4
47,7352001,7376000,23999,False,111,scaffold_4
48,7629001,7665000,35999,False,111,scaffold_4
49,7862001,7874000,11999,False,111,scaffold_4
50,8845001,9699000,853999,False,111,scaffold_4
51,9700001,9845951,145950,True,111,scaffold_4
0,152001,175000,22999,False,111,scaffold_5
1,319001,368000,48999,False,111,scaffold_5
2,463001,526000,62999,False,111,scaffold_5
3,669001,697000,27999,False,111,scaffold_5
4,933001,947000,13999,False,111,scaffold_5
5,2476001,2494000,17999,False,111,scaffold_5
6,2552001,2898000,345999,False,111,scaffold_5
7,3133001,3250000,116999,False,111,scaffold_5
8,3322001,3512000,189999,False,111,scaffold_5
9,3617001,3656000,38999,False,111,scaffold_5
10,3962001,4101000,138999,False,111,scaffold_5
11,4119001,4220000,100999,False,111,scaffold_5
12,4246001,4265000,18999,False,111,scaffold_5
13,4445001,4522000,76999,False,111,scaffold_5
14,4602001,4861000,258999,False,111,scaffold_5
15,4892001,4925000,32999,False,111,scaffold_5
16,5249001,5274000,24999,False,111,scaffold_5
17,5286001,5312000,25999,False,111,scaffold_5
18,5314001,5344000,29999,False,111,scaffold_5
19,6455001,6655000,199999,False,111,scaffold_5
20,7175001,7191000,15999,False,111,scaffold_5
21,7454001,7487000,32999,False,111,scaffold_5
22,7580001,7619000,38999,False,111,scaffold_5
23,7621001,7661000,39999,False,111,scaffold_5
24,7681001,7746000,64999,False,111,scaffold_5
25,8554001,8616000,61999,False,111,scaffold_5
26,8654001,8689000,34999,False,111,scaffold_5
27,8713001,9364176,651175,True,111,scaffold_5
0,65001,75000,9999,False,111,scaffold_6
1,78001,84000,5999,False,111,scaffold_6
2,86001,114000,27999,False,111,scaffold_6
3,162001,202000,39999,False,111,scaffold_6
4,240001,255000,14999,False,111,scaffold_6
5,257001,285000,27999,False,111,scaffold_6
6,459001,486000,26999,False,111,scaffold_6
7,1146001,1226000,79999,False,111,scaffold_6
8,1228001,1265000,36999,False,111,scaffold_6
9,1284001,1311000,26999,False,111,scaffold_6
10,1478001,1547000,68999,False,111,scaffold_6
11,1561001,1595000,33999,False,111,scaffold_6
12,1657001,1689000,31999,False,111,scaffold_6
13,1837001,1906000,68999,False,111,scaffold_6
14,2023001,2104000,80999,False,111,scaffold_6
15,2128001,2206000,77999,False,111,scaffold_6
16,2336001,2691000,354999,False,111,scaffold_6
17,2731001,2872000,140999,False,111,scaffold_6
18,2933001,3027000,93999,False,111,scaffold_6
19,3115001,3178000,62999,False,111,scaffold_6
20,3223001,3333000,109999,False,111,scaffold_6
21,3398001,3440000,41999,False,111,scaffold_6
22,3442001,3806000,363999,False,111,scaffold_6
23,3900001,3913000,12999,False,111,scaffold_6
24,4018001,4192000,173999,False,111,scaffold_6
25,4848001,4868000,19999,False,111,scaffold_6
26,4956001,4993000,36999,False,111,scaffold_6
27,6006001,6082000,75999,False,111,scaffold_6
28,6153001,6190000,36999,False,111,scaffold_6
29,6766001,6803000,36999,False,111,scaffold_6
30,7221001,7338000,116999,False,111,scaffold_6
31,7389001,7441000,51999,False,111,scaffold_6
32,7536001,7793000,256999,False,111,scaffold_6
33,7811001,8268281,457280,True,111,scaffold_6
0,1,8000,7999,True,111,scaffold_7
1,11001,34000,22999,False,111,scaffold_7
2,311001,340000,28999,False,111,scaffold_7
3,342001,508000,165999,False,111,scaffold_7
4,554001,563000,8999,False,111,scaffold_7
5,571001,577000,5999,False,111,scaffold_7
6,706001,736000,29999,False,111,scaffold_7
7,743001,753000,9999,False,111,scaffold_7
8,764001,825000,60999,False,111,scaffold_7
9,859001,864000,4999,False,111,scaffold_7
10,865001,937000,71999,False,111,scaffold_7
11,968001,981000,12999,False,111,scaffold_7
12,982001,1044000,61999,False,111,scaffold_7
13,1048001,1102000,53999,False,111,scaffold_7
14,1160001,1187000,26999,False,111,scaffold_7
15,1191001,1460000,268999,False,111,scaffold_7
16,1461001,1512000,50999,False,111,scaffold_7
17,1588001,1721000,132999,False,111,scaffold_7
18,1726001,1782000,55999,False,111,scaffold_7
19,1856001,1897000,40999,False,111,scaffold_7
20,1981001,2012000,30999,False,111,scaffold_7
21,2421001,2424000,2999,False,111,scaffold_7
22,3325001,3370000,44999,False,111,scaffold_7
23,3523001,3766000,242999,False,111,scaffold_7
24,4415001,4512000,96999,False,111,scaffold_7
25,4658001,4736000,77999,False,111,scaffold_7
26,4754001,4853000,98999,False,111,scaffold_7
27,4978001,5149000,170999,False,111,scaffold_7
28,5472001,5536000,63999,False,111,scaffold_7
29,6765001,6796000,30999,False,111,scaffold_7
30,6954001,7502216,548215,True,111,scaffold_7
0,1,6000,5999,True,111,scaffold_8
1,68001,85000,16999,False,111,scaffold_8
2,93001,101000,7999,False,111,scaffold_8
3,722001,725000,2999,False,111,scaffold_8
4,2415001,2530000,114999,False,111,scaffold_8
5,2535001,2552000,16999,False,111,scaffold_8
6,2650001,2683000,32999,False,111,scaffold_8
7,2722001,2844000,121999,False,111,scaffold_8
8,2846001,2896000,49999,False,111,scaffold_8
9,3032001,3125000,92999,False,111,scaffold_8
10,3126001,3526000,399999,False,111,scaffold_8
11,3577001,3614000,36999,False,111,scaffold_8
12,3615001,3938000,322999,False,111,scaffold_8
13,4036001,4147000,110999,False,111,scaffold_8
14,4203001,4221000,17999,False,111,scaffold_8
15,5093001,5136000,42999,False,111,scaffold_8
16,5171001,5241000,69999,False,111,scaffold_8
17,5579001,5595000,15999,False,111,scaffold_8
18,5651001,5694000,42999,False,111,scaffold_8
19,5750001,5804000,53999,False,111,scaffold_8
20,5840001,5873000,32999,False,111,scaffold_8
21,6322001,6334544,12543,True,111,scaffold_8
0,109001,118000,8999,False,111,scaffold_9
1,367001,404000,36999,False,111,scaffold_9
2,413001,434000,20999,False,111,scaffold_9
3,501001,531000,29999,False,111,scaffold_9
4,670001,696000,25999,False,111,scaffold_9
5,731001,742000,10999,False,111,scaffold_9
6,815001,842000,26999,False,111,scaffold_9
7,873001,986000,112999,False,111,scaffold_9
8,987001,995000,7999,False,111,scaffold_9
9,1001001,1007000,5999,False,111,scaffold_9
10,1010001,1085000,74999,False,111,scaffold_9
11,1087001,1150000,62999,False,111,scaffold_9
12,1151001,1196000,44999,False,111,scaffold_9
13,1312001,1383000,70999,False,111,scaffold_9
14,1428001,1454000,25999,False,111,scaffold_9
15,1457001,1464000,6999,False,111,scaffold_9
16,1487001,1500000,12999,False,111,scaffold_9
17,1600001,1615000,14999,False,111,scaffold_9
18,1656001,1692000,35999,False,111,scaffold_9
19,1749001,1791000,41999,False,111,scaffold_9
20,1815001,1853000,37999,False,111,scaffold_9
21,1970001,2063000,92999,False,111,scaffold_9
22,2076001,2133000,56999,False,111,scaffold_9
23,2144001,2172000,27999,False,111,scaffold_9
24,2173001,2239000,65999,False,111,scaffold_9
25,2594001,2640000,45999,False,111,scaffold_9
26,2731001,3381000,649999,False,111,scaffold_9
27,3383001,5107000,1723999,False,111,scaffold_9
28,5112001,5238000,125999,False,111,scaffold_9
29,5239001,5298000,58999,False,111,scaffold_9
30,5300001,6331288,1031287,True,111,scaffold_9
0,1,414000,413999,True,111,scaffold_10
1,415001,482000,66999,False,111,scaffold_10
2,483001,582000,98999,False,111,scaffold_10
3,602001,756000,153999,False,111,scaffold_10
4,888001,963000,74999,False,111,scaffold_10
5,1038001,1069000,30999,False,111,scaffold_10
6,1087001,1147000,59999,False,111,scaffold_10
7,1386001,1470000,83999,False,111,scaffold_10
8,1704001,1728000,23999,False,111,scaffold_10
9,2088001,2103000,14999,False,111,scaffold_10
10,2140001,2170000,29999,False,111,scaffold_10
11,2211001,2228000,16999,False,111,scaffold_10
12,2266001,2332000,65999,False,111,scaffold_10
13,2334001,2425000,90999,False,111,scaffold_10
14,2512001,2520000,7999,False,111,scaffold_10
15,2521001,2583000,61999,False,111,scaffold_10
16,2600001,2653000,52999,False,111,scaffold_10
17,2672001,2700000,27999,False,111,scaffold_10
18,2714001,2751000,36999,False,111,scaffold_10
19,2754001,2770000,15999,False,111,scaffold_10
20,4002001,4010000,7999,False,111,scaffold_10
21,4053001,4091000,37999,False,111,scaffold_10
22,4154001,4174000,19999,False,111,scaffold_10
23,4444001,4459000,14999,False,111,scaffold_10
24,4508001,4513000,4999,False,111,scaffold_10
25,4515001,4523000,7999,False,111,scaffold_10
26,4526001,4548000,21999,False,111,scaffold_10
27,4574001,4596000,21999,False,111,scaffold_10
28,4679001,4688000,8999,False,111,scaffold_10
29,4734001,4776000,41999,False,111,scaffold_10
30,4798001,4826000,27999,False,111,scaffold_10
31,4828001,4843000,14999,False,111,scaffold_10
32,4848001,4861000,12999,False,111,scaffold_10
0,10001,34000,23999,False,111,scaffold_11
1,40001,99000,58999,False,111,scaffold_11
2,149001,167000,17999,False,111,scaffold_11
3,169001,235000,65999,False,111,scaffold_11
4,240001,247000,6999,False,111,scaffold_11
5,297001,311000,13999,False,111,scaffold_11
6,419001,431000,11999,False,111,scaffold_11
7,648001,656000,7999,False,111,scaffold_11
8,1025001,1034000,8999,False,111,scaffold_11
9,1219001,1242000,22999,False,111,scaffold_11
10,1316001,1340000,23999,False,111,scaffold_11
11,1403001,1409000,5999,False,111,scaffold_11
12,1474001,1478000,3999,False,111,scaffold_11
13,1525001,1545000,19999,False,111,scaffold_11
14,1966001,1984000,17999,False,111,scaffold_11
15,2013001,2061000,47999,False,111,scaffold_11
16,2701001,2877000,175999,False,111,scaffold_11
17,2978001,3019000,40999,False,111,scaffold_11
18,3092001,3175000,82999,False,111,scaffold_11
19,3185001,3383000,197999,False,111,scaffold_11
20,3426001,3478000,51999,False,111,scaffold_11
21,3521001,3651000,129999,False,111,scaffold_11
22,3702001,3934000,231999,False,111,scaffold_11
23,3984001,4161000,176999,False,111,scaffold_11
24,4180001,4710000,529999,False,111,scaffold_11
25,4713001,4766820,53819,True,111,scaffold_11
0,1,1469000,1468999,True,111,scaffold_12
1,1566001,1583000,16999,False,111,scaffold_12
2,1719001,1733000,13999,False,111,scaffold_12
3,1882001,1960000,77999,False,111,scaffold_12
4,1973001,1995000,21999,False,111,scaffold_12
5,2024001,2101000,76999,False,111,scaffold_12
6,2136001,2167000,30999,False,111,scaffold_12
7,2340001,2379000,38999,False,111,scaffold_12
8,2571001,2616000,44999,False,111,scaffold_12
0,1,340000,339999,True,112,scaffold_1
1,482001,498000,15999,False,112,scaffold_1
2,574001,643000,68999,False,112,scaffold_1
3,686001,713000,26999,False,112,scaffold_1
4,731001,742000,10999,False,112,scaffold_1
5,1281001,1292000,10999,False,112,scaffold_1
6,1954001,1964000,9999,False,112,scaffold_1
7,1965001,1984000,18999,False,112,scaffold_1
8,2449001,2517000,67999,False,112,scaffold_1
9,2729001,2746000,16999,False,112,scaffold_1
10,3181001,3208000,26999,False,112,scaffold_1
11,3715001,3733000,17999,False,112,scaffold_1
12,3916001,3941000,24999,False,112,scaffold_1
13,4065001,4111000,45999,False,112,scaffold_1
14,4322001,4354000,31999,False,112,scaffold_1
15,4928001,4983000,54999,False,112,scaffold_1
16,5484001,5512000,27999,False,112,scaffold_1
17,6108001,6153000,44999,False,112,scaffold_1
18,6228001,6380000,151999,False,112,scaffold_1
19,6384001,6507000,122999,False,112,scaffold_1
20,6545001,6554000,8999,False,112,scaffold_1
21,7038001,7247000,208999,False,112,scaffold_1
22,7248001,7588000,339999,False,112,scaffold_1
23,7590001,8477000,886999,False,112,scaffold_1
24,8478001,8656000,177999,False,112,scaffold_1
25,8658001,9584000,925999,False,112,scaffold_1
26,9586001,10354000,767999,False,112,scaffold_1
27,10461001,10627000,165999,False,112,scaffold_1
28,10808001,10811000,2999,False,112,scaffold_1
29,10836001,10858000,21999,False,112,scaffold_1
30,11351001,11504000,152999,False,112,scaffold_1
31,11614001,11951000,336999,False,112,scaffold_1
32,12184001,12204000,19999,False,112,scaffold_1
33,12670001,12722000,51999,False,112,scaffold_1
34,12777001,12888000,110999,False,112,scaffold_1
35,13114001,13135000,20999,False,112,scaffold_1
36,13179001,13211000,31999,False,112,scaffold_1
37,13347001,13377000,29999,False,112,scaffold_1
38,14007001,14009000,1999,False,112,scaffold_1
0,22001,48000,25999,False,112,scaffold_2
1,93001,159000,65999,False,112,scaffold_2
2,168001,176000,7999,False,112,scaffold_2
3,303001,318000,14999,False,112,scaffold_2
4,332001,374000,41999,False,112,scaffold_2
5,2336001,2358000,21999,False,112,scaffold_2
6,2441001,2553000,111999,False,112,scaffold_2
7,2660001,2689000,28999,False,112,scaffold_2
8,2694001,2742000,47999,False,112,scaffold_2
9,3454001,3463000,8999,False,112,scaffold_2
10,3767001,3781000,13999,False,112,scaffold_2
11,4385001,4409000,23999,False,112,scaffold_2
12,4430001,4455000,24999,False,112,scaffold_2
13,4524001,4553000,28999,False,112,scaffold_2
14,4611001,4649000,37999,False,112,scaffold_2
15,5022001,5031000,8999,False,112,scaffold_2
16,5033001,5061000,27999,False,112,scaffold_2
17,5491001,5511000,19999,False,112,scaffold_2
18,5672001,5704000,31999,False,112,scaffold_2
19,6261001,6330000,68999,False,112,scaffold_2
20,6331001,6350000,18999,False,112,scaffold_2
21,7439001,7472000,32999,False,112,scaffold_2
22,7563001,7697000,133999,False,112,scaffold_2
23,7786001,7890000,103999,False,112,scaffold_2
24,7934001,7965000,30999,False,112,scaffold_2
25,7984001,8088000,103999,False,112,scaffold_2
26,8331001,8333000,1999,False,112,scaffold_2
27,8346001,8389000,42999,False,112,scaffold_2
28,8509001,8535000,25999,False,112,scaffold_2
29,11520001,11785000,264999,False,112,scaffold_2
0,1,2000,1999,True,112,scaffold_3
1,51001,55000,3999,False,112,scaffold_3
2,102001,104000,1999,False,112,scaffold_3
3,799001,900000,100999,False,112,scaffold_3
4,2084001,2108000,23999,False,112,scaffold_3
5,2291001,2321000,29999,False,112,scaffold_3
6,2508001,2533000,24999,False,112,scaffold_3
7,4150001,4403000,252999,False,112,scaffold_3
8,4410001,4518000,107999,False,112,scaffold_3
9,4547001,4558000,10999,False,112,scaffold_3
10,4654001,4678000,23999,False,112,scaffold_3
11,6911001,6962000,50999,False,112,scaffold_3
12,6980001,7075000,94999,False,112,scaffold_3
13,7540001,7556000,15999,False,112,scaffold_3
14,7692001,7725000,32999,False,112,scaffold_3
15,7823001,7838000,14999,False,112,scaffold_3
16,8205001,8255000,49999,False,112,scaffold_3
17,8462001,8527000,64999,False,112,scaffold_3
18,8575001,8593000,17999,False,112,scaffold_3
19,9968001,9995000,26999,False,112,scaffold_3
20,10461001,10483000,21999,False,112,scaffold_3
21,10587001,11163000,575999,False,112,scaffold_3
0,17001,32000,14999,False,112,scaffold_4
1,49001,80000,30999,False,112,scaffold_4
2,155001,160000,4999,False,112,scaffold_4
3,161001,215000,53999,False,112,scaffold_4
4,217001,226000,8999,False,112,scaffold_4
5,227001,266000,38999,False,112,scaffold_4
6,291001,310000,18999,False,112,scaffold_4
7,313001,344000,30999,False,112,scaffold_4
8,355001,374000,18999,False,112,scaffold_4
9,375001,380000,4999,False,112,scaffold_4
10,412001,425000,12999,False,112,scaffold_4
11,429001,498000,68999,False,112,scaffold_4
12,545001,599000,53999,False,112,scaffold_4
13,600001,606000,5999,False,112,scaffold_4
14,608001,661000,52999,False,112,scaffold_4
15,670001,691000,20999,False,112,scaffold_4
16,701001,714000,12999,False,112,scaffold_4
17,1121001,1136000,14999,False,112,scaffold_4
18,1137001,1186000,48999,False,112,scaffold_4
19,1199001,1208000,8999,False,112,scaffold_4
20,1210001,1226000,15999,False,112,scaffold_4
21,1254001,1262000,7999,False,112,scaffold_4
22,1265001,1279000,13999,False,112,scaffold_4
23,1283001,1313000,29999,False,112,scaffold_4
24,1362001,1591000,228999,False,112,scaffold_4
25,1749001,1816000,66999,False,112,scaffold_4
26,1905001,1957000,51999,False,112,scaffold_4
27,2211001,2246000,34999,False,112,scaffold_4
28,2247001,2268000,20999,False,112,scaffold_4
29,2269001,2279000,9999,False,112,scaffold_4
30,2284001,2310000,25999,False,112,scaffold_4
31,2312001,2340000,27999,False,112,scaffold_4
32,2480001,2567000,86999,False,112,scaffold_4
33,3335001,3632000,296999,False,112,scaffold_4
34,3676001,3759000,82999,False,112,scaffold_4
35,4944001,4984000,39999,False,112,scaffold_4
36,5477001,5506000,28999,False,112,scaffold_4
37,5514001,5620000,105999,False,112,scaffold_4
38,5669001,5784000,114999,False,112,scaffold_4
39,6145001,6190000,44999,False,112,scaffold_4
40,6804001,6817000,12999,False,112,scaffold_4
41,7037001,7062000,24999,False,112,scaffold_4
42,7985001,7997000,11999,False,112,scaffold_4
43,8849001,9699000,849999,False,112,scaffold_4
44,9700001,9845951,145950,True,112,scaffold_4
0,178001,180000,1999,False,112,scaffold_5
1,318001,368000,49999,False,112,scaffold_5
2,469001,480000,10999,False,112,scaffold_5
3,498001,523000,24999,False,112,scaffold_5
4,933001,947000,13999,False,112,scaffold_5
5,1062001,1068000,5999,False,112,scaffold_5
6,2565001,2581000,15999,False,112,scaffold_5
7,2625001,2737000,111999,False,112,scaffold_5
8,2816001,2871000,54999,False,112,scaffold_5
9,3138001,3185000,46999,False,112,scaffold_5
10,3322001,3438000,115999,False,112,scaffold_5
11,3451001,3497000,45999,False,112,scaffold_5
12,3962001,4101000,138999,False,112,scaffold_5
13,4121001,4142000,20999,False,112,scaffold_5
14,4155001,4219000,63999,False,112,scaffold_5
15,4246001,4262000,15999,False,112,scaffold_5
16,4446001,4483000,36999,False,112,scaffold_5
17,4603001,4649000,45999,False,112,scaffold_5
18,4691001,4717000,25999,False,112,scaffold_5
19,4789001,4861000,71999,False,112,scaffold_5
20,4892001,4925000,32999,False,112,scaffold_5
21,5318001,5345000,26999,False,112,scaffold_5
22,6543001,6565000,21999,False,112,scaffold_5
23,8730001,9363000,632999,False,112,scaffold_5
0,79001,84000,4999,False,112,scaffold_6
1,86001,112000,25999,False,112,scaffold_6
2,240001,253000,12999,False,112,scaffold_6
3,267001,283000,15999,False,112,scaffold_6
4,1229001,1262000,32999,False,112,scaffold_6
5,1479001,1546000,66999,False,112,scaffold_6
6,2023001,2086000,62999,False,112,scaffold_6
7,2130001,2169000,38999,False,112,scaffold_6
8,2371001,2595000,223999,False,112,scaffold_6
9,2596001,2653000,56999,False,112,scaffold_6
10,2657001,2691000,33999,False,112,scaffold_6
11,2731001,2851000,119999,False,112,scaffold_6
12,2933001,3014000,80999,False,112,scaffold_6
13,3115001,3149000,33999,False,112,scaffold_6
14,3224001,3301000,76999,False,112,scaffold_6
15,3407001,3428000,20999,False,112,scaffold_6
16,3462001,3766000,303999,False,112,scaffold_6
17,3899001,3913000,13999,False,112,scaffold_6
18,4018001,4064000,45999,False,112,scaffold_6
19,4085001,4193000,107999,False,112,scaffold_6
20,6011001,6060000,48999,False,112,scaffold_6
21,7283001,7337000,53999,False,112,scaffold_6
22,7557001,7795000,237999,False,112,scaffold_6
23,7811001,8263000,451999,False,112,scaffold_6
0,1,7000,6999,True,112,scaffold_7
1,13001,34000,20999,False,112,scaffold_7
2,323001,340000,16999,False,112,scaffold_7
3,342001,508000,165999,False,112,scaffold_7
4,554001,563000,8999,False,112,scaffold_7
5,571001,577000,5999,False,112,scaffold_7
6,706001,736000,29999,False,112,scaffold_7
7,743001,753000,9999,False,112,scaffold_7
8,764001,815000,50999,False,112,scaffold_7
9,859001,864000,4999,False,112,scaffold_7
10,982001,1044000,61999,False,112,scaffold_7
11,1067001,1099000,31999,False,112,scaffold_7
12,1204001,1460000,255999,False,112,scaffold_7
13,1461001,1512000,50999,False,112,scaffold_7
14,1588001,1688000,99999,False,112,scaffold_7
15,3326001,3369000,42999,False,112,scaffold_7
16,3595001,3649000,53999,False,112,scaffold_7
17,4418001,4517000,98999,False,112,scaffold_7
18,4658001,4681000,22999,False,112,scaffold_7
19,4979001,5030000,50999,False,112,scaffold_7
20,5077001,5111000,33999,False,112,scaffold_7
21,6955001,7270000,314999,False,112,scaffold_7
22,7271001,7502216,231215,True,112,scaffold_7
0,67001,85000,17999,False,112,scaffold_8
1,93001,102000,8999,False,112,scaffold_8
2,2449001,2466000,16999,False,112,scaffold_8
3,2662001,2683000,20999,False,112,scaffold_8
4,2745001,2756000,10999,False,112,scaffold_8
5,3060001,3525000,464999,False,112,scaffold_8
6,3584001,3612000,27999,False,112,scaffold_8
7,3615001,3913000,297999,False,112,scaffold_8
8,5200001,5241000,40999,False,112,scaffold_8
9,6329001,6334544,5543,True,112,scaffold_8
0,109001,117000,7999,False,112,scaffold_9
1,319001,333000,13999,False,112,scaffold_9
2,367001,411000,43999,False,112,scaffold_9
3,413001,434000,20999,False,112,scaffold_9
4,503001,531000,27999,False,112,scaffold_9
5,656001,665000,8999,False,112,scaffold_9
6,670001,696000,25999,False,112,scaffold_9
7,732001,742000,9999,False,112,scaffold_9
8,816001,842000,25999,False,112,scaffold_9
9,850001,862000,11999,False,112,scaffold_9
10,886001,986000,99999,False,112,scaffold_9
11,988001,995000,6999,False,112,scaffold_9
12,1001001,1007000,5999,False,112,scaffold_9
13,1010001,1031000,20999,False,112,scaffold_9
14,1035001,1085000,49999,False,112,scaffold_9
15,1087001,1150000,62999,False,112,scaffold_9
16,1151001,1160000,8999,False,112,scaffold_9
17,1313001,1377000,63999,False,112,scaffold_9
18,2601001,2616000,14999,False,112,scaffold_9
19,2872001,3381000,508999,False,112,scaffold_9
20,3383001,5100000,1716999,False,112,scaffold_9
21,5101001,5107000,5999,False,112,scaffold_9
22,5112001,5114000,1999,False,112,scaffold_9
23,5116001,5238000,121999,False,112,scaffold_9
24,5239001,5298000,58999,False,112,scaffold_9
25,5300001,5490000,189999,False,112,scaffold_9
26,5493001,6331288,838287,True,112,scaffold_9
0,1,197000,196999,True,112,scaffold_10
1,373001,405000,31999,False,112,scaffold_10
2,472001,482000,9999,False,112,scaffold_10
3,508001,576000,67999,False,112,scaffold_10
4,603001,750000,146999,False,112,scaffold_10
5,888001,916000,27999,False,112,scaffold_10
6,924001,962000,37999,False,112,scaffold_10
7,1088001,1105000,16999,False,112,scaffold_10
8,2346001,2366000,19999,False,112,scaffold_10
9,3264001,3268000,3999,False,112,scaffold_10
10,3272001,3274000,1999,False,112,scaffold_10
11,4054001,4091000,36999,False,112,scaffold_10
12,4154001,4174000,19999,False,112,scaffold_10
13,4445001,4456000,10999,False,112,scaffold_10
14,4508001,4513000,4999,False,112,scaffold_10
15,4515001,4523000,7999,False,112,scaffold_10
16,4526001,4547000,20999,False,112,scaffold_10
17,4576001,4595000,18999,False,112,scaffold_10
18,4681001,4688000,6999,False,112,scaffold_10
19,4734001,4766000,31999,False,112,scaffold_10
20,4769001,4776000,6999,False,112,scaffold_10
21,4798001,4824000,25999,False,112,scaffold_10
22,4827001,4843000,15999,False,112,scaffold_10
23,4848001,4861000,12999,False,112,scaffold_10
24,4865001,4866973,1972,True,112,scaffold_10
0,10001,34000,23999,False,112,scaffold_11
1,40001,91000,50999,False,112,scaffold_11
2,149001,167000,17999,False,112,scaffold_11
3,169001,191000,21999,False,112,scaffold_11
4,211001,235000,23999,False,112,scaffold_11
5,240001,248000,7999,False,112,scaffold_11
6,419001,431000,11999,False,112,scaffold_11
7,648001,656000,7999,False,112,scaffold_11
8,1025001,1034000,8999,False,112,scaffold_11
9,1305001,1307000,1999,False,112,scaffold_11
10,1474001,1477000,2999,False,112,scaffold_11
11,2701001,2872000,170999,False,112,scaffold_11
12,3211001,3254000,42999,False,112,scaffold_11
13,3331001,3383000,51999,False,112,scaffold_11
14,3702001,3926000,223999,False,112,scaffold_11
15,4321001,4710000,388999,False,112,scaffold_11
16,4713001,4766820,53819,True,112,scaffold_11
0,1,240000,239999,True,112,scaffold_12
1,289001,370000,80999,False,112,scaffold_12
2,474001,537000,62999,False,112,scaffold_12
3,582001,730000,147999,False,112,scaffold_12
4,739001,856000,116999,False,112,scaffold_12
5,865001,1354000,488999,False,112,scaffold_12
6,1720001,1733000,12999,False,112,scaffold_12
7,2571001,2612000,40999,False,112,scaffold_12
8,2685001,2699000,13999,False,112,scaffold_12
0,1,339000,338999,True,113,scaffold_1
1,482001,498000,15999,False,113,scaffold_1
2,572001,643000,70999,False,113,scaffold_1
3,686001,714000,27999,False,113,scaffold_1
4,729001,743000,13999,False,113,scaffold_1
5,1628001,1660000,31999,False,113,scaffold_1
6,1954001,1984000,29999,False,113,scaffold_1
7,1988001,1993000,4999,False,113,scaffold_1
8,2449001,2517000,67999,False,113,scaffold_1
9,2729001,2746000,16999,False,113,scaffold_1
10,3181001,3208000,26999,False,113,scaffold_1
11,3715001,3733000,17999,False,113,scaffold_1
12,3909001,3941000,31999,False,113,scaffold_1
13,4004001,4030000,25999,False,113,scaffold_1
14,4063001,4112000,48999,False,113,scaffold_1
15,4315001,4354000,38999,False,113,scaffold_1
16,4928001,4983000,54999,False,113,scaffold_1
17,5483001,5511000,27999,False,113,scaffold_1
18,5538001,5570000,31999,False,113,scaffold_1
19,5854001,5874000,19999,False,113,scaffold_1
20,6108001,6153000,44999,False,113,scaffold_1
21,6154001,6176000,21999,False,113,scaffold_1
22,6228001,6509000,280999,False,113,scaffold_1
23,6545001,6554000,8999,False,113,scaffold_1
24,7037001,7247000,209999,False,113,scaffold_1
25,7248001,7584000,335999,False,113,scaffold_1
26,7590001,8656000,1065999,False,113,scaffold_1
27,8658001,9584000,925999,False,113,scaffold_1
28,9586001,10359000,772999,False,113,scaffold_1
29,10461001,10636000,174999,False,113,scaffold_1
30,10836001,10858000,21999,False,113,scaffold_1
31,11351001,11508000,156999,False,113,scaffold_1
32,11562001,11578000,15999,False,113,scaffold_1
33,11583001,11951000,367999,False,113,scaffold_1
34,12184001,12204000,19999,False,113,scaffold_1
35,12667001,12722000,54999,False,113,scaffold_1
36,12778001,12888000,109999,False,113,scaffold_1
37,13113001,13211000,97999,False,113,scaffold_1
38,13347001,13377000,29999,False,113,scaffold_1
39,14285001,14307000,21999,False,113,scaffold_1
0,20001,48000,27999,False,113,scaffold_2
1,93001,159000,65999,False,113,scaffold_2
2,165001,177000,11999,False,113,scaffold_2
3,297001,318000,20999,False,113,scaffold_2
4,332001,374000,41999,False,113,scaffold_2
5,2336001,2358000,21999,False,113,scaffold_2
6,2404001,2424000,19999,False,113,scaffold_2
7,2437001,2554000,116999,False,113,scaffold_2
8,2660001,2689000,28999,False,113,scaffold_2
9,2694001,2742000,47999,False,113,scaffold_2
10,2868001,2899000,30999,False,113,scaffold_2
11,2975001,3021000,45999,False,113,scaffold_2
12,3454001,3464000,9999,False,113,scaffold_2
13,3754001,3783000,28999,False,113,scaffold_2
14,4385001,4409000,23999,False,113,scaffold_2
15,4428001,4457000,28999,False,113,scaffold_2
16,4521001,4656000,134999,False,113,scaffold_2
17,5022001,5031000,8999,False,113,scaffold_2
18,5033001,5061000,27999,False,113,scaffold_2
19,5491001,5512000,20999,False,113,scaffold_2
20,5672001,5707000,34999,False,113,scaffold_2
21,6261001,6330000,68999,False,113,scaffold_2
22,6331001,6351000,19999,False,113,scaffold_2
23,6407001,6449000,41999,False,113,scaffold_2
24,6593001,6628000,34999,False,113,scaffold_2
25,7439001,7472000,32999,False,113,scaffold_2
26,7572001,7697000,124999,False,113,scaffold_2
27,7786001,7891000,104999,False,113,scaffold_2
28,7929001,8160000,230999,False,113,scaffold_2
29,8267001,8297000,29999,False,113,scaffold_2
30,8331001,8333000,1999,False,113,scaffold_2
31,8340001,8344000,3999,False,113,scaffold_2
32,8346001,8389000,42999,False,113,scaffold_2
33,8509001,8536000,26999,False,113,scaffold_2
34,11520001,11785000,264999,False,113,scaffold_2
0,1,2000,1999,True,113,scaffold_3
1,51001,55000,3999,False,113,scaffold_3
2,618001,646000,27999,False,113,scaffold_3
3,798001,901000,102999,False,113,scaffold_3
4,2085001,2108000,22999,False,113,scaffold_3
5,2291001,2321000,29999,False,113,scaffold_3
6,2493001,2531000,37999,False,113,scaffold_3
7,3261001,3271000,9999,False,113,scaffold_3
8,3826001,3891000,64999,False,113,scaffold_3
9,4150001,4384000,233999,False,113,scaffold_3
10,4418001,4518000,99999,False,113,scaffold_3
11,4641001,4689000,47999,False,113,scaffold_3
12,5494001,5509000,14999,False,113,scaffold_3
13,6911001,6962000,50999,False,113,scaffold_3
14,6979001,7092000,112999,False,113,scaffold_3
15,7451001,7458000,6999,False,113,scaffold_3
16,7540001,7556000,15999,False,113,scaffold_3
17,7692001,7727000,34999,False,113,scaffold_3
18,7819001,7839000,19999,False,113,scaffold_3
19,8206001,8253000,46999,False,113,scaffold_3
20,8462001,8527000,64999,False,113,scaffold_3
21,8575001,8593000,17999,False,113,scaffold_3
22,9968001,9996000,27999,False,113,scaffold_3
23,10461001,10483000,21999,False,113,scaffold_3
24,10587001,11167000,579999,False,113,scaffold_3
0,17001,32000,14999,False,113,scaffold_4
1,48001,88000,39999,False,113,scaffold_4
2,101001,112000,10999,False,113,scaffold_4
3,155001,160000,4999,False,113,scaffold_4
4,161001,215000,53999,False,113,scaffold_4
5,217001,226000,8999,False,113,scaffold_4
6,227001,266000,38999,False,113,scaffold_4
7,291001,307000,15999,False,113,scaffold_4
8,318001,344000,25999,False,113,scaffold_4
9,346001,353000,6999,False,113,scaffold_4
10,355001,374000,18999,False,113,scaffold_4
11,375001,380000,4999,False,113,scaffold_4
12,390001,410000,19999,False,113,scaffold_4
13,411001,425000,13999,False,113,scaffold_4
14,429001,502000,72999,False,113,scaffold_4
15,547001,592000,44999,False,113,scaffold_4
16,593001,599000,5999,False,113,scaffold_4
17,600001,607000,6999,False,113,scaffold_4
18,608001,691000,82999,False,113,scaffold_4
19,695001,697000,1999,False,113,scaffold_4
20,701001,727000,25999,False,113,scaffold_4
21,1087001,1110000,22999,False,113,scaffold_4
22,1121001,1136000,14999,False,113,scaffold_4
23,1137001,1179000,41999,False,113,scaffold_4
24,1187001,1198000,10999,False,113,scaffold_4
25,1199001,1208000,8999,False,113,scaffold_4
26,1210001,1226000,15999,False,113,scaffold_4
27,1229001,1231000,1999,False,113,scaffold_4
28,1235001,1253000,17999,False,113,scaffold_4
29,1254001,1262000,7999,False,113,scaffold_4
30,1265001,1279000,13999,False,113,scaffold_4
31,1284001,1323000,38999,False,113,scaffold_4
32,1354001,1591000,236999,False,113,scaffold_4
33,1749001,1872000,122999,False,113,scaffold_4
34,1904001,1957000,52999,False,113,scaffold_4
35,1958001,2020000,61999,False,113,scaffold_4
36,2021001,2055000,33999,False,113,scaffold_4
37,2056001,2068000,11999,False,113,scaffold_4
38,2073001,2099000,25999,False,113,scaffold_4
39,2198001,2206000,7999,False,113,scaffold_4
40,2210001,2246000,35999,False,113,scaffold_4
41,2247001,2280000,32999,False,113,scaffold_4
42,2283001,2351000,67999,False,113,scaffold_4
43,2398001,2421000,22999,False,113,scaffold_4
44,2428001,2461000,32999,False,113,scaffold_4
45,2480001,2567000,86999,False,113,scaffold_4
46,3335001,3632000,296999,False,113,scaffold_4
47,3676001,3759000,82999,False,113,scaffold_4
48,4944001,4985000,40999,False,113,scaffold_4
49,5476001,5506000,29999,False,113,scaffold_4
50,5514001,5620000,105999,False,113,scaffold_4
51,5669001,5784000,114999,False,113,scaffold_4
52,6177001,6190000,12999,False,113,scaffold_4
53,7036001,7062000,25999,False,113,scaffold_4
54,8846001,9699000,852999,False,113,scaffold_4
55,9700001,9845951,145950,True,113,scaffold_4
0,142001,174000,31999,False,113,scaffold_5
1,189001,204000,14999,False,113,scaffold_5
2,318001,368000,49999,False,113,scaffold_5
3,463001,523000,59999,False,113,scaffold_5
4,669001,696000,26999,False,113,scaffold_5
5,933001,947000,13999,False,113,scaffold_5
6,2565001,2581000,15999,False,113,scaffold_5
7,2624001,2738000,113999,False,113,scaffold_5
8,2816001,2871000,54999,False,113,scaffold_5
9,3133001,3185000,51999,False,113,scaffold_5
10,3322001,3438000,115999,False,113,scaffold_5
11,3451001,3498000,46999,False,113,scaffold_5
12,3962001,4101000,138999,False,113,scaffold_5
13,4120001,4219000,98999,False,113,scaffold_5
14,4246001,4265000,18999,False,113,scaffold_5
15,4446001,4483000,36999,False,113,scaffold_5
16,4603001,4680000,76999,False,113,scaffold_5
17,4691001,4718000,26999,False,113,scaffold_5
18,4760001,4861000,100999,False,113,scaffold_5
19,4904001,4917000,12999,False,113,scaffold_5
20,5318001,5346000,27999,False,113,scaffold_5
21,7454001,7483000,28999,False,113,scaffold_5
22,7581001,7609000,27999,False,113,scaffold_5
23,7622001,7637000,14999,False,113,scaffold_5
24,8574001,8614000,39999,False,113,scaffold_5
25,8730001,9364176,634175,True,113,scaffold_5
0,79001,112000,32999,False,113,scaffold_6
1,241001,254000,12999,False,113,scaffold_6
2,1236001,1256000,19999,False,113,scaffold_6
3,1479001,1546000,66999,False,113,scaffold_6
4,2028001,2088000,59999,False,113,scaffold_6
5,2130001,2169000,38999,False,113,scaffold_6
6,2349001,2595000,245999,False,113,scaffold_6
7,2596001,2653000,56999,False,113,scaffold_6
8,2661001,2691000,29999,False,113,scaffold_6
9,2713001,2852000,138999,False,113,scaffold_6
10,2937001,3014000,76999,False,113,scaffold_6
11,3115001,3149000,33999,False,113,scaffold_6
12,3224001,3301000,76999,False,113,scaffold_6
13,3407001,3428000,20999,False,113,scaffold_6
14,3455001,3786000,330999,False,113,scaffold_6
15,3899001,3913000,13999,False,113,scaffold_6
16,4018001,4064000,45999,False,113,scaffold_6
17,4136001,4193000,56999,False,113,scaffold_6
18,6010001,6063000,52999,False,113,scaffold_6
19,7282001,7337000,54999,False,113,scaffold_6
20,7560001,7795000,234999,False,113,scaffold_6
21,7811001,8268281,457280,True,113,scaffold_6
0,323001,341000,17999,False,113,scaffold_7
1,342001,508000,165999,False,113,scaffold_7
2,554001,563000,8999,False,113,scaffold_7
3,571001,577000,5999,False,113,scaffold_7
4,706001,736000,29999,False,113,scaffold_7
5,741001,755000,13999,False,113,scaffold_7
6,764001,829000,64999,False,113,scaffold_7
7,830001,843000,12999,False,113,scaffold_7
8,859001,864000,4999,False,113,scaffold_7
9,865001,884000,18999,False,113,scaffold_7
10,964001,979000,14999,False,113,scaffold_7
11,982001,1044000,61999,False,113,scaffold_7
12,1048001,1104000,55999,False,113,scaffold_7
13,1172001,1187000,14999,False,113,scaffold_7
14,1191001,1512000,320999,False,113,scaffold_7
15,1588001,1688000,99999,False,113,scaffold_7
16,1775001,1782000,6999,False,113,scaffold_7
17,3326001,3369000,42999,False,113,scaffold_7
18,3523001,3550000,26999,False,113,scaffold_7
19,3595001,3649000,53999,False,113,scaffold_7
20,4418001,4512000,93999,False,113,scaffold_7
21,4644001,4733000,88999,False,113,scaffold_7
22,4979001,5030000,50999,False,113,scaffold_7
23,5077001,5112000,34999,False,113,scaffold_7
24,5485001,5515000,29999,False,113,scaffold_7
25,6954001,7502216,548215,True,113,scaffold_7
0,66001,85000,18999,False,113,scaffold_8
1,722001,724000,1999,False,113,scaffold_8
2,729001,732000,2999,False,113,scaffold_8
3,2492001,2525000,32999,False,113,scaffold_8
4,2537001,2550000,12999,False,113,scaffold_8
5,2662001,2683000,20999,False,113,scaffold_8
6,2739001,2757000,17999,False,113,scaffold_8
7,2812001,2844000,31999,False,113,scaffold_8
8,3059001,3525000,465999,False,113,scaffold_8
9,3581001,3612000,30999,False,113,scaffold_8
10,3615001,3916000,300999,False,113,scaffold_8
11,5124001,5135000,10999,False,113,scaffold_8
12,5200001,5241000,40999,False,113,scaffold_8
13,6329001,6334544,5543,True,113,scaffold_8
0,1,22000,21999,True,113,scaffold_9
1,109001,118000,8999,False,113,scaffold_9
2,121001,138000,16999,False,113,scaffold_9
3,303001,315000,11999,False,113,scaffold_9
4,319001,332000,12999,False,113,scaffold_9
5,366001,411000,44999,False,113,scaffold_9
6,413001,434000,20999,False,113,scaffold_9
7,502001,531000,28999,False,113,scaffold_9
8,670001,696000,25999,False,113,scaffold_9
9,814001,842000,27999,False,113,scaffold_9
10,885001,986000,100999,False,113,scaffold_9
11,988001,995000,6999,False,113,scaffold_9
12,1001001,1007000,5999,False,113,scaffold_9
13,1009001,1031000,21999,False,113,scaffold_9
14,1035001,1085000,49999,False,113,scaffold_9
15,1087001,1150000,62999,False,113,scaffold_9
16,1151001,1160000,8999,False,113,scaffold_9
17,1312001,1377000,64999,False,113,scaffold_9
18,1766001,1810000,43999,False,113,scaffold_9
19,2599001,2617000,17999,False,113,scaffold_9
20,2783001,2803000,19999,False,113,scaffold_9
21,2872001,3381000,508999,False,113,scaffold_9
22,3383001,5107000,1723999,False,113,scaffold_9
23,5112001,5115000,2999,False,113,scaffold_9
24,5116001,5238000,121999,False,113,scaffold_9
25,5239001,5298000,58999,False,113,scaffold_9
26,5299001,5491000,191999,False,113,scaffold_9
27,5493001,6331288,838287,True,113,scaffold_9
0,1,235000,234999,True,113,scaffold_10
1,375001,406000,30999,False,113,scaffold_10
2,472001,482000,9999,False,113,scaffold_10
3,483001,500000,16999,False,113,scaffold_10
4,506001,581000,74999,False,113,scaffold_10
5,603001,755000,151999,False,113,scaffold_10
6,785001,794000,8999,False,113,scaffold_10
7,888001,916000,27999,False,113,scaffold_10
8,924001,963000,38999,False,113,scaffold_10
9,1087001,1112000,24999,False,113,scaffold_10
10,4053001,4093000,39999,False,113,scaffold_10
11,4154001,4174000,19999,False,113,scaffold_10
12,4443001,4466000,22999,False,113,scaffold_10
13,4467001,4502000,34999,False,113,scaffold_10
14,4503001,4513000,9999,False,113,scaffold_10
15,4515001,4523000,7999,False,113,scaffold_10
16,4526001,4548000,21999,False,113,scaffold_10
17,4552001,4562000,9999,False,113,scaffold_10
18,4574001,4595000,20999,False,113,scaffold_10
19,4681001,4688000,6999,False,113,scaffold_10
20,4734001,4766000,31999,False,113,scaffold_10
21,4769001,4776000,6999,False,113,scaffold_10
22,4798001,4824000,25999,False,113,scaffold_10
23,4828001,4846000,17999,False,113,scaffold_10
24,4848001,4861000,12999,False,113,scaffold_10
25,4862001,4866973,4972,True,113,scaffold_10
0,10001,93000,82999,False,113,scaffold_11
1,149001,168000,18999,False,113,scaffold_11
2,169001,191000,21999,False,113,scaffold_11
3,213001,236000,22999,False,113,scaffold_11
4,240001,252000,11999,False,113,scaffold_11
5,420001,431000,10999,False,113,scaffold_11
6,649001,656000,6999,False,113,scaffold_11
7,1025001,1034000,8999,False,113,scaffold_11
8,1474001,1477000,2999,False,113,scaffold_11
9,2700001,2875000,174999,False,113,scaffold_11
10,3188001,3255000,66999,False,113,scaffold_11
11,3331001,3382000,50999,False,113,scaffold_11
12,3702001,3927000,224999,False,113,scaffold_11
13,4319001,4710000,390999,False,113,scaffold_11
14,4713001,4766820,53819,True,113,scaffold_11
0,1,370000,369999,True,113,scaffold_12
1,410001,428000,17999,False,113,scaffold_12
2,474001,856000,381999,False,113,scaffold_12
3,865001,1354000,488999,False,113,scaffold_12
4,1720001,1733000,12999,False,113,scaffold_12
5,2559001,2566000,6999,False,113,scaffold_12
6,2571001,2610000,38999,False,113,scaffold_12
0,1,342000,341999,True,114,scaffold_1
1,482001,498000,15999,False,114,scaffold_1
2,571001,643000,71999,False,114,scaffold_1
3,686001,743000,56999,False,114,scaffold_1
4,1280001,1292000,11999,False,114,scaffold_1
5,1827001,1898000,70999,False,114,scaffold_1
6,1954001,1964000,9999,False,114,scaffold_1
7,1965001,1984000,18999,False,114,scaffold_1
8,1988001,1994000,5999,False,114,scaffold_1
9,2447001,2517000,69999,False,114,scaffold_1
10,2729001,2746000,16999,False,114,scaffold_1
11,3173001,3208000,34999,False,114,scaffold_1
12,3715001,3737000,21999,False,114,scaffold_1
13,4060001,4112000,51999,False,114,scaffold_1
14,4322001,4355000,32999,False,114,scaffold_1
15,4928001,5022000,93999,False,114,scaffold_1
16,5482001,5511000,28999,False,114,scaffold_1
17,5535001,5570000,34999,False,114,scaffold_1
18,6108001,6153000,44999,False,114,scaffold_1
19,6228001,6381000,152999,False,114,scaffold_1
20,6384001,6507000,122999,False,114,scaffold_1
21,6543001,6557000,13999,False,114,scaffold_1
22,7038001,7247000,208999,False,114,scaffold_1
23,7248001,7589000,340999,False,114,scaffold_1
24,7590001,8656000,1065999,False,114,scaffold_1
25,8658001,9584000,925999,False,114,scaffold_1
26,9586001,10355000,768999,False,114,scaffold_1
27,10461001,10638000,176999,False,114,scaffold_1
28,10808001,10811000,2999,False,114,scaffold_1
29,10840001,10857000,16999,False,114,scaffold_1
30,11345001,11504000,158999,False,114,scaffold_1
31,11609001,11951000,341999,False,114,scaffold_1
32,12184001,12204000,19999,False,114,scaffold_1
33,12652001,12722000,69999,False,114,scaffold_1
34,12777001,12888000,110999,False,114,scaffold_1
35,13116001,13135000,18999,False,114,scaffold_1
36,13178001,13212000,33999,False,114,scaffold_1
37,13347001,13430000,82999,False,114,scaffold_1
38,14298001,14307000,8999,False,114,scaffold_1
0,22001,48000,25999,False,114,scaffold_2
1,93001,159000,65999,False,114,scaffold_2
2,168001,177000,8999,False,114,scaffold_2
3,303001,318000,14999,False,114,scaffold_2
4,333001,374000,40999,False,114,scaffold_2
5,379001,381000,1999,False,114,scaffold_2
6,2085001,2108000,22999,False,114,scaffold_2
7,2336001,2358000,21999,False,114,scaffold_2
8,2405001,2424000,18999,False,114,scaffold_2
9,2441001,2554000,112999,False,114,scaffold_2
10,2657001,2689000,31999,False,114,scaffold_2
11,2694001,2742000,47999,False,114,scaffold_2
12,2868001,2899000,30999,False,114,scaffold_2
13,3174001,3186000,11999,False,114,scaffold_2
14,3454001,3464000,9999,False,114,scaffold_2
15,3755001,3783000,27999,False,114,scaffold_2
16,4385001,4409000,23999,False,114,scaffold_2
17,4429001,4456000,26999,False,114,scaffold_2
18,4519001,4657000,137999,False,114,scaffold_2
19,4918001,4937000,18999,False,114,scaffold_2
20,5022001,5031000,8999,False,114,scaffold_2
21,5033001,5061000,27999,False,114,scaffold_2
22,5491001,5511000,19999,False,114,scaffold_2
23,5667001,5757000,89999,False,114,scaffold_2
24,5839001,5887000,47999,False,114,scaffold_2
25,6261001,6330000,68999,False,114,scaffold_2
26,6331001,6342000,10999,False,114,scaffold_2
27,7009001,7037000,27999,False,114,scaffold_2
28,7439001,7472000,32999,False,114,scaffold_2
29,7563001,7697000,133999,False,114,scaffold_2
30,7786001,7890000,103999,False,114,scaffold_2
31,7934001,8089000,154999,False,114,scaffold_2
32,8261001,8296000,34999,False,114,scaffold_2
33,8346001,8453000,106999,False,114,scaffold_2
34,8509001,8547000,37999,False,114,scaffold_2
35,11520001,11785000,264999,False,114,scaffold_2
0,1,2000,1999,True,114,scaffold_3
1,51001,55000,3999,False,114,scaffold_3
2,799001,901000,101999,False,114,scaffold_3
3,2041001,2108000,66999,False,114,scaffold_3
4,2110001,2115000,4999,False,114,scaffold_3
5,2291001,2321000,29999,False,114,scaffold_3
6,2487001,2533000,45999,False,114,scaffold_3
7,3769001,3821000,51999,False,114,scaffold_3
8,3822001,3880000,57999,False,114,scaffold_3
9,4108001,4403000,294999,False,114,scaffold_3
10,4418001,4518000,99999,False,114,scaffold_3
11,4547001,4558000,10999,False,114,scaffold_3
12,4653001,4679000,25999,False,114,scaffold_3
13,5990001,6022000,31999,False,114,scaffold_3
14,6910001,7087000,176999,False,114,scaffold_3
15,7540001,7556000,15999,False,114,scaffold_3
16,7692001,7804000,111999,False,114,scaffold_3
17,7816001,7841000,24999,False,114,scaffold_3
18,8175001,8253000,77999,False,114,scaffold_3
19,8462001,8527000,64999,False,114,scaffold_3
20,8575001,8594000,18999,False,114,scaffold_3
21,9968001,9996000,27999,False,114,scaffold_3
22,10461001,10483000,21999,False,114,scaffold_3
23,10587001,11167000,579999,False,114,scaffold_3
0,17001,32000,14999,False,114,scaffold_4
1,48001,88000,39999,False,114,scaffold_4
2,143001,146000,2999,False,114,scaffold_4
3,147001,151000,3999,False,114,scaffold_4
4,155001,160000,4999,False,114,scaffold_4
5,161001,215000,53999,False,114,scaffold_4
6,217001,226000,8999,False,114,scaffold_4
7,227001,266000,38999,False,114,scaffold_4
8,355001,373000,17999,False,114,scaffold_4
9,375001,380000,4999,False,114,scaffold_4
10,412001,425000,12999,False,114,scaffold_4
11,429001,498000,68999,False,114,scaffold_4
12,545001,599000,53999,False,114,scaffold_4
13,608001,662000,53999,False,114,scaffold_4
14,670001,691000,20999,False,114,scaffold_4
15,1121001,1136000,14999,False,114,scaffold_4
16,1137001,1179000,41999,False,114,scaffold_4
17,1199001,1208000,8999,False,114,scaffold_4
18,1210001,1226000,15999,False,114,scaffold_4
19,1235001,1253000,17999,False,114,scaffold_4
20,1283001,1336000,52999,False,114,scaffold_4
21,1372001,1597000,224999,False,114,scaffold_4
22,1613001,2002000,388999,False,114,scaffold_4
23,2025001,2117000,91999,False,114,scaffold_4
24,2162001,2185000,22999,False,114,scaffold_4
25,2255001,2268000,12999,False,114,scaffold_4
26,2269001,2279000,9999,False,114,scaffold_4
27,2284001,2352000,67999,False,114,scaffold_4
28,2353001,2370000,16999,False,114,scaffold_4
29,2398001,2461000,62999,False,114,scaffold_4
30,2476001,2635000,158999,False,114,scaffold_4
31,3336001,3633000,296999,False,114,scaffold_4
32,3645001,3762000,116999,False,114,scaffold_4
33,4901001,4985000,83999,False,114,scaffold_4
34,5476001,5506000,29999,False,114,scaffold_4
35,5515001,5620000,104999,False,114,scaffold_4
36,5662001,5784000,121999,False,114,scaffold_4
37,5786001,5823000,36999,False,114,scaffold_4
38,6764001,6817000,52999,False,114,scaffold_4
39,6902001,6924000,21999,False,114,scaffold_4
40,7036001,7062000,25999,False,114,scaffold_4
41,8846001,9699000,852999,False,114,scaffold_4
42,9700001,9845951,145950,True,114,scaffold_4
0,1,4000,3999,True,114,scaffold_5
1,318001,368000,49999,False,114,scaffold_5
2,463001,524000,60999,False,114,scaffold_5
3,933001,947000,13999,False,114,scaffold_5
4,2563001,2582000,18999,False,114,scaffold_5
5,2624001,2734000,109999,False,114,scaffold_5
6,2813001,2871000,57999,False,114,scaffold_5
7,3138001,3185000,46999,False,114,scaffold_5
8,3218001,3245000,26999,False,114,scaffold_5
9,3322001,3498000,175999,False,114,scaffold_5
10,3617001,3656000,38999,False,114,scaffold_5
11,3962001,4101000,138999,False,114,scaffold_5
12,4121001,4220000,98999,False,114,scaffold_5
13,4246001,4265000,18999,False,114,scaffold_5
14,4446001,4507000,60999,False,114,scaffold_5
15,4601001,4664000,62999,False,114,scaffold_5
16,4691001,4718000,26999,False,114,scaffold_5
17,4789001,4861000,71999,False,114,scaffold_5
18,4894001,4918000,23999,False,114,scaffold_5
19,5318001,5346000,27999,False,114,scaffold_5
20,6394001,6420000,25999,False,114,scaffold_5
21,6481001,6653000,171999,False,114,scaffold_5
22,6889001,6905000,15999,False,114,scaffold_5
23,7454001,7483000,28999,False,114,scaffold_5
24,7580001,7610000,29999,False,114,scaffold_5
25,7622001,7654000,31999,False,114,scaffold_5
26,8666001,8689000,22999,False,114,scaffold_5
27,8706001,9364176,658175,True,114,scaffold_5
0,79001,84000,4999,False,114,scaffold_6
1,86001,113000,26999,False,114,scaffold_6
2,240001,253000,12999,False,114,scaffold_6
3,421001,424000,2999,False,114,scaffold_6
4,1237001,1256000,18999,False,114,scaffold_6
5,1479001,1546000,66999,False,114,scaffold_6
6,1868001,1906000,37999,False,114,scaffold_6
7,2023001,2088000,64999,False,114,scaffold_6
8,2130001,2193000,62999,False,114,scaffold_6
9,2347001,2595000,247999,False,114,scaffold_6
10,2596001,2691000,94999,False,114,scaffold_6
11,2712001,2872000,159999,False,114,scaffold_6
12,2927001,3015000,87999,False,114,scaffold_6
13,3098001,3176000,77999,False,114,scaffold_6
14,3223001,3315000,91999,False,114,scaffold_6
15,3407001,3428000,20999,False,114,scaffold_6
16,3459001,3767000,307999,False,114,scaffold_6
17,3901001,3912000,10999,False,114,scaffold_6
18,4018001,4064000,45999,False,114,scaffold_6
19,4081001,4195000,113999,False,114,scaffold_6
20,6011001,6061000,49999,False,114,scaffold_6
21,7269001,7337000,67999,False,114,scaffold_6
22,7560001,7798000,237999,False,114,scaffold_6
23,7811001,8268281,457280,True,114,scaffold_6
0,13001,31000,17999,False,114,scaffold_7
1,323001,340000,16999,False,114,scaffold_7
2,342001,508000,165999,False,114,scaffold_7
3,554001,563000,8999,False,114,scaffold_7
4,571001,577000,5999,False,114,scaffold_7
5,706001,736000,29999,False,114,scaffold_7
6,741001,753000,11999,False,114,scaffold_7
7,764001,826000,61999,False,114,scaffold_7
8,859001,864000,4999,False,114,scaffold_7
9,868001,884000,15999,False,114,scaffold_7
10,964001,966000,1999,False,114,scaffold_7
11,968001,979000,10999,False,114,scaffold_7
12,982001,1044000,61999,False,114,scaffold_7
13,1048001,1104000,55999,False,114,scaffold_7
14,1191001,1512000,320999,False,114,scaffold_7
15,1588001,1688000,99999,False,114,scaffold_7
16,3325001,3369000,43999,False,114,scaffold_7
17,3528001,3548000,19999,False,114,scaffold_7
18,3596001,3659000,62999,False,114,scaffold_7
19,3717001,3766000,48999,False,114,scaffold_7
20,4415001,4517000,101999,False,114,scaffold_7
21,4635001,4682000,46999,False,114,scaffold_7
22,4979001,5148000,168999,False,114,scaffold_7
23,5483001,5533000,49999,False,114,scaffold_7
24,6954001,7270000,315999,False,114,scaffold_7
25,7271001,7502216,231215,True,114,scaffold_7
0,67001,85000,17999,False,114,scaffold_8
1,93001,101000,7999,False,114,scaffold_8
2,2444001,2525000,80999,False,114,scaffold_8
3,2650001,2683000,32999,False,114,scaffold_8
4,2742001,2757000,14999,False,114,scaffold_8
5,2799001,2844000,44999,False,114,scaffold_8
6,3057001,3525000,467999,False,114,scaffold_8
7,3579001,3612000,32999,False,114,scaffold_8
8,3615001,3916000,300999,False,114,scaffold_8
9,4038001,4102000,63999,False,114,scaffold_8
10,4206001,4220000,13999,False,114,scaffold_8
11,5085001,5136000,50999,False,114,scaffold_8
12,5198001,5241000,42999,False,114,scaffold_8
13,5764001,5774000,9999,False,114,scaffold_8
14,6323001,6334544,11543,True,114,scaffold_8
0,109001,117000,7999,False,114,scaffold_9
1,367001,411000,43999,False,114,scaffold_9
2,413001,436000,22999,False,114,scaffold_9
3,503001,531000,27999,False,114,scaffold_9
4,671001,696000,24999,False,114,scaffold_9
5,732001,742000,9999,False,114,scaffold_9
6,817001,842000,24999,False,114,scaffold_9
7,873001,986000,112999,False,114,scaffold_9
8,987001,995000,7999,False,114,scaffold_9
9,1001001,1007000,5999,False,114,scaffold_9
10,1008001,1085000,76999,False,114,scaffold_9
11,1087001,1150000,62999,False,114,scaffold_9
12,1151001,1175000,23999,False,114,scaffold_9
13,1312001,1383000,70999,False,114,scaffold_9
14,1599001,1618000,18999,False,114,scaffold_9
15,1751001,1791000,39999,False,114,scaffold_9
16,2598001,2616000,17999,False,114,scaffold_9
17,2780001,2803000,22999,False,114,scaffold_9
18,2870001,3381000,510999,False,114,scaffold_9
19,3383001,5100000,1716999,False,114,scaffold_9
20,5101001,5107000,5999,False,114,scaffold_9
21,5112001,5114000,1999,False,114,scaffold_9
22,5116001,5298000,181999,False,114,scaffold_9
23,5300001,6331288,1031287,True,114,scaffold_9
0,1,235000,234999,True,114,scaffold_10
1,281001,405000,123999,False,114,scaffold_10
2,424001,482000,57999,False,114,scaffold_10
3,483001,576000,92999,False,114,scaffold_10
4,603001,754000,150999,False,114,scaffold_10
5,785001,793000,7999,False,114,scaffold_10
6,888001,921000,32999,False,114,scaffold_10
7,923001,962000,38999,False,114,scaffold_10
8,1073001,1112000,38999,False,114,scaffold_10
9,2140001,2167000,26999,False,114,scaffold_10
10,2270001,2298000,27999,False,114,scaffold_10
11,2346001,2368000,21999,False,114,scaffold_10
12,2602001,2621000,18999,False,114,scaffold_10
13,4054001,4091000,36999,False,114,scaffold_10
14,4154001,4174000,19999,False,114,scaffold_10
15,4446001,4462000,15999,False,114,scaffold_10
16,4467001,4477000,9999,False,114,scaffold_10
17,4515001,4523000,7999,False,114,scaffold_10
18,4526001,4548000,21999,False,114,scaffold_10
19,4574001,4596000,21999,False,114,scaffold_10
20,4680001,4688000,7999,False,114,scaffold_10
21,4734001,4776000,41999,False,114,scaffold_10
22,4798001,4824000,25999,False,114,scaffold_10
23,4828001,4843000,14999,False,114,scaffold_10
24,4848001,4861000,12999,False,114,scaffold_10
25,4865001,4866973,1972,True,114,scaffold_10
0,11001,34000,22999,False,114,scaffold_11
1,38001,93000,54999,False,114,scaffold_11
2,149001,167000,17999,False,114,scaffold_11
3,169001,191000,21999,False,114,scaffold_11
4,213001,236000,22999,False,114,scaffold_11
5,240001,248000,7999,False,114,scaffold_11
6,419001,431000,11999,False,114,scaffold_11
7,648001,656000,7999,False,114,scaffold_11
8,1025001,1034000,8999,False,114,scaffold_11
9,1423001,1426000,2999,False,114,scaffold_11
10,2701001,2877000,175999,False,114,scaffold_11
11,3193001,3291000,97999,False,114,scaffold_11
12,3331001,3382000,50999,False,114,scaffold_11
13,3702001,3971000,268999,False,114,scaffold_11
14,4008001,4071000,62999,False,114,scaffold_11
15,4134001,4159000,24999,False,114,scaffold_11
16,4191001,4206000,14999,False,114,scaffold_11
17,4261001,4710000,448999,False,114,scaffold_11
18,4713001,4766820,53819,True,114,scaffold_11
0,1,369000,368999,True,114,scaffold_12
1,473001,543000,69999,False,114,scaffold_12
2,582001,1450000,867999,False,114,scaffold_12
3,1720001,1733000,12999,False,114,scaffold_12
4,2571001,2609000,37999,False,114,scaffold_12
5,2747001,2747968,967,True,114,scaffold_12
0,1,440000,439999,True,115,scaffold_1
1,482001,498000,15999,False,115,scaffold_1
2,571001,657000,85999,False,115,scaffold_1
3,686001,993000,306999,False,115,scaffold_1
4,1010001,1088000,77999,False,115,scaffold_1
5,1147001,1292000,144999,False,115,scaffold_1
6,1297001,1373000,75999,False,115,scaffold_1
7,1449001,1473000,23999,False,115,scaffold_1
8,1607001,3238000,1630999,False,115,scaffold_1
9,3244001,3371000,126999,False,115,scaffold_1
10,3438001,4300000,861999,False,115,scaffold_1
11,4301001,4786000,484999,False,115,scaffold_1
12,4796001,5323000,526999,False,115,scaffold_1
13,5348001,5671000,322999,False,115,scaffold_1
14,5789001,5951000,161999,False,115,scaffold_1
15,5971001,5989000,17999,False,115,scaffold_1
16,5995001,6067000,71999,False,115,scaffold_1
17,6107001,6692000,584999,False,115,scaffold_1
18,6724001,7029000,304999,False,115,scaffold_1
19,7030001,7247000,216999,False,115,scaffold_1
20,7248001,7589000,340999,False,115,scaffold_1
21,7590001,8656000,1065999,False,115,scaffold_1
22,8658001,9584000,925999,False,115,scaffold_1
23,9586001,10792000,1205999,False,115,scaffold_1
24,10837001,10981000,143999,False,115,scaffold_1
25,11013001,13216000,2202999,False,115,scaffold_1
26,13319001,13455000,135999,False,115,scaffold_1
27,13533001,13618000,84999,False,115,scaffold_1
28,13668001,13707000,38999,False,115,scaffold_1
29,13959001,13977000,17999,False,115,scaffold_1
30,14287001,14310000,22999,False,115,scaffold_1
0,1,48000,47999,True,115,scaffold_2
1,67001,159000,91999,False,115,scaffold_2
2,164001,176000,11999,False,115,scaffold_2
3,178001,186000,7999,False,115,scaffold_2
4,256001,287000,30999,False,115,scaffold_2
5,297001,318000,20999,False,115,scaffold_2
6,331001,376000,44999,False,115,scaffold_2
7,456001,546000,89999,False,115,scaffold_2
8,560001,627000,66999,False,115,scaffold_2
9,706001,739000,32999,False,115,scaffold_2
10,917001,1016000,98999,False,115,scaffold_2
11,1019001,1204000,184999,False,115,scaffold_2
12,1312001,1343000,30999,False,115,scaffold_2
13,1451001,1481000,29999,False,115,scaffold_2
14,1505001,1558000,52999,False,115,scaffold_2
15,1629001,1861000,231999,False,115,scaffold_2
16,1877001,1901000,23999,False,115,scaffold_2
17,1921001,1968000,46999,False,115,scaffold_2
18,2036001,2153000,116999,False,115,scaffold_2
19,2276001,2321000,44999,False,115,scaffold_2
20,2322001,2636000,313999,False,115,scaffold_2
21,2647001,2689000,41999,False,115,scaffold_2
22,2694001,2746000,51999,False,115,scaffold_2
23,2761001,2860000,98999,False,115,scaffold_2
24,2861001,3021000,159999,False,115,scaffold_2
25,3022001,3104000,81999,False,115,scaffold_2
26,3174001,3284000,109999,False,115,scaffold_2
27,3285001,3439000,153999,False,115,scaffold_2
28,3449001,3872000,422999,False,115,scaffold_2
29,3884001,3936000,51999,False,115,scaffold_2
30,3938001,4194000,255999,False,115,scaffold_2
31,4196001,4817000,620999,False,115,scaffold_2
32,4838001,4988000,149999,False,115,scaffold_2
33,5012001,5779000,766999,False,115,scaffold_2
34,5837001,6330000,492999,False,115,scaffold_2
35,6331001,6478000,146999,False,115,scaffold_2
36,6501001,7520000,1018999,False,115,scaffold_2
37,7544001,7561000,16999,False,115,scaffold_2
38,7563001,8330000,766999,False,115,scaffold_2
39,8331001,8344000,12999,False,115,scaffold_2
40,8346001,8645000,298999,False,115,scaffold_2
41,8671001,8850000,178999,False,115,scaffold_2
42,8921001,9900000,978999,False,115,scaffold_2
43,10165001,10251000,85999,False,115,scaffold_2
44,10328001,10355000,26999,False,115,scaffold_2
45,10398001,10755000,356999,False,115,scaffold_2
46,10773001,10817000,43999,False,115,scaffold_2
47,10913001,10962000,48999,False,115,scaffold_2
48,10995001,10998000,2999,False,115,scaffold_2
49,11000001,11365000,364999,False,115,scaffold_2
50,11366001,11802476,436475,True,115,scaffold_2
0,373001,382000,8999,False,115,scaffold_3
1,575001,594000,18999,False,115,scaffold_3
2,618001,640000,21999,False,115,scaffold_3
3,641001,646000,4999,False,115,scaffold_3
4,660001,737000,76999,False,115,scaffold_3
5,771001,783000,11999,False,115,scaffold_3
6,795001,936000,140999,False,115,scaffold_3
7,1063001,1084000,20999,False,115,scaffold_3
8,1085001,1105000,19999,False,115,scaffold_3
9,1163001,1272000,108999,False,115,scaffold_3
10,1583001,1788000,204999,False,115,scaffold_3
11,1880001,1934000,53999,False,115,scaffold_3
12,1936001,1983000,46999,False,115,scaffold_3
13,1998001,2428000,429999,False,115,scaffold_3
14,2436001,2533000,96999,False,115,scaffold_3
15,2534001,2554000,19999,False,115,scaffold_3
16,2594001,2923000,328999,False,115,scaffold_3
17,3066001,3450000,383999,False,115,scaffold_3
18,3499001,3921000,421999,False,115,scaffold_3
19,3922001,4399000,476999,False,115,scaffold_3
20,4418001,4672000,253999,False,115,scaffold_3
21,4673001,4694000,20999,False,115,scaffold_3
22,4695001,4926000,230999,False,115,scaffold_3
23,4953001,5223000,269999,False,115,scaffold_3
24,5236001,5506000,269999,False,115,scaffold_3
25,5542001,5765000,222999,False,115,scaffold_3
26,5776001,6323000,546999,False,115,scaffold_3
27,6352001,6399000,46999,False,115,scaffold_3
28,6421001,7157000,735999,False,115,scaffold_3
29,7223001,7447000,223999,False,115,scaffold_3
30,7482001,7564000,81999,False,115,scaffold_3
31,7576001,8117000,540999,False,115,scaffold_3
32,8119001,8173000,53999,False,115,scaffold_3
33,8174001,8638000,463999,False,115,scaffold_3
34,8654001,8806000,151999,False,115,scaffold_3
35,8839001,8917000,77999,False,115,scaffold_3
36,8956001,9248000,291999,False,115,scaffold_3
37,9279001,9619000,339999,False,115,scaffold_3
38,9705001,9722000,16999,False,115,scaffold_3
39,9723001,10149000,425999,False,115,scaffold_3
40,10152001,10458000,305999,False,115,scaffold_3
41,10461001,10547000,85999,False,115,scaffold_3
42,10548001,11182071,634070,True,115,scaffold_3
0,48001,115000,66999,False,115,scaffold_4
1,119001,151000,31999,False,115,scaffold_4
2,155001,215000,59999,False,115,scaffold_4
3,217001,272000,54999,False,115,scaffold_4
4,283001,353000,69999,False,115,scaffold_4
5,355001,372000,16999,False,115,scaffold_4
6,389001,425000,35999,False,115,scaffold_4
7,429001,505000,75999,False,115,scaffold_4
8,510001,692000,181999,False,115,scaffold_4
9,701001,726000,24999,False,115,scaffold_4
10,1121001,1208000,86999,False,115,scaffold_4
11,1210001,1226000,15999,False,115,scaffold_4
12,1228001,1279000,50999,False,115,scaffold_4
13,1283001,1605000,321999,False,115,scaffold_4
14,1613001,1849000,235999,False,115,scaffold_4
15,1850001,2116000,265999,False,115,scaffold_4
16,2138001,2205000,66999,False,115,scaffold_4
17,2207001,2218000,10999,False,115,scaffold_4
18,2219001,2268000,48999,False,115,scaffold_4
19,2269001,2280000,10999,False,115,scaffold_4
20,2284001,2471000,186999,False,115,scaffold_4
21,2476001,2675000,198999,False,115,scaffold_4
22,2676001,2812000,135999,False,115,scaffold_4
23,2842001,3146000,303999,False,115,scaffold_4
24,3158001,4570000,1411999,False,115,scaffold_4
25,4688001,5506000,817999,False,115,scaffold_4
26,5513001,5784000,270999,False,115,scaffold_4
27,5786001,6612000,825999,False,115,scaffold_4
28,6614001,6617000,2999,False,115,scaffold_4
29,6620001,6924000,303999,False,115,scaffold_4
30,6926001,7007000,80999,False,115,scaffold_4
31,7008001,7787000,778999,False,115,scaffold_4
32,7862001,8139000,276999,False,115,scaffold_4
33,8186001,8220000,33999,False,115,scaffold_4
34,8266001,8330000,63999,False,115,scaffold_4
35,8389001,8512000,122999,False,115,scaffold_4
36,8519001,8685000,165999,False,115,scaffold_4
37,8703001,8830000,126999,False,115,scaffold_4
38,8843001,9061000,217999,False,115,scaffold_4
39,9062001,9699000,636999,False,115,scaffold_4
40,9700001,9845951,145950,True,115,scaffold_4
0,139001,174000,34999,False,115,scaffold_5
1,324001,428000,103999,False,115,scaffold_5
2,446001,523000,76999,False,115,scaffold_5
3,669001,708000,38999,False,115,scaffold_5
4,933001,947000,13999,False,115,scaffold_5
5,1332001,1349000,16999,False,115,scaffold_5
6,1362001,1387000,24999,False,115,scaffold_5
7,1542001,1563000,20999,False,115,scaffold_5
8,1627001,1661000,33999,False,115,scaffold_5
9,1946001,1968000,21999,False,115,scaffold_5
10,2092001,2104000,11999,False,115,scaffold_5
11,2105001,2117000,11999,False,115,scaffold_5
12,2255001,2312000,56999,False,115,scaffold_5
13,2381001,2450000,68999,False,115,scaffold_5
14,2474001,2493000,18999,False,115,scaffold_5
15,2516001,3663000,1146999,False,115,scaffold_5
16,3666001,5590000,1923999,False,115,scaffold_5
17,5633001,5828000,194999,False,115,scaffold_5
18,5859001,5889000,29999,False,115,scaffold_5
19,6156001,6251000,94999,False,115,scaffold_5
20,6310001,7085000,774999,False,115,scaffold_5
21,7118001,7387000,268999,False,115,scaffold_5
22,7406001,7445000,38999,False,115,scaffold_5
23,7453001,7806000,352999,False,115,scaffold_5
24,7814001,7909000,94999,False,115,scaffold_5
25,7953001,8047000,93999,False,115,scaffold_5
26,8258001,8539000,280999,False,115,scaffold_5
27,8540001,8689000,148999,False,115,scaffold_5
28,8691001,9364176,673175,True,115,scaffold_5
0,43001,75000,31999,False,115,scaffold_6
1,86001,419000,332999,False,115,scaffold_6
2,556001,582000,25999,False,115,scaffold_6
3,635001,714000,78999,False,115,scaffold_6
4,786001,810000,23999,False,115,scaffold_6
5,964001,1094000,129999,False,115,scaffold_6
6,1121001,1309000,187999,False,115,scaffold_6
7,1326001,1604000,277999,False,115,scaffold_6
8,1659001,1906000,246999,False,115,scaffold_6
9,1907001,1951000,43999,False,115,scaffold_6
10,1958001,2019000,60999,False,115,scaffold_6
11,2023001,2105000,81999,False,115,scaffold_6
12,2127001,2297000,169999,False,115,scaffold_6
13,2315001,2867000,551999,False,115,scaffold_6
14,2932001,3806000,873999,False,115,scaffold_6
15,3810001,4207000,396999,False,115,scaffold_6
16,4209001,4489000,279999,False,115,scaffold_6
17,4574001,4680000,105999,False,115,scaffold_6
18,4686001,4753000,66999,False,115,scaffold_6
19,4770001,4919000,148999,False,115,scaffold_6
20,4924001,5006000,81999,False,115,scaffold_6
21,5055001,5843000,787999,False,115,scaffold_6
22,5854001,6310000,455999,False,115,scaffold_6
23,6446001,7339000,892999,False,115,scaffold_6
24,7361001,7932000,570999,False,115,scaffold_6
25,7933001,8268281,335280,True,115,scaffold_6
0,1,31000,30999,True,115,scaffold_7
1,296001,341000,44999,False,115,scaffold_7
2,342001,505000,162999,False,115,scaffold_7
3,580001,612000,31999,False,115,scaffold_7
4,614001,755000,140999,False,115,scaffold_7
5,760001,829000,68999,False,115,scaffold_7
6,830001,842000,11999,False,115,scaffold_7
7,876001,963000,86999,False,115,scaffold_7
8,982001,1044000,61999,False,115,scaffold_7
9,1048001,1103000,54999,False,115,scaffold_7
10,1191001,1695000,503999,False,115,scaffold_7
11,1727001,1902000,174999,False,115,scaffold_7
12,1976001,2178000,201999,False,115,scaffold_7
13,2180001,2412000,231999,False,115,scaffold_7
14,2427001,2759000,331999,False,115,scaffold_7
15,2811001,3206000,394999,False,115,scaffold_7
16,3228001,4153000,924999,False,115,scaffold_7
17,4198001,4294000,95999,False,115,scaffold_7
18,4321001,4518000,196999,False,115,scaffold_7
19,4522001,5664000,1141999,False,115,scaffold_7
20,5718001,5809000,90999,False,115,scaffold_7
21,5915001,6422000,506999,False,115,scaffold_7
22,6462001,6512000,49999,False,115,scaffold_7
23,6526001,6871000,344999,False,115,scaffold_7
24,6954001,7270000,315999,False,115,scaffold_7
25,7271001,7502216,231215,True,115,scaffold_7
0,32001,87000,54999,False,115,scaffold_8
1,336001,355000,18999,False,115,scaffold_8
2,434001,458000,23999,False,115,scaffold_8
3,1004001,1067000,62999,False,115,scaffold_8
4,1086001,1132000,45999,False,115,scaffold_8
5,1169001,1210000,40999,False,115,scaffold_8
6,1322001,1447000,124999,False,115,scaffold_8
7,1497001,1650000,152999,False,115,scaffold_8
8,1673001,1763000,89999,False,115,scaffold_8
9,1800001,2683000,882999,False,115,scaffold_8
10,2684001,2844000,159999,False,115,scaffold_8
11,2846001,4712000,1865999,False,115,scaffold_8
12,4732001,4960000,227999,False,115,scaffold_8
13,4996001,5695000,698999,False,115,scaffold_8
14,5754001,5771000,16999,False,115,scaffold_8
15,5776001,6334544,558543,True,115,scaffold_8
0,1,22000,21999,True,115,scaffold_9
1,80001,106000,25999,False,115,scaffold_9
2,109001,138000,28999,False,115,scaffold_9
3,150001,181000,30999,False,115,scaffold_9
4,287001,411000,123999,False,115,scaffold_9
5,413001,434000,20999,False,115,scaffold_9
6,483001,531000,47999,False,115,scaffold_9
7,598001,619000,20999,False,115,scaffold_9
8,660001,665000,4999,False,115,scaffold_9
9,671001,693000,21999,False,115,scaffold_9
10,722001,742000,19999,False,115,scaffold_9
11,814001,843000,28999,False,115,scaffold_9
12,886001,986000,99999,False,115,scaffold_9
13,987001,995000,7999,False,115,scaffold_9
14,998001,1007000,8999,False,115,scaffold_9
15,1009001,1172000,162999,False,115,scaffold_9
16,1212001,1276000,63999,False,115,scaffold_9
17,1312001,1382000,69999,False,115,scaffold_9
18,1483001,1500000,16999,False,115,scaffold_9
19,1520001,1585000,64999,False,115,scaffold_9
20,1598001,1632000,33999,False,115,scaffold_9
21,1633001,1691000,57999,False,115,scaffold_9
22,1705001,1808000,102999,False,115,scaffold_9
23,1816001,1856000,39999,False,115,scaffold_9
24,1886001,1962000,75999,False,115,scaffold_9
25,1970001,2067000,96999,False,115,scaffold_9
26,2098001,2572000,473999,False,115,scaffold_9
27,2592001,2673000,80999,False,115,scaffold_9
28,2674001,3381000,706999,False,115,scaffold_9
29,3383001,5099000,1715999,False,115,scaffold_9
30,5101001,5110000,8999,False,115,scaffold_9
31,5112001,5298000,185999,False,115,scaffold_9
32,5300001,5490000,189999,False,115,scaffold_9
33,5492001,6331288,839287,True,115,scaffold_9
0,1,414000,413999,True,115,scaffold_10
1,415001,482000,66999,False,115,scaffold_10
2,483001,1069000,585999,False,115,scaffold_10
3,1073001,1211000,137999,False,115,scaffold_10
4,1268001,1300000,31999,False,115,scaffold_10
5,1301001,1919000,617999,False,115,scaffold_10
6,1997001,2111000,113999,False,115,scaffold_10
7,2136001,2180000,43999,False,115,scaffold_10
8,2226001,2471000,244999,False,115,scaffold_10
9,2521001,2656000,134999,False,115,scaffold_10
10,2675001,2697000,21999,False,115,scaffold_10
11,2731001,2748000,16999,False,115,scaffold_10
12,2787001,2813000,25999,False,115,scaffold_10
13,2814001,3002000,187999,False,115,scaffold_10
14,3003001,3039000,35999,False,115,scaffold_10
15,3066001,3227000,160999,False,115,scaffold_10
16,3362001,3431000,68999,False,115,scaffold_10
17,3649001,3675000,25999,False,115,scaffold_10
18,4001001,4136000,134999,False,115,scaffold_10
19,4139001,4211000,71999,False,115,scaffold_10
20,4214001,4247000,32999,False,115,scaffold_10
21,4316001,4411000,94999,False,115,scaffold_10
22,4441001,4513000,71999,False,115,scaffold_10
23,4515001,4523000,7999,False,115,scaffold_10
24,4526001,4547000,20999,False,115,scaffold_10
25,4554001,4562000,7999,False,115,scaffold_10
26,4565001,4658000,92999,False,115,scaffold_10
27,4716001,4776000,59999,False,115,scaffold_10
28,4791001,4824000,32999,False,115,scaffold_10
29,4827001,4846000,18999,False,115,scaffold_10
30,4848001,4866973,18972,True,115,scaffold_10
0,9001,108000,98999,False,115,scaffold_11
1,132001,236000,103999,False,115,scaffold_11
2,240001,253000,12999,False,115,scaffold_11
3,278001,322000,43999,False,115,scaffold_11
4,419001,431000,11999,False,115,scaffold_11
5,638001,656000,17999,False,115,scaffold_11
6,1219001,1243000,23999,False,115,scaffold_11
7,1670001,1694000,23999,False,115,scaffold_11
8,1773001,1805000,31999,False,115,scaffold_11
9,2074001,2171000,96999,False,115,scaffold_11
10,2194001,2212000,17999,False,115,scaffold_11
11,2325001,3406000,1080999,False,115,scaffold_11
12,3408001,4161000,752999,False,115,scaffold_11
13,4182001,4710000,527999,False,115,scaffold_11
14,4712001,4766820,54819,True,115,scaffold_11
0,1,1620000,1619999,True,115,scaffold_12
1,1637001,1682000,44999,False,115,scaffold_12
2,1717001,1750000,32999,False,115,scaffold_12
3,1786001,1812000,25999,False,115,scaffold_12
4,1888001,1959000,70999,False,115,scaffold_12
5,1973001,2001000,27999,False,115,scaffold_12
6,2024001,2124000,99999,False,115,scaffold_12
7,2130001,2183000,52999,False,115,scaffold_12
8,2292001,2378000,85999,False,115,scaffold_12
9,2459001,2482000,22999,False,115,scaffold_12
10,2571001,2624000,52999,False,115,scaffold_12
11,2625001,2639000,13999,False,115,scaffold_12
0,1,356000,355999,True,116,scaffold_1
1,482001,498000,15999,False,116,scaffold_1
2,570001,643000,72999,False,116,scaffold_1
3,686001,749000,62999,False,116,scaffold_1
4,1268001,1292000,23999,False,116,scaffold_1
5,1606001,1699000,92999,False,116,scaffold_1
6,1814001,1899000,84999,False,116,scaffold_1
7,1950001,1984000,33999,False,116,scaffold_1
8,2363001,2415000,51999,False,116,scaffold_1
9,2449001,2518000,68999,False,116,scaffold_1
10,2563001,2582000,18999,False,116,scaffold_1
11,2726001,2746000,19999,False,116,scaffold_1
12,2902001,2921000,18999,False,116,scaffold_1
13,3049001,3062000,12999,False,116,scaffold_1
14,3174001,3209000,34999,False,116,scaffold_1
15,3450001,3477000,26999,False,116,scaffold_1
16,3575001,3622000,46999,False,116,scaffold_1
17,3701001,3782000,80999,False,116,scaffold_1
18,3849001,3887000,37999,False,116,scaffold_1
19,3908001,3941000,32999,False,116,scaffold_1
20,4002001,4030000,27999,False,116,scaffold_1
21,4062001,4112000,49999,False,116,scaffold_1
22,4314001,4355000,40999,False,116,scaffold_1
23,4709001,4769000,59999,False,116,scaffold_1
24,4796001,4810000,13999,False,116,scaffold_1
25,4927001,5011000,83999,False,116,scaffold_1
26,5087001,5116000,28999,False,116,scaffold_1
27,5438001,5449000,10999,False,116,scaffold_1
28,5481001,5511000,29999,False,116,scaffold_1
29,5535001,5580000,44999,False,116,scaffold_1
30,5852001,5910000,57999,False,116,scaffold_1
31,6108001,6177000,68999,False,116,scaffold_1
32,6228001,6380000,151999,False,116,scaffold_1
33,6382001,6578000,195999,False,116,scaffold_1
34,7037001,7247000,209999,False,116,scaffold_1
35,7248001,7589000,340999,False,116,scaffold_1
36,7590001,8477000,886999,False,116,scaffold_1
37,8478001,8656000,177999,False,116,scaffold_1
38,8658001,9584000,925999,False,116,scaffold_1
39,9586001,10362000,775999,False,116,scaffold_1
40,10460001,10640000,179999,False,116,scaffold_1
41,10664001,10763000,98999,False,116,scaffold_1
42,10838001,10857000,18999,False,116,scaffold_1
43,11016001,11029000,12999,False,116,scaffold_1
44,11279001,11305000,25999,False,116,scaffold_1
45,11347001,11510000,162999,False,116,scaffold_1
46,11551001,11951000,399999,False,116,scaffold_1
47,12184001,12243000,58999,False,116,scaffold_1
48,12653001,12722000,68999,False,116,scaffold_1
49,12775001,12888000,112999,False,116,scaffold_1
50,12964001,13002000,37999,False,116,scaffold_1
51,13099001,13212000,112999,False,116,scaffold_1
52,13347001,13430000,82999,False,116,scaffold_1
53,13842001,13845000,2999,False,116,scaffold_1
54,14285001,14307000,21999,False,116,scaffold_1
55,14605001,14609000,3999,False,116,scaffold_1
0,43001,48000,4999,False,116,scaffold_2
1,93001,159000,65999,False,116,scaffold_2
2,168001,176000,7999,False,116,scaffold_2
3,296001,318000,21999,False,116,scaffold_2
4,333001,374000,40999,False,116,scaffold_2
5,2336001,2390000,53999,False,116,scaffold_2
6,2404001,2615000,210999,False,116,scaffold_2
7,2660001,2689000,28999,False,116,scaffold_2
8,2694001,2746000,51999,False,116,scaffold_2
9,2768001,2786000,17999,False,116,scaffold_2
10,2834001,2856000,21999,False,116,scaffold_2
11,2868001,2902000,33999,False,116,scaffold_2
12,2973001,3013000,39999,False,116,scaffold_2
13,3367001,3389000,21999,False,116,scaffold_2
14,3451001,3466000,14999,False,116,scaffold_2
15,3754001,3783000,28999,False,116,scaffold_2
16,4260001,4270000,9999,False,116,scaffold_2
17,4340001,4409000,68999,False,116,scaffold_2
18,4426001,4460000,33999,False,116,scaffold_2
19,4473001,4658000,184999,False,116,scaffold_2
20,4918001,4955000,36999,False,116,scaffold_2
21,5021001,5104000,82999,False,116,scaffold_2
22,5210001,5223000,12999,False,116,scaffold_2
23,5369001,5393000,23999,False,116,scaffold_2
24,5413001,5481000,67999,False,116,scaffold_2
25,5490001,5559000,68999,False,116,scaffold_2
26,5658001,5704000,45999,False,116,scaffold_2
27,5719001,5760000,40999,False,116,scaffold_2
28,5840001,5888000,47999,False,116,scaffold_2
29,5913001,6037000,123999,False,116,scaffold_2
30,6245001,6349000,103999,False,116,scaffold_2
31,6394001,6449000,54999,False,116,scaffold_2
32,6509001,6519000,9999,False,116,scaffold_2
33,6589001,6628000,38999,False,116,scaffold_2
34,6828001,6902000,73999,False,116,scaffold_2
35,6947001,6979000,31999,False,116,scaffold_2
36,7002001,7038000,35999,False,116,scaffold_2
37,7049001,7098000,48999,False,116,scaffold_2
38,7141001,7242000,100999,False,116,scaffold_2
39,7340001,7475000,134999,False,116,scaffold_2
40,7491001,7519000,27999,False,116,scaffold_2
41,7548001,7561000,12999,False,116,scaffold_2
42,7563001,7698000,134999,False,116,scaffold_2
43,7780001,8161000,380999,False,116,scaffold_2
44,8259001,8314000,54999,False,116,scaffold_2
45,8331001,8333000,1999,False,116,scaffold_2
46,8335001,8345000,9999,False,116,scaffold_2
47,8346001,8453000,106999,False,116,scaffold_2
48,8495001,8563000,67999,False,116,scaffold_2
49,9139001,9175000,35999,False,116,scaffold_2
50,9348001,9473000,124999,False,116,scaffold_2
51,9603001,9621000,17999,False,116,scaffold_2
52,11367001,11381000,13999,False,116,scaffold_2
53,11392001,11426000,33999,False,116,scaffold_2
54,11471001,11503000,31999,False,116,scaffold_2
55,11520001,11786000,265999,False,116,scaffold_2
0,1,2000,1999,True,116,scaffold_3
1,51001,55000,3999,False,116,scaffold_3
2,797001,900000,102999,False,116,scaffold_3
3,2010001,2108000,97999,False,116,scaffold_3
4,2282001,2322000,39999,False,116,scaffold_3
5,2433001,2532000,98999,False,116,scaffold_3
6,3610001,3620000,9999,False,116,scaffold_3
7,3768001,3893000,124999,False,116,scaffold_3
8,3902001,3921000,18999,False,116,scaffold_3
9,3996001,4028000,31999,False,116,scaffold_3
10,4102001,4403000,300999,False,116,scaffold_3
11,4410001,4522000,111999,False,116,scaffold_3
12,4545001,4564000,18999,False,116,scaffold_3
13,4566001,4577000,10999,False,116,scaffold_3
14,4636001,4686000,49999,False,116,scaffold_3
15,5240001,5271000,30999,False,116,scaffold_3
16,5494001,5509000,14999,False,116,scaffold_3
17,5926001,5945000,18999,False,116,scaffold_3
18,5990001,6020000,29999,False,116,scaffold_3
19,6543001,6574000,30999,False,116,scaffold_3
20,6742001,6785000,42999,False,116,scaffold_3
21,6910001,6962000,51999,False,116,scaffold_3
22,6979001,7090000,110999,False,116,scaffold_3
23,7334001,7402000,67999,False,116,scaffold_3
24,7462001,7480000,17999,False,116,scaffold_3
25,7483001,7556000,72999,False,116,scaffold_3
26,7677001,7840000,162999,False,116,scaffold_3
27,8056001,8116000,59999,False,116,scaffold_3
28,8176001,8255000,78999,False,116,scaffold_3
29,8399001,8527000,127999,False,116,scaffold_3
30,8575001,8594000,18999,False,116,scaffold_3
31,9064001,9072000,7999,False,116,scaffold_3
32,9967001,10004000,36999,False,116,scaffold_3
33,10277001,10337000,59999,False,116,scaffold_3
34,10445001,10458000,12999,False,116,scaffold_3
35,10461001,10485000,23999,False,116,scaffold_3
36,10527001,10572000,44999,False,116,scaffold_3
37,10574001,11168000,593999,False,116,scaffold_3
0,17001,33000,15999,False,116,scaffold_4
1,48001,87000,38999,False,116,scaffold_4
2,135001,146000,10999,False,116,scaffold_4
3,147001,151000,3999,False,116,scaffold_4
4,155001,160000,4999,False,116,scaffold_4
5,161001,215000,53999,False,116,scaffold_4
6,217001,226000,8999,False,116,scaffold_4
7,227001,266000,38999,False,116,scaffold_4
8,289001,304000,14999,False,116,scaffold_4
9,318001,344000,25999,False,116,scaffold_4
10,355001,374000,18999,False,116,scaffold_4
11,375001,380000,4999,False,116,scaffold_4
12,412001,425000,12999,False,116,scaffold_4
13,429001,498000,68999,False,116,scaffold_4
14,542001,592000,49999,False,116,scaffold_4
15,608001,691000,82999,False,116,scaffold_4
16,1087001,1097000,9999,False,116,scaffold_4
17,1099001,1110000,10999,False,116,scaffold_4
18,1113001,1136000,22999,False,116,scaffold_4
19,1137001,1198000,60999,False,116,scaffold_4
20,1199001,1208000,8999,False,116,scaffold_4
21,1210001,1226000,15999,False,116,scaffold_4
22,1254001,1262000,7999,False,116,scaffold_4
23,1265001,1279000,13999,False,116,scaffold_4
24,1283001,1337000,53999,False,116,scaffold_4
25,1372001,1576000,203999,False,116,scaffold_4
26,1577001,1597000,19999,False,116,scaffold_4
27,1608001,1611000,2999,False,116,scaffold_4
28,1613001,1715000,101999,False,116,scaffold_4
29,1749001,1849000,99999,False,116,scaffold_4
30,1850001,1868000,17999,False,116,scaffold_4
31,1904001,1957000,52999,False,116,scaffold_4
32,1958001,2004000,45999,False,116,scaffold_4
33,2036001,2065000,28999,False,116,scaffold_4
34,2233001,2246000,12999,False,116,scaffold_4
35,2247001,2268000,20999,False,116,scaffold_4
36,2269001,2279000,9999,False,116,scaffold_4
37,2284001,2339000,54999,False,116,scaffold_4
38,2399001,2445000,45999,False,116,scaffold_4
39,2447001,2461000,13999,False,116,scaffold_4
40,2476001,2634000,157999,False,116,scaffold_4
41,3029001,3063000,33999,False,116,scaffold_4
42,3087001,3128000,40999,False,116,scaffold_4
43,3226001,3247000,20999,False,116,scaffold_4
44,3336001,3760000,423999,False,116,scaffold_4
45,4900001,5061000,160999,False,116,scaffold_4
46,5172001,5223000,50999,False,116,scaffold_4
47,5295001,5409000,113999,False,116,scaffold_4
48,5476001,5506000,29999,False,116,scaffold_4
49,5514001,5784000,269999,False,116,scaffold_4
50,5786001,5818000,31999,False,116,scaffold_4
51,6145001,6195000,49999,False,116,scaffold_4
52,6893001,6924000,30999,False,116,scaffold_4
53,6950001,6996000,45999,False,116,scaffold_4
54,7036001,7124000,87999,False,116,scaffold_4
55,7208001,7323000,114999,False,116,scaffold_4
56,7628001,7665000,36999,False,116,scaffold_4
57,7985001,8001000,15999,False,116,scaffold_4
58,8845001,9699000,853999,False,116,scaffold_4
59,9700001,9710000,9999,False,116,scaffold_4
60,9711001,9845951,134950,True,116,scaffold_4
0,1,5000,4999,True,116,scaffold_5
1,141001,174000,32999,False,116,scaffold_5
2,189001,204000,14999,False,116,scaffold_5
3,318001,386000,67999,False,116,scaffold_5
4,462001,523000,60999,False,116,scaffold_5
5,933001,947000,13999,False,116,scaffold_5
6,2473001,2495000,21999,False,116,scaffold_5
7,2509001,2515000,5999,False,116,scaffold_5
8,2552001,2894000,341999,False,116,scaffold_5
9,3093001,3258000,164999,False,116,scaffold_5
10,3277001,3512000,234999,False,116,scaffold_5
11,3615001,3657000,41999,False,116,scaffold_5
12,3961001,4221000,259999,False,116,scaffold_5
13,4227001,4322000,94999,False,116,scaffold_5
14,4445001,4526000,80999,False,116,scaffold_5
15,4600001,4862000,261999,False,116,scaffold_5
16,4874001,4922000,47999,False,116,scaffold_5
17,4966001,4994000,27999,False,116,scaffold_5
18,5249001,5344000,94999,False,116,scaffold_5
19,6408001,6420000,11999,False,116,scaffold_5
20,6454001,6693000,238999,False,116,scaffold_5
21,6877001,6906000,28999,False,116,scaffold_5
22,7049001,7086000,36999,False,116,scaffold_5
23,7168001,7202000,33999,False,116,scaffold_5
24,7458001,7483000,24999,False,116,scaffold_5
25,7552001,7610000,57999,False,116,scaffold_5
26,7622001,7659000,36999,False,116,scaffold_5
27,8258001,8266000,7999,False,116,scaffold_5
28,8553001,8605000,51999,False,116,scaffold_5
29,8673001,8685000,11999,False,116,scaffold_5
30,8715001,9363000,647999,False,116,scaffold_5
0,60001,75000,14999,False,116,scaffold_6
1,77001,85000,7999,False,116,scaffold_6
2,86001,114000,27999,False,116,scaffold_6
3,162001,210000,47999,False,116,scaffold_6
4,239001,254000,14999,False,116,scaffold_6
5,267001,278000,10999,False,116,scaffold_6
6,1229001,1263000,33999,False,116,scaffold_6
7,1478001,1549000,70999,False,116,scaffold_6
8,1658001,1687000,28999,False,116,scaffold_6
9,1833001,1906000,72999,False,116,scaffold_6
10,2026001,2212000,185999,False,116,scaffold_6
11,2236001,2284000,47999,False,116,scaffold_6
12,2335001,2595000,259999,False,116,scaffold_6
13,2596001,2654000,57999,False,116,scaffold_6
14,2657001,2864000,206999,False,116,scaffold_6
15,2927001,3014000,86999,False,116,scaffold_6
16,3078001,3177000,98999,False,116,scaffold_6
17,3224001,3350000,125999,False,116,scaffold_6
18,3351001,3788000,436999,False,116,scaffold_6
19,3881001,3921000,39999,False,116,scaffold_6
20,3966001,4072000,105999,False,116,scaffold_6
21,4080001,4193000,112999,False,116,scaffold_6
22,5285001,5320000,34999,False,116,scaffold_6
23,5586001,5647000,60999,False,116,scaffold_6
24,5917001,5972000,54999,False,116,scaffold_6
25,6008001,6084000,75999,False,116,scaffold_6
26,6833001,6859000,25999,False,116,scaffold_6
27,7257001,7338000,80999,False,116,scaffold_6
28,7389001,7495000,105999,False,116,scaffold_6
29,7549001,8268281,719280,True,116,scaffold_6
0,1,7000,6999,True,116,scaffold_7
1,13001,31000,17999,False,116,scaffold_7
2,323001,340000,16999,False,116,scaffold_7
3,342001,507000,164999,False,116,scaffold_7
4,554001,563000,8999,False,116,scaffold_7
5,570001,577000,6999,False,116,scaffold_7
6,706001,736000,29999,False,116,scaffold_7
7,742001,753000,10999,False,116,scaffold_7
8,764001,829000,64999,False,116,scaffold_7
9,838001,843000,4999,False,116,scaffold_7
10,858001,864000,5999,False,116,scaffold_7
11,868001,948000,79999,False,116,scaffold_7
12,949001,963000,13999,False,116,scaffold_7
13,983001,1031000,47999,False,116,scaffold_7
14,1034001,1044000,9999,False,116,scaffold_7
15,1069001,1101000,31999,False,116,scaffold_7
16,1204001,1512000,307999,False,116,scaffold_7
17,1588001,1688000,99999,False,116,scaffold_7
18,2851001,2880000,28999,False,116,scaffold_7
19,3297001,3376000,78999,False,116,scaffold_7
20,3520001,3829000,308999,False,116,scaffold_7
21,4028001,4061000,32999,False,116,scaffold_7
22,4324001,4362000,37999,False,116,scaffold_7
23,4415001,4517000,101999,False,116,scaffold_7
24,4551001,4607000,55999,False,116,scaffold_7
25,4623001,4854000,230999,False,116,scaffold_7
26,4979001,5148000,168999,False,116,scaffold_7
27,5483001,5536000,52999,False,116,scaffold_7
28,6219001,6243000,23999,False,116,scaffold_7
29,6751001,6798000,46999,False,116,scaffold_7
30,6954001,7270000,315999,False,116,scaffold_7
31,7271001,7502216,231215,True,116,scaffold_7
0,66001,85000,18999,False,116,scaffold_8
1,1836001,1931000,94999,False,116,scaffold_8
2,2091001,2131000,39999,False,116,scaffold_8
3,2360001,2530000,169999,False,116,scaffold_8
4,2536001,2552000,15999,False,116,scaffold_8
5,2740001,2758000,17999,False,116,scaffold_8
6,2797001,2844000,46999,False,116,scaffold_8
7,3058001,3125000,66999,False,116,scaffold_8
8,3126001,3526000,399999,False,116,scaffold_8
9,3577001,3612000,34999,False,116,scaffold_8
10,3615001,3939000,323999,False,116,scaffold_8
11,4034001,4103000,68999,False,116,scaffold_8
12,4203001,4221000,17999,False,116,scaffold_8
13,4816001,4850000,33999,False,116,scaffold_8
14,5104001,5138000,33999,False,116,scaffold_8
15,5170001,5241000,70999,False,116,scaffold_8
16,5651001,5692000,40999,False,116,scaffold_8
17,6328001,6334544,6543,True,116,scaffold_8
0,1,22000,21999,True,116,scaffold_9
1,109001,117000,7999,False,116,scaffold_9
2,121001,136000,14999,False,116,scaffold_9
3,303001,315000,11999,False,116,scaffold_9
4,319001,411000,91999,False,116,scaffold_9
5,413001,440000,26999,False,116,scaffold_9
6,501001,531000,29999,False,116,scaffold_9
7,548001,561000,12999,False,116,scaffold_9
8,654001,659000,4999,False,116,scaffold_9
9,660001,665000,4999,False,116,scaffold_9
10,670001,695000,24999,False,116,scaffold_9
11,732001,742000,9999,False,116,scaffold_9
12,816001,842000,25999,False,116,scaffold_9
13,886001,986000,99999,False,116,scaffold_9
14,988001,996000,7999,False,116,scaffold_9
15,997001,1007000,9999,False,116,scaffold_9
16,1009001,1031000,21999,False,116,scaffold_9
17,1035001,1085000,49999,False,116,scaffold_9
18,1087001,1150000,62999,False,116,scaffold_9
19,1151001,1165000,13999,False,116,scaffold_9
20,1312001,1378000,65999,False,116,scaffold_9
21,1766001,1792000,25999,False,116,scaffold_9
22,2601001,2620000,18999,False,116,scaffold_9
23,2731001,2821000,89999,False,116,scaffold_9
24,2844001,3381000,536999,False,116,scaffold_9
25,3383001,5110000,1726999,False,116,scaffold_9
26,5112001,5114000,1999,False,116,scaffold_9
27,5116001,5238000,121999,False,116,scaffold_9
28,5239001,5298000,58999,False,116,scaffold_9
29,5300001,5490000,189999,False,116,scaffold_9
30,5493001,6331288,838287,True,116,scaffold_9
0,1,414000,413999,True,116,scaffold_10
1,416001,482000,65999,False,116,scaffold_10
2,483001,877000,393999,False,116,scaffold_10
3,888001,963000,74999,False,116,scaffold_10
4,1073001,1146000,72999,False,116,scaffold_10
5,2141001,2171000,29999,False,116,scaffold_10
6,2346001,2368000,21999,False,116,scaffold_10
7,2565001,2582000,16999,False,116,scaffold_10
8,4049001,4112000,62999,False,116,scaffold_10
9,4154001,4181000,26999,False,116,scaffold_10
10,4335001,4365000,29999,False,116,scaffold_10
11,4443001,4462000,18999,False,116,scaffold_10
12,4467001,4476000,8999,False,116,scaffold_10
13,4503001,4513000,9999,False,116,scaffold_10
14,4515001,4523000,7999,False,116,scaffold_10
15,4526001,4548000,21999,False,116,scaffold_10
16,4574001,4597000,22999,False,116,scaffold_10
17,4679001,4688000,8999,False,116,scaffold_10
18,4716001,4720000,3999,False,116,scaffold_10
19,4727001,4732000,4999,False,116,scaffold_10
20,4734001,4776000,41999,False,116,scaffold_10
21,4798001,4824000,25999,False,116,scaffold_10
22,4828001,4846000,17999,False,116,scaffold_10
23,4848001,4861000,12999,False,116,scaffold_10
24,4862001,4866973,4972,True,116,scaffold_10
0,10001,91000,80999,False,116,scaffold_11
1,143001,167000,23999,False,116,scaffold_11
2,169001,191000,21999,False,116,scaffold_11
3,213001,236000,22999,False,116,scaffold_11
4,240001,250000,9999,False,116,scaffold_11
5,295001,320000,24999,False,116,scaffold_11
6,419001,431000,11999,False,116,scaffold_11
7,648001,656000,7999,False,116,scaffold_11
8,1025001,1034000,8999,False,116,scaffold_11
9,2701001,2875000,173999,False,116,scaffold_11
10,2955001,3020000,64999,False,116,scaffold_11
11,3082001,3175000,92999,False,116,scaffold_11
12,3185001,3297000,111999,False,116,scaffold_11
13,3305001,3383000,77999,False,116,scaffold_11
14,3558001,3933000,374999,False,116,scaffold_11
15,4006001,4160000,153999,False,116,scaffold_11
16,4257001,4710000,452999,False,116,scaffold_11
17,4712001,4766820,54819,True,116,scaffold_11
0,1,856000,855999,True,116,scaffold_12
1,865001,1469000,603999,False,116,scaffold_12
2,1720001,1733000,12999,False,116,scaffold_12
3,2352001,2362000,9999,False,116,scaffold_12
4,2571001,2609000,37999,False,116,scaffold_12
0,1,342000,341999,True,117,scaffold_1
1,379001,439000,59999,False,117,scaffold_1
2,482001,498000,15999,False,117,scaffold_1
3,571001,643000,71999,False,117,scaffold_1
4,686001,750000,63999,False,117,scaffold_1
5,1280001,1292000,11999,False,117,scaffold_1
6,1607001,1660000,52999,False,117,scaffold_1
7,1810001,1901000,90999,False,117,scaffold_1
8,1950001,1984000,33999,False,117,scaffold_1
9,1986001,2015000,28999,False,117,scaffold_1
10,2294001,2330000,35999,False,117,scaffold_1
11,2363001,2384000,20999,False,117,scaffold_1
12,2449001,2517000,67999,False,117,scaffold_1
13,2729001,2746000,16999,False,117,scaffold_1
14,2893001,2921000,27999,False,117,scaffold_1
15,2987001,3024000,36999,False,117,scaffold_1
16,3174001,3209000,34999,False,117,scaffold_1
17,3713001,3742000,28999,False,117,scaffold_1
18,3785001,3882000,96999,False,117,scaffold_1
19,3901001,3941000,39999,False,117,scaffold_1
20,3960001,4039000,78999,False,117,scaffold_1
21,4060001,4120000,59999,False,117,scaffold_1
22,4307001,4355000,47999,False,117,scaffold_1
23,4706001,4744000,37999,False,117,scaffold_1
24,4796001,4821000,24999,False,117,scaffold_1
25,4926001,5062000,135999,False,117,scaffold_1
26,5087001,5118000,30999,False,117,scaffold_1
27,5436001,5456000,19999,False,117,scaffold_1
28,5481001,5511000,29999,False,117,scaffold_1
29,5535001,5579000,43999,False,117,scaffold_1
30,5852001,5870000,17999,False,117,scaffold_1
31,6108001,6153000,44999,False,117,scaffold_1
32,6154001,6177000,22999,False,117,scaffold_1
33,6203001,6381000,177999,False,117,scaffold_1
34,6382001,6509000,126999,False,117,scaffold_1
35,6543001,6558000,14999,False,117,scaffold_1
36,6838001,6851000,12999,False,117,scaffold_1
37,7037001,7247000,209999,False,117,scaffold_1
38,7248001,7584000,335999,False,117,scaffold_1
39,7585001,7589000,3999,False,117,scaffold_1
40,7590001,8656000,1065999,False,117,scaffold_1
41,8658001,9584000,925999,False,117,scaffold_1
42,9586001,10361000,774999,False,117,scaffold_1
43,10460001,10637000,176999,False,117,scaffold_1
44,10722001,10758000,35999,False,117,scaffold_1
45,10838001,10856000,17999,False,117,scaffold_1
46,10910001,10963000,52999,False,117,scaffold_1
47,11014001,11073000,58999,False,117,scaffold_1
48,11275001,11959000,683999,False,117,scaffold_1
49,12184001,12243000,58999,False,117,scaffold_1
50,12637001,12722000,84999,False,117,scaffold_1
51,12742001,12888000,145999,False,117,scaffold_1
52,12898001,12950000,51999,False,117,scaffold_1
53,12963001,13005000,41999,False,117,scaffold_1
54,13095001,13213000,117999,False,117,scaffold_1
55,13346001,13432000,85999,False,117,scaffold_1
56,13554001,13590000,35999,False,117,scaffold_1
57,13678001,13701000,22999,False,117,scaffold_1
58,13817001,13845000,27999,False,117,scaffold_1
59,13899001,13927000,27999,False,117,scaffold_1
60,13928001,13937000,8999,False,117,scaffold_1
61,13959001,14005000,45999,False,117,scaffold_1
62,14289001,14309000,19999,False,117,scaffold_1
63,14595001,14611000,15999,False,117,scaffold_1
64,14779001,14794116,15115,True,117,scaffold_1
0,1,48000,47999,True,117,scaffold_2
1,67001,91000,23999,False,117,scaffold_2
2,95001,159000,63999,False,117,scaffold_2
3,168001,176000,7999,False,117,scaffold_2
4,240001,278000,37999,False,117,scaffold_2
5,296001,318000,21999,False,117,scaffold_2
6,332001,374000,41999,False,117,scaffold_2
7,719001,739000,19999,False,117,scaffold_2
8,1692001,1718000,25999,False,117,scaffold_2
9,2085001,2109000,23999,False,117,scaffold_2
10,2303001,2334000,30999,False,117,scaffold_2
11,2336001,2560000,223999,False,117,scaffold_2
12,2626001,2639000,12999,False,117,scaffold_2
13,2660001,2689000,28999,False,117,scaffold_2
14,2694001,2747000,52999,False,117,scaffold_2
15,2767001,2787000,19999,False,117,scaffold_2
16,2816001,2855000,38999,False,117,scaffold_2
17,2878001,3021000,142999,False,117,scaffold_2
18,3022001,3057000,34999,False,117,scaffold_2
19,3161001,3187000,25999,False,117,scaffold_2
20,3335001,3342000,6999,False,117,scaffold_2
21,3362001,3390000,27999,False,117,scaffold_2
22,3450001,3466000,15999,False,117,scaffold_2
23,3645001,3691000,45999,False,117,scaffold_2
24,3754001,3784000,29999,False,117,scaffold_2
25,4051001,4064000,12999,False,117,scaffold_2
26,4243001,4322000,78999,False,117,scaffold_2
27,4344001,4409000,64999,False,117,scaffold_2
28,4426001,4458000,31999,False,117,scaffold_2
29,4474001,4658000,183999,False,117,scaffold_2
30,4697001,4772000,74999,False,117,scaffold_2
31,4782001,4790000,7999,False,117,scaffold_2
32,4793001,4815000,21999,False,117,scaffold_2
33,4917001,4961000,43999,False,117,scaffold_2
34,5018001,5031000,12999,False,117,scaffold_2
35,5033001,5104000,70999,False,117,scaffold_2
36,5286001,5314000,27999,False,117,scaffold_2
37,5361001,5534000,172999,False,117,scaffold_2
38,5615001,5760000,144999,False,117,scaffold_2
39,5836001,5888000,51999,False,117,scaffold_2
40,5915001,6079000,163999,False,117,scaffold_2
41,6103001,6138000,34999,False,117,scaffold_2
42,6226001,6351000,124999,False,117,scaffold_2
43,6383001,6449000,65999,False,117,scaffold_2
44,6576001,6628000,51999,False,117,scaffold_2
45,6810001,6854000,43999,False,117,scaffold_2
46,6951001,6997000,45999,False,117,scaffold_2
47,6999001,7038000,38999,False,117,scaffold_2
48,7050001,7097000,46999,False,117,scaffold_2
49,7386001,7473000,86999,False,117,scaffold_2
50,7491001,7518000,26999,False,117,scaffold_2
51,7550001,7561000,10999,False,117,scaffold_2
52,7563001,7708000,144999,False,117,scaffold_2
53,7785001,8314000,528999,False,117,scaffold_2
54,8347001,8454000,106999,False,117,scaffold_2
55,8508001,8563000,54999,False,117,scaffold_2
56,9038001,9051000,12999,False,117,scaffold_2
57,9140001,9178000,37999,False,117,scaffold_2
58,9347001,9382000,34999,False,117,scaffold_2
59,9601001,9635000,33999,False,117,scaffold_2
60,9673001,9706000,32999,False,117,scaffold_2
61,9840001,9904000,63999,False,117,scaffold_2
62,9926001,9944000,17999,False,117,scaffold_2
63,10712001,10731000,18999,False,117,scaffold_2
64,10995001,10998000,2999,False,117,scaffold_2
65,11367001,11381000,13999,False,117,scaffold_2
66,11395001,11425000,29999,False,117,scaffold_2
67,11520001,11786000,265999,False,117,scaffold_2
68,11797001,11802476,5475,True,117,scaffold_2
0,352001,362000,9999,False,117,scaffold_3
1,528001,539000,10999,False,117,scaffold_3
2,618001,646000,27999,False,117,scaffold_3
3,798001,901000,102999,False,117,scaffold_3
4,1940001,1976000,35999,False,117,scaffold_3
5,1998001,2147000,148999,False,117,scaffold_3
6,2291001,2336000,44999,False,117,scaffold_3
7,2433001,2472000,38999,False,117,scaffold_3
8,2487001,2533000,45999,False,117,scaffold_3
9,2561001,2572000,10999,False,117,scaffold_3
10,2641001,2683000,41999,False,117,scaffold_3
11,2717001,2761000,43999,False,117,scaffold_3
12,3070001,3144000,73999,False,117,scaffold_3
13,3605001,3643000,37999,False,117,scaffold_3
14,3713001,3747000,33999,False,117,scaffold_3
15,3764001,3891000,126999,False,117,scaffold_3
16,3909001,3921000,11999,False,117,scaffold_3
17,3922001,3948000,25999,False,117,scaffold_3
18,4007001,4032000,24999,False,117,scaffold_3
19,4070001,4403000,332999,False,117,scaffold_3
20,4413001,4518000,104999,False,117,scaffold_3
21,4542001,4564000,21999,False,117,scaffold_3
22,4566001,4690000,123999,False,117,scaffold_3
23,4999001,5030000,30999,False,117,scaffold_3
24,5158001,5279000,120999,False,117,scaffold_3
25,5492001,5507000,14999,False,117,scaffold_3
26,5878001,5953000,74999,False,117,scaffold_3
27,5975001,6022000,46999,False,117,scaffold_3
28,6741001,6804000,62999,False,117,scaffold_3
29,6847001,6962000,114999,False,117,scaffold_3
30,6963001,7098000,134999,False,117,scaffold_3
31,7114001,7157000,42999,False,117,scaffold_3
32,7335001,7398000,62999,False,117,scaffold_3
33,7482001,7563000,80999,False,117,scaffold_3
34,7676001,7856000,179999,False,117,scaffold_3
35,8028001,8116000,87999,False,117,scaffold_3
36,8121001,8156000,34999,False,117,scaffold_3
37,8183001,8253000,69999,False,117,scaffold_3
38,8398001,8527000,128999,False,117,scaffold_3
39,8575001,8593000,17999,False,117,scaffold_3
40,9006001,9075000,68999,False,117,scaffold_3
41,9968001,10000000,31999,False,117,scaffold_3
42,10058001,10090000,31999,False,117,scaffold_3
43,10465001,10488000,22999,False,117,scaffold_3
44,10551001,10572000,20999,False,117,scaffold_3
45,10574001,11182071,608070,True,117,scaffold_3
0,1,7000,6999,True,117,scaffold_4
1,11001,13000,1999,False,117,scaffold_4
2,17001,32000,14999,False,117,scaffold_4
3,48001,112000,63999,False,117,scaffold_4
4,113001,116000,2999,False,117,scaffold_4
5,120001,146000,25999,False,117,scaffold_4
6,147001,151000,3999,False,117,scaffold_4
7,155001,215000,59999,False,117,scaffold_4
8,217001,278000,60999,False,117,scaffold_4
9,283001,307000,23999,False,117,scaffold_4
10,308001,353000,44999,False,117,scaffold_4
11,355001,374000,18999,False,117,scaffold_4
12,375001,380000,4999,False,117,scaffold_4
13,383001,425000,41999,False,117,scaffold_4
14,429001,505000,75999,False,117,scaffold_4
15,540001,592000,51999,False,117,scaffold_4
16,593001,606000,12999,False,117,scaffold_4
17,608001,691000,82999,False,117,scaffold_4
18,704001,727000,22999,False,117,scaffold_4
19,1112001,1136000,23999,False,117,scaffold_4
20,1138001,1226000,87999,False,117,scaffold_4
21,1229001,1253000,23999,False,117,scaffold_4
22,1281001,1605000,323999,False,117,scaffold_4
23,1613001,2205000,591999,False,117,scaffold_4
24,2210001,2246000,35999,False,117,scaffold_4
25,2247001,2281000,33999,False,117,scaffold_4
26,2282001,2461000,178999,False,117,scaffold_4
27,2476001,2642000,165999,False,117,scaffold_4
28,2676001,2714000,37999,False,117,scaffold_4
29,2735001,2802000,66999,False,117,scaffold_4
30,2904001,3130000,225999,False,117,scaffold_4
31,3213001,3217000,3999,False,117,scaffold_4
32,3223001,3245000,21999,False,117,scaffold_4
33,3289001,3320000,30999,False,117,scaffold_4
34,3334001,3785000,450999,False,117,scaffold_4
35,4058001,4074000,15999,False,117,scaffold_4
36,4270001,4306000,35999,False,117,scaffold_4
37,4900001,5094000,193999,False,117,scaffold_4
38,5172001,5244000,71999,False,117,scaffold_4
39,5301001,5329000,27999,False,117,scaffold_4
40,5475001,5506000,30999,False,117,scaffold_4
41,5514001,5784000,269999,False,117,scaffold_4
42,5786001,5824000,37999,False,117,scaffold_4
43,6056001,6094000,37999,False,117,scaffold_4
44,6148001,6195000,46999,False,117,scaffold_4
45,6615001,6617000,1999,False,117,scaffold_4
46,6764001,6817000,52999,False,117,scaffold_4
47,6894001,6924000,29999,False,117,scaffold_4
48,6926001,6938000,11999,False,117,scaffold_4
49,6950001,7003000,52999,False,117,scaffold_4
50,7036001,7124000,87999,False,117,scaffold_4
51,7126001,7175000,48999,False,117,scaffold_4
52,7209001,7304000,94999,False,117,scaffold_4
53,7364001,7368000,3999,False,117,scaffold_4
54,7629001,7665000,35999,False,117,scaffold_4
55,7861001,7922000,60999,False,117,scaffold_4
56,7984001,8014000,29999,False,117,scaffold_4
57,8847001,9699000,851999,False,117,scaffold_4
58,9700001,9845951,145950,True,117,scaffold_4
0,1,4000,3999,True,117,scaffold_5
1,189001,207000,17999,False,117,scaffold_5
2,318001,428000,109999,False,117,scaffold_5
3,445001,526000,80999,False,117,scaffold_5
4,671001,698000,26999,False,117,scaffold_5
5,933001,947000,13999,False,117,scaffold_5
6,1062001,1068000,5999,False,117,scaffold_5
7,1069001,1104000,34999,False,117,scaffold_5
8,2255001,2302000,46999,False,117,scaffold_5
9,2554001,2876000,321999,False,117,scaffold_5
10,3121001,3249000,127999,False,117,scaffold_5
11,3277001,3514000,236999,False,117,scaffold_5
12,3608001,3657000,48999,False,117,scaffold_5
13,3919001,4101000,181999,False,117,scaffold_5
14,4112001,4322000,209999,False,117,scaffold_5
15,4445001,4549000,103999,False,117,scaffold_5
16,4589001,4927000,337999,False,117,scaffold_5
17,4971001,4989000,17999,False,117,scaffold_5
18,5217001,5274000,56999,False,117,scaffold_5
19,5284001,5312000,27999,False,117,scaffold_5
20,5314001,5344000,29999,False,117,scaffold_5
21,5499001,5529000,29999,False,117,scaffold_5
22,5870001,5887000,16999,False,117,scaffold_5
23,6392001,6438000,45999,False,117,scaffold_5
24,6453001,6704000,250999,False,117,scaffold_5
25,6824001,6851000,26999,False,117,scaffold_5
26,6886001,6906000,19999,False,117,scaffold_5
27,7174001,7220000,45999,False,117,scaffold_5
28,7406001,7440000,33999,False,117,scaffold_5
29,7454001,7510000,55999,False,117,scaffold_5
30,7546001,7619000,72999,False,117,scaffold_5
31,7620001,7659000,38999,False,117,scaffold_5
32,7709001,7803000,93999,False,117,scaffold_5
33,8258001,8280000,21999,False,117,scaffold_5
34,8415001,8467000,51999,False,117,scaffold_5
35,8549001,8616000,66999,False,117,scaffold_5
36,8637001,8687000,49999,False,117,scaffold_5
37,8708001,9364176,656175,True,117,scaffold_5
0,59001,75000,15999,False,117,scaffold_6
1,79001,85000,5999,False,117,scaffold_6
2,86001,114000,27999,False,117,scaffold_6
3,147001,209000,61999,False,117,scaffold_6
4,239001,357000,117999,False,117,scaffold_6
5,552001,568000,15999,False,117,scaffold_6
6,786001,801000,14999,False,117,scaffold_6
7,967001,1038000,70999,False,117,scaffold_6
8,1148001,1226000,77999,False,117,scaffold_6
9,1229001,1311000,81999,False,117,scaffold_6
10,1478001,1549000,70999,False,117,scaffold_6
11,1558001,1600000,41999,False,117,scaffold_6
12,1658001,1687000,28999,False,117,scaffold_6
13,1824001,1901000,76999,False,117,scaffold_6
14,2023001,2211000,187999,False,117,scaffold_6
15,2236001,2285000,48999,False,117,scaffold_6
16,2315001,2872000,556999,False,117,scaffold_6
17,2933001,3031000,97999,False,117,scaffold_6
18,3080001,3178000,97999,False,117,scaffold_6
19,3222001,3806000,583999,False,117,scaffold_6
20,3897001,3913000,15999,False,117,scaffold_6
21,3967001,4206000,238999,False,117,scaffold_6
22,4440001,4481000,40999,False,117,scaffold_6
23,5562001,5647000,84999,False,117,scaffold_6
24,5864001,5972000,107999,False,117,scaffold_6
25,6004001,6093000,88999,False,117,scaffold_6
26,6122001,6198000,75999,False,117,scaffold_6
27,6257001,6277000,19999,False,117,scaffold_6
28,6776001,6857000,80999,False,117,scaffold_6
29,7184001,7339000,154999,False,117,scaffold_6
30,7389001,7530000,140999,False,117,scaffold_6
31,7531001,8268281,737280,True,117,scaffold_6
0,13001,34000,20999,False,117,scaffold_7
1,320001,509000,188999,False,117,scaffold_7
2,571001,579000,7999,False,117,scaffold_7
3,623001,703000,79999,False,117,scaffold_7
4,706001,736000,29999,False,117,scaffold_7
5,741001,754000,12999,False,117,scaffold_7
6,764001,829000,64999,False,117,scaffold_7
7,859001,864000,4999,False,117,scaffold_7
8,865001,948000,82999,False,117,scaffold_7
9,949001,963000,13999,False,117,scaffold_7
10,964001,966000,1999,False,117,scaffold_7
11,968001,980000,11999,False,117,scaffold_7
12,982001,1044000,61999,False,117,scaffold_7
13,1048001,1123000,74999,False,117,scaffold_7
14,1169001,1512000,342999,False,117,scaffold_7
15,1588001,1700000,111999,False,117,scaffold_7
16,1728001,1780000,51999,False,117,scaffold_7
17,1819001,1901000,81999,False,117,scaffold_7
18,1983001,2006000,22999,False,117,scaffold_7
19,2915001,2959000,43999,False,117,scaffold_7
20,3296001,3388000,91999,False,117,scaffold_7
21,3520001,3767000,246999,False,117,scaffold_7
22,4021001,4054000,32999,False,117,scaffold_7
23,4323001,4362000,38999,False,117,scaffold_7
24,4414001,4512000,97999,False,117,scaffold_7
25,4549001,4597000,47999,False,117,scaffold_7
26,4631001,4834000,202999,False,117,scaffold_7
27,4978001,5168000,189999,False,117,scaffold_7
28,5421001,5433000,11999,False,117,scaffold_7
29,5461001,5537000,75999,False,117,scaffold_7
30,6085001,6094000,8999,False,117,scaffold_7
31,6096001,6245000,148999,False,117,scaffold_7
32,6330001,6370000,39999,False,117,scaffold_7
33,6568001,6685000,116999,False,117,scaffold_7
34,6752001,6793000,40999,False,117,scaffold_7
35,6953001,7270000,316999,False,117,scaffold_7
36,7271001,7502216,231215,True,117,scaffold_7
0,1,6000,5999,True,117,scaffold_8
1,37001,85000,47999,False,117,scaffold_8
2,93001,102000,8999,False,117,scaffold_8
3,112001,116000,3999,False,117,scaffold_8
4,729001,734000,4999,False,117,scaffold_8
5,1858001,1931000,72999,False,117,scaffold_8
6,2415001,2587000,171999,False,117,scaffold_8
7,2650001,2757000,106999,False,117,scaffold_8
8,2798001,2844000,45999,False,117,scaffold_8
9,2845001,2890000,44999,False,117,scaffold_8
10,3039001,3553000,513999,False,117,scaffold_8
11,3580001,3612000,31999,False,117,scaffold_8
12,3615001,3944000,328999,False,117,scaffold_8
13,4035001,4108000,72999,False,117,scaffold_8
14,4173001,4269000,95999,False,117,scaffold_8
15,4394001,4434000,39999,False,117,scaffold_8
16,4610001,4681000,70999,False,117,scaffold_8
17,5083001,5241000,157999,False,117,scaffold_8
18,5579001,5599000,19999,False,117,scaffold_8
19,5649001,5723000,73999,False,117,scaffold_8
20,6320001,6334544,14543,True,117,scaffold_8
0,1,22000,21999,True,117,scaffold_9
1,109001,138000,28999,False,117,scaffold_9
2,271001,276000,4999,False,117,scaffold_9
3,299001,316000,16999,False,117,scaffold_9
4,319001,411000,91999,False,117,scaffold_9
5,413001,434000,20999,False,117,scaffold_9
6,486001,531000,44999,False,117,scaffold_9
7,547001,563000,15999,False,117,scaffold_9
8,631001,665000,33999,False,117,scaffold_9
9,669001,697000,27999,False,117,scaffold_9
10,731001,741000,9999,False,117,scaffold_9
11,814001,842000,27999,False,117,scaffold_9
12,874001,986000,111999,False,117,scaffold_9
13,988001,1007000,18999,False,117,scaffold_9
14,1008001,1177000,168999,False,117,scaffold_9
15,1203001,1230000,26999,False,117,scaffold_9
16,1312001,1395000,82999,False,117,scaffold_9
17,1413001,1421000,7999,False,117,scaffold_9
18,1428001,1455000,26999,False,117,scaffold_9
19,1457001,1470000,12999,False,117,scaffold_9
20,1487001,1500000,12999,False,117,scaffold_9
21,1502001,1592000,89999,False,117,scaffold_9
22,1599001,1625000,25999,False,117,scaffold_9
23,1653001,1684000,30999,False,117,scaffold_9
24,1749001,1801000,51999,False,117,scaffold_9
25,1831001,1853000,21999,False,117,scaffold_9
26,1879001,1954000,74999,False,117,scaffold_9
27,1970001,2060000,89999,False,117,scaffold_9
28,2074001,2134000,59999,False,117,scaffold_9
29,2136001,2172000,35999,False,117,scaffold_9
30,2597001,2639000,41999,False,117,scaffold_9
31,2645001,2657000,11999,False,117,scaffold_9
32,2731001,3381000,649999,False,117,scaffold_9
33,3383001,5107000,1723999,False,117,scaffold_9
34,5112001,5115000,2999,False,117,scaffold_9
35,5116001,5238000,121999,False,117,scaffold_9
36,5239001,5298000,58999,False,117,scaffold_9
37,5299001,6331288,1032287,True,117,scaffold_9
0,1,414000,413999,True,117,scaffold_10
1,415001,482000,66999,False,117,scaffold_10
2,483001,877000,393999,False,117,scaffold_10
3,888001,1069000,180999,False,117,scaffold_10
4,1072001,1146000,73999,False,117,scaffold_10
5,1317001,1472000,154999,False,117,scaffold_10
6,1539001,1573000,33999,False,117,scaffold_10
7,1605001,1675000,69999,False,117,scaffold_10
8,1862001,1912000,49999,False,117,scaffold_10
9,2036001,2107000,70999,False,117,scaffold_10
10,2131001,2177000,45999,False,117,scaffold_10
11,2211001,2227000,15999,False,117,scaffold_10
12,2268001,2327000,58999,False,117,scaffold_10
13,2346001,2469000,122999,False,117,scaffold_10
14,2521001,2575000,53999,False,117,scaffold_10
15,2600001,2653000,52999,False,117,scaffold_10
16,2687001,2700000,12999,False,117,scaffold_10
17,2702001,2712000,9999,False,117,scaffold_10
18,2714001,2812000,97999,False,117,scaffold_10
19,3153001,3185000,31999,False,117,scaffold_10
20,3776001,3795000,18999,False,117,scaffold_10
21,4046001,4093000,46999,False,117,scaffold_10
22,4142001,4149000,6999,False,117,scaffold_10
23,4154001,4174000,19999,False,117,scaffold_10
24,4403001,4462000,58999,False,117,scaffold_10
25,4465001,4502000,36999,False,117,scaffold_10
26,4503001,4513000,9999,False,117,scaffold_10
27,4515001,4523000,7999,False,117,scaffold_10
28,4526001,4548000,21999,False,117,scaffold_10
29,4554001,4562000,7999,False,117,scaffold_10
30,4565001,4596000,30999,False,117,scaffold_10
31,4735001,4766000,30999,False,117,scaffold_10
32,4767001,4776000,8999,False,117,scaffold_10
33,4798001,4824000,25999,False,117,scaffold_10
34,4828001,4846000,17999,False,117,scaffold_10
35,4848001,4861000,12999,False,117,scaffold_10
36,4862001,4866973,4972,True,117,scaffold_10
0,14001,93000,78999,False,117,scaffold_11
1,132001,167000,34999,False,117,scaffold_11
2,169001,236000,66999,False,117,scaffold_11
3,240001,253000,12999,False,117,scaffold_11
4,289001,321000,31999,False,117,scaffold_11
5,419001,431000,11999,False,117,scaffold_11
6,641001,656000,14999,False,117,scaffold_11
7,1474001,1478000,3999,False,117,scaffold_11
8,1481001,1492000,10999,False,117,scaffold_11
9,1774001,1802000,27999,False,117,scaffold_11
10,1855001,1884000,28999,False,117,scaffold_11
11,2002001,2053000,50999,False,117,scaffold_11
12,2116001,2130000,13999,False,117,scaffold_11
13,2700001,2877000,176999,False,117,scaffold_11
14,2980001,3014000,33999,False,117,scaffold_11
15,3086001,3175000,88999,False,117,scaffold_11
16,3186001,3297000,110999,False,117,scaffold_11
17,3302001,3389000,86999,False,117,scaffold_11
18,3428001,3479000,50999,False,117,scaffold_11
19,3521001,3972000,450999,False,117,scaffold_11
20,3984001,4162000,177999,False,117,scaffold_11
21,4179001,4710000,530999,False,117,scaffold_11
22,4712001,4766820,54819,True,117,scaffold_11
0,1,1501000,1500999,True,117,scaffold_12
1,1562001,1589000,26999,False,117,scaffold_12
2,1719001,1747000,27999,False,117,scaffold_12
3,1774001,1806000,31999,False,117,scaffold_12
4,1900001,1962000,61999,False,117,scaffold_12
5,1964001,2000000,35999,False,117,scaffold_12
6,2043001,2103000,59999,False,117,scaffold_12
7,2130001,2164000,33999,False,117,scaffold_12
8,2350001,2361000,10999,False,117,scaffold_12
9,2571001,2610000,38999,False,117,scaffold_12
10,2659001,2682000,22999,False,117,scaffold_12
11,2685001,2698000,12999,False,117,scaffold_12
12,2700001,2708000,7999,False,117,scaffold_12
0,1,342000,341999,True,118,scaffold_1
1,482001,498000,15999,False,118,scaffold_1
2,571001,643000,71999,False,118,scaffold_1
3,686001,756000,69999,False,118,scaffold_1
4,1810001,1898000,87999,False,118,scaffold_1
5,1918001,1984000,65999,False,118,scaffold_1
6,2352001,2391000,38999,False,118,scaffold_1
7,2449001,2517000,67999,False,118,scaffold_1
8,2729001,2746000,16999,False,118,scaffold_1
9,2903001,2921000,17999,False,118,scaffold_1
10,3180001,3208000,27999,False,118,scaffold_1
11,3714001,3737000,22999,False,118,scaffold_1
12,3769001,3878000,108999,False,118,scaffold_1
13,3901001,3941000,39999,False,118,scaffold_1
14,3978001,4031000,52999,False,118,scaffold_1
15,4062001,4112000,49999,False,118,scaffold_1
16,4315001,4357000,41999,False,118,scaffold_1
17,4720001,4745000,24999,False,118,scaffold_1
18,4927001,5025000,97999,False,118,scaffold_1
19,5087001,5117000,29999,False,118,scaffold_1
20,5481001,5521000,39999,False,118,scaffold_1
21,5533001,5578000,44999,False,118,scaffold_1
22,5851001,5875000,23999,False,118,scaffold_1
23,5898001,5910000,11999,False,118,scaffold_1
24,6108001,6179000,70999,False,118,scaffold_1
25,6228001,6508000,279999,False,118,scaffold_1
26,6542001,6562000,19999,False,118,scaffold_1
27,6834001,6852000,17999,False,118,scaffold_1
28,7038001,7247000,208999,False,118,scaffold_1
29,7248001,7589000,340999,False,118,scaffold_1
30,7590001,8656000,1065999,False,118,scaffold_1
31,8658001,9584000,925999,False,118,scaffold_1
32,9586001,10356000,769999,False,118,scaffold_1
33,10460001,10640000,179999,False,118,scaffold_1
34,10738001,10755000,16999,False,118,scaffold_1
35,10808001,10811000,2999,False,118,scaffold_1
36,10837001,10857000,19999,False,118,scaffold_1
37,11282001,11576000,293999,False,118,scaffold_1
38,11614001,11963000,348999,False,118,scaffold_1
39,12184001,12204000,19999,False,118,scaffold_1
40,12427001,12450000,22999,False,118,scaffold_1
41,12636001,12722000,85999,False,118,scaffold_1
42,12775001,12890000,114999,False,118,scaffold_1
43,12899001,12951000,51999,False,118,scaffold_1
44,12967001,13002000,34999,False,118,scaffold_1
45,13107001,13211000,103999,False,118,scaffold_1
46,13347001,13408000,60999,False,118,scaffold_1
47,13570001,13590000,19999,False,118,scaffold_1
48,13958001,13991000,32999,False,118,scaffold_1
49,14289001,14309000,19999,False,118,scaffold_1
50,14647001,14660000,12999,False,118,scaffold_1
0,21001,48000,26999,False,118,scaffold_2
1,95001,159000,63999,False,118,scaffold_2
2,165001,177000,11999,False,118,scaffold_2
3,279001,288000,8999,False,118,scaffold_2
4,303001,318000,14999,False,118,scaffold_2
5,333001,374000,40999,False,118,scaffold_2
6,2336001,2358000,21999,False,118,scaffold_2
7,2404001,2609000,204999,False,118,scaffold_2
8,2627001,2639000,11999,False,118,scaffold_2
9,2645001,2689000,43999,False,118,scaffold_2
10,2693001,2745000,51999,False,118,scaffold_2
11,2766001,2788000,21999,False,118,scaffold_2
12,2868001,2900000,31999,False,118,scaffold_2
13,2947001,3013000,65999,False,118,scaffold_2
14,3364001,3390000,25999,False,118,scaffold_2
15,3450001,3475000,24999,False,118,scaffold_2
16,3754001,3790000,35999,False,118,scaffold_2
17,4383001,4409000,25999,False,118,scaffold_2
18,4426001,4457000,30999,False,118,scaffold_2
19,4521001,4656000,134999,False,118,scaffold_2
20,4781001,4790000,8999,False,118,scaffold_2
21,4793001,4807000,13999,False,118,scaffold_2
22,4916001,4968000,51999,False,118,scaffold_2
23,5021001,5031000,9999,False,118,scaffold_2
24,5033001,5104000,70999,False,118,scaffold_2
25,5285001,5316000,30999,False,118,scaffold_2
26,5362001,5394000,31999,False,118,scaffold_2
27,5414001,5481000,66999,False,118,scaffold_2
28,5491001,5515000,23999,False,118,scaffold_2
29,5523001,5548000,24999,False,118,scaffold_2
30,5658001,5704000,45999,False,118,scaffold_2
31,5719001,5760000,40999,False,118,scaffold_2
32,5840001,5887000,46999,False,118,scaffold_2
33,6260001,6351000,90999,False,118,scaffold_2
34,6386001,6451000,64999,False,118,scaffold_2
35,6591001,6628000,36999,False,118,scaffold_2
36,7004001,7037000,32999,False,118,scaffold_2
37,7063001,7097000,33999,False,118,scaffold_2
38,7433001,7473000,39999,False,118,scaffold_2
39,7550001,7561000,10999,False,118,scaffold_2
40,7563001,7698000,134999,False,118,scaffold_2
41,7786001,8161000,374999,False,118,scaffold_2
42,8260001,8319000,58999,False,118,scaffold_2
43,8331001,8333000,1999,False,118,scaffold_2
44,8335001,8345000,9999,False,118,scaffold_2
45,8346001,8455000,108999,False,118,scaffold_2
46,8465001,8494000,28999,False,118,scaffold_2
47,8495001,8563000,67999,False,118,scaffold_2
48,9139001,9167000,27999,False,118,scaffold_2
49,9347001,9389000,41999,False,118,scaffold_2
50,9601001,9628000,26999,False,118,scaffold_2
51,11520001,11786000,265999,False,118,scaffold_2
0,528001,539000,10999,False,118,scaffold_3
1,618001,647000,28999,False,118,scaffold_3
2,796001,900000,103999,False,118,scaffold_3
3,2008001,2108000,99999,False,118,scaffold_3
4,2109001,2117000,7999,False,118,scaffold_3
5,2290001,2336000,45999,False,118,scaffold_3
6,2487001,2531000,43999,False,118,scaffold_3
7,2717001,2751000,33999,False,118,scaffold_3
8,3066001,3081000,14999,False,118,scaffold_3
9,3768001,3821000,52999,False,118,scaffold_3
10,3822001,3893000,70999,False,118,scaffold_3
11,4007001,4031000,23999,False,118,scaffold_3
12,4107001,4398000,290999,False,118,scaffold_3
13,4414001,4519000,104999,False,118,scaffold_3
14,4547001,4576000,28999,False,118,scaffold_3
15,4636001,4686000,49999,False,118,scaffold_3
16,5158001,5190000,31999,False,118,scaffold_3
17,5236001,5273000,36999,False,118,scaffold_3
18,5493001,5509000,15999,False,118,scaffold_3
19,5863001,5910000,46999,False,118,scaffold_3
20,5990001,6020000,29999,False,118,scaffold_3
21,6741001,6785000,43999,False,118,scaffold_3
22,6910001,6962000,51999,False,118,scaffold_3
23,6963001,7090000,126999,False,118,scaffold_3
24,7286001,7301000,14999,False,118,scaffold_3
25,7522001,7557000,34999,False,118,scaffold_3
26,7682001,7841000,158999,False,118,scaffold_3
27,8028001,8116000,87999,False,118,scaffold_3
28,8121001,8156000,34999,False,118,scaffold_3
29,8176001,8253000,76999,False,118,scaffold_3
30,8427001,8534000,106999,False,118,scaffold_3
31,8575001,8594000,18999,False,118,scaffold_3
32,8757001,8771000,13999,False,118,scaffold_3
33,9019001,9075000,55999,False,118,scaffold_3
34,9968001,9996000,27999,False,118,scaffold_3
35,10065001,10087000,21999,False,118,scaffold_3
36,10461001,10485000,23999,False,118,scaffold_3
37,10586001,11182071,596070,True,118,scaffold_3
0,1,7000,6999,True,118,scaffold_4
1,11001,13000,1999,False,118,scaffold_4
2,14001,16000,1999,False,118,scaffold_4
3,17001,32000,14999,False,118,scaffold_4
4,48001,88000,39999,False,118,scaffold_4
5,120001,146000,25999,False,118,scaffold_4
6,147001,151000,3999,False,118,scaffold_4
7,155001,216000,60999,False,118,scaffold_4
8,217001,226000,8999,False,118,scaffold_4
9,227001,267000,39999,False,118,scaffold_4
10,283001,311000,27999,False,118,scaffold_4
11,312001,344000,31999,False,118,scaffold_4
12,345001,353000,7999,False,118,scaffold_4
13,355001,374000,18999,False,118,scaffold_4
14,375001,380000,4999,False,118,scaffold_4
15,389001,410000,20999,False,118,scaffold_4
16,412001,425000,12999,False,118,scaffold_4
17,429001,505000,75999,False,118,scaffold_4
18,540001,592000,51999,False,118,scaffold_4
19,593001,606000,12999,False,118,scaffold_4
20,608001,691000,82999,False,118,scaffold_4
21,704001,726000,21999,False,118,scaffold_4
22,1043001,1047000,3999,False,118,scaffold_4
23,1120001,1136000,15999,False,118,scaffold_4
24,1137001,1198000,60999,False,118,scaffold_4
25,1199001,1226000,26999,False,118,scaffold_4
26,1236001,1279000,42999,False,118,scaffold_4
27,1283001,1337000,53999,False,118,scaffold_4
28,1354001,1604000,249999,False,118,scaffold_4
29,1613001,2131000,517999,False,118,scaffold_4
30,2138001,2173000,34999,False,118,scaffold_4
31,2193001,2208000,14999,False,118,scaffold_4
32,2210001,2246000,35999,False,118,scaffold_4
33,2247001,2461000,213999,False,118,scaffold_4
34,2480001,2635000,154999,False,118,scaffold_4
35,2679001,2794000,114999,False,118,scaffold_4
36,2943001,2951000,7999,False,118,scaffold_4
37,3075001,3130000,54999,False,118,scaffold_4
38,3335001,3766000,430999,False,118,scaffold_4
39,4900001,5053000,152999,False,118,scaffold_4
40,5171001,5225000,53999,False,118,scaffold_4
41,5476001,5506000,29999,False,118,scaffold_4
42,5514001,5620000,105999,False,118,scaffold_4
43,5655001,5784000,128999,False,118,scaffold_4
44,5786001,5818000,31999,False,118,scaffold_4
45,6068001,6094000,25999,False,118,scaffold_4
46,6145001,6194000,48999,False,118,scaffold_4
47,6726001,6747000,20999,False,118,scaffold_4
48,6766001,6817000,50999,False,118,scaffold_4
49,6899001,6924000,24999,False,118,scaffold_4
50,7036001,7098000,61999,False,118,scaffold_4
51,7147001,7176000,28999,False,118,scaffold_4
52,7225001,7323000,97999,False,118,scaffold_4
53,8845001,9699000,853999,False,118,scaffold_4
54,9700001,9845951,145950,True,118,scaffold_4
0,1,4000,3999,True,118,scaffold_5
1,28001,32000,3999,False,118,scaffold_5
2,141001,174000,32999,False,118,scaffold_5
3,319001,428000,108999,False,118,scaffold_5
4,445001,526000,80999,False,118,scaffold_5
5,669001,702000,32999,False,118,scaffold_5
6,933001,955000,21999,False,118,scaffold_5
7,2475001,2494000,18999,False,118,scaffold_5
8,2546001,2874000,327999,False,118,scaffold_5
9,3091001,3193000,101999,False,118,scaffold_5
10,3218001,3241000,22999,False,118,scaffold_5
11,3279001,3513000,233999,False,118,scaffold_5
12,3621001,3658000,36999,False,118,scaffold_5
13,3961001,4101000,139999,False,118,scaffold_5
14,4118001,4220000,101999,False,118,scaffold_5
15,4246001,4272000,25999,False,118,scaffold_5
16,4444001,4523000,78999,False,118,scaffold_5
17,4597001,4751000,153999,False,118,scaffold_5
18,4752001,4862000,109999,False,118,scaffold_5
19,4883001,4919000,35999,False,118,scaffold_5
20,5059001,5090000,30999,False,118,scaffold_5
21,5287001,5312000,24999,False,118,scaffold_5
22,5314001,5344000,29999,False,118,scaffold_5
23,5704001,5739000,34999,False,118,scaffold_5
24,6392001,6662000,269999,False,118,scaffold_5
25,6763001,6789000,25999,False,118,scaffold_5
26,7307001,7325000,17999,False,118,scaffold_5
27,7406001,7437000,30999,False,118,scaffold_5
28,7454001,7483000,28999,False,118,scaffold_5
29,7559001,7664000,104999,False,118,scaffold_5
30,8258001,8259000,999,False,118,scaffold_5
31,8435001,8463000,27999,False,118,scaffold_5
32,8551001,8617000,65999,False,118,scaffold_5
33,8658001,8686000,27999,False,118,scaffold_5
34,8730001,9363000,632999,False,118,scaffold_5
0,41001,46000,4999,False,118,scaffold_6
1,60001,75000,14999,False,118,scaffold_6
2,78001,85000,6999,False,118,scaffold_6
3,86001,112000,25999,False,118,scaffold_6
4,168001,208000,39999,False,118,scaffold_6
5,240001,287000,46999,False,118,scaffold_6
6,1235001,1263000,27999,False,118,scaffold_6
7,1284001,1311000,26999,False,118,scaffold_6
8,1434001,1461000,26999,False,118,scaffold_6
9,1478001,1551000,72999,False,118,scaffold_6
10,1557001,1583000,25999,False,118,scaffold_6
11,1868001,1900000,31999,False,118,scaffold_6
12,2023001,2107000,83999,False,118,scaffold_6
13,2128001,2195000,66999,False,118,scaffold_6
14,2238001,2266000,27999,False,118,scaffold_6
15,2317001,2653000,335999,False,118,scaffold_6
16,2655001,2872000,216999,False,118,scaffold_6
17,2933001,3031000,97999,False,118,scaffold_6
18,3114001,3175000,60999,False,118,scaffold_6
19,3223001,3333000,109999,False,118,scaffold_6
20,3396001,3806000,409999,False,118,scaffold_6
21,3897001,3913000,15999,False,118,scaffold_6
22,3966001,4195000,228999,False,118,scaffold_6
23,4847001,4868000,20999,False,118,scaffold_6
24,6004001,6073000,68999,False,118,scaffold_6
25,6124001,6190000,65999,False,118,scaffold_6
26,7185001,7247000,61999,False,118,scaffold_6
27,7263001,7349000,85999,False,118,scaffold_6
28,7389001,7482000,92999,False,118,scaffold_6
29,7560001,8268281,708280,True,118,scaffold_6
0,1,8000,7999,True,118,scaffold_7
1,13001,31000,17999,False,118,scaffold_7
2,323001,510000,186999,False,118,scaffold_7
3,571001,579000,7999,False,118,scaffold_7
4,622001,676000,53999,False,118,scaffold_7
5,706001,753000,46999,False,118,scaffold_7
6,764001,821000,56999,False,118,scaffold_7
7,859001,864000,4999,False,118,scaffold_7
8,868001,938000,69999,False,118,scaffold_7
9,964001,981000,16999,False,118,scaffold_7
10,982001,1044000,61999,False,118,scaffold_7
11,1048001,1124000,75999,False,118,scaffold_7
12,1170001,1460000,289999,False,118,scaffold_7
13,1461001,1512000,50999,False,118,scaffold_7
14,1588001,1689000,100999,False,118,scaffold_7
15,1727001,1754000,26999,False,118,scaffold_7
16,1827001,1898000,70999,False,118,scaffold_7
17,3295001,3373000,77999,False,118,scaffold_7
18,3519001,3766000,246999,False,118,scaffold_7
19,4415001,4517000,101999,False,118,scaffold_7
20,4551001,4579000,27999,False,118,scaffold_7
21,4655001,4736000,80999,False,118,scaffold_7
22,4777001,4831000,53999,False,118,scaffold_7
23,4978001,5149000,170999,False,118,scaffold_7
24,5469001,5537000,67999,False,118,scaffold_7
25,6644001,6683000,38999,False,118,scaffold_7
26,6954001,7270000,315999,False,118,scaffold_7
27,7271001,7502216,231215,True,118,scaffold_7
0,1,6000,5999,True,118,scaffold_8
1,31001,85000,53999,False,118,scaffold_8
2,93001,102000,8999,False,118,scaffold_8
3,541001,549000,7999,False,118,scaffold_8
4,1393001,1425000,31999,False,118,scaffold_8
5,2444001,2533000,88999,False,118,scaffold_8
6,2535001,2552000,16999,False,118,scaffold_8
7,2650001,2683000,32999,False,118,scaffold_8
8,2684001,2688000,3999,False,118,scaffold_8
9,2742001,2757000,14999,False,118,scaffold_8
10,2798001,2844000,45999,False,118,scaffold_8
11,3038001,3525000,486999,False,118,scaffold_8
12,3580001,3614000,33999,False,118,scaffold_8
13,3615001,3915000,299999,False,118,scaffold_8
14,4039001,4107000,67999,False,118,scaffold_8
15,4170001,4224000,53999,False,118,scaffold_8
16,5088001,5136000,47999,False,118,scaffold_8
17,5164001,5241000,76999,False,118,scaffold_8
18,5651001,5692000,40999,False,118,scaffold_8
19,6327001,6334544,7543,True,118,scaffold_8
0,1,22000,21999,True,118,scaffold_9
1,109001,117000,7999,False,118,scaffold_9
2,121001,138000,16999,False,118,scaffold_9
3,236001,242000,5999,False,118,scaffold_9
4,298001,316000,17999,False,118,scaffold_9
5,319001,411000,91999,False,118,scaffold_9
6,413001,434000,20999,False,118,scaffold_9
7,484001,531000,46999,False,118,scaffold_9
8,652001,665000,12999,False,118,scaffold_9
9,671001,696000,24999,False,118,scaffold_9
10,731001,742000,10999,False,118,scaffold_9
11,815001,842000,26999,False,118,scaffold_9
12,850001,862000,11999,False,118,scaffold_9
13,872001,986000,113999,False,118,scaffold_9
14,988001,995000,6999,False,118,scaffold_9
15,1001001,1085000,83999,False,118,scaffold_9
16,1087001,1177000,89999,False,118,scaffold_9
17,1312001,1377000,64999,False,118,scaffold_9
18,1428001,1441000,12999,False,118,scaffold_9
19,1487001,1500000,12999,False,118,scaffold_9
20,1569001,1592000,22999,False,118,scaffold_9
21,1599001,1616000,16999,False,118,scaffold_9
22,1759001,1796000,36999,False,118,scaffold_9
23,1987001,2133000,145999,False,118,scaffold_9
24,2598001,2616000,17999,False,118,scaffold_9
25,2735001,3381000,645999,False,118,scaffold_9
26,3383001,5110000,1726999,False,118,scaffold_9
27,5112001,5238000,125999,False,118,scaffold_9
28,5239001,5298000,58999,False,118,scaffold_9
29,5300001,6331288,1031287,True,118,scaffold_9
0,1,226000,225999,True,118,scaffold_10
1,261001,414000,152999,False,118,scaffold_10
2,415001,482000,66999,False,118,scaffold_10
3,483001,582000,98999,False,118,scaffold_10
4,602001,796000,193999,False,118,scaffold_10
5,812001,840000,27999,False,118,scaffold_10
6,862001,870000,7999,False,118,scaffold_10
7,888001,963000,74999,False,118,scaffold_10
8,1087001,1144000,56999,False,118,scaffold_10
9,1443001,1470000,26999,False,118,scaffold_10
10,1803001,1817000,13999,False,118,scaffold_10
11,2079001,2107000,27999,False,118,scaffold_10
12,2136001,2169000,32999,False,118,scaffold_10
13,2339001,2425000,85999,False,118,scaffold_10
14,2563001,2585000,21999,False,118,scaffold_10
15,2601001,2636000,34999,False,118,scaffold_10
16,2792001,2813000,20999,False,118,scaffold_10
17,4050001,4093000,42999,False,118,scaffold_10
18,4154001,4174000,19999,False,118,scaffold_10
19,4335001,4359000,23999,False,118,scaffold_10
20,4443001,4462000,18999,False,118,scaffold_10
21,4467001,4513000,45999,False,118,scaffold_10
22,4515001,4523000,7999,False,118,scaffold_10
23,4526001,4548000,21999,False,118,scaffold_10
24,4554001,4562000,7999,False,118,scaffold_10
25,4574001,4597000,22999,False,118,scaffold_10
26,4716001,4732000,15999,False,118,scaffold_10
27,4734001,4766000,31999,False,118,scaffold_10
28,4769001,4776000,6999,False,118,scaffold_10
29,4798001,4824000,25999,False,118,scaffold_10
30,4828001,4846000,17999,False,118,scaffold_10
31,4848001,4861000,12999,False,118,scaffold_10
32,4865001,4866973,1972,True,118,scaffold_10
0,10001,92000,81999,False,118,scaffold_11
1,149001,167000,17999,False,118,scaffold_11
2,169001,236000,66999,False,118,scaffold_11
3,240001,254000,13999,False,118,scaffold_11
4,291001,320000,28999,False,118,scaffold_11
5,419001,431000,11999,False,118,scaffold_11
6,648001,657000,8999,False,118,scaffold_11
7,1025001,1034000,8999,False,118,scaffold_11
8,1403001,1409000,5999,False,118,scaffold_11
9,1423001,1426000,2999,False,118,scaffold_11
10,1474001,1477000,2999,False,118,scaffold_11
11,2000001,2036000,35999,False,118,scaffold_11
12,2701001,2877000,175999,False,118,scaffold_11
13,2983001,3015000,31999,False,118,scaffold_11
14,3084001,3164000,79999,False,118,scaffold_11
15,3188001,3293000,104999,False,118,scaffold_11
16,3329001,3383000,53999,False,118,scaffold_11
17,3434001,3480000,45999,False,118,scaffold_11
18,3521001,3933000,411999,False,118,scaffold_11
19,4009001,4109000,99999,False,118,scaffold_11
20,4133001,4158000,24999,False,118,scaffold_11
21,4181001,4710000,528999,False,118,scaffold_11
22,4713001,4766820,53819,True,118,scaffold_11
0,1,389000,388999,True,118,scaffold_12
1,403001,1484000,1080999,False,118,scaffold_12
2,1562001,1586000,23999,False,118,scaffold_12
3,1720001,1746000,25999,False,118,scaffold_12
4,2043001,2102000,58999,False,118,scaffold_12
5,2130001,2166000,35999,False,118,scaffold_12
6,2172001,2192000,19999,False,118,scaffold_12
7,2571001,2621000,49999,False,118,scaffold_12
8,2660001,2682000,21999,False,118,scaffold_12
0,1,342000,341999,True,119,scaffold_1
1,482001,498000,15999,False,119,scaffold_1
2,574001,643000,68999,False,119,scaffold_1
3,686001,759000,72999,False,119,scaffold_1
4,1281001,1292000,10999,False,119,scaffold_1
5,1814001,1898000,83999,False,119,scaffold_1
6,1952001,1964000,11999,False,119,scaffold_1
7,1965001,1984000,18999,False,119,scaffold_1
8,2449001,2517000,67999,False,119,scaffold_1
9,2729001,2746000,16999,False,119,scaffold_1
10,3179001,3208000,28999,False,119,scaffold_1
11,3712001,3734000,21999,False,119,scaffold_1
12,3902001,3941000,38999,False,119,scaffold_1
13,4003001,4027000,23999,False,119,scaffold_1
14,4061001,4112000,50999,False,119,scaffold_1
15,4321001,4355000,33999,False,119,scaffold_1
16,4927001,5022000,94999,False,119,scaffold_1
17,5481001,5511000,29999,False,119,scaffold_1
18,5537001,5569000,31999,False,119,scaffold_1
19,6108001,6153000,44999,False,119,scaffold_1
20,6228001,6379000,150999,False,119,scaffold_1
21,6384001,6507000,122999,False,119,scaffold_1
22,6543001,6555000,11999,False,119,scaffold_1
23,7038001,7247000,208999,False,119,scaffold_1
24,7248001,7583000,334999,False,119,scaffold_1
25,7590001,8656000,1065999,False,119,scaffold_1
26,8658001,9584000,925999,False,119,scaffold_1
27,9586001,10355000,768999,False,119,scaffold_1
28,10461001,10638000,176999,False,119,scaffold_1
29,10808001,10811000,2999,False,119,scaffold_1
30,10835001,10857000,21999,False,119,scaffold_1
31,11276001,11302000,25999,False,119,scaffold_1
32,11346001,11504000,157999,False,119,scaffold_1
33,11609001,11951000,341999,False,119,scaffold_1
34,12184001,12204000,19999,False,119,scaffold_1
35,12652001,12722000,69999,False,119,scaffold_1
36,12777001,12888000,110999,False,119,scaffold_1
37,13113001,13212000,98999,False,119,scaffold_1
38,13347001,13430000,82999,False,119,scaffold_1
39,14285001,14307000,21999,False,119,scaffold_1
0,22001,48000,25999,False,119,scaffold_2
1,93001,159000,65999,False,119,scaffold_2
2,168001,177000,8999,False,119,scaffold_2
3,302001,318000,15999,False,119,scaffold_2
4,331001,374000,42999,False,119,scaffold_2
5,2086001,2100000,13999,False,119,scaffold_2
6,2336001,2358000,21999,False,119,scaffold_2
7,2404001,2424000,19999,False,119,scaffold_2
8,2441001,2553000,111999,False,119,scaffold_2
9,2627001,2639000,11999,False,119,scaffold_2
10,2660001,2689000,28999,False,119,scaffold_2
11,2694001,2743000,48999,False,119,scaffold_2
12,2766001,2788000,21999,False,119,scaffold_2
13,2868001,2902000,33999,False,119,scaffold_2
14,2996001,3010000,13999,False,119,scaffold_2
15,3451001,3465000,13999,False,119,scaffold_2
16,3754001,3787000,32999,False,119,scaffold_2
17,4382001,4409000,26999,False,119,scaffold_2
18,4426001,4458000,31999,False,119,scaffold_2
19,4516001,4580000,63999,False,119,scaffold_2
20,4593001,4654000,60999,False,119,scaffold_2
21,4783001,4790000,6999,False,119,scaffold_2
22,4918001,4954000,35999,False,119,scaffold_2
23,5020001,5061000,40999,False,119,scaffold_2
24,5370001,5392000,21999,False,119,scaffold_2
25,5491001,5511000,19999,False,119,scaffold_2
26,5672001,5704000,31999,False,119,scaffold_2
27,6261001,6330000,68999,False,119,scaffold_2
28,6331001,6341000,9999,False,119,scaffold_2
29,6429001,6449000,19999,False,119,scaffold_2
30,6593001,6628000,34999,False,119,scaffold_2
31,7018001,7036000,17999,False,119,scaffold_2
32,7439001,7473000,33999,False,119,scaffold_2
33,7563001,7697000,133999,False,119,scaffold_2
34,7786001,7891000,104999,False,119,scaffold_2
35,7934001,7966000,31999,False,119,scaffold_2
36,7984001,8160000,175999,False,119,scaffold_2
37,8267001,8294000,26999,False,119,scaffold_2
38,8331001,8333000,1999,False,119,scaffold_2
39,8339001,8345000,5999,False,119,scaffold_2
40,8346001,8453000,106999,False,119,scaffold_2
41,8509001,8562000,52999,False,119,scaffold_2
42,11366001,11374000,7999,False,119,scaffold_2
43,11520001,11786000,265999,False,119,scaffold_2
0,1,2000,1999,True,119,scaffold_3
1,51001,55000,3999,False,119,scaffold_3
2,799001,900000,100999,False,119,scaffold_3
3,2079001,2108000,28999,False,119,scaffold_3
4,2291001,2335000,43999,False,119,scaffold_3
5,2487001,2533000,45999,False,119,scaffold_3
6,3770001,3808000,37999,False,119,scaffold_3
7,4108001,4399000,290999,False,119,scaffold_3
8,4416001,4518000,101999,False,119,scaffold_3
9,4546001,4558000,11999,False,119,scaffold_3
10,4653001,4680000,26999,False,119,scaffold_3
11,5495001,5506000,10999,False,119,scaffold_3
12,5975001,6024000,48999,False,119,scaffold_3
13,6762001,6779000,16999,False,119,scaffold_3
14,6909001,6962000,52999,False,119,scaffold_3
15,6963001,6968000,4999,False,119,scaffold_3
16,6979001,7089000,109999,False,119,scaffold_3
17,7534001,7556000,21999,False,119,scaffold_3
18,7692001,7799000,106999,False,119,scaffold_3
19,7818001,7851000,32999,False,119,scaffold_3
20,8177001,8254000,76999,False,119,scaffold_3
21,8462001,8527000,64999,False,119,scaffold_3
22,8575001,8594000,18999,False,119,scaffold_3
23,9968001,9995000,26999,False,119,scaffold_3
24,10461001,10483000,21999,False,119,scaffold_3
25,10587001,11162000,574999,False,119,scaffold_3
0,11001,13000,1999,False,119,scaffold_4
1,17001,32000,14999,False,119,scaffold_4
2,48001,88000,39999,False,119,scaffold_4
3,121001,146000,24999,False,119,scaffold_4
4,147001,151000,3999,False,119,scaffold_4
5,155001,160000,4999,False,119,scaffold_4
6,163001,215000,51999,False,119,scaffold_4
7,217001,226000,8999,False,119,scaffold_4
8,227001,266000,38999,False,119,scaffold_4
9,319001,344000,24999,False,119,scaffold_4
10,355001,374000,18999,False,119,scaffold_4
11,375001,380000,4999,False,119,scaffold_4
12,412001,425000,12999,False,119,scaffold_4
13,429001,500000,70999,False,119,scaffold_4
14,545001,592000,46999,False,119,scaffold_4
15,593001,606000,12999,False,119,scaffold_4
16,608001,661000,52999,False,119,scaffold_4
17,670001,691000,20999,False,119,scaffold_4
18,701001,712000,10999,False,119,scaffold_4
19,1121001,1198000,76999,False,119,scaffold_4
20,1199001,1208000,8999,False,119,scaffold_4
21,1210001,1226000,15999,False,119,scaffold_4
22,1254001,1262000,7999,False,119,scaffold_4
23,1265001,1279000,13999,False,119,scaffold_4
24,1283001,1336000,52999,False,119,scaffold_4
25,1372001,1598000,225999,False,119,scaffold_4
26,1613001,2002000,388999,False,119,scaffold_4
27,2021001,2117000,95999,False,119,scaffold_4
28,2210001,2268000,57999,False,119,scaffold_4
29,2269001,2279000,9999,False,119,scaffold_4
30,2284001,2340000,55999,False,119,scaffold_4
31,2342001,2351000,8999,False,119,scaffold_4
32,2429001,2461000,31999,False,119,scaffold_4
33,2477001,2635000,157999,False,119,scaffold_4
34,3336001,3635000,298999,False,119,scaffold_4
35,3676001,3762000,85999,False,119,scaffold_4
36,4900001,5044000,143999,False,119,scaffold_4
37,5172001,5224000,51999,False,119,scaffold_4
38,5305001,5328000,22999,False,119,scaffold_4
39,5477001,5506000,28999,False,119,scaffold_4
40,5514001,5620000,105999,False,119,scaffold_4
41,5660001,5784000,123999,False,119,scaffold_4
42,5786001,5816000,29999,False,119,scaffold_4
43,6145001,6193000,47999,False,119,scaffold_4
44,6773001,6817000,43999,False,119,scaffold_4
45,6902001,6924000,21999,False,119,scaffold_4
46,6969001,6995000,25999,False,119,scaffold_4
47,7036001,7062000,25999,False,119,scaffold_4
48,7229001,7270000,40999,False,119,scaffold_4
49,7643001,7656000,12999,False,119,scaffold_4
50,8845001,9699000,853999,False,119,scaffold_4
51,9700001,9845951,145950,True,119,scaffold_4
0,1,4000,3999,True,119,scaffold_5
1,195001,204000,8999,False,119,scaffold_5
2,296001,300000,3999,False,119,scaffold_5
3,318001,326000,7999,False,119,scaffold_5
4,327001,386000,58999,False,119,scaffold_5
5,463001,523000,59999,False,119,scaffold_5
6,669001,679000,9999,False,119,scaffold_5
7,933001,947000,13999,False,119,scaffold_5
8,2565001,2582000,16999,False,119,scaffold_5
9,2619001,2738000,118999,False,119,scaffold_5
10,2813001,2871000,57999,False,119,scaffold_5
11,3133001,3185000,51999,False,119,scaffold_5
12,3217001,3254000,36999,False,119,scaffold_5
13,3309001,3511000,201999,False,119,scaffold_5
14,3962001,4101000,138999,False,119,scaffold_5
15,4119001,4219000,99999,False,119,scaffold_5
16,4246001,4264000,17999,False,119,scaffold_5
17,4446001,4506000,59999,False,119,scaffold_5
18,4602001,4680000,77999,False,119,scaffold_5
19,4690001,4717000,26999,False,119,scaffold_5
20,4783001,4861000,77999,False,119,scaffold_5
21,5318001,5346000,27999,False,119,scaffold_5
22,6409001,6419000,9999,False,119,scaffold_5
23,6519001,6652000,132999,False,119,scaffold_5
24,7580001,7610000,29999,False,119,scaffold_5
25,7622001,7654000,31999,False,119,scaffold_5
26,8572001,8595000,22999,False,119,scaffold_5
27,8675001,8688000,12999,False,119,scaffold_5
28,8706001,9364176,658175,True,119,scaffold_5
0,79001,85000,5999,False,119,scaffold_6
1,86001,113000,26999,False,119,scaffold_6
2,239001,253000,13999,False,119,scaffold_6
3,257001,262000,4999,False,119,scaffold_6
4,267001,283000,15999,False,119,scaffold_6
5,1229001,1261000,31999,False,119,scaffold_6
6,1479001,1546000,66999,False,119,scaffold_6
7,2023001,2087000,63999,False,119,scaffold_6
8,2135001,2193000,57999,False,119,scaffold_6
9,2336001,2595000,258999,False,119,scaffold_6
10,2596001,2653000,56999,False,119,scaffold_6
11,2655001,2691000,35999,False,119,scaffold_6
12,2712001,2851000,138999,False,119,scaffold_6
13,2927001,3016000,88999,False,119,scaffold_6
14,3115001,3179000,63999,False,119,scaffold_6
15,3224001,3301000,76999,False,119,scaffold_6
16,3405001,3428000,22999,False,119,scaffold_6
17,3461001,3766000,304999,False,119,scaffold_6
18,3901001,3912000,10999,False,119,scaffold_6
19,4018001,4072000,53999,False,119,scaffold_6
20,4080001,4193000,112999,False,119,scaffold_6
21,6010001,6063000,52999,False,119,scaffold_6
22,7269001,7337000,67999,False,119,scaffold_6
23,7550001,8268281,718280,True,119,scaffold_6
0,13001,34000,20999,False,119,scaffold_7
1,323001,340000,16999,False,119,scaffold_7
2,342001,508000,165999,False,119,scaffold_7
3,554001,563000,8999,False,119,scaffold_7
4,571001,577000,5999,False,119,scaffold_7
5,706001,736000,29999,False,119,scaffold_7
6,749001,753000,3999,False,119,scaffold_7
7,764001,829000,64999,False,119,scaffold_7
8,859001,864000,4999,False,119,scaffold_7
9,964001,980000,15999,False,119,scaffold_7
10,982001,1044000,61999,False,119,scaffold_7
11,1048001,1080000,31999,False,119,scaffold_7
12,1172001,1187000,14999,False,119,scaffold_7
13,1191001,1512000,320999,False,119,scaffold_7
14,1588001,1688000,99999,False,119,scaffold_7
15,3325001,3369000,43999,False,119,scaffold_7
16,3527001,3548000,20999,False,119,scaffold_7
17,3595001,3651000,55999,False,119,scaffold_7
18,4415001,4518000,102999,False,119,scaffold_7
19,4658001,4681000,22999,False,119,scaffold_7
20,4979001,5149000,169999,False,119,scaffold_7
21,5484001,5515000,30999,False,119,scaffold_7
22,6954001,7270000,315999,False,119,scaffold_7
23,7271001,7502216,231215,True,119,scaffold_7
0,66001,85000,18999,False,119,scaffold_8
1,93001,101000,7999,False,119,scaffold_8
2,2444001,2527000,82999,False,119,scaffold_8
3,2657001,2681000,23999,False,119,scaffold_8
4,2741001,2757000,15999,False,119,scaffold_8
5,3059001,3525000,465999,False,119,scaffold_8
6,3578001,3612000,33999,False,119,scaffold_8
7,3615001,3937000,321999,False,119,scaffold_8
8,4050001,4108000,57999,False,119,scaffold_8
9,4400001,4431000,30999,False,119,scaffold_8
10,5095001,5136000,40999,False,119,scaffold_8
11,5172001,5241000,68999,False,119,scaffold_8
12,6320001,6334544,14543,True,119,scaffold_8
0,1001,19000,17999,False,119,scaffold_9
1,109001,118000,8999,False,119,scaffold_9
2,121001,134000,12999,False,119,scaffold_9
3,189001,194000,4999,False,119,scaffold_9
4,303001,315000,11999,False,119,scaffold_9
5,319001,331000,11999,False,119,scaffold_9
6,367001,411000,43999,False,119,scaffold_9
7,413001,434000,20999,False,119,scaffold_9
8,502001,531000,28999,False,119,scaffold_9
9,548001,561000,12999,False,119,scaffold_9
10,660001,665000,4999,False,119,scaffold_9
11,670001,697000,26999,False,119,scaffold_9
12,732001,742000,9999,False,119,scaffold_9
13,816001,843000,26999,False,119,scaffold_9
14,850001,862000,11999,False,119,scaffold_9
15,886001,986000,99999,False,119,scaffold_9
16,988001,995000,6999,False,119,scaffold_9
17,1001001,1007000,5999,False,119,scaffold_9
18,1009001,1085000,75999,False,119,scaffold_9
19,1087001,1150000,62999,False,119,scaffold_9
20,1151001,1175000,23999,False,119,scaffold_9
21,1312001,1380000,67999,False,119,scaffold_9
22,1599001,1616000,16999,False,119,scaffold_9
23,1749001,1791000,41999,False,119,scaffold_9
24,2150001,2171000,20999,False,119,scaffold_9
25,2599001,2616000,16999,False,119,scaffold_9
26,2781001,2803000,21999,False,119,scaffold_9
27,2870001,3381000,510999,False,119,scaffold_9
28,3383001,5107000,1723999,False,119,scaffold_9
29,5112001,5114000,1999,False,119,scaffold_9
30,5116001,5238000,121999,False,119,scaffold_9
31,5239001,5298000,58999,False,119,scaffold_9
32,5300001,5490000,189999,False,119,scaffold_9
33,5492001,6331288,839287,True,119,scaffold_9
0,1,199000,198999,True,119,scaffold_10
1,335001,406000,70999,False,119,scaffold_10
2,420001,482000,61999,False,119,scaffold_10
3,483001,582000,98999,False,119,scaffold_10
4,603001,754000,150999,False,119,scaffold_10
5,888001,917000,28999,False,119,scaffold_10
6,923001,963000,39999,False,119,scaffold_10
7,1088001,1105000,16999,False,119,scaffold_10
8,2091001,2102000,10999,False,119,scaffold_10
9,2140001,2167000,26999,False,119,scaffold_10
10,2336001,2368000,31999,False,119,scaffold_10
11,4052001,4091000,38999,False,119,scaffold_10
12,4154001,4174000,19999,False,119,scaffold_10
13,4515001,4523000,7999,False,119,scaffold_10
14,4526001,4548000,21999,False,119,scaffold_10
15,4576001,4596000,19999,False,119,scaffold_10
16,4681001,4688000,6999,False,119,scaffold_10
17,4734001,4766000,31999,False,119,scaffold_10
18,4767001,4776000,8999,False,119,scaffold_10
19,4798001,4824000,25999,False,119,scaffold_10
20,4828001,4843000,14999,False,119,scaffold_10
21,4848001,4861000,12999,False,119,scaffold_10
22,4862001,4866973,4972,True,119,scaffold_10
0,10001,93000,82999,False,119,scaffold_11
1,149001,167000,17999,False,119,scaffold_11
2,169001,191000,21999,False,119,scaffold_11
3,213001,235000,21999,False,119,scaffold_11
4,240001,248000,7999,False,119,scaffold_11
5,297001,311000,13999,False,119,scaffold_11
6,419001,431000,11999,False,119,scaffold_11
7,648001,656000,7999,False,119,scaffold_11
8,1025001,1034000,8999,False,119,scaffold_11
9,1423001,1426000,2999,False,119,scaffold_11
10,1474001,1477000,2999,False,119,scaffold_11
11,2701001,2877000,175999,False,119,scaffold_11
12,3092001,3121000,28999,False,119,scaffold_11
13,3188001,3289000,100999,False,119,scaffold_11
14,3331001,3383000,51999,False,119,scaffold_11
15,3553001,3578000,24999,False,119,scaffold_11
16,3702001,3926000,223999,False,119,scaffold_11
17,4045001,4054000,8999,False,119,scaffold_11
18,4133001,4159000,25999,False,119,scaffold_11
19,4255001,4710000,454999,False,119,scaffold_11
20,4713001,4766820,53819,True,119,scaffold_11
0,1,370000,369999,True,119,scaffold_12
1,404001,538000,133999,False,119,scaffold_12
2,580001,856000,275999,False,119,scaffold_12
3,865001,1469000,603999,False,119,scaffold_12
4,1720001,1733000,12999,False,119,scaffold_12
5,2571001,2619000,47999,False,119,scaffold_12
6,2685001,2696000,10999,False,119,scaffold_12
7,2747001,2747968,967,True,119,scaffold_12
0,1,342000,341999,True,120,scaffold_1
1,482001,498000,15999,False,120,scaffold_1
2,571001,643000,71999,False,120,scaffold_1
3,686001,756000,69999,False,120,scaffold_1
4,1281001,1292000,10999,False,120,scaffold_1
5,1613001,1660000,46999,False,120,scaffold_1
6,1811001,1899000,87999,False,120,scaffold_1
7,1951001,1984000,32999,False,120,scaffold_1
8,1988001,1994000,5999,False,120,scaffold_1
9,2364001,2385000,20999,False,120,scaffold_1
10,2449001,2517000,67999,False,120,scaffold_1
11,2729001,2746000,16999,False,120,scaffold_1
12,2990001,3022000,31999,False,120,scaffold_1
13,3172001,3209000,36999,False,120,scaffold_1
14,3705001,3750000,44999,False,120,scaffold_1
15,3802001,3880000,77999,False,120,scaffold_1
16,3901001,3941000,39999,False,120,scaffold_1
17,3942001,4059000,116999,False,120,scaffold_1
18,4060001,4113000,52999,False,120,scaffold_1
19,4314001,4355000,40999,False,120,scaffold_1
20,4927001,5025000,97999,False,120,scaffold_1
21,5088001,5110000,21999,False,120,scaffold_1
22,5481001,5512000,30999,False,120,scaffold_1
23,5535001,5570000,34999,False,120,scaffold_1
24,5854001,5876000,21999,False,120,scaffold_1
25,6107001,6153000,45999,False,120,scaffold_1
26,6154001,6177000,22999,False,120,scaffold_1
27,6219001,6511000,291999,False,120,scaffold_1
28,6542001,6562000,19999,False,120,scaffold_1
29,6838001,6851000,12999,False,120,scaffold_1
30,7037001,7247000,209999,False,120,scaffold_1
31,7248001,7589000,340999,False,120,scaffold_1
32,7590001,8656000,1065999,False,120,scaffold_1
33,8658001,9584000,925999,False,120,scaffold_1
34,9586001,10355000,768999,False,120,scaffold_1
35,10457001,10636000,178999,False,120,scaffold_1
36,10736001,10754000,17999,False,120,scaffold_1
37,10840001,10857000,16999,False,120,scaffold_1
38,10898001,10940000,41999,False,120,scaffold_1
39,11275001,11964000,688999,False,120,scaffold_1
40,12184001,12205000,20999,False,120,scaffold_1
41,12652001,12722000,69999,False,120,scaffold_1
42,12777001,12888000,110999,False,120,scaffold_1
43,12965001,13002000,36999,False,120,scaffold_1
44,13107001,13213000,105999,False,120,scaffold_1
45,13347001,13455000,107999,False,120,scaffold_1
46,13559001,13590000,30999,False,120,scaffold_1
47,13785001,13845000,59999,False,120,scaffold_1
48,13928001,13938000,9999,False,120,scaffold_1
49,13959001,13973000,13999,False,120,scaffold_1
50,14286001,14314000,27999,False,120,scaffold_1
0,21001,48000,26999,False,120,scaffold_2
1,93001,159000,65999,False,120,scaffold_2
2,168001,177000,8999,False,120,scaffold_2
3,297001,318000,20999,False,120,scaffold_2
4,331001,374000,42999,False,120,scaffold_2
5,732001,739000,6999,False,120,scaffold_2
6,1310001,1330000,19999,False,120,scaffold_2
7,1351001,1365000,13999,False,120,scaffold_2
8,1689001,1721000,31999,False,120,scaffold_2
9,2085001,2108000,22999,False,120,scaffold_2
10,2336001,2424000,87999,False,120,scaffold_2
11,2437001,2604000,166999,False,120,scaffold_2
12,2626001,2639000,12999,False,120,scaffold_2
13,2645001,2689000,43999,False,120,scaffold_2
14,2693001,2744000,50999,False,120,scaffold_2
15,2766001,2788000,21999,False,120,scaffold_2
16,2818001,2856000,37999,False,120,scaffold_2
17,2868001,2905000,36999,False,120,scaffold_2
18,2991001,3021000,29999,False,120,scaffold_2
19,3022001,3041000,18999,False,120,scaffold_2
20,3333001,3344000,10999,False,120,scaffold_2
21,3449001,3467000,17999,False,120,scaffold_2
22,3754001,3783000,28999,False,120,scaffold_2
23,4243001,4275000,31999,False,120,scaffold_2
24,4383001,4409000,25999,False,120,scaffold_2
25,4426001,4457000,30999,False,120,scaffold_2
26,4519001,4656000,136999,False,120,scaffold_2
27,4782001,4790000,7999,False,120,scaffold_2
28,4918001,4962000,43999,False,120,scaffold_2
29,5020001,5031000,10999,False,120,scaffold_2
30,5033001,5104000,70999,False,120,scaffold_2
31,5285001,5314000,28999,False,120,scaffold_2
32,5362001,5396000,33999,False,120,scaffold_2
33,5455001,5481000,25999,False,120,scaffold_2
34,5491001,5531000,39999,False,120,scaffold_2
35,5658001,5759000,100999,False,120,scaffold_2
36,5840001,5891000,50999,False,120,scaffold_2
37,5912001,5958000,45999,False,120,scaffold_2
38,6261001,6330000,68999,False,120,scaffold_2
39,6331001,6351000,19999,False,120,scaffold_2
40,6407001,6450000,42999,False,120,scaffold_2
41,6590001,6628000,37999,False,120,scaffold_2
42,6946001,6979000,32999,False,120,scaffold_2
43,7004001,7038000,33999,False,120,scaffold_2
44,7050001,7117000,66999,False,120,scaffold_2
45,7400001,7473000,72999,False,120,scaffold_2
46,7491001,7518000,26999,False,120,scaffold_2
47,7549001,7561000,11999,False,120,scaffold_2
48,7563001,7706000,142999,False,120,scaffold_2
49,7786001,8173000,386999,False,120,scaffold_2
50,8261001,8313000,51999,False,120,scaffold_2
51,8331001,8333000,1999,False,120,scaffold_2
52,8340001,8345000,4999,False,120,scaffold_2
53,8346001,8454000,107999,False,120,scaffold_2
54,8495001,8563000,67999,False,120,scaffold_2
55,9139001,9168000,28999,False,120,scaffold_2
56,9674001,9709000,34999,False,120,scaffold_2
57,10991001,10993000,1999,False,120,scaffold_2
58,11520001,11786000,265999,False,120,scaffold_2
0,346001,349000,2999,False,120,scaffold_3
1,618001,646000,27999,False,120,scaffold_3
2,797001,900000,102999,False,120,scaffold_3
3,2007001,2108000,100999,False,120,scaffold_3
4,2109001,2116000,6999,False,120,scaffold_3
5,2291001,2335000,43999,False,120,scaffold_3
6,2485001,2531000,45999,False,120,scaffold_3
7,2716001,2757000,40999,False,120,scaffold_3
8,3768001,3821000,52999,False,120,scaffold_3
9,3822001,3891000,68999,False,120,scaffold_3
10,3910001,3921000,10999,False,120,scaffold_3
11,4093001,4403000,309999,False,120,scaffold_3
12,4413001,4518000,104999,False,120,scaffold_3
13,4547001,4558000,10999,False,120,scaffold_3
14,4637001,4686000,48999,False,120,scaffold_3
15,5164001,5206000,41999,False,120,scaffold_3
16,5238001,5272000,33999,False,120,scaffold_3
17,5805001,6020000,214999,False,120,scaffold_3
18,6742001,6779000,36999,False,120,scaffold_3
19,6910001,6962000,51999,False,120,scaffold_3
20,6963001,7098000,134999,False,120,scaffold_3
21,7282001,7298000,15999,False,120,scaffold_3
22,7373001,7397000,23999,False,120,scaffold_3
23,7431001,7445000,13999,False,120,scaffold_3
24,7449001,7458000,8999,False,120,scaffold_3
25,7506001,7561000,54999,False,120,scaffold_3
26,7676001,7854000,177999,False,120,scaffold_3
27,8052001,8110000,57999,False,120,scaffold_3
28,8183001,8253000,69999,False,120,scaffold_3
29,8423001,8449000,25999,False,120,scaffold_3
30,8462001,8527000,64999,False,120,scaffold_3
31,8575001,8594000,18999,False,120,scaffold_3
32,9006001,9080000,73999,False,120,scaffold_3
33,9106001,9142000,35999,False,120,scaffold_3
34,9968001,9996000,27999,False,120,scaffold_3
35,10461001,10485000,23999,False,120,scaffold_3
36,10554001,10565000,10999,False,120,scaffold_3
37,10587001,11182071,595070,True,120,scaffold_3
0,17001,32000,14999,False,120,scaffold_4
1,48001,88000,39999,False,120,scaffold_4
2,91001,112000,20999,False,120,scaffold_4
3,113001,115000,1999,False,120,scaffold_4
4,120001,146000,25999,False,120,scaffold_4
5,147001,151000,3999,False,120,scaffold_4
6,155001,160000,4999,False,120,scaffold_4
7,161001,215000,53999,False,120,scaffold_4
8,217001,226000,8999,False,120,scaffold_4
9,227001,266000,38999,False,120,scaffold_4
10,283001,307000,23999,False,120,scaffold_4
11,308001,344000,35999,False,120,scaffold_4
12,355001,374000,18999,False,120,scaffold_4
13,375001,380000,4999,False,120,scaffold_4
14,383001,425000,41999,False,120,scaffold_4
15,426001,592000,165999,False,120,scaffold_4
16,593001,599000,5999,False,120,scaffold_4
17,600001,606000,5999,False,120,scaffold_4
18,608001,691000,82999,False,120,scaffold_4
19,695001,697000,1999,False,120,scaffold_4
20,701001,714000,12999,False,120,scaffold_4
21,1087001,1109000,21999,False,120,scaffold_4
22,1113001,1136000,22999,False,120,scaffold_4
23,1137001,1226000,88999,False,120,scaffold_4
24,1265001,1279000,13999,False,120,scaffold_4
25,1283001,1336000,52999,False,120,scaffold_4
26,1370001,1605000,234999,False,120,scaffold_4
27,1613001,2186000,572999,False,120,scaffold_4
28,2188001,2209000,20999,False,120,scaffold_4
29,2210001,2246000,35999,False,120,scaffold_4
30,2247001,2279000,31999,False,120,scaffold_4
31,2283001,2371000,87999,False,120,scaffold_4
32,2391001,2461000,69999,False,120,scaffold_4
33,2477001,2635000,157999,False,120,scaffold_4
34,2679001,2795000,115999,False,120,scaffold_4
35,2940001,2954000,13999,False,120,scaffold_4
36,3031001,3129000,97999,False,120,scaffold_4
37,3206001,3267000,60999,False,120,scaffold_4
38,3335001,3775000,439999,False,120,scaffold_4
39,4055001,4104000,48999,False,120,scaffold_4
40,4900001,5089000,188999,False,120,scaffold_4
41,5171001,5241000,69999,False,120,scaffold_4
42,5475001,5506000,30999,False,120,scaffold_4
43,5514001,5784000,269999,False,120,scaffold_4
44,5786001,5818000,31999,False,120,scaffold_4
45,6145001,6195000,49999,False,120,scaffold_4
46,6770001,6817000,46999,False,120,scaffold_4
47,6875001,6924000,48999,False,120,scaffold_4
48,6951001,6995000,43999,False,120,scaffold_4
49,7036001,7124000,87999,False,120,scaffold_4
50,7150001,7174000,23999,False,120,scaffold_4
51,7226001,7268000,41999,False,120,scaffold_4
52,7641001,7665000,23999,False,120,scaffold_4
53,8843001,9699000,855999,False,120,scaffold_4
54,9700001,9845951,145950,True,120,scaffold_4
0,1,5000,4999,True,120,scaffold_5
1,28001,32000,3999,False,120,scaffold_5
2,319001,401000,81999,False,120,scaffold_5
3,402001,428000,25999,False,120,scaffold_5
4,462001,524000,61999,False,120,scaffold_5
5,669001,696000,26999,False,120,scaffold_5
6,933001,947000,13999,False,120,scaffold_5
7,2081001,2104000,22999,False,120,scaffold_5
8,2475001,2498000,22999,False,120,scaffold_5
9,2508001,2515000,6999,False,120,scaffold_5
10,2516001,2528000,11999,False,120,scaffold_5
11,2545001,2874000,328999,False,120,scaffold_5
12,3132001,3199000,66999,False,120,scaffold_5
13,3217001,3519000,301999,False,120,scaffold_5
14,3616001,3659000,42999,False,120,scaffold_5
15,3962001,4101000,138999,False,120,scaffold_5
16,4120001,4322000,201999,False,120,scaffold_5
17,4444001,4553000,108999,False,120,scaffold_5
18,4595001,4751000,155999,False,120,scaffold_5
19,4752001,4924000,171999,False,120,scaffold_5
20,5260001,5273000,12999,False,120,scaffold_5
21,5286001,5312000,25999,False,120,scaffold_5
22,5314001,5345000,30999,False,120,scaffold_5
23,6393001,6420000,26999,False,120,scaffold_5
24,6454001,6653000,198999,False,120,scaffold_5
25,6886001,6906000,19999,False,120,scaffold_5
26,7406001,7439000,32999,False,120,scaffold_5
27,7454001,7514000,59999,False,120,scaffold_5
28,7559001,7661000,101999,False,120,scaffold_5
29,8554001,8616000,61999,False,120,scaffold_5
30,8658001,8686000,27999,False,120,scaffold_5
31,8711001,9364176,653175,True,120,scaffold_5
0,60001,75000,14999,False,120,scaffold_6
1,78001,85000,6999,False,120,scaffold_6
2,86001,116000,29999,False,120,scaffold_6
3,148001,210000,61999,False,120,scaffold_6
4,239001,255000,15999,False,120,scaffold_6
5,257001,325000,67999,False,120,scaffold_6
6,786001,802000,15999,False,120,scaffold_6
7,1147001,1266000,118999,False,120,scaffold_6
8,1284001,1303000,18999,False,120,scaffold_6
9,1478001,1547000,68999,False,120,scaffold_6
10,1658001,1684000,25999,False,120,scaffold_6
11,1837001,1906000,68999,False,120,scaffold_6
12,2026001,2104000,77999,False,120,scaffold_6
13,2128001,2196000,67999,False,120,scaffold_6
14,2236001,2283000,46999,False,120,scaffold_6
15,2335001,2595000,259999,False,120,scaffold_6
16,2596001,2654000,57999,False,120,scaffold_6
17,2659001,2691000,31999,False,120,scaffold_6
18,2711001,2872000,160999,False,120,scaffold_6
19,2934001,3031000,96999,False,120,scaffold_6
20,3073001,3203000,129999,False,120,scaffold_6
21,3222001,3350000,127999,False,120,scaffold_6
22,3351001,3795000,443999,False,120,scaffold_6
23,3898001,3913000,14999,False,120,scaffold_6
24,4018001,4072000,53999,False,120,scaffold_6
25,4073001,4195000,121999,False,120,scaffold_6
26,4838001,4869000,30999,False,120,scaffold_6
27,4954001,4996000,41999,False,120,scaffold_6
28,6006001,6063000,56999,False,120,scaffold_6
29,6124001,6190000,65999,False,120,scaffold_6
30,6774001,6804000,29999,False,120,scaffold_6
31,6836001,6857000,20999,False,120,scaffold_6
32,7185001,7338000,152999,False,120,scaffold_6
33,7388001,7440000,51999,False,120,scaffold_6
34,7550001,8268281,718280,True,120,scaffold_6
0,14001,31000,16999,False,120,scaffold_7
1,323001,340000,16999,False,120,scaffold_7
2,342001,508000,165999,False,120,scaffold_7
3,571001,576000,4999,False,120,scaffold_7
4,623001,642000,18999,False,120,scaffold_7
5,654001,736000,81999,False,120,scaffold_7
6,740001,753000,12999,False,120,scaffold_7
7,764001,843000,78999,False,120,scaffold_7
8,859001,864000,4999,False,120,scaffold_7
9,867001,945000,77999,False,120,scaffold_7
10,964001,966000,1999,False,120,scaffold_7
11,968001,1044000,75999,False,120,scaffold_7
12,1048001,1104000,55999,False,120,scaffold_7
13,1106001,1136000,29999,False,120,scaffold_7
14,1138001,1148000,9999,False,120,scaffold_7
15,1169001,1187000,17999,False,120,scaffold_7
16,1191001,1460000,268999,False,120,scaffold_7
17,1461001,1512000,50999,False,120,scaffold_7
18,1588001,1698000,109999,False,120,scaffold_7
19,1740001,1757000,16999,False,120,scaffold_7
20,1758001,1777000,18999,False,120,scaffold_7
21,1850001,1892000,41999,False,120,scaffold_7
22,2851001,2879000,27999,False,120,scaffold_7
23,3326001,3373000,46999,False,120,scaffold_7
24,3519001,3551000,31999,False,120,scaffold_7
25,3593001,3767000,173999,False,120,scaffold_7
26,4330001,4361000,30999,False,120,scaffold_7
27,4415001,4516000,100999,False,120,scaffold_7
28,4635001,4735000,99999,False,120,scaffold_7
29,4778001,4839000,60999,False,120,scaffold_7
30,4978001,5167000,188999,False,120,scaffold_7
31,5466001,5536000,69999,False,120,scaffold_7
32,5574001,5584000,9999,False,120,scaffold_7
33,5588001,5597000,8999,False,120,scaffold_7
34,6953001,7270000,316999,False,120,scaffold_7
35,7271001,7502216,231215,True,120,scaffold_7
0,1,7000,6999,True,120,scaffold_8
1,55001,85000,29999,False,120,scaffold_8
2,299001,304000,4999,False,120,scaffold_8
3,722001,725000,2999,False,120,scaffold_8
4,1875001,1931000,55999,False,120,scaffold_8
5,2414001,2471000,56999,False,120,scaffold_8
6,2490001,2552000,61999,False,120,scaffold_8
7,2650001,2757000,106999,False,120,scaffold_8
8,2798001,2844000,45999,False,120,scaffold_8
9,2847001,2876000,28999,False,120,scaffold_8
10,2946001,2967000,20999,False,120,scaffold_8
11,3025001,3526000,500999,False,120,scaffold_8
12,3583001,3938000,354999,False,120,scaffold_8
13,4038001,4108000,69999,False,120,scaffold_8
14,4173001,4221000,47999,False,120,scaffold_8
15,4400001,4432000,31999,False,120,scaffold_8
16,5086001,5137000,50999,False,120,scaffold_8
17,5164001,5241000,76999,False,120,scaffold_8
18,5579001,5596000,16999,False,120,scaffold_8
19,5651001,5694000,42999,False,120,scaffold_8
20,5760001,5774000,13999,False,120,scaffold_8
21,6320001,6334544,14543,True,120,scaffold_8
0,1,21000,20999,True,120,scaffold_9
1,109001,118000,8999,False,120,scaffold_9
2,303001,315000,11999,False,120,scaffold_9
3,319001,332000,12999,False,120,scaffold_9
4,366001,411000,44999,False,120,scaffold_9
5,413001,434000,20999,False,120,scaffold_9
6,484001,531000,46999,False,120,scaffold_9
7,547001,563000,15999,False,120,scaffold_9
8,660001,665000,4999,False,120,scaffold_9
9,671001,702000,30999,False,120,scaffold_9
10,733001,739000,5999,False,120,scaffold_9
11,815001,843000,27999,False,120,scaffold_9
12,850001,861000,10999,False,120,scaffold_9
13,883001,986000,102999,False,120,scaffold_9
14,988001,995000,6999,False,120,scaffold_9
15,1009001,1085000,75999,False,120,scaffold_9
16,1087001,1182000,94999,False,120,scaffold_9
17,1190001,1196000,5999,False,120,scaffold_9
18,1311001,1383000,71999,False,120,scaffold_9
19,1427001,1440000,12999,False,120,scaffold_9
20,1487001,1500000,12999,False,120,scaffold_9
21,1574001,1592000,17999,False,120,scaffold_9
22,1599001,1623000,23999,False,120,scaffold_9
23,1637001,1692000,54999,False,120,scaffold_9
24,1759001,1791000,31999,False,120,scaffold_9
25,1970001,2036000,65999,False,120,scaffold_9
26,2038001,2056000,17999,False,120,scaffold_9
27,2075001,2133000,57999,False,120,scaffold_9
28,2137001,2198000,60999,False,120,scaffold_9
29,2598001,2634000,35999,False,120,scaffold_9
30,2737001,3381000,643999,False,120,scaffold_9
31,3383001,5107000,1723999,False,120,scaffold_9
32,5112001,5238000,125999,False,120,scaffold_9
33,5239001,5298000,58999,False,120,scaffold_9
34,5299001,6331288,1032287,True,120,scaffold_9
0,1,236000,235999,True,120,scaffold_10
1,255001,414000,158999,False,120,scaffold_10
2,415001,482000,66999,False,120,scaffold_10
3,483001,584000,100999,False,120,scaffold_10
4,603001,797000,193999,False,120,scaffold_10
5,807001,840000,32999,False,120,scaffold_10
6,888001,963000,74999,False,120,scaffold_10
7,1043001,1069000,25999,False,120,scaffold_10
8,1073001,1149000,75999,False,120,scaffold_10
9,1877001,1908000,30999,False,120,scaffold_10
10,2086001,2103000,16999,False,120,scaffold_10
11,2144001,2172000,27999,False,120,scaffold_10
12,2268001,2325000,56999,False,120,scaffold_10
13,2338001,2471000,132999,False,120,scaffold_10
14,2600001,2657000,56999,False,120,scaffold_10
15,2672001,2700000,27999,False,120,scaffold_10
16,2702001,2745000,42999,False,120,scaffold_10
17,2919001,2928000,8999,False,120,scaffold_10
18,4002001,4011000,8999,False,120,scaffold_10
19,4050001,4092000,41999,False,120,scaffold_10
20,4142001,4148000,5999,False,120,scaffold_10
21,4154001,4174000,19999,False,120,scaffold_10
22,4334001,4359000,24999,False,120,scaffold_10
23,4443001,4462000,18999,False,120,scaffold_10
24,4465001,4502000,36999,False,120,scaffold_10
25,4503001,4513000,9999,False,120,scaffold_10
26,4515001,4548000,32999,False,120,scaffold_10
27,4565001,4596000,30999,False,120,scaffold_10
28,4734001,4776000,41999,False,120,scaffold_10
29,4798001,4824000,25999,False,120,scaffold_10
30,4828001,4843000,14999,False,120,scaffold_10
31,4848001,4861000,12999,False,120,scaffold_10
32,4862001,4866973,4972,True,120,scaffold_10
0,11001,92000,80999,False,120,scaffold_11
1,149001,167000,17999,False,120,scaffold_11
2,169001,191000,21999,False,120,scaffold_11
3,213001,235000,21999,False,120,scaffold_11
4,240001,253000,12999,False,120,scaffold_11
5,296001,319000,22999,False,120,scaffold_11
6,419001,431000,11999,False,120,scaffold_11
7,648001,656000,7999,False,120,scaffold_11
8,781001,785000,3999,False,120,scaffold_11
9,1025001,1034000,8999,False,120,scaffold_11
10,1403001,1409000,5999,False,120,scaffold_11
11,1423001,1427000,3999,False,120,scaffold_11
12,1474001,1477000,2999,False,120,scaffold_11
13,1873001,1883000,9999,False,120,scaffold_11
14,1992001,2059000,66999,False,120,scaffold_11
15,2701001,2878000,176999,False,120,scaffold_11
16,2957001,3011000,53999,False,120,scaffold_11
17,3089001,3143000,53999,False,120,scaffold_11
18,3185001,3297000,111999,False,120,scaffold_11
19,3310001,3383000,72999,False,120,scaffold_11
20,3425001,3482000,56999,False,120,scaffold_11
21,3520001,3969000,448999,False,120,scaffold_11
22,3995001,4163000,167999,False,120,scaffold_11
23,4182001,4710000,527999,False,120,scaffold_11
24,4713001,4766820,53819,True,120,scaffold_11
0,1,375000,374999,True,120,scaffold_12
1,403001,1499000,1095999,False,120,scaffold_12
2,1720001,1733000,12999,False,120,scaffold_12
3,1786001,1808000,21999,False,120,scaffold_12
4,1923001,1952000,28999,False,120,scaffold_12
5,1973001,1995000,21999,False,120,scaffold_12
6,2044001,2087000,42999,False,120,scaffold_12
7,2088001,2103000,14999,False,120,scaffold_12
8,2137001,2166000,28999,False,120,scaffold_12
9,2347001,2377000,29999,False,120,scaffold_12
10,2559001,2566000,6999,False,120,scaffold_12
11,2571001,2609000,37999,False,120,scaffold_12
12,2659001,2681000,21999,False,120,scaffold_12
13,2685001,2708000,22999,False,120,scaffold_12
0,1,342000,341999,True,121,scaffold_1
1,482001,498000,15999,False,121,scaffold_1
2,572001,643000,70999,False,121,scaffold_1
3,686001,743000,56999,False,121,scaffold_1
4,1274001,1292000,17999,False,121,scaffold_1
5,1618001,1660000,41999,False,121,scaffold_1
6,1812001,1898000,85999,False,121,scaffold_1
7,1916001,1984000,67999,False,121,scaffold_1
8,1986001,1993000,6999,False,121,scaffold_1
9,2363001,2412000,48999,False,121,scaffold_1
10,2449001,2528000,78999,False,121,scaffold_1
11,2729001,2746000,16999,False,121,scaffold_1
12,2991001,3020000,28999,False,121,scaffold_1
13,3173001,3212000,38999,False,121,scaffold_1
14,3443001,3499000,55999,False,121,scaffold_1
15,3714001,3758000,43999,False,121,scaffold_1
16,3767001,3877000,109999,False,121,scaffold_1
17,3902001,3941000,38999,False,121,scaffold_1
18,3960001,4031000,70999,False,121,scaffold_1
19,4062001,4117000,54999,False,121,scaffold_1
20,4314001,4355000,40999,False,121,scaffold_1
21,4796001,4814000,17999,False,121,scaffold_1
22,4927001,5022000,94999,False,121,scaffold_1
23,5087001,5110000,22999,False,121,scaffold_1
24,5481001,5512000,30999,False,121,scaffold_1
25,5535001,5593000,57999,False,121,scaffold_1
26,5856001,5911000,54999,False,121,scaffold_1
27,6108001,6381000,272999,False,121,scaffold_1
28,6382001,6566000,183999,False,121,scaffold_1
29,7038001,7247000,208999,False,121,scaffold_1
30,7248001,7583000,334999,False,121,scaffold_1
31,7590001,8477000,886999,False,121,scaffold_1
32,8478001,8656000,177999,False,121,scaffold_1
33,8658001,9584000,925999,False,121,scaffold_1
34,9586001,10368000,781999,False,121,scaffold_1
35,10448001,10639000,190999,False,121,scaffold_1
36,10736001,10763000,26999,False,121,scaffold_1
37,10835001,10857000,21999,False,121,scaffold_1
38,10920001,10966000,45999,False,121,scaffold_1
39,11015001,11029000,13999,False,121,scaffold_1
40,11281001,11307000,25999,False,121,scaffold_1
41,11308001,11510000,201999,False,121,scaffold_1
42,11557001,11963000,405999,False,121,scaffold_1
43,12184001,12243000,58999,False,121,scaffold_1
44,12636001,12723000,86999,False,121,scaffold_1
45,12775001,12950000,174999,False,121,scaffold_1
46,12965001,13002000,36999,False,121,scaffold_1
47,13113001,13216000,102999,False,121,scaffold_1
48,13346001,13433000,86999,False,121,scaffold_1
49,13517001,13538000,20999,False,121,scaffold_1
50,13571001,13582000,10999,False,121,scaffold_1
51,13811001,13845000,33999,False,121,scaffold_1
52,13913001,13927000,13999,False,121,scaffold_1
53,13928001,13941000,12999,False,121,scaffold_1
54,14025001,14062000,36999,False,121,scaffold_1
55,14290001,14313000,22999,False,121,scaffold_1
0,22001,48000,25999,False,121,scaffold_2
1,67001,91000,23999,False,121,scaffold_2
2,93001,159000,65999,False,121,scaffold_2
3,165001,177000,11999,False,121,scaffold_2
4,296001,318000,21999,False,121,scaffold_2
5,332001,374000,41999,False,121,scaffold_2
6,1287001,1305000,17999,False,121,scaffold_2
7,1689001,1714000,24999,False,121,scaffold_2
8,2083001,2107000,23999,False,121,scaffold_2
9,2319001,2334000,14999,False,121,scaffold_2
10,2336001,2386000,49999,False,121,scaffold_2
11,2397001,2609000,211999,False,121,scaffold_2
12,2626001,2639000,12999,False,121,scaffold_2
13,2645001,2689000,43999,False,121,scaffold_2
14,2694001,2746000,51999,False,121,scaffold_2
15,2820001,2855000,34999,False,121,scaffold_2
16,2878001,2906000,27999,False,121,scaffold_2
17,2974001,3021000,46999,False,121,scaffold_2
18,3022001,3059000,36999,False,121,scaffold_2
19,3450001,3488000,37999,False,121,scaffold_2
20,3754001,3787000,32999,False,121,scaffold_2
21,4243001,4277000,33999,False,121,scaffold_2
22,4382001,4409000,26999,False,121,scaffold_2
23,4425001,4457000,31999,False,121,scaffold_2
24,4511001,4656000,144999,False,121,scaffold_2
25,4783001,4790000,6999,False,121,scaffold_2
26,4917001,4950000,32999,False,121,scaffold_2
27,5021001,5104000,82999,False,121,scaffold_2
28,5285001,5314000,28999,False,121,scaffold_2
29,5369001,5395000,25999,False,121,scaffold_2
30,5445001,5538000,92999,False,121,scaffold_2
31,5658001,5761000,102999,False,121,scaffold_2
32,5840001,5887000,46999,False,121,scaffold_2
33,5915001,6054000,138999,False,121,scaffold_2
34,6261001,6351000,89999,False,121,scaffold_2
35,6390001,6451000,60999,False,121,scaffold_2
36,6574001,6628000,53999,False,121,scaffold_2
37,7002001,7037000,34999,False,121,scaffold_2
38,7050001,7097000,46999,False,121,scaffold_2
39,7438001,7473000,34999,False,121,scaffold_2
40,7491001,7518000,26999,False,121,scaffold_2
41,7545001,7561000,15999,False,121,scaffold_2
42,7563001,7727000,163999,False,121,scaffold_2
43,7786001,7926000,139999,False,121,scaffold_2
44,7933001,8320000,386999,False,121,scaffold_2
45,8331001,8333000,1999,False,121,scaffold_2
46,8335001,8344000,8999,False,121,scaffold_2
47,8346001,8454000,107999,False,121,scaffold_2
48,8495001,8564000,68999,False,121,scaffold_2
49,9140001,9168000,27999,False,121,scaffold_2
50,9601001,9636000,34999,False,121,scaffold_2
51,9672001,9697000,24999,False,121,scaffold_2
52,10710001,10730000,19999,False,121,scaffold_2
53,10995001,10998000,2999,False,121,scaffold_2
54,11367001,11377000,9999,False,121,scaffold_2
55,11394001,11425000,30999,False,121,scaffold_2
56,11520001,11786000,265999,False,121,scaffold_2
0,618001,646000,27999,False,121,scaffold_3
1,795001,900000,104999,False,121,scaffold_3
2,1939001,1980000,40999,False,121,scaffold_3
3,2010001,2108000,97999,False,121,scaffold_3
4,2109001,2116000,6999,False,121,scaffold_3
5,2291001,2336000,44999,False,121,scaffold_3
6,2487001,2533000,45999,False,121,scaffold_3
7,2623001,2750000,126999,False,121,scaffold_3
8,3110001,3135000,24999,False,121,scaffold_3
9,3136001,3145000,8999,False,121,scaffold_3
10,3768001,3891000,122999,False,121,scaffold_3
11,4108001,4403000,294999,False,121,scaffold_3
12,4410001,4519000,108999,False,121,scaffold_3
13,4547001,4558000,10999,False,121,scaffold_3
14,4614001,4686000,71999,False,121,scaffold_3
15,5157001,5196000,38999,False,121,scaffold_3
16,5239001,5265000,25999,False,121,scaffold_3
17,5493001,5509000,15999,False,121,scaffold_3
18,5863001,5939000,75999,False,121,scaffold_3
19,5990001,6024000,33999,False,121,scaffold_3
20,6741001,6787000,45999,False,121,scaffold_3
21,6910001,6962000,51999,False,121,scaffold_3
22,6979001,7093000,113999,False,121,scaffold_3
23,7371001,7396000,24999,False,121,scaffold_3
24,7432001,7445000,12999,False,121,scaffold_3
25,7483001,7556000,72999,False,121,scaffold_3
26,7676001,7842000,165999,False,121,scaffold_3
27,8037001,8070000,32999,False,121,scaffold_3
28,8092001,8102000,9999,False,121,scaffold_3
29,8134001,8156000,21999,False,121,scaffold_3
30,8175001,8253000,77999,False,121,scaffold_3
31,8401001,8527000,125999,False,121,scaffold_3
32,8575001,8593000,17999,False,121,scaffold_3
33,9001001,9077000,75999,False,121,scaffold_3
34,9968001,9995000,26999,False,121,scaffold_3
35,10065001,10087000,21999,False,121,scaffold_3
36,10461001,10485000,23999,False,121,scaffold_3
37,10551001,11182071,631070,True,121,scaffold_3
0,1,7000,6999,True,121,scaffold_4
1,11001,13000,1999,False,121,scaffold_4
2,14001,32000,17999,False,121,scaffold_4
3,48001,88000,39999,False,121,scaffold_4
4,147001,151000,3999,False,121,scaffold_4
5,155001,215000,59999,False,121,scaffold_4
6,217001,226000,8999,False,121,scaffold_4
7,227001,269000,41999,False,121,scaffold_4
8,285001,344000,58999,False,121,scaffold_4
9,346001,353000,6999,False,121,scaffold_4
10,355001,374000,18999,False,121,scaffold_4
11,390001,410000,19999,False,121,scaffold_4
12,412001,425000,12999,False,121,scaffold_4
13,429001,502000,72999,False,121,scaffold_4
14,539001,592000,52999,False,121,scaffold_4
15,593001,606000,12999,False,121,scaffold_4
16,608001,691000,82999,False,121,scaffold_4
17,700001,727000,26999,False,121,scaffold_4
18,1043001,1048000,4999,False,121,scaffold_4
19,1083001,1108000,24999,False,121,scaffold_4
20,1113001,1136000,22999,False,121,scaffold_4
21,1138001,1226000,87999,False,121,scaffold_4
22,1229001,1253000,23999,False,121,scaffold_4
23,1283001,1605000,321999,False,121,scaffold_4
24,1613001,2199000,585999,False,121,scaffold_4
25,2211001,2246000,34999,False,121,scaffold_4
26,2247001,2268000,20999,False,121,scaffold_4
27,2269001,2281000,11999,False,121,scaffold_4
28,2282001,2461000,178999,False,121,scaffold_4
29,2476001,2635000,158999,False,121,scaffold_4
30,2684001,2721000,36999,False,121,scaffold_4
31,2904001,2956000,51999,False,121,scaffold_4
32,3029001,3128000,98999,False,121,scaffold_4
33,3334001,3766000,431999,False,121,scaffold_4
34,4054001,4107000,52999,False,121,scaffold_4
35,4277001,4306000,28999,False,121,scaffold_4
36,4900001,5089000,188999,False,121,scaffold_4
37,5171001,5244000,72999,False,121,scaffold_4
38,5300001,5404000,103999,False,121,scaffold_4
39,5477001,5506000,28999,False,121,scaffold_4
40,5515001,5620000,104999,False,121,scaffold_4
41,5659001,5784000,124999,False,121,scaffold_4
42,5786001,5828000,41999,False,121,scaffold_4
43,6145001,6193000,47999,False,121,scaffold_4
44,6286001,6294000,7999,False,121,scaffold_4
45,6762001,6817000,54999,False,121,scaffold_4
46,6893001,6924000,30999,False,121,scaffold_4
47,6926001,7001000,74999,False,121,scaffold_4
48,7036001,7124000,87999,False,121,scaffold_4
49,7209001,7323000,113999,False,121,scaffold_4
50,7638001,7665000,26999,False,121,scaffold_4
51,7860001,7874000,13999,False,121,scaffold_4
52,8843001,9699000,855999,False,121,scaffold_4
53,9700001,9845951,145950,True,121,scaffold_4
0,28001,31000,2999,False,121,scaffold_5
1,139001,175000,35999,False,121,scaffold_5
2,186001,204000,17999,False,121,scaffold_5
3,318001,401000,82999,False,121,scaffold_5
4,402001,428000,25999,False,121,scaffold_5
5,434001,436000,1999,False,121,scaffold_5
6,443001,526000,82999,False,121,scaffold_5
7,669001,697000,27999,False,121,scaffold_5
8,836001,843000,6999,False,121,scaffold_5
9,933001,947000,13999,False,121,scaffold_5
10,2265001,2300000,34999,False,121,scaffold_5
11,2477001,2496000,18999,False,121,scaffold_5
12,2550001,2777000,226999,False,121,scaffold_5
13,2813001,2874000,60999,False,121,scaffold_5
14,3133001,3513000,379999,False,121,scaffold_5
15,3617001,3658000,40999,False,121,scaffold_5
16,3957001,4101000,143999,False,121,scaffold_5
17,4112001,4223000,110999,False,121,scaffold_5
18,4226001,4355000,128999,False,121,scaffold_5
19,4446001,4522000,75999,False,121,scaffold_5
20,4586001,4924000,337999,False,121,scaffold_5
21,5056001,5087000,30999,False,121,scaffold_5
22,5249001,5274000,24999,False,121,scaffold_5
23,5281001,5312000,30999,False,121,scaffold_5
24,5313001,5344000,30999,False,121,scaffold_5
25,6408001,6438000,29999,False,121,scaffold_5
26,6455001,6680000,224999,False,121,scaffold_5
27,6770001,6786000,15999,False,121,scaffold_5
28,6889001,6905000,15999,False,121,scaffold_5
29,7174001,7203000,28999,False,121,scaffold_5
30,7406001,7441000,34999,False,121,scaffold_5
31,7454001,7483000,28999,False,121,scaffold_5
32,7571001,7610000,38999,False,121,scaffold_5
33,7622001,7656000,33999,False,121,scaffold_5
34,7694001,7747000,52999,False,121,scaffold_5
35,8412001,8470000,57999,False,121,scaffold_5
36,8548001,8616000,67999,False,121,scaffold_5
37,8639001,8689000,49999,False,121,scaffold_5
38,8712001,9364176,652175,True,121,scaffold_5
0,65001,75000,9999,False,121,scaffold_6
1,79001,85000,5999,False,121,scaffold_6
2,86001,121000,34999,False,121,scaffold_6
3,149001,208000,58999,False,121,scaffold_6
4,240001,254000,13999,False,121,scaffold_6
5,256001,261000,4999,False,121,scaffold_6
6,267001,318000,50999,False,121,scaffold_6
7,466001,485000,18999,False,121,scaffold_6
8,553001,566000,12999,False,121,scaffold_6
9,1147001,1226000,78999,False,121,scaffold_6
10,1229001,1310000,80999,False,121,scaffold_6
11,1430001,1548000,117999,False,121,scaffold_6
12,1561001,1595000,33999,False,121,scaffold_6
13,1657001,1712000,54999,False,121,scaffold_6
14,1844001,1901000,56999,False,121,scaffold_6
15,2023001,2104000,80999,False,121,scaffold_6
16,2129001,2209000,79999,False,121,scaffold_6
17,2243001,2281000,37999,False,121,scaffold_6
18,2335001,2872000,536999,False,121,scaffold_6
19,2927001,3014000,86999,False,121,scaffold_6
20,3080001,3178000,97999,False,121,scaffold_6
21,3222001,3333000,110999,False,121,scaffold_6
22,3381001,3795000,413999,False,121,scaffold_6
23,3882001,3913000,30999,False,121,scaffold_6
24,3965001,4197000,231999,False,121,scaffold_6
25,4835001,4872000,36999,False,121,scaffold_6
26,5553001,5647000,93999,False,121,scaffold_6
27,5909001,5969000,59999,False,121,scaffold_6
28,6002001,6082000,79999,False,121,scaffold_6
29,6136001,6196000,59999,False,121,scaffold_6
30,6782001,6803000,20999,False,121,scaffold_6
31,7185001,7337000,151999,False,121,scaffold_6
32,7390001,7476000,85999,False,121,scaffold_6
33,7549001,8268281,719280,True,121,scaffold_6
0,1,9000,8999,True,121,scaffold_7
1,13001,34000,20999,False,121,scaffold_7
2,304001,340000,35999,False,121,scaffold_7
3,342001,508000,165999,False,121,scaffold_7
4,650001,753000,102999,False,121,scaffold_7
5,764001,826000,61999,False,121,scaffold_7
6,859001,864000,4999,False,121,scaffold_7
7,865001,901000,35999,False,121,scaffold_7
8,964001,966000,1999,False,121,scaffold_7
9,968001,980000,11999,False,121,scaffold_7
10,982001,1044000,61999,False,121,scaffold_7
11,1048001,1119000,70999,False,121,scaffold_7
12,1160001,1512000,351999,False,121,scaffold_7
13,1588001,1696000,107999,False,121,scaffold_7
14,1725001,1782000,56999,False,121,scaffold_7
15,1995001,2012000,16999,False,121,scaffold_7
16,3297001,3371000,73999,False,121,scaffold_7
17,3523001,3767000,243999,False,121,scaffold_7
18,4333001,4361000,27999,False,121,scaffold_7
19,4415001,4517000,101999,False,121,scaffold_7
20,4658001,4734000,75999,False,121,scaffold_7
21,4978001,5167000,188999,False,121,scaffold_7
22,5466001,5536000,69999,False,121,scaffold_7
23,6765001,6794000,28999,False,121,scaffold_7
24,6953001,7270000,316999,False,121,scaffold_7
25,7271001,7502216,231215,True,121,scaffold_7
0,1,6000,5999,True,121,scaffold_8
1,66001,85000,18999,False,121,scaffold_8
2,92001,102000,9999,False,121,scaffold_8
3,299001,304000,4999,False,121,scaffold_8
4,1906001,1926000,19999,False,121,scaffold_8
5,2360001,2587000,226999,False,121,scaffold_8
6,2650001,2683000,32999,False,121,scaffold_8
7,2684001,2844000,159999,False,121,scaffold_8
8,3035001,3556000,520999,False,121,scaffold_8
9,3584001,3612000,27999,False,121,scaffold_8
10,3615001,3950000,334999,False,121,scaffold_8
11,4039001,4107000,67999,False,121,scaffold_8
12,4169001,4221000,51999,False,121,scaffold_8
13,4397001,4434000,36999,False,121,scaffold_8
14,4629001,4668000,38999,False,121,scaffold_8
15,4898001,4915000,16999,False,121,scaffold_8
16,5095001,5137000,41999,False,121,scaffold_8
17,5170001,5241000,70999,False,121,scaffold_8
18,5527001,5597000,69999,False,121,scaffold_8
19,5651001,5692000,40999,False,121,scaffold_8
20,5760001,5772000,11999,False,121,scaffold_8
21,6322001,6334544,12543,True,121,scaffold_8
0,1,22000,21999,True,121,scaffold_9
1,109001,119000,9999,False,121,scaffold_9
2,121001,143000,21999,False,121,scaffold_9
3,236001,243000,6999,False,121,scaffold_9
4,366001,411000,44999,False,121,scaffold_9
5,413001,434000,20999,False,121,scaffold_9
6,468001,531000,62999,False,121,scaffold_9
7,547001,564000,16999,False,121,scaffold_9
8,653001,665000,11999,False,121,scaffold_9
9,671001,710000,38999,False,121,scaffold_9
10,730001,742000,11999,False,121,scaffold_9
11,814001,847000,32999,False,121,scaffold_9
12,850001,859000,8999,False,121,scaffold_9
13,874001,986000,111999,False,121,scaffold_9
14,987001,995000,7999,False,121,scaffold_9
15,1009001,1031000,21999,False,121,scaffold_9
16,1036001,1085000,48999,False,121,scaffold_9
17,1087001,1177000,89999,False,121,scaffold_9
18,1202001,1230000,27999,False,121,scaffold_9
19,1312001,1383000,70999,False,121,scaffold_9
20,1457001,1464000,6999,False,121,scaffold_9
21,1487001,1499000,11999,False,121,scaffold_9
22,1550001,1585000,34999,False,121,scaffold_9
23,1749001,1792000,42999,False,121,scaffold_9
24,1987001,2062000,74999,False,121,scaffold_9
25,2076001,2132000,55999,False,121,scaffold_9
26,2598001,2633000,34999,False,121,scaffold_9
27,2737001,3381000,643999,False,121,scaffold_9
28,3383001,5107000,1723999,False,121,scaffold_9
29,5112001,5115000,2999,False,121,scaffold_9
30,5116001,5238000,121999,False,121,scaffold_9
31,5239001,5298000,58999,False,121,scaffold_9
32,5299001,5490000,190999,False,121,scaffold_9
33,5492001,6331288,839287,True,121,scaffold_9
0,1,235000,234999,True,121,scaffold_10
1,258001,414000,155999,False,121,scaffold_10
2,415001,482000,66999,False,121,scaffold_10
3,483001,582000,98999,False,121,scaffold_10
4,602001,877000,274999,False,121,scaffold_10
5,888001,990000,101999,False,121,scaffold_10
6,1073001,1145000,71999,False,121,scaffold_10
7,1373001,1473000,99999,False,121,scaffold_10
8,2078001,2103000,24999,False,121,scaffold_10
9,2136001,2180000,43999,False,121,scaffold_10
10,2268001,2308000,39999,False,121,scaffold_10
11,2346001,2451000,104999,False,121,scaffold_10
12,2453001,2467000,13999,False,121,scaffold_10
13,2563001,2583000,19999,False,121,scaffold_10
14,2600001,2650000,49999,False,121,scaffold_10
15,2839001,2861000,21999,False,121,scaffold_10
16,4051001,4093000,41999,False,121,scaffold_10
17,4154001,4174000,19999,False,121,scaffold_10
18,4334001,4371000,36999,False,121,scaffold_10
19,4443001,4462000,18999,False,121,scaffold_10
20,4467001,4491000,23999,False,121,scaffold_10
21,4493001,4513000,19999,False,121,scaffold_10
22,4515001,4523000,7999,False,121,scaffold_10
23,4526001,4548000,21999,False,121,scaffold_10
24,4554001,4562000,7999,False,121,scaffold_10
25,4565001,4596000,30999,False,121,scaffold_10
26,4734001,4776000,41999,False,121,scaffold_10
27,4798001,4824000,25999,False,121,scaffold_10
28,4828001,4843000,14999,False,121,scaffold_10
29,4848001,4861000,12999,False,121,scaffold_10
30,4865001,4866973,1972,True,121,scaffold_10
0,12001,93000,80999,False,121,scaffold_11
1,132001,167000,34999,False,121,scaffold_11
2,169001,212000,42999,False,121,scaffold_11
3,213001,235000,21999,False,121,scaffold_11
4,240001,251000,10999,False,121,scaffold_11
5,296001,327000,30999,False,121,scaffold_11
6,419001,431000,11999,False,121,scaffold_11
7,637001,657000,19999,False,121,scaffold_11
8,1219001,1241000,21999,False,121,scaffold_11
9,1316001,1337000,20999,False,121,scaffold_11
10,1423001,1426000,2999,False,121,scaffold_11
11,1863001,1869000,5999,False,121,scaffold_11
12,2010001,2034000,23999,False,121,scaffold_11
13,2035001,2050000,14999,False,121,scaffold_11
14,2701001,2877000,175999,False,121,scaffold_11
15,2978001,3014000,35999,False,121,scaffold_11
16,3083001,3159000,75999,False,121,scaffold_11
17,3185001,3325000,139999,False,121,scaffold_11
18,3327001,3383000,55999,False,121,scaffold_11
19,3433001,3479000,45999,False,121,scaffold_11
20,3525001,3682000,156999,False,121,scaffold_11
21,3702001,4159000,456999,False,121,scaffold_11
22,4182001,4710000,527999,False,121,scaffold_11
23,4713001,4766820,53819,True,121,scaffold_11
0,1,1501000,1500999,True,121,scaffold_12
1,1717001,1747000,29999,False,121,scaffold_12
2,2044001,2103000,58999,False,121,scaffold_12
3,2137001,2177000,39999,False,121,scaffold_12
4,2571001,2618000,46999,False,121,scaffold_12
5,2659001,2682000,22999,False,121,scaffold_12
6,2685001,2699000,13999,False,121,scaffold_12
0,1,342000,341999,True,122,scaffold_1
1,482001,498000,15999,False,122,scaffold_1
2,571001,643000,71999,False,122,scaffold_1
3,686001,743000,56999,False,122,scaffold_1
4,1281001,1292000,10999,False,122,scaffold_1
5,1823001,1899000,75999,False,122,scaffold_1
6,1951001,1964000,12999,False,122,scaffold_1
7,1965001,1984000,18999,False,122,scaffold_1
8,2449001,2517000,67999,False,122,scaffold_1
9,2725001,2746000,20999,False,122,scaffold_1
10,3179001,3209000,29999,False,122,scaffold_1
11,3592001,3623000,30999,False,122,scaffold_1
12,3705001,3756000,50999,False,122,scaffold_1
13,3902001,3941000,38999,False,122,scaffold_1
14,3991001,4027000,35999,False,122,scaffold_1
15,4060001,4110000,49999,False,122,scaffold_1
16,4314001,4355000,40999,False,122,scaffold_1
17,4796001,4810000,13999,False,122,scaffold_1
18,4927001,5027000,99999,False,122,scaffold_1
19,5087001,5115000,27999,False,122,scaffold_1
20,5481001,5521000,39999,False,122,scaffold_1
21,5536001,5570000,33999,False,122,scaffold_1
22,5858001,5871000,12999,False,122,scaffold_1
23,6108001,6177000,68999,False,122,scaffold_1
24,6204001,6381000,176999,False,122,scaffold_1
25,6384001,6567000,182999,False,122,scaffold_1
26,7037001,7247000,209999,False,122,scaffold_1
27,7248001,7583000,334999,False,122,scaffold_1
28,7590001,8656000,1065999,False,122,scaffold_1
29,8658001,9584000,925999,False,122,scaffold_1
30,9586001,10355000,768999,False,122,scaffold_1
31,10461001,10640000,178999,False,122,scaffold_1
32,11344001,11509000,164999,False,122,scaffold_1
33,11551001,11964000,412999,False,122,scaffold_1
34,12184001,12203000,18999,False,122,scaffold_1
35,12652001,12723000,70999,False,122,scaffold_1
36,12777001,12888000,110999,False,122,scaffold_1
37,12970001,13002000,31999,False,122,scaffold_1
38,13101001,13170000,68999,False,122,scaffold_1
39,13181001,13214000,32999,False,122,scaffold_1
40,13346001,13404000,57999,False,122,scaffold_1
41,13564001,13583000,18999,False,122,scaffold_1
42,14605001,14609000,3999,False,122,scaffold_1
0,22001,48000,25999,False,122,scaffold_2
1,95001,159000,63999,False,122,scaffold_2
2,168001,177000,8999,False,122,scaffold_2
3,303001,318000,14999,False,122,scaffold_2
4,333001,374000,40999,False,122,scaffold_2
5,732001,739000,6999,False,122,scaffold_2
6,2336001,2366000,29999,False,122,scaffold_2
7,2404001,2553000,148999,False,122,scaffold_2
8,2660001,2689000,28999,False,122,scaffold_2
9,2694001,2742000,47999,False,122,scaffold_2
10,2819001,2855000,35999,False,122,scaffold_2
11,3361001,3390000,28999,False,122,scaffold_2
12,3757001,3783000,25999,False,122,scaffold_2
13,4383001,4409000,25999,False,122,scaffold_2
14,4426001,4458000,31999,False,122,scaffold_2
15,4512001,4659000,146999,False,122,scaffold_2
16,4783001,4790000,6999,False,122,scaffold_2
17,4793001,4807000,13999,False,122,scaffold_2
18,4918001,4951000,32999,False,122,scaffold_2
19,5021001,5104000,82999,False,122,scaffold_2
20,5375001,5392000,16999,False,122,scaffold_2
21,5414001,5481000,66999,False,122,scaffold_2
22,5491001,5515000,23999,False,122,scaffold_2
23,5658001,5756000,97999,False,122,scaffold_2
24,5840001,5888000,47999,False,122,scaffold_2
25,6261001,6330000,68999,False,122,scaffold_2
26,6331001,6350000,18999,False,122,scaffold_2
27,6427001,6449000,21999,False,122,scaffold_2
28,6591001,6628000,36999,False,122,scaffold_2
29,6833001,6861000,27999,False,122,scaffold_2
30,7006001,7036000,29999,False,122,scaffold_2
31,7064001,7115000,50999,False,122,scaffold_2
32,7345001,7473000,127999,False,122,scaffold_2
33,7491001,7504000,12999,False,122,scaffold_2
34,7563001,7697000,133999,False,122,scaffold_2
35,7779001,7891000,111999,False,122,scaffold_2
36,7934001,8161000,226999,False,122,scaffold_2
37,8261001,8313000,51999,False,122,scaffold_2
38,8335001,8345000,9999,False,122,scaffold_2
39,8346001,8453000,106999,False,122,scaffold_2
40,8509001,8562000,52999,False,122,scaffold_2
41,9028001,9051000,22999,False,122,scaffold_2
42,9159001,9165000,5999,False,122,scaffold_2
43,11519001,11786000,266999,False,122,scaffold_2
0,10001,16000,5999,False,122,scaffold_3
1,51001,54000,2999,False,122,scaffold_3
2,528001,539000,10999,False,122,scaffold_3
3,540001,548000,7999,False,122,scaffold_3
4,618001,646000,27999,False,122,scaffold_3
5,798001,901000,102999,False,122,scaffold_3
6,2020001,2108000,87999,False,122,scaffold_3
7,2290001,2334000,43999,False,122,scaffold_3
8,2487001,2531000,43999,False,122,scaffold_3
9,3765001,3891000,125999,False,122,scaffold_3
10,4108001,4396000,287999,False,122,scaffold_3
11,4418001,4518000,99999,False,122,scaffold_3
12,4546001,4559000,12999,False,122,scaffold_3
13,4652001,4685000,32999,False,122,scaffold_3
14,5494001,5509000,14999,False,122,scaffold_3
15,5990001,6019000,28999,False,122,scaffold_3
16,6738001,6783000,44999,False,122,scaffold_3
17,6893001,6962000,68999,False,122,scaffold_3
18,6980001,7084000,103999,False,122,scaffold_3
19,7143001,7157000,13999,False,122,scaffold_3
20,7256001,7300000,43999,False,122,scaffold_3
21,7337001,7398000,60999,False,122,scaffold_3
22,7522001,7556000,33999,False,122,scaffold_3
23,7692001,7849000,156999,False,122,scaffold_3
24,8082001,8115000,32999,False,122,scaffold_3
25,8121001,8156000,34999,False,122,scaffold_3
26,8177001,8253000,75999,False,122,scaffold_3
27,8428001,8527000,98999,False,122,scaffold_3
28,8575001,8594000,18999,False,122,scaffold_3
29,8605001,8627000,21999,False,122,scaffold_3
30,9968001,10000000,31999,False,122,scaffold_3
31,10461001,10483000,21999,False,122,scaffold_3
32,10587001,11165000,577999,False,122,scaffold_3
0,17001,32000,14999,False,122,scaffold_4
1,48001,88000,39999,False,122,scaffold_4
2,136001,151000,14999,False,122,scaffold_4
3,161001,215000,53999,False,122,scaffold_4
4,217001,226000,8999,False,122,scaffold_4
5,227001,266000,38999,False,122,scaffold_4
6,289001,307000,17999,False,122,scaffold_4
7,318001,353000,34999,False,122,scaffold_4
8,355001,374000,18999,False,122,scaffold_4
9,375001,380000,4999,False,122,scaffold_4
10,412001,425000,12999,False,122,scaffold_4
11,429001,505000,75999,False,122,scaffold_4
12,545001,592000,46999,False,122,scaffold_4
13,593001,599000,5999,False,122,scaffold_4
14,608001,691000,82999,False,122,scaffold_4
15,701001,714000,12999,False,122,scaffold_4
16,1120001,1136000,15999,False,122,scaffold_4
17,1137001,1178000,40999,False,122,scaffold_4
18,1201001,1208000,6999,False,122,scaffold_4
19,1210001,1226000,15999,False,122,scaffold_4
20,1254001,1262000,7999,False,122,scaffold_4
21,1265001,1279000,13999,False,122,scaffold_4
22,1283001,1336000,52999,False,122,scaffold_4
23,1372001,1597000,224999,False,122,scaffold_4
24,1613001,1868000,254999,False,122,scaffold_4
25,1887001,2000000,112999,False,122,scaffold_4
26,2037001,2065000,27999,False,122,scaffold_4
27,2247001,2268000,20999,False,122,scaffold_4
28,2269001,2279000,9999,False,122,scaffold_4
29,2284001,2310000,25999,False,122,scaffold_4
30,2312001,2339000,26999,False,122,scaffold_4
31,2480001,2635000,154999,False,122,scaffold_4
32,3336001,3633000,296999,False,122,scaffold_4
33,3645001,3766000,120999,False,122,scaffold_4
34,4900001,5001000,100999,False,122,scaffold_4
35,5027001,5047000,19999,False,122,scaffold_4
36,5170001,5224000,53999,False,122,scaffold_4
37,5341001,5407000,65999,False,122,scaffold_4
38,5477001,5506000,28999,False,122,scaffold_4
39,5514001,5784000,269999,False,122,scaffold_4
40,5786001,5824000,37999,False,122,scaffold_4
41,6145001,6194000,48999,False,122,scaffold_4
42,6770001,6788000,17999,False,122,scaffold_4
43,6789001,6817000,27999,False,122,scaffold_4
44,6969001,6995000,25999,False,122,scaffold_4
45,7036001,7124000,87999,False,122,scaffold_4
46,7225001,7324000,98999,False,122,scaffold_4
47,7985001,7998000,12999,False,122,scaffold_4
48,8846001,9699000,852999,False,122,scaffold_4
49,9700001,9845951,145950,True,122,scaffold_4
0,1,4000,3999,True,122,scaffold_5
1,141001,174000,32999,False,122,scaffold_5
2,189001,204000,14999,False,122,scaffold_5
3,296001,300000,3999,False,122,scaffold_5
4,318001,386000,67999,False,122,scaffold_5
5,460001,523000,62999,False,122,scaffold_5
6,933001,947000,13999,False,122,scaffold_5
7,2475001,2493000,17999,False,122,scaffold_5
8,2565001,2738000,172999,False,122,scaffold_5
9,2816001,2871000,54999,False,122,scaffold_5
10,3133001,3186000,52999,False,122,scaffold_5
11,3217001,3258000,40999,False,122,scaffold_5
12,3279001,3512000,232999,False,122,scaffold_5
13,3621001,3658000,36999,False,122,scaffold_5
14,3962001,4101000,138999,False,122,scaffold_5
15,4119001,4222000,102999,False,122,scaffold_5
16,4227001,4275000,47999,False,122,scaffold_5
17,4446001,4504000,57999,False,122,scaffold_5
18,4603001,4681000,77999,False,122,scaffold_5
19,4690001,4720000,29999,False,122,scaffold_5
20,4789001,4857000,67999,False,122,scaffold_5
21,4904001,4917000,12999,False,122,scaffold_5
22,4973001,4989000,15999,False,122,scaffold_5
23,5287001,5312000,24999,False,122,scaffold_5
24,5314001,5346000,31999,False,122,scaffold_5
25,6406001,6436000,29999,False,122,scaffold_5
26,6506001,6653000,146999,False,122,scaffold_5
27,7406001,7441000,34999,False,122,scaffold_5
28,7454001,7483000,28999,False,122,scaffold_5
29,7559001,7654000,94999,False,122,scaffold_5
30,8434001,8473000,38999,False,122,scaffold_5
31,8559001,8616000,56999,False,122,scaffold_5
32,8702001,9364176,662175,True,122,scaffold_5
0,78001,84000,5999,False,122,scaffold_6
1,86001,114000,27999,False,122,scaffold_6
2,165001,209000,43999,False,122,scaffold_6
3,241001,253000,11999,False,122,scaffold_6
4,268001,296000,27999,False,122,scaffold_6
5,1236001,1262000,25999,False,122,scaffold_6
6,1478001,1546000,67999,False,122,scaffold_6
7,1844001,1906000,61999,False,122,scaffold_6
8,2023001,2086000,62999,False,122,scaffold_6
9,2132001,2168000,35999,False,122,scaffold_6
10,2336001,2595000,258999,False,122,scaffold_6
11,2596001,2653000,56999,False,122,scaffold_6
12,2655001,2691000,35999,False,122,scaffold_6
13,2731001,2864000,132999,False,122,scaffold_6
14,2927001,3016000,88999,False,122,scaffold_6
15,3081001,3191000,109999,False,122,scaffold_6
16,3223001,3315000,91999,False,122,scaffold_6
17,3401001,3806000,404999,False,122,scaffold_6
18,3882001,3913000,30999,False,122,scaffold_6
19,4018001,4072000,53999,False,122,scaffold_6
20,4073001,4195000,121999,False,122,scaffold_6
21,5945001,5969000,23999,False,122,scaffold_6
22,6010001,6082000,71999,False,122,scaffold_6
23,6776001,6803000,26999,False,122,scaffold_6
24,7263001,7337000,73999,False,122,scaffold_6
25,7382001,7436000,53999,False,122,scaffold_6
26,7550001,8268281,718280,True,122,scaffold_6
0,1,7000,6999,True,122,scaffold_7
1,13001,34000,20999,False,122,scaffold_7
2,323001,340000,16999,False,122,scaffold_7
3,342001,508000,165999,False,122,scaffold_7
4,571001,577000,5999,False,122,scaffold_7
5,706001,753000,46999,False,122,scaffold_7
6,764001,829000,64999,False,122,scaffold_7
7,830001,843000,12999,False,122,scaffold_7
8,859001,864000,4999,False,122,scaffold_7
9,868001,872000,3999,False,122,scaffold_7
10,875001,929000,53999,False,122,scaffold_7
11,988001,1044000,55999,False,122,scaffold_7
12,1057001,1080000,22999,False,122,scaffold_7
13,1191001,1512000,320999,False,122,scaffold_7
14,1588001,1689000,100999,False,122,scaffold_7
15,3326001,3370000,43999,False,122,scaffold_7
16,3521001,3807000,285999,False,122,scaffold_7
17,3922001,3926000,3999,False,122,scaffold_7
18,4415001,4517000,101999,False,122,scaffold_7
19,4550001,4595000,44999,False,122,scaffold_7
20,4630001,4819000,188999,False,122,scaffold_7
21,4979001,5149000,169999,False,122,scaffold_7
22,5473001,5536000,62999,False,122,scaffold_7
23,6954001,7270000,315999,False,122,scaffold_7
24,7271001,7502216,231215,True,122,scaffold_7
0,67001,87000,19999,False,122,scaffold_8
1,722001,724000,1999,False,122,scaffold_8
2,1908001,1930000,21999,False,122,scaffold_8
3,2361001,2376000,14999,False,122,scaffold_8
4,2444001,2530000,85999,False,122,scaffold_8
5,2652001,2683000,30999,False,122,scaffold_8
6,2740001,2757000,16999,False,122,scaffold_8
7,2798001,2844000,45999,False,122,scaffold_8
8,3058001,3525000,466999,False,122,scaffold_8
9,3577001,3612000,34999,False,122,scaffold_8
10,3615001,3950000,334999,False,122,scaffold_8
11,4016001,4099000,82999,False,122,scaffold_8
12,4206001,4221000,14999,False,122,scaffold_8
13,5124001,5135000,10999,False,122,scaffold_8
14,5163001,5241000,77999,False,122,scaffold_8
15,5579001,5595000,15999,False,122,scaffold_8
16,6329001,6334544,5543,True,122,scaffold_8
0,1,20000,19999,True,122,scaffold_9
1,109001,117000,7999,False,122,scaffold_9
2,121001,138000,16999,False,122,scaffold_9
3,366001,411000,44999,False,122,scaffold_9
4,413001,434000,20999,False,122,scaffold_9
5,501001,531000,29999,False,122,scaffold_9
6,548001,561000,12999,False,122,scaffold_9
7,671001,696000,24999,False,122,scaffold_9
8,731001,741000,9999,False,122,scaffold_9
9,814001,842000,27999,False,122,scaffold_9
10,850001,860000,9999,False,122,scaffold_9
11,886001,986000,99999,False,122,scaffold_9
12,988001,995000,6999,False,122,scaffold_9
13,1010001,1031000,20999,False,122,scaffold_9
14,1036001,1085000,48999,False,122,scaffold_9
15,1087001,1150000,62999,False,122,scaffold_9
16,1151001,1164000,12999,False,122,scaffold_9
17,1311001,1377000,65999,False,122,scaffold_9
18,1767001,1809000,41999,False,122,scaffold_9
19,2601001,2616000,14999,False,122,scaffold_9
20,2737001,2821000,83999,False,122,scaffold_9
21,2872001,3381000,508999,False,122,scaffold_9
22,3383001,5107000,1723999,False,122,scaffold_9
23,5112001,5115000,2999,False,122,scaffold_9
24,5116001,5238000,121999,False,122,scaffold_9
25,5239001,5298000,58999,False,122,scaffold_9
26,5300001,5490000,189999,False,122,scaffold_9
27,5493001,6331288,838287,True,122,scaffold_9
0,1,199000,198999,True,122,scaffold_10
1,370001,414000,43999,False,122,scaffold_10
2,415001,482000,66999,False,122,scaffold_10
3,483001,576000,92999,False,122,scaffold_10
4,603001,757000,153999,False,122,scaffold_10
5,780001,794000,13999,False,122,scaffold_10
6,888001,917000,28999,False,122,scaffold_10
7,924001,963000,38999,False,122,scaffold_10
8,1073001,1144000,70999,False,122,scaffold_10
9,2088001,2103000,14999,False,122,scaffold_10
10,2346001,2392000,45999,False,122,scaffold_10
11,4002001,4005000,2999,False,122,scaffold_10
12,4053001,4092000,38999,False,122,scaffold_10
13,4154001,4174000,19999,False,122,scaffold_10
14,4316001,4324000,7999,False,122,scaffold_10
15,4467001,4513000,45999,False,122,scaffold_10
16,4515001,4523000,7999,False,122,scaffold_10
17,4526001,4548000,21999,False,122,scaffold_10
18,4574001,4597000,22999,False,122,scaffold_10
19,4734001,4751000,16999,False,122,scaffold_10
20,4752001,4776000,23999,False,122,scaffold_10
21,4798001,4824000,25999,False,122,scaffold_10
22,4827001,4843000,15999,False,122,scaffold_10
23,4848001,4861000,12999,False,122,scaffold_10
24,4865001,4866973,1972,True,122,scaffold_10
0,10001,34000,23999,False,122,scaffold_11
1,40001,91000,50999,False,122,scaffold_11
2,149001,168000,18999,False,122,scaffold_11
3,169001,191000,21999,False,122,scaffold_11
4,213001,235000,21999,False,122,scaffold_11
5,240001,249000,8999,False,122,scaffold_11
6,296001,320000,23999,False,122,scaffold_11
7,419001,431000,11999,False,122,scaffold_11
8,648001,656000,7999,False,122,scaffold_11
9,781001,785000,3999,False,122,scaffold_11
10,1025001,1034000,8999,False,122,scaffold_11
11,1423001,1426000,2999,False,122,scaffold_11
12,2701001,2873000,171999,False,122,scaffold_11
13,2982001,3012000,29999,False,122,scaffold_11
14,3092001,3148000,55999,False,122,scaffold_11
15,3188001,3293000,104999,False,122,scaffold_11
16,3331001,3383000,51999,False,122,scaffold_11
17,3703001,3927000,223999,False,122,scaffold_11
18,4009001,4160000,150999,False,122,scaffold_11
19,4317001,4710000,392999,False,122,scaffold_11
20,4713001,4766820,53819,True,122,scaffold_11
0,1,856000,855999,True,122,scaffold_12
1,865001,1427000,561999,False,122,scaffold_12
2,1720001,1733000,12999,False,122,scaffold_12
3,2571001,2610000,38999,False,122,scaffold_12
4,2672001,2682000,9999,False,122,scaffold_12
0,1,392000,391999,True,123,scaffold_1
1,482001,498000,15999,False,123,scaffold_1
2,574001,643000,68999,False,123,scaffold_1
3,686001,756000,69999,False,123,scaffold_1
4,1176001,1196000,19999,False,123,scaffold_1
5,1265001,1292000,26999,False,123,scaffold_1
6,1817001,1899000,81999,False,123,scaffold_1
7,1950001,2017000,66999,False,123,scaffold_1
8,2346001,2413000,66999,False,123,scaffold_1
9,2449001,2517000,67999,False,123,scaffold_1
10,2563001,2621000,57999,False,123,scaffold_1
11,2722001,2775000,52999,False,123,scaffold_1
12,2877001,2929000,51999,False,123,scaffold_1
13,2960001,3018000,57999,False,123,scaffold_1
14,3047001,3063000,15999,False,123,scaffold_1
15,3179001,3209000,29999,False,123,scaffold_1
16,3446001,3624000,177999,False,123,scaffold_1
17,3701001,3879000,177999,False,123,scaffold_1
18,3901001,3941000,39999,False,123,scaffold_1
19,3942001,4059000,116999,False,123,scaffold_1
20,4060001,4155000,94999,False,123,scaffold_1
21,4304001,4354000,49999,False,123,scaffold_1
22,4719001,4790000,70999,False,123,scaffold_1
23,4796001,4814000,17999,False,123,scaffold_1
24,4927001,5031000,103999,False,123,scaffold_1
25,5051001,5065000,13999,False,123,scaffold_1
26,5087001,5116000,28999,False,123,scaffold_1
27,5142001,5189000,46999,False,123,scaffold_1
28,5481001,5513000,31999,False,123,scaffold_1
29,5535001,5582000,46999,False,123,scaffold_1
30,5852001,5911000,58999,False,123,scaffold_1
31,6108001,6567000,458999,False,123,scaffold_1
32,6637001,6658000,20999,False,123,scaffold_1
33,6836001,6891000,54999,False,123,scaffold_1
34,7023001,7029000,5999,False,123,scaffold_1
35,7030001,7247000,216999,False,123,scaffold_1
36,7248001,7588000,339999,False,123,scaffold_1
37,7590001,8656000,1065999,False,123,scaffold_1
38,8658001,9584000,925999,False,123,scaffold_1
39,9586001,10359000,772999,False,123,scaffold_1
40,10450001,10643000,192999,False,123,scaffold_1
41,10663001,10764000,100999,False,123,scaffold_1
42,10840001,10857000,16999,False,123,scaffold_1
43,10919001,10940000,20999,False,123,scaffold_1
44,11015001,11029000,13999,False,123,scaffold_1
45,11280001,11977000,696999,False,123,scaffold_1
46,12165001,12242000,76999,False,123,scaffold_1
47,12424001,12528000,103999,False,123,scaffold_1
48,12652001,12722000,69999,False,123,scaffold_1
49,12774001,12892000,117999,False,123,scaffold_1
50,12914001,13002000,87999,False,123,scaffold_1
51,13018001,13215000,196999,False,123,scaffold_1
52,13347001,13431000,83999,False,123,scaffold_1
53,13564001,13574000,9999,False,123,scaffold_1
54,14105001,14108000,2999,False,123,scaffold_1
0,7001,48000,40999,False,123,scaffold_2
1,95001,159000,63999,False,123,scaffold_2
2,168001,177000,8999,False,123,scaffold_2
3,297001,318000,20999,False,123,scaffold_2
4,333001,374000,40999,False,123,scaffold_2
5,706001,739000,32999,False,123,scaffold_2
6,946001,974000,27999,False,123,scaffold_2
7,1691001,1720000,28999,False,123,scaffold_2
8,2085001,2111000,25999,False,123,scaffold_2
9,2336001,2358000,21999,False,123,scaffold_2
10,2396001,2639000,242999,False,123,scaffold_2
11,2645001,2688000,42999,False,123,scaffold_2
12,2693001,2747000,53999,False,123,scaffold_2
13,2767001,2788000,20999,False,123,scaffold_2
14,2819001,2855000,35999,False,123,scaffold_2
15,2868001,2906000,37999,False,123,scaffold_2
16,2947001,3021000,73999,False,123,scaffold_2
17,3334001,3342000,7999,False,123,scaffold_2
18,3363001,3390000,26999,False,123,scaffold_2
19,3450001,3467000,16999,False,123,scaffold_2
20,3676001,3693000,16999,False,123,scaffold_2
21,3754001,3787000,32999,False,123,scaffold_2
22,4239001,4276000,36999,False,123,scaffold_2
23,4335001,4409000,73999,False,123,scaffold_2
24,4426001,4501000,74999,False,123,scaffold_2
25,4519001,4765000,245999,False,123,scaffold_2
26,4782001,4790000,7999,False,123,scaffold_2
27,4793001,4814000,20999,False,123,scaffold_2
28,4917001,4976000,58999,False,123,scaffold_2
29,5021001,5105000,83999,False,123,scaffold_2
30,5209001,5220000,10999,False,123,scaffold_2
31,5348001,5558000,209999,False,123,scaffold_2
32,5609001,5704000,94999,False,123,scaffold_2
33,5720001,5763000,42999,False,123,scaffold_2
34,5840001,6059000,218999,False,123,scaffold_2
35,6261001,6450000,188999,False,123,scaffold_2
36,6576001,6631000,54999,False,123,scaffold_2
37,6810001,6914000,103999,False,123,scaffold_2
38,7001001,7039000,37999,False,123,scaffold_2
39,7063001,7234000,170999,False,123,scaffold_2
40,7269001,7310000,40999,False,123,scaffold_2
41,7340001,7477000,136999,False,123,scaffold_2
42,7485001,7523000,37999,False,123,scaffold_2
43,7549001,7561000,11999,False,123,scaffold_2
44,7563001,7698000,134999,False,123,scaffold_2
45,7780001,8313000,532999,False,123,scaffold_2
46,8346001,8564000,217999,False,123,scaffold_2
47,9006001,9063000,56999,False,123,scaffold_2
48,9116001,9188000,71999,False,123,scaffold_2
49,9320001,9512000,191999,False,123,scaffold_2
50,9565001,9633000,67999,False,123,scaffold_2
51,9673001,9695000,21999,False,123,scaffold_2
52,10438001,10563000,124999,False,123,scaffold_2
53,11024001,11066000,41999,False,123,scaffold_2
54,11393001,11503000,109999,False,123,scaffold_2
55,11518001,11786000,267999,False,123,scaffold_2
0,528001,537000,8999,False,123,scaffold_3
1,618001,646000,27999,False,123,scaffold_3
2,799001,900000,100999,False,123,scaffold_3
3,1163001,1192000,28999,False,123,scaffold_3
4,1944001,1979000,34999,False,123,scaffold_3
5,2006001,2108000,101999,False,123,scaffold_3
6,2161001,2176000,14999,False,123,scaffold_3
7,2274001,2337000,62999,False,123,scaffold_3
8,2434001,2532000,97999,False,123,scaffold_3
9,2717001,2736000,18999,False,123,scaffold_3
10,3110001,3144000,33999,False,123,scaffold_3
11,3678001,3699000,20999,False,123,scaffold_3
12,3740001,3896000,155999,False,123,scaffold_3
13,4092001,4404000,311999,False,123,scaffold_3
14,4416001,4558000,141999,False,123,scaffold_3
15,4569001,4686000,116999,False,123,scaffold_3
16,5167001,5205000,37999,False,123,scaffold_3
17,5241001,5272000,30999,False,123,scaffold_3
18,5678001,5692000,13999,False,123,scaffold_3
19,5805001,5917000,111999,False,123,scaffold_3
20,5929001,5938000,8999,False,123,scaffold_3
21,5975001,6024000,48999,False,123,scaffold_3
22,6517001,6573000,55999,False,123,scaffold_3
23,6657001,6700000,42999,False,123,scaffold_3
24,6730001,6808000,77999,False,123,scaffold_3
25,6909001,7098000,188999,False,123,scaffold_3
26,7254001,7301000,46999,False,123,scaffold_3
27,7333001,7403000,69999,False,123,scaffold_3
28,7449001,7460000,10999,False,123,scaffold_3
29,7462001,7480000,17999,False,123,scaffold_3
30,7482001,7562000,79999,False,123,scaffold_3
31,7576001,7631000,54999,False,123,scaffold_3
32,7678001,7895000,216999,False,123,scaffold_3
33,7913001,7944000,30999,False,123,scaffold_3
34,8052001,8116000,63999,False,123,scaffold_3
35,8183001,8256000,72999,False,123,scaffold_3
36,8424001,8527000,102999,False,123,scaffold_3
37,8575001,8594000,18999,False,123,scaffold_3
38,9006001,9077000,70999,False,123,scaffold_3
39,9953001,10090000,136999,False,123,scaffold_3
40,10120001,10143000,22999,False,123,scaffold_3
41,10234001,10341000,106999,False,123,scaffold_3
42,10441001,10457000,15999,False,123,scaffold_3
43,10461001,10486000,24999,False,123,scaffold_3
44,10550001,11182071,632070,True,123,scaffold_3
0,1,7000,6999,True,123,scaffold_4
1,14001,16000,1999,False,123,scaffold_4
2,17001,32000,14999,False,123,scaffold_4
3,48001,104000,55999,False,123,scaffold_4
4,120001,146000,25999,False,123,scaffold_4
5,147001,151000,3999,False,123,scaffold_4
6,155001,216000,60999,False,123,scaffold_4
7,217001,226000,8999,False,123,scaffold_4
8,227001,266000,38999,False,123,scaffold_4
9,288001,353000,64999,False,123,scaffold_4
10,355001,380000,24999,False,123,scaffold_4
11,412001,425000,12999,False,123,scaffold_4
12,429001,504000,74999,False,123,scaffold_4
13,511001,532000,20999,False,123,scaffold_4
14,533001,606000,72999,False,123,scaffold_4
15,608001,691000,82999,False,123,scaffold_4
16,1028001,1042000,13999,False,123,scaffold_4
17,1052001,1063000,10999,False,123,scaffold_4
18,1087001,1208000,120999,False,123,scaffold_4
19,1210001,1225000,14999,False,123,scaffold_4
20,1254001,1279000,24999,False,123,scaffold_4
21,1283001,1337000,53999,False,123,scaffold_4
22,1355001,1599000,243999,False,123,scaffold_4
23,1613001,2179000,565999,False,123,scaffold_4
24,2221001,2246000,24999,False,123,scaffold_4
25,2247001,2279000,31999,False,123,scaffold_4
26,2284001,2310000,25999,False,123,scaffold_4
27,2312001,2461000,148999,False,123,scaffold_4
28,2476001,2583000,106999,False,123,scaffold_4
29,2597001,2635000,37999,False,123,scaffold_4
30,2740001,2790000,49999,False,123,scaffold_4
31,3039001,3128000,88999,False,123,scaffold_4
32,3206001,3306000,99999,False,123,scaffold_4
33,3336001,3767000,430999,False,123,scaffold_4
34,4062001,4106000,43999,False,123,scaffold_4
35,4283001,4313000,29999,False,123,scaffold_4
36,4901001,5093000,191999,False,123,scaffold_4
37,5173001,5243000,69999,False,123,scaffold_4
38,5269001,5438000,168999,False,123,scaffold_4
39,5475001,5506000,30999,False,123,scaffold_4
40,5515001,5784000,268999,False,123,scaffold_4
41,5786001,5819000,32999,False,123,scaffold_4
42,6147001,6204000,56999,False,123,scaffold_4
43,6213001,6305000,91999,False,123,scaffold_4
44,6615001,6617000,1999,False,123,scaffold_4
45,6705001,6817000,111999,False,123,scaffold_4
46,6857001,6924000,66999,False,123,scaffold_4
47,6949001,7124000,174999,False,123,scaffold_4
48,7153001,7175000,21999,False,123,scaffold_4
49,7193001,7323000,129999,False,123,scaffold_4
50,7512001,7556000,43999,False,123,scaffold_4
51,7627001,7667000,39999,False,123,scaffold_4
52,7864001,7884000,19999,False,123,scaffold_4
53,8754001,8818000,63999,False,123,scaffold_4
54,8844001,9845951,1001950,True,123,scaffold_4
0,127001,173000,45999,False,123,scaffold_5
1,319001,428000,108999,False,123,scaffold_5
2,463001,526000,62999,False,123,scaffold_5
3,669001,698000,28999,False,123,scaffold_5
4,930001,950000,19999,False,123,scaffold_5
5,2257001,2282000,24999,False,123,scaffold_5
6,2474001,2493000,18999,False,123,scaffold_5
7,2551001,2875000,323999,False,123,scaffold_5
8,2945001,2997000,51999,False,123,scaffold_5
9,3092001,3195000,102999,False,123,scaffold_5
10,3216001,3514000,297999,False,123,scaffold_5
11,3618001,3658000,39999,False,123,scaffold_5
12,3718001,3750000,31999,False,123,scaffold_5
13,3775001,3814000,38999,False,123,scaffold_5
14,3836001,4219000,382999,False,123,scaffold_5
15,4228001,4321000,92999,False,123,scaffold_5
16,4444001,4554000,109999,False,123,scaffold_5
17,4570001,4927000,356999,False,123,scaffold_5
18,4968001,5106000,137999,False,123,scaffold_5
19,5225001,5388000,162999,False,123,scaffold_5
20,5510001,5528000,17999,False,123,scaffold_5
21,5687001,5736000,48999,False,123,scaffold_5
22,5866001,5886000,19999,False,123,scaffold_5
23,6391001,6742000,350999,False,123,scaffold_5
24,6756001,6790000,33999,False,123,scaffold_5
25,6878001,6907000,28999,False,123,scaffold_5
26,7036001,7083000,46999,False,123,scaffold_5
27,7162001,7248000,85999,False,123,scaffold_5
28,7335001,7363000,27999,False,123,scaffold_5
29,7406001,7445000,38999,False,123,scaffold_5
30,7454001,7513000,58999,False,123,scaffold_5
31,7545001,7610000,64999,False,123,scaffold_5
32,7622001,7659000,36999,False,123,scaffold_5
33,8258001,8281000,22999,False,123,scaffold_5
34,8322001,8345000,22999,False,123,scaffold_5
35,8435001,8469000,33999,False,123,scaffold_5
36,8553001,8616000,62999,False,123,scaffold_5
37,8659001,8689000,29999,False,123,scaffold_5
38,8712001,9364176,652175,True,123,scaffold_5
0,63001,75000,11999,False,123,scaffold_6
1,76001,85000,8999,False,123,scaffold_6
2,86001,121000,34999,False,123,scaffold_6
3,159001,211000,51999,False,123,scaffold_6
4,238001,295000,56999,False,123,scaffold_6
5,787001,797000,9999,False,123,scaffold_6
6,1234001,1265000,30999,False,123,scaffold_6
7,1286001,1305000,18999,False,123,scaffold_6
8,1438001,1467000,28999,False,123,scaffold_6
9,1478001,1595000,116999,False,123,scaffold_6
10,1658001,1712000,53999,False,123,scaffold_6
11,1766001,1906000,139999,False,123,scaffold_6
12,2024001,2103000,78999,False,123,scaffold_6
13,2130001,2215000,84999,False,123,scaffold_6
14,2238001,2283000,44999,False,123,scaffold_6
15,2336001,2871000,534999,False,123,scaffold_6
16,2933001,3032000,98999,False,123,scaffold_6
17,3064001,3211000,146999,False,123,scaffold_6
18,3222001,3801000,578999,False,123,scaffold_6
19,3879001,3921000,41999,False,123,scaffold_6
20,3965001,4195000,229999,False,123,scaffold_6
21,4851001,4868000,16999,False,123,scaffold_6
22,4925001,4997000,71999,False,123,scaffold_6
23,5556001,5647000,90999,False,123,scaffold_6
24,5670001,5746000,75999,False,123,scaffold_6
25,5862001,5974000,111999,False,123,scaffold_6
26,6001001,6087000,85999,False,123,scaffold_6
27,6126001,6208000,81999,False,123,scaffold_6
28,6255001,6278000,22999,False,123,scaffold_6
29,6765001,6804000,38999,False,123,scaffold_6
30,6911001,7005000,93999,False,123,scaffold_6
31,7173001,7341000,167999,False,123,scaffold_6
32,7375001,7476000,100999,False,123,scaffold_6
33,7545001,8268281,723280,True,123,scaffold_6
0,11001,34000,22999,False,123,scaffold_7
1,36001,47000,10999,False,123,scaffold_7
2,299001,505000,205999,False,123,scaffold_7
3,571001,579000,7999,False,123,scaffold_7
4,614001,754000,139999,False,123,scaffold_7
5,764001,829000,64999,False,123,scaffold_7
6,868001,938000,69999,False,123,scaffold_7
7,968001,981000,12999,False,123,scaffold_7
8,982001,1044000,61999,False,123,scaffold_7
9,1047001,1159000,111999,False,123,scaffold_7
10,1191001,1460000,268999,False,123,scaffold_7
11,1461001,1512000,50999,False,123,scaffold_7
12,1556001,1688000,131999,False,123,scaffold_7
13,2851001,2956000,104999,False,123,scaffold_7
14,3009001,3076000,66999,False,123,scaffold_7
15,3298001,3315000,16999,False,123,scaffold_7
16,3321001,3423000,101999,False,123,scaffold_7
17,3499001,3829000,329999,False,123,scaffold_7
18,4028001,4067000,38999,False,123,scaffold_7
19,4333001,4382000,48999,False,123,scaffold_7
20,4415001,4517000,101999,False,123,scaffold_7
21,4548001,4600000,51999,False,123,scaffold_7
22,4629001,4820000,190999,False,123,scaffold_7
23,4978001,5211000,232999,False,123,scaffold_7
24,5375001,5536000,160999,False,123,scaffold_7
25,6102001,6277000,174999,False,123,scaffold_7
26,6326001,6373000,46999,False,123,scaffold_7
27,6557001,6592000,34999,False,123,scaffold_7
28,6750001,6799000,48999,False,123,scaffold_7
29,6954001,7270000,315999,False,123,scaffold_7
30,7271001,7502216,231215,True,123,scaffold_7
0,33001,87000,53999,False,123,scaffold_8
1,729001,732000,2999,False,123,scaffold_8
2,1391001,1426000,34999,False,123,scaffold_8
3,1622001,1639000,16999,False,123,scaffold_8
4,1640001,1647000,6999,False,123,scaffold_8
5,1669001,1719000,49999,False,123,scaffold_8
6,1810001,1956000,145999,False,123,scaffold_8
7,2091001,2135000,43999,False,123,scaffold_8
8,2333001,2552000,218999,False,123,scaffold_8
9,2646001,2844000,197999,False,123,scaffold_8
10,3033001,3955000,921999,False,123,scaffold_8
11,4041001,4126000,84999,False,123,scaffold_8
12,4169001,4267000,97999,False,123,scaffold_8
13,4399001,4429000,29999,False,123,scaffold_8
14,4567001,4669000,101999,False,123,scaffold_8
15,4815001,4849000,33999,False,123,scaffold_8
16,5029001,5241000,211999,False,123,scaffold_8
17,5521001,5597000,75999,False,123,scaffold_8
18,5650001,5695000,44999,False,123,scaffold_8
19,6326001,6334544,8543,True,123,scaffold_8
0,1,23000,22999,True,123,scaffold_9
1,109001,119000,9999,False,123,scaffold_9
2,121001,138000,16999,False,123,scaffold_9
3,319001,438000,118999,False,123,scaffold_9
4,479001,531000,51999,False,123,scaffold_9
5,644001,665000,20999,False,123,scaffold_9
6,671001,697000,25999,False,123,scaffold_9
7,815001,841000,25999,False,123,scaffold_9
8,873001,986000,112999,False,123,scaffold_9
9,987001,995000,7999,False,123,scaffold_9
10,998001,1007000,8999,False,123,scaffold_9
11,1008001,1032000,23999,False,123,scaffold_9
12,1035001,1085000,49999,False,123,scaffold_9
13,1087001,1177000,89999,False,123,scaffold_9
14,1241001,1257000,15999,False,123,scaffold_9
15,1312001,1378000,65999,False,123,scaffold_9
16,1759001,1806000,46999,False,123,scaffold_9
17,2000001,2056000,55999,False,123,scaffold_9
18,2586001,2666000,79999,False,123,scaffold_9
19,2731001,3381000,649999,False,123,scaffold_9
20,3383001,5107000,1723999,False,123,scaffold_9
21,5112001,5298000,185999,False,123,scaffold_9
22,5300001,6331288,1031287,True,123,scaffold_9
0,1,237000,236999,True,123,scaffold_10
1,256001,414000,157999,False,123,scaffold_10
2,415001,482000,66999,False,123,scaffold_10
3,483001,871000,387999,False,123,scaffold_10
4,888001,986000,97999,False,123,scaffold_10
5,1073001,1112000,38999,False,123,scaffold_10
6,1539001,1675000,135999,False,123,scaffold_10
7,2077001,2108000,30999,False,123,scaffold_10
8,2144001,2179000,34999,False,123,scaffold_10
9,2268001,2308000,39999,False,123,scaffold_10
10,2346001,2444000,97999,False,123,scaffold_10
11,2552001,2576000,23999,False,123,scaffold_10
12,2909001,2928000,18999,False,123,scaffold_10
13,4000001,4012000,11999,False,123,scaffold_10
14,4052001,4112000,59999,False,123,scaffold_10
15,4154001,4182000,27999,False,123,scaffold_10
16,4442001,4466000,23999,False,123,scaffold_10
17,4467001,4483000,15999,False,123,scaffold_10
18,4503001,4513000,9999,False,123,scaffold_10
19,4515001,4548000,32999,False,123,scaffold_10
20,4565001,4596000,30999,False,123,scaffold_10
21,4735001,4766000,30999,False,123,scaffold_10
22,4769001,4776000,6999,False,123,scaffold_10
23,4781001,4784000,2999,False,123,scaffold_10
24,4791001,4797000,5999,False,123,scaffold_10
25,4798001,4824000,25999,False,123,scaffold_10
26,4828001,4861000,32999,False,123,scaffold_10
27,4862001,4866973,4972,True,123,scaffold_10
0,10001,93000,82999,False,123,scaffold_11
1,132001,167000,34999,False,123,scaffold_11
2,168001,212000,43999,False,123,scaffold_11
3,213001,236000,22999,False,123,scaffold_11
4,239001,253000,13999,False,123,scaffold_11
5,296001,320000,23999,False,123,scaffold_11
6,419001,431000,11999,False,123,scaffold_11
7,648001,656000,7999,False,123,scaffold_11
8,1124001,1131000,6999,False,123,scaffold_11
9,1423001,1426000,2999,False,123,scaffold_11
10,1474001,1477000,2999,False,123,scaffold_11
11,1526001,1543000,16999,False,123,scaffold_11
12,2393001,2496000,102999,False,123,scaffold_11
13,2700001,2889000,188999,False,123,scaffold_11
14,2952001,3020000,67999,False,123,scaffold_11
15,3059001,3177000,117999,False,123,scaffold_11
16,3187001,3325000,137999,False,123,scaffold_11
17,3327001,3391000,63999,False,123,scaffold_11
18,3430001,3479000,48999,False,123,scaffold_11
19,3563001,4159000,595999,False,123,scaffold_11
20,4189001,4766820,577819,True,123,scaffold_11
0,1,1469000,1468999,True,123,scaffold_12
1,1555001,1592000,36999,False,123,scaffold_12
2,1714001,1762000,47999,False,123,scaffold_12
3,2069001,2093000,23999,False,123,scaffold_12
4,2571001,2618000,46999,False,123,scaffold_12
5,2661001,2723000,61999,False,123,scaffold_12
0,1,340000,339999,True,124,scaffold_1
1,482001,498000,15999,False,124,scaffold_1
2,572001,643000,70999,False,124,scaffold_1
3,686001,756000,69999,False,124,scaffold_1
4,1281001,1292000,10999,False,124,scaffold_1
5,1817001,1900000,82999,False,124,scaffold_1
6,1954001,1964000,9999,False,124,scaffold_1
7,1965001,1984000,18999,False,124,scaffold_1
8,2364001,2384000,19999,False,124,scaffold_1
9,2449001,2517000,67999,False,124,scaffold_1
10,2567001,2577000,9999,False,124,scaffold_1
11,2726001,2746000,19999,False,124,scaffold_1
12,3176001,3209000,32999,False,124,scaffold_1
13,3715001,3737000,21999,False,124,scaffold_1
14,3916001,3941000,24999,False,124,scaffold_1
15,3960001,4028000,67999,False,124,scaffold_1
16,4063001,4111000,47999,False,124,scaffold_1
17,4323001,4354000,30999,False,124,scaffold_1
18,4928001,5012000,83999,False,124,scaffold_1
19,5087001,5114000,26999,False,124,scaffold_1
20,5481001,5511000,29999,False,124,scaffold_1
21,5537001,5572000,34999,False,124,scaffold_1
22,6108001,6153000,44999,False,124,scaffold_1
23,6154001,6177000,22999,False,124,scaffold_1
24,6228001,6381000,152999,False,124,scaffold_1
25,6384001,6507000,122999,False,124,scaffold_1
26,6543001,6555000,11999,False,124,scaffold_1
27,7038001,7247000,208999,False,124,scaffold_1
28,7248001,7588000,339999,False,124,scaffold_1
29,7590001,8656000,1065999,False,124,scaffold_1
30,8658001,9584000,925999,False,124,scaffold_1
31,9586001,10355000,768999,False,124,scaffold_1
32,10460001,10634000,173999,False,124,scaffold_1
33,10808001,10811000,2999,False,124,scaffold_1
34,10832001,10858000,25999,False,124,scaffold_1
35,11344001,11509000,164999,False,124,scaffold_1
36,11556001,11951000,394999,False,124,scaffold_1
37,12184001,12206000,21999,False,124,scaffold_1
38,12428001,12442000,13999,False,124,scaffold_1
39,12652001,12723000,70999,False,124,scaffold_1
40,12746001,12755000,8999,False,124,scaffold_1
41,12776001,12888000,111999,False,124,scaffold_1
42,13113001,13215000,101999,False,124,scaffold_1
43,13347001,13439000,91999,False,124,scaffold_1
44,14294001,14307000,12999,False,124,scaffold_1
45,14471001,14479000,7999,False,124,scaffold_1
46,14690001,14692000,1999,False,124,scaffold_1
0,22001,48000,25999,False,124,scaffold_2
1,93001,159000,65999,False,124,scaffold_2
2,168001,177000,8999,False,124,scaffold_2
3,333001,374000,40999,False,124,scaffold_2
4,2336001,2358000,21999,False,124,scaffold_2
5,2404001,2424000,19999,False,124,scaffold_2
6,2441001,2600000,158999,False,124,scaffold_2
7,2627001,2639000,11999,False,124,scaffold_2
8,2645001,2689000,43999,False,124,scaffold_2
9,2694001,2744000,49999,False,124,scaffold_2
10,2868001,2899000,30999,False,124,scaffold_2
11,2994001,3012000,17999,False,124,scaffold_2
12,3173001,3186000,12999,False,124,scaffold_2
13,3450001,3465000,14999,False,124,scaffold_2
14,3759001,3783000,23999,False,124,scaffold_2
15,4334001,4409000,74999,False,124,scaffold_2
16,4426001,4458000,31999,False,124,scaffold_2
17,4520001,4656000,135999,False,124,scaffold_2
18,4783001,4790000,6999,False,124,scaffold_2
19,4793001,4799000,5999,False,124,scaffold_2
20,4918001,4949000,30999,False,124,scaffold_2
21,5022001,5064000,41999,False,124,scaffold_2
22,5370001,5395000,24999,False,124,scaffold_2
23,5447001,5471000,23999,False,124,scaffold_2
24,5491001,5511000,19999,False,124,scaffold_2
25,5658001,5758000,99999,False,124,scaffold_2
26,5841001,5887000,45999,False,124,scaffold_2
27,5915001,5989000,73999,False,124,scaffold_2
28,6261001,6330000,68999,False,124,scaffold_2
29,6331001,6350000,18999,False,124,scaffold_2
30,6591001,6628000,36999,False,124,scaffold_2
31,7005001,7037000,31999,False,124,scaffold_2
32,7428001,7472000,43999,False,124,scaffold_2
33,7492001,7503000,10999,False,124,scaffold_2
34,7550001,7561000,10999,False,124,scaffold_2
35,7563001,7697000,133999,False,124,scaffold_2
36,7786001,7916000,129999,False,124,scaffold_2
37,7934001,8161000,226999,False,124,scaffold_2
38,8265001,8313000,47999,False,124,scaffold_2
39,8331001,8333000,1999,False,124,scaffold_2
40,8334001,8345000,10999,False,124,scaffold_2
41,8346001,8453000,106999,False,124,scaffold_2
42,8509001,8559000,49999,False,124,scaffold_2
43,11367001,11381000,13999,False,124,scaffold_2
44,11520001,11786000,265999,False,124,scaffold_2
0,1,2000,1999,True,124,scaffold_3
1,798001,900000,101999,False,124,scaffold_3
2,2015001,2107000,91999,False,124,scaffold_3
3,2291001,2336000,44999,False,124,scaffold_3
4,2487001,2533000,45999,False,124,scaffold_3
5,2717001,2735000,17999,False,124,scaffold_3
6,3100001,3141000,40999,False,124,scaffold_3
7,3625001,3643000,17999,False,124,scaffold_3
8,3826001,3890000,63999,False,124,scaffold_3
9,4108001,4403000,294999,False,124,scaffold_3
10,4418001,4519000,100999,False,124,scaffold_3
11,4547001,4558000,10999,False,124,scaffold_3
12,4647001,4680000,32999,False,124,scaffold_3
13,5494001,5509000,14999,False,124,scaffold_3
14,5990001,6020000,29999,False,124,scaffold_3
15,6893001,7089000,195999,False,124,scaffold_3
16,7334001,7401000,66999,False,124,scaffold_3
17,7451001,7458000,6999,False,124,scaffold_3
18,7522001,7556000,33999,False,124,scaffold_3
19,7692001,7856000,163999,False,124,scaffold_3
20,8175001,8253000,77999,False,124,scaffold_3
21,8462001,8527000,64999,False,124,scaffold_3
22,8575001,8594000,18999,False,124,scaffold_3
23,9018001,9079000,60999,False,124,scaffold_3
24,9968001,9996000,27999,False,124,scaffold_3
25,10461001,10479000,17999,False,124,scaffold_3
26,10587001,11165000,577999,False,124,scaffold_3
0,11001,13000,1999,False,124,scaffold_4
1,21001,32000,10999,False,124,scaffold_4
2,49001,88000,38999,False,124,scaffold_4
3,132001,146000,13999,False,124,scaffold_4
4,147001,151000,3999,False,124,scaffold_4
5,155001,215000,59999,False,124,scaffold_4
6,217001,226000,8999,False,124,scaffold_4
7,227001,266000,38999,False,124,scaffold_4
8,294001,311000,16999,False,124,scaffold_4
9,312001,344000,31999,False,124,scaffold_4
10,355001,374000,18999,False,124,scaffold_4
11,375001,380000,4999,False,124,scaffold_4
12,391001,410000,18999,False,124,scaffold_4
13,411001,425000,13999,False,124,scaffold_4
14,429001,498000,68999,False,124,scaffold_4
15,545001,592000,46999,False,124,scaffold_4
16,593001,606000,12999,False,124,scaffold_4
17,608001,667000,58999,False,124,scaffold_4
18,669001,691000,21999,False,124,scaffold_4
19,701001,714000,12999,False,124,scaffold_4
20,1121001,1136000,14999,False,124,scaffold_4
21,1137001,1198000,60999,False,124,scaffold_4
22,1199001,1226000,26999,False,124,scaffold_4
23,1268001,1279000,10999,False,124,scaffold_4
24,1283001,1336000,52999,False,124,scaffold_4
25,1370001,1604000,233999,False,124,scaffold_4
26,1613001,1957000,343999,False,124,scaffold_4
27,1958001,2020000,61999,False,124,scaffold_4
28,2021001,2117000,95999,False,124,scaffold_4
29,2119001,2182000,62999,False,124,scaffold_4
30,2190001,2206000,15999,False,124,scaffold_4
31,2210001,2281000,70999,False,124,scaffold_4
32,2284001,2340000,55999,False,124,scaffold_4
33,2342001,2387000,44999,False,124,scaffold_4
34,2398001,2461000,62999,False,124,scaffold_4
35,2476001,2635000,158999,False,124,scaffold_4
36,2919001,2956000,36999,False,124,scaffold_4
37,3075001,3127000,51999,False,124,scaffold_4
38,3336001,3637000,300999,False,124,scaffold_4
39,3645001,3768000,122999,False,124,scaffold_4
40,4900001,5044000,143999,False,124,scaffold_4
41,5175001,5207000,31999,False,124,scaffold_4
42,5476001,5506000,29999,False,124,scaffold_4
43,5516001,5620000,103999,False,124,scaffold_4
44,5662001,5784000,121999,False,124,scaffold_4
45,5786001,5824000,37999,False,124,scaffold_4
46,6145001,6193000,47999,False,124,scaffold_4
47,6764001,6817000,52999,False,124,scaffold_4
48,6900001,6924000,23999,False,124,scaffold_4
49,6970001,6984000,13999,False,124,scaffold_4
50,7036001,7062000,25999,False,124,scaffold_4
51,7225001,7276000,50999,False,124,scaffold_4
52,8849001,9699000,849999,False,124,scaffold_4
53,9700001,9845951,145950,True,124,scaffold_4
0,323001,326000,2999,False,124,scaffold_5
1,327001,389000,61999,False,124,scaffold_5
2,463001,523000,59999,False,124,scaffold_5
3,836001,842000,5999,False,124,scaffold_5
4,933001,947000,13999,False,124,scaffold_5
5,2475001,2492000,16999,False,124,scaffold_5
6,2563001,2744000,180999,False,124,scaffold_5
7,2813001,2871000,57999,False,124,scaffold_5
8,3134001,3185000,50999,False,124,scaffold_5
9,3217001,3256000,38999,False,124,scaffold_5
10,3301001,3512000,210999,False,124,scaffold_5
11,3962001,4101000,138999,False,124,scaffold_5
12,4118001,4219000,100999,False,124,scaffold_5
13,4246001,4262000,15999,False,124,scaffold_5
14,4445001,4506000,60999,False,124,scaffold_5
15,4601001,4681000,79999,False,124,scaffold_5
16,4690001,4861000,170999,False,124,scaffold_5
17,4904001,4917000,12999,False,124,scaffold_5
18,5259001,5273000,13999,False,124,scaffold_5
19,5287001,5312000,24999,False,124,scaffold_5
20,5314001,5344000,29999,False,124,scaffold_5
21,6407001,6420000,12999,False,124,scaffold_5
22,6478001,6629000,150999,False,124,scaffold_5
23,7580001,7619000,38999,False,124,scaffold_5
24,7621001,7654000,32999,False,124,scaffold_5
25,8570001,8616000,45999,False,124,scaffold_5
26,8659001,8689000,29999,False,124,scaffold_5
27,8713001,9364176,651175,True,124,scaffold_5
0,79001,113000,33999,False,124,scaffold_6
1,239001,253000,13999,False,124,scaffold_6
2,267001,283000,15999,False,124,scaffold_6
3,1146001,1196000,49999,False,124,scaffold_6
4,1236001,1256000,19999,False,124,scaffold_6
5,1479001,1546000,66999,False,124,scaffold_6
6,1562001,1595000,32999,False,124,scaffold_6
7,1868001,1906000,37999,False,124,scaffold_6
8,2023001,2087000,63999,False,124,scaffold_6
9,2129001,2214000,84999,False,124,scaffold_6
10,2240001,2283000,42999,False,124,scaffold_6
11,2336001,2595000,258999,False,124,scaffold_6
12,2596001,2654000,57999,False,124,scaffold_6
13,2655001,2852000,196999,False,124,scaffold_6
14,2927001,3017000,89999,False,124,scaffold_6
15,3100001,3192000,91999,False,124,scaffold_6
16,3224001,3343000,118999,False,124,scaffold_6
17,3357001,3361000,3999,False,124,scaffold_6
18,3406001,3766000,359999,False,124,scaffold_6
19,3900001,3913000,12999,False,124,scaffold_6
20,4018001,4072000,53999,False,124,scaffold_6
21,4080001,4195000,114999,False,124,scaffold_6
22,4842001,4872000,29999,False,124,scaffold_6
23,6011001,6061000,49999,False,124,scaffold_6
24,6784001,6801000,16999,False,124,scaffold_6
25,7263001,7337000,73999,False,124,scaffold_6
26,7389001,7440000,50999,False,124,scaffold_6
27,7549001,8268281,719280,True,124,scaffold_6
0,15001,30000,14999,False,124,scaffold_7
1,323001,340000,16999,False,124,scaffold_7
2,342001,508000,165999,False,124,scaffold_7
3,571001,577000,5999,False,124,scaffold_7
4,706001,736000,29999,False,124,scaffold_7
5,740001,753000,12999,False,124,scaffold_7
6,764001,822000,57999,False,124,scaffold_7
7,859001,864000,4999,False,124,scaffold_7
8,868001,943000,74999,False,124,scaffold_7
9,982001,1044000,61999,False,124,scaffold_7
10,1048001,1099000,50999,False,124,scaffold_7
11,1191001,1512000,320999,False,124,scaffold_7
12,1588001,1695000,106999,False,124,scaffold_7
13,3325001,3369000,43999,False,124,scaffold_7
14,3522001,3551000,28999,False,124,scaffold_7
15,3576001,3766000,189999,False,124,scaffold_7
16,4415001,4518000,102999,False,124,scaffold_7
17,4635001,4734000,98999,False,124,scaffold_7
18,4978001,5149000,170999,False,124,scaffold_7
19,5472001,5536000,63999,False,124,scaffold_7
20,5666001,5674000,7999,False,124,scaffold_7
21,6953001,7270000,316999,False,124,scaffold_7
22,7271001,7502216,231215,True,124,scaffold_7
0,66001,85000,18999,False,124,scaffold_8
1,2444001,2470000,25999,False,124,scaffold_8
2,2491001,2528000,36999,False,124,scaffold_8
3,2536001,2551000,14999,False,124,scaffold_8
4,2650001,2683000,32999,False,124,scaffold_8
5,2742001,2757000,14999,False,124,scaffold_8
6,2798001,2844000,45999,False,124,scaffold_8
7,3038001,3525000,486999,False,124,scaffold_8
8,3579001,3612000,32999,False,124,scaffold_8
9,3615001,3936000,320999,False,124,scaffold_8
10,4039001,4108000,68999,False,124,scaffold_8
11,4206001,4220000,13999,False,124,scaffold_8
12,5095001,5136000,40999,False,124,scaffold_8
13,5170001,5241000,70999,False,124,scaffold_8
14,6321001,6334544,13543,True,124,scaffold_8
0,1,21000,20999,True,124,scaffold_9
1,109001,117000,7999,False,124,scaffold_9
2,303001,315000,11999,False,124,scaffold_9
3,319001,331000,11999,False,124,scaffold_9
4,367001,411000,43999,False,124,scaffold_9
5,413001,433000,19999,False,124,scaffold_9
6,504001,531000,26999,False,124,scaffold_9
7,670001,697000,26999,False,124,scaffold_9
8,814001,842000,27999,False,124,scaffold_9
9,850001,862000,11999,False,124,scaffold_9
10,872001,986000,113999,False,124,scaffold_9
11,987001,995000,7999,False,124,scaffold_9
12,1001001,1007000,5999,False,124,scaffold_9
13,1010001,1085000,74999,False,124,scaffold_9
14,1087001,1166000,78999,False,124,scaffold_9
15,1312001,1378000,65999,False,124,scaffold_9
16,1457001,1458000,999,False,124,scaffold_9
17,1601001,1620000,18999,False,124,scaffold_9
18,1749001,1791000,41999,False,124,scaffold_9
19,1970001,1978000,7999,False,124,scaffold_9
20,2000001,2056000,55999,False,124,scaffold_9
21,2075001,2133000,57999,False,124,scaffold_9
22,2147001,2170000,22999,False,124,scaffold_9
23,2601001,2618000,16999,False,124,scaffold_9
24,2737001,2824000,86999,False,124,scaffold_9
25,2845001,3381000,535999,False,124,scaffold_9
26,3383001,5107000,1723999,False,124,scaffold_9
27,5112001,5114000,1999,False,124,scaffold_9
28,5116001,5238000,121999,False,124,scaffold_9
29,5239001,5298000,58999,False,124,scaffold_9
30,5300001,5490000,189999,False,124,scaffold_9
31,5493001,6331288,838287,True,124,scaffold_9
0,1,136000,135999,True,124,scaffold_10
1,137001,236000,98999,False,124,scaffold_10
2,258001,414000,155999,False,124,scaffold_10
3,451001,482000,30999,False,124,scaffold_10
4,483001,580000,96999,False,124,scaffold_10
5,603001,756000,152999,False,124,scaffold_10
6,783001,794000,10999,False,124,scaffold_10
7,888001,916000,27999,False,124,scaffold_10
8,924001,962000,37999,False,124,scaffold_10
9,1087001,1105000,17999,False,124,scaffold_10
10,2090001,2103000,12999,False,124,scaffold_10
11,2136001,2176000,39999,False,124,scaffold_10
12,2273001,2325000,51999,False,124,scaffold_10
13,2346001,2397000,50999,False,124,scaffold_10
14,2557001,2577000,19999,False,124,scaffold_10
15,2673001,2700000,26999,False,124,scaffold_10
16,3570001,3582000,11999,False,124,scaffold_10
17,4054001,4091000,36999,False,124,scaffold_10
18,4154001,4174000,19999,False,124,scaffold_10
19,4443001,4462000,18999,False,124,scaffold_10
20,4467001,4477000,9999,False,124,scaffold_10
21,4515001,4523000,7999,False,124,scaffold_10
22,4526001,4548000,21999,False,124,scaffold_10
23,4554001,4562000,7999,False,124,scaffold_10
24,4574001,4596000,21999,False,124,scaffold_10
25,4679001,4688000,8999,False,124,scaffold_10
26,4734001,4766000,31999,False,124,scaffold_10
27,4769001,4776000,6999,False,124,scaffold_10
28,4791001,4797000,5999,False,124,scaffold_10
29,4798001,4824000,25999,False,124,scaffold_10
30,4828001,4843000,14999,False,124,scaffold_10
31,4848001,4861000,12999,False,124,scaffold_10
32,4865001,4866973,1972,True,124,scaffold_10
0,10001,33000,22999,False,124,scaffold_11
1,42001,89000,46999,False,124,scaffold_11
2,147001,167000,19999,False,124,scaffold_11
3,169001,191000,21999,False,124,scaffold_11
4,214001,235000,20999,False,124,scaffold_11
5,240001,246000,5999,False,124,scaffold_11
6,419001,431000,11999,False,124,scaffold_11
7,648001,656000,7999,False,124,scaffold_11
8,1025001,1034000,8999,False,124,scaffold_11
9,1423001,1426000,2999,False,124,scaffold_11
10,1474001,1478000,3999,False,124,scaffold_11
11,1854001,1870000,15999,False,124,scaffold_11
12,1872001,1883000,10999,False,124,scaffold_11
13,2702001,2877000,174999,False,124,scaffold_11
14,2977001,3019000,41999,False,124,scaffold_11
15,3092001,3142000,49999,False,124,scaffold_11
16,3187001,3293000,105999,False,124,scaffold_11
17,3324001,3383000,58999,False,124,scaffold_11
18,3434001,3477000,42999,False,124,scaffold_11
19,3524001,3651000,126999,False,124,scaffold_11
20,3702001,3933000,230999,False,124,scaffold_11
21,3996001,4158000,161999,False,124,scaffold_11
22,4183001,4710000,526999,False,124,scaffold_11
23,4713001,4766820,53819,True,124,scaffold_11
0,1,386000,385999,True,124,scaffold_12
1,404001,541000,136999,False,124,scaffold_12
2,582001,856000,273999,False,124,scaffold_12
3,865001,1469000,603999,False,124,scaffold_12
4,1720001,1733000,12999,False,124,scaffold_12
5,1790001,1796000,5999,False,124,scaffold_12
6,2050001,2087000,36999,False,124,scaffold_12
7,2088001,2103000,14999,False,124,scaffold_12
8,2342001,2378000,35999,False,124,scaffold_12
9,2571001,2609000,37999,False,124,scaffold_12
0,1,340000,339999,True,125,scaffold_1
1,482001,498000,15999,False,125,scaffold_1
2,574001,643000,68999,False,125,scaffold_1
3,686001,759000,72999,False,125,scaffold_1
4,1272001,1292000,19999,False,125,scaffold_1
5,1616001,1660000,43999,False,125,scaffold_1
6,1810001,1899000,88999,False,125,scaffold_1
7,1954001,1964000,9999,False,125,scaffold_1
8,1965001,1984000,18999,False,125,scaffold_1
9,1987001,1994000,6999,False,125,scaffold_1
10,2449001,2517000,67999,False,125,scaffold_1
11,2725001,2746000,20999,False,125,scaffold_1
12,3174001,3208000,33999,False,125,scaffold_1
13,3446001,3472000,25999,False,125,scaffold_1
14,3580001,3621000,40999,False,125,scaffold_1
15,3712001,3739000,26999,False,125,scaffold_1
16,3907001,3941000,33999,False,125,scaffold_1
17,4003001,4028000,24999,False,125,scaffold_1
18,4060001,4111000,50999,False,125,scaffold_1
19,4317001,4353000,35999,False,125,scaffold_1
20,4925001,4999000,73999,False,125,scaffold_1
21,5087001,5113000,25999,False,125,scaffold_1
22,5482001,5512000,29999,False,125,scaffold_1
23,5535001,5570000,34999,False,125,scaffold_1
24,5852001,5875000,22999,False,125,scaffold_1
25,6108001,6153000,44999,False,125,scaffold_1
26,6154001,6177000,22999,False,125,scaffold_1
27,6228001,6381000,152999,False,125,scaffold_1
28,6384001,6565000,180999,False,125,scaffold_1
29,6640001,6659000,18999,False,125,scaffold_1
30,7038001,7247000,208999,False,125,scaffold_1
31,7248001,7588000,339999,False,125,scaffold_1
32,7590001,8477000,886999,False,125,scaffold_1
33,8478001,8656000,177999,False,125,scaffold_1
34,8658001,9584000,925999,False,125,scaffold_1
35,9586001,10356000,769999,False,125,scaffold_1
36,10461001,10640000,178999,False,125,scaffold_1
37,10808001,10811000,2999,False,125,scaffold_1
38,10835001,10858000,22999,False,125,scaffold_1
39,11277001,11509000,231999,False,125,scaffold_1
40,11554001,11956000,401999,False,125,scaffold_1
41,12184001,12238000,53999,False,125,scaffold_1
42,12652001,12722000,69999,False,125,scaffold_1
43,12775001,12888000,112999,False,125,scaffold_1
44,12965001,13001000,35999,False,125,scaffold_1
45,13113001,13212000,98999,False,125,scaffold_1
46,13348001,13405000,56999,False,125,scaffold_1
47,14285001,14309000,23999,False,125,scaffold_1
0,22001,48000,25999,False,125,scaffold_2
1,95001,159000,63999,False,125,scaffold_2
2,168001,177000,8999,False,125,scaffold_2
3,330001,374000,43999,False,125,scaffold_2
4,2336001,2358000,21999,False,125,scaffold_2
5,2404001,2424000,19999,False,125,scaffold_2
6,2441001,2553000,111999,False,125,scaffold_2
7,2660001,2689000,28999,False,125,scaffold_2
8,2694001,2742000,47999,False,125,scaffold_2
9,2821001,2855000,33999,False,125,scaffold_2
10,2868001,2899000,30999,False,125,scaffold_2
11,2994001,3012000,17999,False,125,scaffold_2
12,3336001,3342000,5999,False,125,scaffold_2
13,3450001,3465000,14999,False,125,scaffold_2
14,3755001,3789000,33999,False,125,scaffold_2
15,4383001,4409000,25999,False,125,scaffold_2
16,4427001,4457000,29999,False,125,scaffold_2
17,4520001,4664000,143999,False,125,scaffold_2
18,4717001,4790000,72999,False,125,scaffold_2
19,4918001,4938000,19999,False,125,scaffold_2
20,5021001,5031000,9999,False,125,scaffold_2
21,5033001,5061000,27999,False,125,scaffold_2
22,5080001,5104000,23999,False,125,scaffold_2
23,5186001,5222000,35999,False,125,scaffold_2
24,5368001,5393000,24999,False,125,scaffold_2
25,5447001,5480000,32999,False,125,scaffold_2
26,5491001,5515000,23999,False,125,scaffold_2
27,5669001,5707000,37999,False,125,scaffold_2
28,5719001,5761000,41999,False,125,scaffold_2
29,5910001,5993000,82999,False,125,scaffold_2
30,6261001,6330000,68999,False,125,scaffold_2
31,6331001,6352000,20999,False,125,scaffold_2
32,6410001,6449000,38999,False,125,scaffold_2
33,6589001,6628000,38999,False,125,scaffold_2
34,6832001,6855000,22999,False,125,scaffold_2
35,7005001,7038000,32999,False,125,scaffold_2
36,7063001,7097000,33999,False,125,scaffold_2
37,7167001,7197000,29999,False,125,scaffold_2
38,7341001,7472000,130999,False,125,scaffold_2
39,7549001,7561000,11999,False,125,scaffold_2
40,7563001,7697000,133999,False,125,scaffold_2
41,7780001,7895000,114999,False,125,scaffold_2
42,7934001,8161000,226999,False,125,scaffold_2
43,8261001,8297000,35999,False,125,scaffold_2
44,8331001,8333000,1999,False,125,scaffold_2
45,8340001,8345000,4999,False,125,scaffold_2
46,8346001,8453000,106999,False,125,scaffold_2
47,8509001,8559000,49999,False,125,scaffold_2
48,9141001,9168000,26999,False,125,scaffold_2
49,11366001,11374000,7999,False,125,scaffold_2
50,11520001,11786000,265999,False,125,scaffold_2
0,51001,55000,3999,False,125,scaffold_3
1,204001,207000,2999,False,125,scaffold_3
2,796001,901000,104999,False,125,scaffold_3
3,2041001,2108000,66999,False,125,scaffold_3
4,2291001,2321000,29999,False,125,scaffold_3
5,2482001,2531000,48999,False,125,scaffold_3
6,3768001,3821000,52999,False,125,scaffold_3
7,3822001,3860000,37999,False,125,scaffold_3
8,4108001,4398000,289999,False,125,scaffold_3
9,4418001,4518000,99999,False,125,scaffold_3
10,4547001,4558000,10999,False,125,scaffold_3
11,4568001,4577000,8999,False,125,scaffold_3
12,4652001,4684000,31999,False,125,scaffold_3
13,5496001,5509000,12999,False,125,scaffold_3
14,5990001,6016000,25999,False,125,scaffold_3
15,6757001,6785000,27999,False,125,scaffold_3
16,6907001,6962000,54999,False,125,scaffold_3
17,6963001,6968000,4999,False,125,scaffold_3
18,6979001,7089000,109999,False,125,scaffold_3
19,7336001,7398000,61999,False,125,scaffold_3
20,7525001,7556000,30999,False,125,scaffold_3
21,7690001,7798000,107999,False,125,scaffold_3
22,7820001,7854000,33999,False,125,scaffold_3
23,8184001,8257000,72999,False,125,scaffold_3
24,8462001,8527000,64999,False,125,scaffold_3
25,8575001,8594000,18999,False,125,scaffold_3
26,9968001,9996000,27999,False,125,scaffold_3
27,10551001,10572000,20999,False,125,scaffold_3
28,10574001,11165000,590999,False,125,scaffold_3
0,17001,32000,14999,False,125,scaffold_4
1,48001,88000,39999,False,125,scaffold_4
2,155001,160000,4999,False,125,scaffold_4
3,161001,215000,53999,False,125,scaffold_4
4,217001,226000,8999,False,125,scaffold_4
5,227001,266000,38999,False,125,scaffold_4
6,294001,307000,12999,False,125,scaffold_4
7,355001,374000,18999,False,125,scaffold_4
8,375001,380000,4999,False,125,scaffold_4
9,412001,425000,12999,False,125,scaffold_4
10,429001,500000,70999,False,125,scaffold_4
11,547001,592000,44999,False,125,scaffold_4
12,608001,691000,82999,False,125,scaffold_4
13,695001,697000,1999,False,125,scaffold_4
14,701001,714000,12999,False,125,scaffold_4
15,1113001,1136000,22999,False,125,scaffold_4
16,1137001,1178000,40999,False,125,scaffold_4
17,1199001,1208000,8999,False,125,scaffold_4
18,1210001,1226000,15999,False,125,scaffold_4
19,1235001,1246000,10999,False,125,scaffold_4
20,1283001,1333000,49999,False,125,scaffold_4
21,1372001,1599000,226999,False,125,scaffold_4
22,1613001,1992000,378999,False,125,scaffold_4
23,2026001,2065000,38999,False,125,scaffold_4
24,2071001,2098000,26999,False,125,scaffold_4
25,2211001,2246000,34999,False,125,scaffold_4
26,2247001,2268000,20999,False,125,scaffold_4
27,2269001,2279000,9999,False,125,scaffold_4
28,2284001,2340000,55999,False,125,scaffold_4
29,2342001,2385000,42999,False,125,scaffold_4
30,2476001,2583000,106999,False,125,scaffold_4
31,2600001,2635000,34999,False,125,scaffold_4
32,3079001,3127000,47999,False,125,scaffold_4
33,3336001,3761000,424999,False,125,scaffold_4
34,4051001,4073000,21999,False,125,scaffold_4
35,4921001,5089000,167999,False,125,scaffold_4
36,5171001,5224000,52999,False,125,scaffold_4
37,5300001,5356000,55999,False,125,scaffold_4
38,5473001,5506000,32999,False,125,scaffold_4
39,5516001,5784000,267999,False,125,scaffold_4
40,5786001,5817000,30999,False,125,scaffold_4
41,6145001,6195000,49999,False,125,scaffold_4
42,6764001,6817000,52999,False,125,scaffold_4
43,6893001,6924000,30999,False,125,scaffold_4
44,6970001,6989000,18999,False,125,scaffold_4
45,7036001,7062000,25999,False,125,scaffold_4
46,7208001,7325000,116999,False,125,scaffold_4
47,8846001,9699000,852999,False,125,scaffold_4
48,9700001,9845951,145950,True,125,scaffold_4
0,1,4000,3999,True,125,scaffold_5
1,178001,180000,1999,False,125,scaffold_5
2,318001,326000,7999,False,125,scaffold_5
3,327001,368000,40999,False,125,scaffold_5
4,463001,523000,59999,False,125,scaffold_5
5,933001,947000,13999,False,125,scaffold_5
6,2512001,2515000,2999,False,125,scaffold_5
7,2560001,2592000,31999,False,125,scaffold_5
8,2615001,2871000,255999,False,125,scaffold_5
9,3133001,3185000,51999,False,125,scaffold_5
10,3217001,3247000,29999,False,125,scaffold_5
11,3309001,3514000,204999,False,125,scaffold_5
12,3962001,4101000,138999,False,125,scaffold_5
13,4120001,4222000,101999,False,125,scaffold_5
14,4232001,4321000,88999,False,125,scaffold_5
15,4445001,4526000,80999,False,125,scaffold_5
16,4600001,4861000,260999,False,125,scaffold_5
17,4893001,4918000,24999,False,125,scaffold_5
18,5249001,5274000,24999,False,125,scaffold_5
19,5286001,5312000,25999,False,125,scaffold_5
20,5314001,5346000,31999,False,125,scaffold_5
21,6405001,6420000,14999,False,125,scaffold_5
22,6456001,6668000,211999,False,125,scaffold_5
23,7173001,7185000,11999,False,125,scaffold_5
24,7454001,7484000,29999,False,125,scaffold_5
25,7578001,7608000,29999,False,125,scaffold_5
26,7622001,7657000,34999,False,125,scaffold_5
27,8580001,8593000,12999,False,125,scaffold_5
28,8673001,8689000,15999,False,125,scaffold_5
29,8713001,9364176,651175,True,125,scaffold_5
0,79001,84000,4999,False,125,scaffold_6
1,86001,114000,27999,False,125,scaffold_6
2,239001,254000,14999,False,125,scaffold_6
3,257001,262000,4999,False,125,scaffold_6
4,267001,278000,10999,False,125,scaffold_6
5,1229001,1261000,31999,False,125,scaffold_6
6,1478001,1547000,68999,False,125,scaffold_6
7,1563001,1595000,31999,False,125,scaffold_6
8,1842001,1906000,63999,False,125,scaffold_6
9,2023001,2088000,64999,False,125,scaffold_6
10,2130001,2180000,49999,False,125,scaffold_6
11,2336001,2595000,258999,False,125,scaffold_6
12,2596001,2695000,98999,False,125,scaffold_6
13,2712001,2851000,138999,False,125,scaffold_6
14,2934001,3016000,81999,False,125,scaffold_6
15,3079001,3191000,111999,False,125,scaffold_6
16,3223001,3350000,126999,False,125,scaffold_6
17,3351001,3806000,454999,False,125,scaffold_6
18,3886001,3913000,26999,False,125,scaffold_6
19,3968001,3995000,26999,False,125,scaffold_6
20,4018001,4193000,174999,False,125,scaffold_6
21,5940001,5972000,31999,False,125,scaffold_6
22,6011001,6073000,61999,False,125,scaffold_6
23,7263001,7339000,75999,False,125,scaffold_6
24,7389001,7476000,86999,False,125,scaffold_6
25,7541001,8268281,727280,True,125,scaffold_6
0,1,7000,6999,True,125,scaffold_7
1,13001,31000,17999,False,125,scaffold_7
2,323001,340000,16999,False,125,scaffold_7
3,342001,508000,165999,False,125,scaffold_7
4,554001,563000,8999,False,125,scaffold_7
5,570001,577000,6999,False,125,scaffold_7
6,706001,724000,17999,False,125,scaffold_7
7,725001,736000,10999,False,125,scaffold_7
8,764001,809000,44999,False,125,scaffold_7
9,859001,864000,4999,False,125,scaffold_7
10,951001,963000,11999,False,125,scaffold_7
11,964001,966000,1999,False,125,scaffold_7
12,968001,980000,11999,False,125,scaffold_7
13,982001,1044000,61999,False,125,scaffold_7
14,1048001,1101000,52999,False,125,scaffold_7
15,1204001,1512000,307999,False,125,scaffold_7
16,1588001,1689000,100999,False,125,scaffold_7
17,3325001,3369000,43999,False,125,scaffold_7
18,3523001,3767000,243999,False,125,scaffold_7
19,4415001,4518000,102999,False,125,scaffold_7
20,4551001,4580000,28999,False,125,scaffold_7
21,4631001,4737000,105999,False,125,scaffold_7
22,4752001,4819000,66999,False,125,scaffold_7
23,4978001,5149000,170999,False,125,scaffold_7
24,5469001,5516000,46999,False,125,scaffold_7
25,5520001,5535000,14999,False,125,scaffold_7
26,5666001,5674000,7999,False,125,scaffold_7
27,6953001,7270000,316999,False,125,scaffold_7
28,7271001,7502216,231215,True,125,scaffold_7
0,1,6000,5999,True,125,scaffold_8
1,67001,85000,17999,False,125,scaffold_8
2,722001,724000,1999,False,125,scaffold_8
3,1859001,1927000,67999,False,125,scaffold_8
4,2413001,2471000,57999,False,125,scaffold_8
5,2491001,2527000,35999,False,125,scaffold_8
6,2537001,2549000,11999,False,125,scaffold_8
7,2659001,2683000,23999,False,125,scaffold_8
8,2741001,2758000,16999,False,125,scaffold_8
9,2798001,2844000,45999,False,125,scaffold_8
10,3060001,3525000,464999,False,125,scaffold_8
11,3577001,3612000,34999,False,125,scaffold_8
12,3615001,3945000,329999,False,125,scaffold_8
13,4038001,4105000,66999,False,125,scaffold_8
14,4400001,4426000,25999,False,125,scaffold_8
15,5095001,5136000,40999,False,125,scaffold_8
16,5198001,5241000,42999,False,125,scaffold_8
17,5654001,5694000,39999,False,125,scaffold_8
18,6329001,6334544,5543,True,125,scaffold_8
0,109001,117000,7999,False,125,scaffold_9
1,121001,124000,2999,False,125,scaffold_9
2,189001,194000,4999,False,125,scaffold_9
3,303001,315000,11999,False,125,scaffold_9
4,319001,326000,6999,False,125,scaffold_9
5,367001,404000,36999,False,125,scaffold_9
6,413001,434000,20999,False,125,scaffold_9
7,490001,531000,40999,False,125,scaffold_9
8,670001,696000,25999,False,125,scaffold_9
9,731001,742000,10999,False,125,scaffold_9
10,815001,842000,26999,False,125,scaffold_9
11,886001,986000,99999,False,125,scaffold_9
12,987001,995000,7999,False,125,scaffold_9
13,1001001,1007000,5999,False,125,scaffold_9
14,1009001,1031000,21999,False,125,scaffold_9
15,1036001,1085000,48999,False,125,scaffold_9
16,1087001,1165000,77999,False,125,scaffold_9
17,1312001,1377000,64999,False,125,scaffold_9
18,1755001,1791000,35999,False,125,scaffold_9
19,2601001,2633000,31999,False,125,scaffold_9
20,2735001,2821000,85999,False,125,scaffold_9
21,2870001,3381000,510999,False,125,scaffold_9
22,3383001,5107000,1723999,False,125,scaffold_9
23,5112001,5114000,1999,False,125,scaffold_9
24,5116001,5298000,181999,False,125,scaffold_9
25,5300001,6331288,1031287,True,125,scaffold_9
0,1,136000,135999,True,125,scaffold_10
1,137001,405000,267999,False,125,scaffold_10
2,431001,482000,50999,False,125,scaffold_10
3,483001,576000,92999,False,125,scaffold_10
4,603001,795000,191999,False,125,scaffold_10
5,888001,917000,28999,False,125,scaffold_10
6,923001,962000,38999,False,125,scaffold_10
7,1073001,1112000,38999,False,125,scaffold_10
8,2140001,2170000,29999,False,125,scaffold_10
9,2273001,2300000,26999,False,125,scaffold_10
10,2347001,2364000,16999,False,125,scaffold_10
11,4053001,4095000,41999,False,125,scaffold_10
12,4154001,4174000,19999,False,125,scaffold_10
13,4443001,4462000,18999,False,125,scaffold_10
14,4467001,4491000,23999,False,125,scaffold_10
15,4506001,4513000,6999,False,125,scaffold_10
16,4515001,4523000,7999,False,125,scaffold_10
17,4526001,4547000,20999,False,125,scaffold_10
18,4575001,4596000,20999,False,125,scaffold_10
19,4679001,4688000,8999,False,125,scaffold_10
20,4734001,4751000,16999,False,125,scaffold_10
21,4752001,4766000,13999,False,125,scaffold_10
22,4768001,4776000,7999,False,125,scaffold_10
23,4798001,4824000,25999,False,125,scaffold_10
24,4827001,4843000,15999,False,125,scaffold_10
25,4848001,4861000,12999,False,125,scaffold_10
26,4865001,4866973,1972,True,125,scaffold_10
0,10001,37000,26999,False,125,scaffold_11
1,38001,93000,54999,False,125,scaffold_11
2,149001,167000,17999,False,125,scaffold_11
3,169001,191000,21999,False,125,scaffold_11
4,210001,236000,25999,False,125,scaffold_11
5,240001,246000,5999,False,125,scaffold_11
6,419001,431000,11999,False,125,scaffold_11
7,649001,656000,6999,False,125,scaffold_11
8,781001,785000,3999,False,125,scaffold_11
9,1025001,1034000,8999,False,125,scaffold_11
10,1423001,1427000,3999,False,125,scaffold_11
11,2701001,2867000,165999,False,125,scaffold_11
12,2984001,3010000,25999,False,125,scaffold_11
13,3090001,3164000,73999,False,125,scaffold_11
14,3185001,3258000,72999,False,125,scaffold_11
15,3329001,3383000,53999,False,125,scaffold_11
16,3560001,3577000,16999,False,125,scaffold_11
17,3702001,3933000,230999,False,125,scaffold_11
18,4009001,4159000,149999,False,125,scaffold_11
19,4183001,4240000,56999,False,125,scaffold_11
20,4275001,4710000,434999,False,125,scaffold_11
21,4713001,4766820,53819,True,125,scaffold_11
0,1,731000,730999,True,125,scaffold_12
1,739001,1468000,728999,False,125,scaffold_12
2,1720001,1733000,12999,False,125,scaffold_12
3,2571001,2618000,46999,False,125,scaffold_12
0,1,340000,339999,True,126,scaffold_1
1,482001,498000,15999,False,126,scaffold_1
2,572001,643000,70999,False,126,scaffold_1
3,686001,713000,26999,False,126,scaffold_1
4,731001,742000,10999,False,126,scaffold_1
5,1281001,1292000,10999,False,126,scaffold_1
6,1954001,1964000,9999,False,126,scaffold_1
7,1965001,1984000,18999,False,126,scaffold_1
8,2449001,2469000,19999,False,126,scaffold_1
9,2473001,2513000,39999,False,126,scaffold_1
10,2729001,2746000,16999,False,126,scaffold_1
11,3181001,3208000,26999,False,126,scaffold_1
12,3715001,3733000,17999,False,126,scaffold_1
13,3916001,3941000,24999,False,126,scaffold_1
14,4062001,4112000,49999,False,126,scaffold_1
15,4315001,4354000,38999,False,126,scaffold_1
16,4929001,4963000,33999,False,126,scaffold_1
17,4969001,4983000,13999,False,126,scaffold_1
18,5484001,5511000,26999,False,126,scaffold_1
19,6108001,6153000,44999,False,126,scaffold_1
20,6228001,6507000,278999,False,126,scaffold_1
21,6545001,6554000,8999,False,126,scaffold_1
22,7038001,7247000,208999,False,126,scaffold_1
23,7248001,7588000,339999,False,126,scaffold_1
24,7590001,8477000,886999,False,126,scaffold_1
25,8478001,8656000,177999,False,126,scaffold_1
26,8658001,9584000,925999,False,126,scaffold_1
27,9586001,10354000,767999,False,126,scaffold_1
28,10461001,10635000,173999,False,126,scaffold_1
29,10808001,10811000,2999,False,126,scaffold_1
30,10836001,10858000,21999,False,126,scaffold_1
31,11352001,11504000,151999,False,126,scaffold_1
32,11615001,11951000,335999,False,126,scaffold_1
33,12184001,12204000,19999,False,126,scaffold_1
34,12678001,12722000,43999,False,126,scaffold_1
35,12777001,12888000,110999,False,126,scaffold_1
36,13113001,13144000,30999,False,126,scaffold_1
37,13178001,13211000,32999,False,126,scaffold_1
38,13347001,13377000,29999,False,126,scaffold_1
39,13901001,13903000,1999,False,126,scaffold_1
0,21001,48000,26999,False,126,scaffold_2
1,117001,159000,41999,False,126,scaffold_2
2,168001,177000,8999,False,126,scaffold_2
3,333001,374000,40999,False,126,scaffold_2
4,2336001,2358000,21999,False,126,scaffold_2
5,2405001,2424000,18999,False,126,scaffold_2
6,2441001,2553000,111999,False,126,scaffold_2
7,2627001,2639000,11999,False,126,scaffold_2
8,2660001,2689000,28999,False,126,scaffold_2
9,2694001,2742000,47999,False,126,scaffold_2
10,2995001,3012000,16999,False,126,scaffold_2
11,3454001,3463000,8999,False,126,scaffold_2
12,3768001,3781000,12999,False,126,scaffold_2
13,4385001,4409000,23999,False,126,scaffold_2
14,4429001,4456000,26999,False,126,scaffold_2
15,4525001,4553000,27999,False,126,scaffold_2
16,4607001,4654000,46999,False,126,scaffold_2
17,4918001,4937000,18999,False,126,scaffold_2
18,5022001,5031000,8999,False,126,scaffold_2
19,5033001,5061000,27999,False,126,scaffold_2
20,5491001,5511000,19999,False,126,scaffold_2
21,5672001,5704000,31999,False,126,scaffold_2
22,6261001,6330000,68999,False,126,scaffold_2
23,6331001,6341000,9999,False,126,scaffold_2
24,7439001,7472000,32999,False,126,scaffold_2
25,7563001,7697000,133999,False,126,scaffold_2
26,7786001,7890000,103999,False,126,scaffold_2
27,7934001,7967000,32999,False,126,scaffold_2
28,7984001,8131000,146999,False,126,scaffold_2
29,8331001,8333000,1999,False,126,scaffold_2
30,8335001,8344000,8999,False,126,scaffold_2
31,8346001,8389000,42999,False,126,scaffold_2
32,8509001,8535000,25999,False,126,scaffold_2
33,11366001,11374000,7999,False,126,scaffold_2
34,11520001,11785000,264999,False,126,scaffold_2
0,1,2000,1999,True,126,scaffold_3
1,51001,55000,3999,False,126,scaffold_3
2,102001,104000,1999,False,126,scaffold_3
3,799001,900000,100999,False,126,scaffold_3
4,2085001,2108000,22999,False,126,scaffold_3
5,2291001,2321000,29999,False,126,scaffold_3
6,2510001,2533000,22999,False,126,scaffold_3
7,4150001,4396000,245999,False,126,scaffold_3
8,4414001,4518000,103999,False,126,scaffold_3
9,4547001,4558000,10999,False,126,scaffold_3
10,4652001,4679000,26999,False,126,scaffold_3
11,6911001,6962000,50999,False,126,scaffold_3
12,6980001,7075000,94999,False,126,scaffold_3
13,7540001,7556000,15999,False,126,scaffold_3
14,7692001,7725000,32999,False,126,scaffold_3
15,7823001,7838000,14999,False,126,scaffold_3
16,8208001,8255000,46999,False,126,scaffold_3
17,8462001,8527000,64999,False,126,scaffold_3
18,8575001,8594000,18999,False,126,scaffold_3
19,9968001,9995000,26999,False,126,scaffold_3
20,10461001,10483000,21999,False,126,scaffold_3
21,10587001,11165000,577999,False,126,scaffold_3
0,3001,7000,3999,False,126,scaffold_4
1,17001,32000,14999,False,126,scaffold_4
2,48001,88000,39999,False,126,scaffold_4
3,155001,215000,59999,False,126,scaffold_4
4,217001,226000,8999,False,126,scaffold_4
5,227001,266000,38999,False,126,scaffold_4
6,355001,374000,18999,False,126,scaffold_4
7,375001,380000,4999,False,126,scaffold_4
8,396001,410000,13999,False,126,scaffold_4
9,412001,425000,12999,False,126,scaffold_4
10,429001,498000,68999,False,126,scaffold_4
11,545001,592000,46999,False,126,scaffold_4
12,593001,599000,5999,False,126,scaffold_4
13,600001,606000,5999,False,126,scaffold_4
14,608001,661000,52999,False,126,scaffold_4
15,670001,691000,20999,False,126,scaffold_4
16,701001,714000,12999,False,126,scaffold_4
17,739001,741000,1999,False,126,scaffold_4
18,1120001,1136000,15999,False,126,scaffold_4
19,1137001,1178000,40999,False,126,scaffold_4
20,1199001,1208000,8999,False,126,scaffold_4
21,1210001,1226000,15999,False,126,scaffold_4
22,1248001,1253000,4999,False,126,scaffold_4
23,1270001,1279000,8999,False,126,scaffold_4
24,1283001,1314000,30999,False,126,scaffold_4
25,1372001,1591000,218999,False,126,scaffold_4
26,1750001,1817000,66999,False,126,scaffold_4
27,1824001,1849000,24999,False,126,scaffold_4
28,1940001,1957000,16999,False,126,scaffold_4
29,2247001,2279000,31999,False,126,scaffold_4
30,2284001,2310000,25999,False,126,scaffold_4
31,2312001,2340000,27999,False,126,scaffold_4
32,2480001,2533000,52999,False,126,scaffold_4
33,3335001,3632000,296999,False,126,scaffold_4
34,3676001,3759000,82999,False,126,scaffold_4
35,4944001,4984000,39999,False,126,scaffold_4
36,5477001,5506000,28999,False,126,scaffold_4
37,5516001,5620000,103999,False,126,scaffold_4
38,5669001,5784000,114999,False,126,scaffold_4
39,6805001,6817000,11999,False,126,scaffold_4
40,7037001,7062000,24999,False,126,scaffold_4
41,8849001,9699000,849999,False,126,scaffold_4
42,9700001,9845951,145950,True,126,scaffold_4
0,191001,204000,12999,False,126,scaffold_5
1,296001,300000,3999,False,126,scaffold_5
2,318001,326000,7999,False,126,scaffold_5
3,327001,368000,40999,False,126,scaffold_5
4,469001,478000,8999,False,126,scaffold_5
5,508001,523000,14999,False,126,scaffold_5
6,933001,947000,13999,False,126,scaffold_5
7,2565001,2584000,18999,False,126,scaffold_5
8,2620001,2732000,111999,False,126,scaffold_5
9,2816001,2871000,54999,False,126,scaffold_5
10,3139001,3185000,45999,False,126,scaffold_5
11,3322001,3438000,115999,False,126,scaffold_5
12,3451001,3498000,46999,False,126,scaffold_5
13,3962001,4101000,138999,False,126,scaffold_5
14,4121001,4142000,20999,False,126,scaffold_5
15,4155001,4219000,63999,False,126,scaffold_5
16,4246001,4262000,15999,False,126,scaffold_5
17,4446001,4483000,36999,False,126,scaffold_5
18,4600001,4649000,48999,False,126,scaffold_5
19,4691001,4717000,25999,False,126,scaffold_5
20,4789001,4861000,71999,False,126,scaffold_5
21,4904001,4917000,12999,False,126,scaffold_5
22,5318001,5346000,27999,False,126,scaffold_5
23,7373001,7386000,12999,False,126,scaffold_5
24,8730001,9363000,632999,False,126,scaffold_5
0,79001,84000,4999,False,126,scaffold_6
1,86001,112000,25999,False,126,scaffold_6
2,240001,253000,12999,False,126,scaffold_6
3,257001,262000,4999,False,126,scaffold_6
4,267001,283000,15999,False,126,scaffold_6
5,1228001,1266000,37999,False,126,scaffold_6
6,1479001,1546000,66999,False,126,scaffold_6
7,2023001,2086000,62999,False,126,scaffold_6
8,2135001,2169000,33999,False,126,scaffold_6
9,2371001,2595000,223999,False,126,scaffold_6
10,2596001,2653000,56999,False,126,scaffold_6
11,2661001,2691000,29999,False,126,scaffold_6
12,2731001,2852000,120999,False,126,scaffold_6
13,2928001,3014000,85999,False,126,scaffold_6
14,3115001,3149000,33999,False,126,scaffold_6
15,3224001,3301000,76999,False,126,scaffold_6
16,3408001,3427000,18999,False,126,scaffold_6
17,3462001,3766000,303999,False,126,scaffold_6
18,3901001,3912000,10999,False,126,scaffold_6
19,4018001,4066000,47999,False,126,scaffold_6
20,4086001,4192000,105999,False,126,scaffold_6
21,6011001,6060000,48999,False,126,scaffold_6
22,7282001,7337000,54999,False,126,scaffold_6
23,7560001,7795000,234999,False,126,scaffold_6
24,7811001,8268281,457280,True,126,scaffold_6
0,14001,34000,19999,False,126,scaffold_7
1,169001,171000,1999,False,126,scaffold_7
2,323001,340000,16999,False,126,scaffold_7
3,342001,508000,165999,False,126,scaffold_7
4,554001,563000,8999,False,126,scaffold_7
5,571001,577000,5999,False,126,scaffold_7
6,706001,736000,29999,False,126,scaffold_7
7,764001,809000,44999,False,126,scaffold_7
8,859001,864000,4999,False,126,scaffold_7
9,982001,1044000,61999,False,126,scaffold_7
10,1191001,1460000,268999,False,126,scaffold_7
11,1461001,1512000,50999,False,126,scaffold_7
12,1588001,1689000,100999,False,126,scaffold_7
13,3326001,3369000,42999,False,126,scaffold_7
14,3595001,3649000,53999,False,126,scaffold_7
15,4416001,4535000,118999,False,126,scaffold_7
16,4658001,4682000,23999,False,126,scaffold_7
17,4979001,5030000,50999,False,126,scaffold_7
18,5073001,5111000,37999,False,126,scaffold_7
19,5609001,5628000,18999,False,126,scaffold_7
20,6955001,7270000,314999,False,126,scaffold_7
21,7271001,7502216,231215,True,126,scaffold_7
0,1,7000,6999,True,126,scaffold_8
1,67001,85000,17999,False,126,scaffold_8
2,2538001,2548000,9999,False,126,scaffold_8
3,2745001,2756000,10999,False,126,scaffold_8
4,3060001,3525000,464999,False,126,scaffold_8
5,3585001,3612000,26999,False,126,scaffold_8
6,3615001,3913000,297999,False,126,scaffold_8
7,5124001,5136000,11999,False,126,scaffold_8
8,5199001,5241000,41999,False,126,scaffold_8
9,6329001,6334544,5543,True,126,scaffold_8
0,109001,117000,7999,False,126,scaffold_9
1,303001,315000,11999,False,126,scaffold_9
2,319001,332000,12999,False,126,scaffold_9
3,367001,411000,43999,False,126,scaffold_9
4,413001,434000,20999,False,126,scaffold_9
5,502001,531000,28999,False,126,scaffold_9
6,652001,665000,12999,False,126,scaffold_9
7,671001,697000,25999,False,126,scaffold_9
8,732001,742000,9999,False,126,scaffold_9
9,794001,803000,8999,False,126,scaffold_9
10,815001,842000,26999,False,126,scaffold_9
11,850001,862000,11999,False,126,scaffold_9
12,872001,986000,113999,False,126,scaffold_9
13,988001,1000000,11999,False,126,scaffold_9
14,1001001,1007000,5999,False,126,scaffold_9
15,1010001,1031000,20999,False,126,scaffold_9
16,1035001,1085000,49999,False,126,scaffold_9
17,1087001,1150000,62999,False,126,scaffold_9
18,1151001,1160000,8999,False,126,scaffold_9
19,1313001,1377000,63999,False,126,scaffold_9
20,1767001,1790000,22999,False,126,scaffold_9
21,2601001,2616000,14999,False,126,scaffold_9
22,2874001,3381000,506999,False,126,scaffold_9
23,3383001,5100000,1716999,False,126,scaffold_9
24,5101001,5107000,5999,False,126,scaffold_9
25,5112001,5114000,1999,False,126,scaffold_9
26,5116001,5238000,121999,False,126,scaffold_9
27,5239001,5298000,58999,False,126,scaffold_9
28,5300001,6331288,1031287,True,126,scaffold_9
0,1,136000,135999,True,126,scaffold_10
1,137001,197000,59999,False,126,scaffold_10
2,375001,405000,29999,False,126,scaffold_10
3,472001,482000,9999,False,126,scaffold_10
4,508001,576000,67999,False,126,scaffold_10
5,603001,748000,144999,False,126,scaffold_10
6,888001,916000,27999,False,126,scaffold_10
7,924001,962000,37999,False,126,scaffold_10
8,1087001,1105000,17999,False,126,scaffold_10
9,2346001,2366000,19999,False,126,scaffold_10
10,4054001,4091000,36999,False,126,scaffold_10
11,4154001,4174000,19999,False,126,scaffold_10
12,4446001,4462000,15999,False,126,scaffold_10
13,4467001,4476000,8999,False,126,scaffold_10
14,4506001,4513000,6999,False,126,scaffold_10
15,4527001,4548000,20999,False,126,scaffold_10
16,4575001,4596000,20999,False,126,scaffold_10
17,4679001,4688000,8999,False,126,scaffold_10
18,4734001,4766000,31999,False,126,scaffold_10
19,4767001,4776000,8999,False,126,scaffold_10
20,4791001,4797000,5999,False,126,scaffold_10
21,4798001,4824000,25999,False,126,scaffold_10
22,4827001,4843000,15999,False,126,scaffold_10
23,4848001,4861000,12999,False,126,scaffold_10
24,4865001,4866973,1972,True,126,scaffold_10
0,10001,34000,23999,False,126,scaffold_11
1,38001,92000,53999,False,126,scaffold_11
2,149001,167000,17999,False,126,scaffold_11
3,169001,191000,21999,False,126,scaffold_11
4,211001,235000,23999,False,126,scaffold_11
5,240001,249000,8999,False,126,scaffold_11
6,419001,431000,11999,False,126,scaffold_11
7,648001,656000,7999,False,126,scaffold_11
8,1025001,1034000,8999,False,126,scaffold_11
9,1305001,1307000,1999,False,126,scaffold_11
10,2701001,2872000,170999,False,126,scaffold_11
11,3211001,3254000,42999,False,126,scaffold_11
12,3329001,3371000,41999,False,126,scaffold_11
13,3702001,3926000,223999,False,126,scaffold_11
14,4322001,4710000,387999,False,126,scaffold_11
15,4713001,4766820,53819,True,126,scaffold_11
0,1,241000,240999,True,126,scaffold_12
1,250001,369000,118999,False,126,scaffold_12
2,474001,537000,62999,False,126,scaffold_12
3,582001,856000,273999,False,126,scaffold_12
4,865001,1355000,489999,False,126,scaffold_12
5,1720001,1733000,12999,False,126,scaffold_12
6,2571001,2612000,40999,False,126,scaffold_12
7,2747001,2747968,967,True,126,scaffold_12
0,1,342000,341999,True,127,scaffold_1
1,482001,498000,15999,False,127,scaffold_1
2,570001,643000,72999,False,127,scaffold_1
3,686001,743000,56999,False,127,scaffold_1
4,1817001,1897000,79999,False,127,scaffold_1
5,1952001,1964000,11999,False,127,scaffold_1
6,1965001,1984000,18999,False,127,scaffold_1
7,2449001,2517000,67999,False,127,scaffold_1
8,2729001,2746000,16999,False,127,scaffold_1
9,3179001,3208000,28999,False,127,scaffold_1
10,3715001,3733000,17999,False,127,scaffold_1
11,3916001,3941000,24999,False,127,scaffold_1
12,4063001,4111000,47999,False,127,scaffold_1
13,4315001,4354000,38999,False,127,scaffold_1
14,4928001,4997000,68999,False,127,scaffold_1
15,5484001,5511000,26999,False,127,scaffold_1
16,5536001,5570000,33999,False,127,scaffold_1
17,6108001,6153000,44999,False,127,scaffold_1
18,6154001,6176000,21999,False,127,scaffold_1
19,6228001,6381000,152999,False,127,scaffold_1
20,6384001,6507000,122999,False,127,scaffold_1
21,6545001,6554000,8999,False,127,scaffold_1
22,7038001,7247000,208999,False,127,scaffold_1
23,7248001,7588000,339999,False,127,scaffold_1
24,7590001,8656000,1065999,False,127,scaffold_1
25,8658001,9584000,925999,False,127,scaffold_1
26,9586001,10355000,768999,False,127,scaffold_1
27,10461001,10630000,168999,False,127,scaffold_1
28,10808001,10811000,2999,False,127,scaffold_1
29,10840001,10855000,14999,False,127,scaffold_1
30,11344001,11504000,159999,False,127,scaffold_1
31,11613001,11956000,342999,False,127,scaffold_1
32,12184001,12205000,20999,False,127,scaffold_1
33,12664001,12722000,57999,False,127,scaffold_1
34,12777001,12888000,110999,False,127,scaffold_1
35,13114001,13135000,20999,False,127,scaffold_1
36,13179001,13211000,31999,False,127,scaffold_1
37,13347001,13378000,30999,False,127,scaffold_1
38,14007001,14009000,1999,False,127,scaffold_1
39,14297001,14306000,8999,False,127,scaffold_1
40,14560001,14562000,1999,False,127,scaffold_1
0,20001,48000,27999,False,127,scaffold_2
1,93001,159000,65999,False,127,scaffold_2
2,165001,177000,11999,False,127,scaffold_2
3,302001,318000,15999,False,127,scaffold_2
4,330001,374000,43999,False,127,scaffold_2
5,2336001,2358000,21999,False,127,scaffold_2
6,2403001,2424000,20999,False,127,scaffold_2
7,2441001,2553000,111999,False,127,scaffold_2
8,2660001,2689000,28999,False,127,scaffold_2
9,2694001,2746000,51999,False,127,scaffold_2
10,2974001,3013000,38999,False,127,scaffold_2
11,3454001,3463000,8999,False,127,scaffold_2
12,3760001,3783000,22999,False,127,scaffold_2
13,4382001,4409000,26999,False,127,scaffold_2
14,4426001,4457000,30999,False,127,scaffold_2
15,4521001,4555000,33999,False,127,scaffold_2
16,4595001,4656000,60999,False,127,scaffold_2
17,4784001,4790000,5999,False,127,scaffold_2
18,4919001,4934000,14999,False,127,scaffold_2
19,5022001,5031000,8999,False,127,scaffold_2
20,5033001,5061000,27999,False,127,scaffold_2
21,5491001,5511000,19999,False,127,scaffold_2
22,5672001,5704000,31999,False,127,scaffold_2
23,5842001,5882000,39999,False,127,scaffold_2
24,6261001,6350000,88999,False,127,scaffold_2
25,6411001,6449000,37999,False,127,scaffold_2
26,7439001,7473000,33999,False,127,scaffold_2
27,7563001,7697000,133999,False,127,scaffold_2
28,7786001,7890000,103999,False,127,scaffold_2
29,7929001,8161000,231999,False,127,scaffold_2
30,8331001,8333000,1999,False,127,scaffold_2
31,8340001,8345000,4999,False,127,scaffold_2
32,8346001,8453000,106999,False,127,scaffold_2
33,8509001,8537000,27999,False,127,scaffold_2
34,11367001,11374000,6999,False,127,scaffold_2
35,11520001,11786000,265999,False,127,scaffold_2
0,1,2000,1999,True,127,scaffold_3
1,51001,55000,3999,False,127,scaffold_3
2,618001,646000,27999,False,127,scaffold_3
3,798001,900000,101999,False,127,scaffold_3
4,2084001,2108000,23999,False,127,scaffold_3
5,2291001,2321000,29999,False,127,scaffold_3
6,2500001,2533000,32999,False,127,scaffold_3
7,3768001,3821000,52999,False,127,scaffold_3
8,3822001,3859000,36999,False,127,scaffold_3
9,4149001,4398000,248999,False,127,scaffold_3
10,4418001,4518000,99999,False,127,scaffold_3
11,4546001,4558000,11999,False,127,scaffold_3
12,4652001,4681000,28999,False,127,scaffold_3
13,6762001,6779000,16999,False,127,scaffold_3
14,6910001,6962000,51999,False,127,scaffold_3
15,6963001,7082000,118999,False,127,scaffold_3
16,7522001,7556000,33999,False,127,scaffold_3
17,7692001,7732000,39999,False,127,scaffold_3
18,7819001,7840000,20999,False,127,scaffold_3
19,8208001,8255000,46999,False,127,scaffold_3
20,8462001,8527000,64999,False,127,scaffold_3
21,8575001,8593000,17999,False,127,scaffold_3
22,9968001,9996000,27999,False,127,scaffold_3
23,10461001,10483000,21999,False,127,scaffold_3
24,10587001,11162000,574999,False,127,scaffold_3
0,17001,32000,14999,False,127,scaffold_4
1,48001,88000,39999,False,127,scaffold_4
2,133001,146000,12999,False,127,scaffold_4
3,147001,151000,3999,False,127,scaffold_4
4,155001,160000,4999,False,127,scaffold_4
5,161001,215000,53999,False,127,scaffold_4
6,217001,226000,8999,False,127,scaffold_4
7,227001,241000,13999,False,127,scaffold_4
8,242001,266000,23999,False,127,scaffold_4
9,319001,344000,24999,False,127,scaffold_4
10,355001,374000,18999,False,127,scaffold_4
11,375001,380000,4999,False,127,scaffold_4
12,412001,425000,12999,False,127,scaffold_4
13,429001,504000,74999,False,127,scaffold_4
14,545001,606000,60999,False,127,scaffold_4
15,608001,691000,82999,False,127,scaffold_4
16,1120001,1136000,15999,False,127,scaffold_4
17,1137001,1178000,40999,False,127,scaffold_4
18,1229001,1231000,1999,False,127,scaffold_4
19,1235001,1253000,17999,False,127,scaffold_4
20,1270001,1279000,8999,False,127,scaffold_4
21,1283001,1315000,31999,False,127,scaffold_4
22,1375001,1591000,215999,False,127,scaffold_4
23,1613001,1617000,3999,False,127,scaffold_4
24,1627001,1640000,12999,False,127,scaffold_4
25,1659001,1689000,29999,False,127,scaffold_4
26,1749001,1849000,99999,False,127,scaffold_4
27,1850001,1868000,17999,False,127,scaffold_4
28,1904001,1957000,52999,False,127,scaffold_4
29,1958001,2002000,43999,False,127,scaffold_4
30,2035001,2065000,29999,False,127,scaffold_4
31,2284001,2340000,55999,False,127,scaffold_4
32,2428001,2461000,32999,False,127,scaffold_4
33,2480001,2533000,52999,False,127,scaffold_4
34,3336001,3633000,296999,False,127,scaffold_4
35,3649001,3760000,110999,False,127,scaffold_4
36,4941001,4985000,43999,False,127,scaffold_4
37,4989001,4994000,4999,False,127,scaffold_4
38,5477001,5506000,28999,False,127,scaffold_4
39,5514001,5620000,105999,False,127,scaffold_4
40,5659001,5784000,124999,False,127,scaffold_4
41,5786001,5817000,30999,False,127,scaffold_4
42,6149001,6191000,41999,False,127,scaffold_4
43,6908001,6924000,15999,False,127,scaffold_4
44,7036001,7062000,25999,False,127,scaffold_4
45,8849001,9699000,849999,False,127,scaffold_4
46,9703001,9845951,142950,True,127,scaffold_4
0,1,4000,3999,True,127,scaffold_5
1,196001,204000,7999,False,127,scaffold_5
2,318001,326000,7999,False,127,scaffold_5
3,327001,382000,54999,False,127,scaffold_5
4,462001,523000,60999,False,127,scaffold_5
5,668001,680000,11999,False,127,scaffold_5
6,933001,947000,13999,False,127,scaffold_5
7,2565001,2590000,24999,False,127,scaffold_5
8,2625001,2737000,111999,False,127,scaffold_5
9,2813001,2871000,57999,False,127,scaffold_5
10,3137001,3185000,47999,False,127,scaffold_5
11,3322001,3438000,115999,False,127,scaffold_5
12,3451001,3497000,45999,False,127,scaffold_5
13,3962001,4101000,138999,False,127,scaffold_5
14,4120001,4220000,99999,False,127,scaffold_5
15,4246001,4272000,25999,False,127,scaffold_5
16,4444001,4500000,55999,False,127,scaffold_5
17,4601001,4717000,115999,False,127,scaffold_5
18,4761001,4861000,99999,False,127,scaffold_5
19,4904001,4921000,16999,False,127,scaffold_5
20,5287001,5312000,24999,False,127,scaffold_5
21,5314001,5344000,29999,False,127,scaffold_5
22,6511001,6566000,54999,False,127,scaffold_5
23,7373001,7386000,12999,False,127,scaffold_5
24,7580001,7619000,38999,False,127,scaffold_5
25,7622001,7637000,14999,False,127,scaffold_5
26,8730001,9363000,632999,False,127,scaffold_5
27,9364001,9364176,175,True,127,scaffold_5
0,79001,113000,33999,False,127,scaffold_6
1,240001,254000,13999,False,127,scaffold_6
2,257001,262000,4999,False,127,scaffold_6
3,267001,283000,15999,False,127,scaffold_6
4,1238001,1256000,17999,False,127,scaffold_6
5,1479001,1546000,66999,False,127,scaffold_6
6,2023001,2096000,72999,False,127,scaffold_6
7,2134001,2168000,33999,False,127,scaffold_6
8,2369001,2653000,283999,False,127,scaffold_6
9,2660001,2691000,30999,False,127,scaffold_6
10,2731001,2854000,122999,False,127,scaffold_6
11,2936001,3014000,77999,False,127,scaffold_6
12,3114001,3149000,34999,False,127,scaffold_6
13,3224001,3301000,76999,False,127,scaffold_6
14,3406001,3429000,22999,False,127,scaffold_6
15,3459001,3766000,306999,False,127,scaffold_6
16,3901001,3912000,10999,False,127,scaffold_6
17,4018001,4072000,53999,False,127,scaffold_6
18,4083001,4194000,110999,False,127,scaffold_6
19,6010001,6060000,49999,False,127,scaffold_6
20,7263001,7337000,73999,False,127,scaffold_6
21,7541001,8268281,727280,True,127,scaffold_6
0,1,7000,6999,True,127,scaffold_7
1,13001,34000,20999,False,127,scaffold_7
2,323001,340000,16999,False,127,scaffold_7
3,342001,505000,162999,False,127,scaffold_7
4,554001,563000,8999,False,127,scaffold_7
5,571001,577000,5999,False,127,scaffold_7
6,706001,736000,29999,False,127,scaffold_7
7,741001,753000,11999,False,127,scaffold_7
8,764001,829000,64999,False,127,scaffold_7
9,830001,843000,12999,False,127,scaffold_7
10,859001,864000,4999,False,127,scaffold_7
11,968001,980000,11999,False,127,scaffold_7
12,982001,1044000,61999,False,127,scaffold_7
13,1048001,1101000,52999,False,127,scaffold_7
14,1204001,1460000,255999,False,127,scaffold_7
15,1461001,1512000,50999,False,127,scaffold_7
16,1588001,1688000,99999,False,127,scaffold_7
17,3304001,3312000,7999,False,127,scaffold_7
18,3324001,3372000,47999,False,127,scaffold_7
19,3540001,3544000,3999,False,127,scaffold_7
20,3595001,3703000,107999,False,127,scaffold_7
21,4415001,4535000,119999,False,127,scaffold_7
22,4658001,4734000,75999,False,127,scaffold_7
23,4978001,5114000,135999,False,127,scaffold_7
24,5484001,5535000,50999,False,127,scaffold_7
25,5609001,5628000,18999,False,127,scaffold_7
26,6954001,7270000,315999,False,127,scaffold_7
27,7271001,7502216,231215,True,127,scaffold_7
0,1,6000,5999,True,127,scaffold_8
1,66001,85000,18999,False,127,scaffold_8
2,2444001,2470000,25999,False,127,scaffold_8
3,2491001,2528000,36999,False,127,scaffold_8
4,2537001,2549000,11999,False,127,scaffold_8
5,2657001,2683000,25999,False,127,scaffold_8
6,2745001,2756000,10999,False,127,scaffold_8
7,2798001,2844000,45999,False,127,scaffold_8
8,3059001,3525000,465999,False,127,scaffold_8
9,3584001,3612000,27999,False,127,scaffold_8
10,3615001,3915000,299999,False,127,scaffold_8
11,5199001,5241000,41999,False,127,scaffold_8
12,6329001,6334544,5543,True,127,scaffold_8
0,109001,117000,7999,False,127,scaffold_9
1,121001,138000,16999,False,127,scaffold_9
2,236001,242000,5999,False,127,scaffold_9
3,303001,315000,11999,False,127,scaffold_9
4,319001,331000,11999,False,127,scaffold_9
5,367001,411000,43999,False,127,scaffold_9
6,413001,434000,20999,False,127,scaffold_9
7,503001,531000,27999,False,127,scaffold_9
8,652001,665000,12999,False,127,scaffold_9
9,670001,696000,25999,False,127,scaffold_9
10,732001,742000,9999,False,127,scaffold_9
11,794001,803000,8999,False,127,scaffold_9
12,816001,843000,26999,False,127,scaffold_9
13,850001,862000,11999,False,127,scaffold_9
14,872001,986000,113999,False,127,scaffold_9
15,988001,995000,6999,False,127,scaffold_9
16,1001001,1007000,5999,False,127,scaffold_9
17,1008001,1031000,22999,False,127,scaffold_9
18,1037001,1085000,47999,False,127,scaffold_9
19,1087001,1150000,62999,False,127,scaffold_9
20,1151001,1165000,13999,False,127,scaffold_9
21,1312001,1377000,64999,False,127,scaffold_9
22,1600001,1615000,14999,False,127,scaffold_9
23,1770001,1788000,17999,False,127,scaffold_9
24,2598001,2616000,17999,False,127,scaffold_9
25,2739001,2759000,19999,False,127,scaffold_9
26,2782001,2803000,20999,False,127,scaffold_9
27,2845001,3381000,535999,False,127,scaffold_9
28,3383001,5110000,1726999,False,127,scaffold_9
29,5112001,5114000,1999,False,127,scaffold_9
30,5116001,5238000,121999,False,127,scaffold_9
31,5239001,5298000,58999,False,127,scaffold_9
32,5299001,5490000,190999,False,127,scaffold_9
33,5493001,6331288,838287,True,127,scaffold_9
0,1,198000,197999,True,127,scaffold_10
1,375001,408000,32999,False,127,scaffold_10
2,471001,482000,10999,False,127,scaffold_10
3,483001,582000,98999,False,127,scaffold_10
4,603001,755000,151999,False,127,scaffold_10
5,888001,916000,27999,False,127,scaffold_10
6,924001,962000,37999,False,127,scaffold_10
7,1073001,1112000,38999,False,127,scaffold_10
8,2346001,2367000,20999,False,127,scaffold_10
9,4002001,4010000,7999,False,127,scaffold_10
10,4053001,4092000,38999,False,127,scaffold_10
11,4154001,4174000,19999,False,127,scaffold_10
12,4443001,4462000,18999,False,127,scaffold_10
13,4467001,4477000,9999,False,127,scaffold_10
14,4515001,4523000,7999,False,127,scaffold_10
15,4526001,4548000,21999,False,127,scaffold_10
16,4574001,4596000,21999,False,127,scaffold_10
17,4680001,4688000,7999,False,127,scaffold_10
18,4735001,4766000,30999,False,127,scaffold_10
19,4769001,4776000,6999,False,127,scaffold_10
20,4798001,4824000,25999,False,127,scaffold_10
21,4828001,4843000,14999,False,127,scaffold_10
22,4848001,4861000,12999,False,127,scaffold_10
23,4865001,4866973,1972,True,127,scaffold_10
0,10001,34000,23999,False,127,scaffold_11
1,39001,93000,53999,False,127,scaffold_11
2,149001,167000,17999,False,127,scaffold_11
3,169001,191000,21999,False,127,scaffold_11
4,213001,235000,21999,False,127,scaffold_11
5,419001,431000,11999,False,127,scaffold_11
6,648001,656000,7999,False,127,scaffold_11
7,1025001,1034000,8999,False,127,scaffold_11
8,1423001,1426000,2999,False,127,scaffold_11
9,1474001,1477000,2999,False,127,scaffold_11
10,2701001,2873000,171999,False,127,scaffold_11
11,3188001,3259000,70999,False,127,scaffold_11
12,3328001,3383000,54999,False,127,scaffold_11
13,3702001,3927000,224999,False,127,scaffold_11
14,4134001,4159000,24999,False,127,scaffold_11
15,4321001,4710000,388999,False,127,scaffold_11
16,4713001,4766820,53819,True,127,scaffold_11
0,1,369000,368999,True,127,scaffold_12
1,474001,537000,62999,False,127,scaffold_12
2,582001,1429000,846999,False,127,scaffold_12
3,1720001,1733000,12999,False,127,scaffold_12
4,2571001,2619000,47999,False,127,scaffold_12
5,2685001,2699000,13999,False,127,scaffold_12
0,1,342000,341999,True,128,scaffold_1
1,482001,498000,15999,False,128,scaffold_1
2,571001,643000,71999,False,128,scaffold_1
3,686001,714000,27999,False,128,scaffold_1
4,727001,743000,15999,False,128,scaffold_1
5,1281001,1292000,10999,False,128,scaffold_1
6,1954001,1964000,9999,False,128,scaffold_1
7,1965001,1984000,18999,False,128,scaffold_1
8,2449001,2469000,19999,False,128,scaffold_1
9,2473001,2513000,39999,False,128,scaffold_1
10,2729001,2746000,16999,False,128,scaffold_1
11,3181001,3208000,26999,False,128,scaffold_1
12,3715001,3733000,17999,False,128,scaffold_1
13,3916001,3941000,24999,False,128,scaffold_1
14,4063001,4111000,47999,False,128,scaffold_1
15,4315001,4354000,38999,False,128,scaffold_1
16,4928001,4983000,54999,False,128,scaffold_1
17,5484001,5511000,26999,False,128,scaffold_1
18,6108001,6153000,44999,False,128,scaffold_1
19,6154001,6176000,21999,False,128,scaffold_1
20,6228001,6382000,153999,False,128,scaffold_1
21,6384001,6509000,124999,False,128,scaffold_1
22,6545001,6554000,8999,False,128,scaffold_1
23,7038001,7247000,208999,False,128,scaffold_1
24,7248001,7588000,339999,False,128,scaffold_1
25,7590001,8656000,1065999,False,128,scaffold_1
26,8658001,9584000,925999,False,128,scaffold_1
27,9586001,10354000,767999,False,128,scaffold_1
28,10461001,10636000,174999,False,128,scaffold_1
29,10808001,10811000,2999,False,128,scaffold_1
30,10836001,10858000,21999,False,128,scaffold_1
31,11352001,11504000,151999,False,128,scaffold_1
32,11638001,11951000,312999,False,128,scaffold_1
33,12184001,12204000,19999,False,128,scaffold_1
34,12667001,12722000,54999,False,128,scaffold_1
35,12777001,12888000,110999,False,128,scaffold_1
36,13115001,13134000,18999,False,128,scaffold_1
37,13180001,13211000,30999,False,128,scaffold_1
38,13347001,13377000,29999,False,128,scaffold_1
39,14007001,14009000,1999,False,128,scaffold_1
0,21001,48000,26999,False,128,scaffold_2
1,117001,159000,41999,False,128,scaffold_2
2,168001,177000,8999,False,128,scaffold_2
3,313001,318000,4999,False,128,scaffold_2
4,331001,374000,42999,False,128,scaffold_2
5,2336001,2358000,21999,False,128,scaffold_2
6,2405001,2415000,9999,False,128,scaffold_2
7,2416001,2424000,7999,False,128,scaffold_2
8,2441001,2553000,111999,False,128,scaffold_2
9,2660001,2689000,28999,False,128,scaffold_2
10,2694001,2742000,47999,False,128,scaffold_2
11,2777001,2788000,10999,False,128,scaffold_2
12,2975001,3021000,45999,False,128,scaffold_2
13,3451001,3465000,13999,False,128,scaffold_2
14,3759001,3783000,23999,False,128,scaffold_2
15,4385001,4409000,23999,False,128,scaffold_2
16,4427001,4457000,29999,False,128,scaffold_2
17,4521001,4555000,33999,False,128,scaffold_2
18,4606001,4653000,46999,False,128,scaffold_2
19,4783001,4790000,6999,False,128,scaffold_2
20,5022001,5031000,8999,False,128,scaffold_2
21,5033001,5061000,27999,False,128,scaffold_2
22,5491001,5514000,22999,False,128,scaffold_2
23,5672001,5704000,31999,False,128,scaffold_2
24,6261001,6330000,68999,False,128,scaffold_2
25,6331001,6350000,18999,False,128,scaffold_2
26,6430001,6447000,16999,False,128,scaffold_2
27,7439001,7473000,33999,False,128,scaffold_2
28,7563001,7697000,133999,False,128,scaffold_2
29,7786001,7890000,103999,False,128,scaffold_2
30,7934001,7965000,30999,False,128,scaffold_2
31,7984001,8088000,103999,False,128,scaffold_2
32,8331001,8333000,1999,False,128,scaffold_2
33,8346001,8389000,42999,False,128,scaffold_2
34,8417001,8453000,35999,False,128,scaffold_2
35,8509001,8545000,35999,False,128,scaffold_2
36,11367001,11374000,6999,False,128,scaffold_2
37,11520001,11785000,264999,False,128,scaffold_2
0,1,2000,1999,True,128,scaffold_3
1,51001,55000,3999,False,128,scaffold_3
2,102001,104000,1999,False,128,scaffold_3
3,800001,901000,100999,False,128,scaffold_3
4,2085001,2108000,22999,False,128,scaffold_3
5,2291001,2321000,29999,False,128,scaffold_3
6,2510001,2533000,22999,False,128,scaffold_3
7,4149001,4403000,253999,False,128,scaffold_3
8,4410001,4518000,107999,False,128,scaffold_3
9,4546001,4558000,11999,False,128,scaffold_3
10,4652001,4678000,25999,False,128,scaffold_3
11,5578001,5581000,2999,False,128,scaffold_3
12,6911001,6962000,50999,False,128,scaffold_3
13,6979001,7036000,56999,False,128,scaffold_3
14,7524001,7556000,31999,False,128,scaffold_3
15,7692001,7728000,35999,False,128,scaffold_3
16,7821001,7838000,16999,False,128,scaffold_3
17,8208001,8255000,46999,False,128,scaffold_3
18,8462001,8527000,64999,False,128,scaffold_3
19,8575001,8594000,18999,False,128,scaffold_3
20,9968001,9995000,26999,False,128,scaffold_3
21,10461001,10484000,22999,False,128,scaffold_3
22,10587001,11165000,577999,False,128,scaffold_3
0,17001,32000,14999,False,128,scaffold_4
1,48001,88000,39999,False,128,scaffold_4
2,155001,160000,4999,False,128,scaffold_4
3,161001,215000,53999,False,128,scaffold_4
4,217001,226000,8999,False,128,scaffold_4
5,227001,266000,38999,False,128,scaffold_4
6,294001,307000,12999,False,128,scaffold_4
7,355001,374000,18999,False,128,scaffold_4
8,375001,380000,4999,False,128,scaffold_4
9,389001,410000,20999,False,128,scaffold_4
10,412001,425000,12999,False,128,scaffold_4
11,429001,498000,68999,False,128,scaffold_4
12,545001,599000,53999,False,128,scaffold_4
13,608001,661000,52999,False,128,scaffold_4
14,670001,691000,20999,False,128,scaffold_4
15,701001,714000,12999,False,128,scaffold_4
16,1121001,1136000,14999,False,128,scaffold_4
17,1137001,1178000,40999,False,128,scaffold_4
18,1199001,1208000,8999,False,128,scaffold_4
19,1210001,1226000,15999,False,128,scaffold_4
20,1235001,1246000,10999,False,128,scaffold_4
21,1248001,1253000,4999,False,128,scaffold_4
22,1254001,1262000,7999,False,128,scaffold_4
23,1265001,1279000,13999,False,128,scaffold_4
24,1283001,1319000,35999,False,128,scaffold_4
25,1376001,1421000,44999,False,128,scaffold_4
26,1432001,1591000,158999,False,128,scaffold_4
27,1749001,1816000,66999,False,128,scaffold_4
28,1932001,1957000,24999,False,128,scaffold_4
29,1958001,1975000,16999,False,128,scaffold_4
30,2211001,2218000,6999,False,128,scaffold_4
31,2247001,2279000,31999,False,128,scaffold_4
32,2284001,2340000,55999,False,128,scaffold_4
33,2476001,2533000,56999,False,128,scaffold_4
34,3336001,3632000,295999,False,128,scaffold_4
35,3676001,3760000,83999,False,128,scaffold_4
36,4944001,4984000,39999,False,128,scaffold_4
37,5477001,5506000,28999,False,128,scaffold_4
38,5514001,5620000,105999,False,128,scaffold_4
39,5669001,5784000,114999,False,128,scaffold_4
40,6807001,6817000,9999,False,128,scaffold_4
41,7036001,7062000,25999,False,128,scaffold_4
42,8846001,9699000,852999,False,128,scaffold_4
43,9700001,9845951,145950,True,128,scaffold_4
0,192001,204000,11999,False,128,scaffold_5
1,296001,299000,2999,False,128,scaffold_5
2,318001,368000,49999,False,128,scaffold_5
3,463001,523000,59999,False,128,scaffold_5
4,933001,947000,13999,False,128,scaffold_5
5,1036001,1038000,1999,False,128,scaffold_5
6,1062001,1068000,5999,False,128,scaffold_5
7,2565001,2582000,16999,False,128,scaffold_5
8,2625001,2732000,106999,False,128,scaffold_5
9,2816001,2871000,54999,False,128,scaffold_5
10,3134001,3185000,50999,False,128,scaffold_5
11,3322001,3438000,115999,False,128,scaffold_5
12,3451001,3498000,46999,False,128,scaffold_5
13,3962001,4101000,138999,False,128,scaffold_5
14,4121001,4142000,20999,False,128,scaffold_5
15,4155001,4219000,63999,False,128,scaffold_5
16,4246001,4263000,16999,False,128,scaffold_5
17,4447001,4483000,35999,False,128,scaffold_5
18,4600001,4650000,49999,False,128,scaffold_5
19,4691001,4717000,25999,False,128,scaffold_5
20,4811001,4861000,49999,False,128,scaffold_5
21,4894001,4918000,23999,False,128,scaffold_5
22,5318001,5346000,27999,False,128,scaffold_5
23,6534001,6566000,31999,False,128,scaffold_5
24,7097001,7100000,2999,False,128,scaffold_5
25,7373001,7386000,12999,False,128,scaffold_5
26,7582001,7608000,25999,False,128,scaffold_5
27,7622001,7638000,15999,False,128,scaffold_5
28,8730001,9363000,632999,False,128,scaffold_5
0,79001,85000,5999,False,128,scaffold_6
1,86001,112000,25999,False,128,scaffold_6
2,239001,253000,13999,False,128,scaffold_6
3,257001,262000,4999,False,128,scaffold_6
4,1238001,1258000,19999,False,128,scaffold_6
5,1479001,1546000,66999,False,128,scaffold_6
6,2023001,2087000,63999,False,128,scaffold_6
7,2130001,2194000,63999,False,128,scaffold_6
8,2371001,2595000,223999,False,128,scaffold_6
9,2596001,2653000,56999,False,128,scaffold_6
10,2657001,2691000,33999,False,128,scaffold_6
11,2731001,2851000,119999,False,128,scaffold_6
12,2933001,3014000,80999,False,128,scaffold_6
13,3115001,3149000,33999,False,128,scaffold_6
14,3223001,3301000,77999,False,128,scaffold_6
15,3407001,3428000,20999,False,128,scaffold_6
16,3462001,3766000,303999,False,128,scaffold_6
17,3901001,3912000,10999,False,128,scaffold_6
18,4018001,4066000,47999,False,128,scaffold_6
19,4081001,4193000,111999,False,128,scaffold_6
20,6011001,6060000,48999,False,128,scaffold_6
21,7284001,7337000,52999,False,128,scaffold_6
22,7560001,7795000,234999,False,128,scaffold_6
23,7811001,8268281,457280,True,128,scaffold_6
0,1,8000,7999,True,128,scaffold_7
1,13001,31000,17999,False,128,scaffold_7
2,323001,340000,16999,False,128,scaffold_7
3,342001,508000,165999,False,128,scaffold_7
4,554001,563000,8999,False,128,scaffold_7
5,571001,577000,5999,False,128,scaffold_7
6,706001,736000,29999,False,128,scaffold_7
7,764001,809000,44999,False,128,scaffold_7
8,859001,864000,4999,False,128,scaffold_7
9,964001,966000,1999,False,128,scaffold_7
10,982001,1044000,61999,False,128,scaffold_7
11,1048001,1096000,47999,False,128,scaffold_7
12,1191001,1512000,320999,False,128,scaffold_7
13,1588001,1689000,100999,False,128,scaffold_7
14,3326001,3369000,42999,False,128,scaffold_7
15,3596001,3649000,52999,False,128,scaffold_7
16,3718001,3766000,47999,False,128,scaffold_7
17,4418001,4535000,116999,False,128,scaffold_7
18,4658001,4734000,75999,False,128,scaffold_7
19,4979001,5030000,50999,False,128,scaffold_7
20,5074001,5114000,39999,False,128,scaffold_7
21,5484001,5515000,30999,False,128,scaffold_7
22,5609001,5628000,18999,False,128,scaffold_7
23,6954001,7270000,315999,False,128,scaffold_7
24,7271001,7502216,231215,True,128,scaffold_7
0,67001,85000,17999,False,128,scaffold_8
1,2444001,2470000,25999,False,128,scaffold_8
2,2492001,2513000,20999,False,128,scaffold_8
3,2661001,2683000,21999,False,128,scaffold_8
4,2742001,2757000,14999,False,128,scaffold_8
5,2813001,2844000,30999,False,128,scaffold_8
6,3059001,3525000,465999,False,128,scaffold_8
7,3584001,3612000,27999,False,128,scaffold_8
8,3615001,3913000,297999,False,128,scaffold_8
9,5125001,5135000,9999,False,128,scaffold_8
10,5200001,5241000,40999,False,128,scaffold_8
11,6329001,6334544,5543,True,128,scaffold_8
0,109001,117000,7999,False,128,scaffold_9
1,302001,315000,12999,False,128,scaffold_9
2,319001,332000,12999,False,128,scaffold_9
3,367001,411000,43999,False,128,scaffold_9
4,413001,434000,20999,False,128,scaffold_9
5,502001,531000,28999,False,128,scaffold_9
6,548001,561000,12999,False,128,scaffold_9
7,652001,664000,11999,False,128,scaffold_9
8,671001,696000,24999,False,128,scaffold_9
9,732001,742000,9999,False,128,scaffold_9
10,794001,803000,8999,False,128,scaffold_9
11,816001,845000,28999,False,128,scaffold_9
12,886001,986000,99999,False,128,scaffold_9
13,988001,995000,6999,False,128,scaffold_9
14,1001001,1006000,4999,False,128,scaffold_9
15,1009001,1031000,21999,False,128,scaffold_9
16,1035001,1085000,49999,False,128,scaffold_9
17,1087001,1150000,62999,False,128,scaffold_9
18,1151001,1165000,13999,False,128,scaffold_9
19,1312001,1377000,64999,False,128,scaffold_9
20,1770001,1783000,12999,False,128,scaffold_9
21,2601001,2616000,14999,False,128,scaffold_9
22,2872001,3381000,508999,False,128,scaffold_9
23,3383001,5107000,1723999,False,128,scaffold_9
24,5112001,5238000,125999,False,128,scaffold_9
25,5239001,5298000,58999,False,128,scaffold_9
26,5300001,5490000,189999,False,128,scaffold_9
27,5493001,6331288,838287,True,128,scaffold_9
0,1,197000,196999,True,128,scaffold_10
1,375001,405000,29999,False,128,scaffold_10
2,508001,576000,67999,False,128,scaffold_10
3,603001,753000,149999,False,128,scaffold_10
4,888001,917000,28999,False,128,scaffold_10
5,923001,962000,38999,False,128,scaffold_10
6,1087001,1111000,23999,False,128,scaffold_10
7,2346001,2366000,19999,False,128,scaffold_10
8,4054001,4091000,36999,False,128,scaffold_10
9,4154001,4174000,19999,False,128,scaffold_10
10,4447001,4462000,14999,False,128,scaffold_10
11,4506001,4513000,6999,False,128,scaffold_10
12,4515001,4523000,7999,False,128,scaffold_10
13,4526001,4548000,21999,False,128,scaffold_10
14,4576001,4596000,19999,False,128,scaffold_10
15,4681001,4688000,6999,False,128,scaffold_10
16,4734001,4766000,31999,False,128,scaffold_10
17,4769001,4776000,6999,False,128,scaffold_10
18,4798001,4824000,25999,False,128,scaffold_10
19,4828001,4843000,14999,False,128,scaffold_10
20,4848001,4861000,12999,False,128,scaffold_10
21,4865001,4866973,1972,True,128,scaffold_10
0,10001,34000,23999,False,128,scaffold_11
1,40001,93000,52999,False,128,scaffold_11
2,149001,167000,17999,False,128,scaffold_11
3,169001,191000,21999,False,128,scaffold_11
4,213001,235000,21999,False,128,scaffold_11
5,240001,247000,6999,False,128,scaffold_11
6,419001,431000,11999,False,128,scaffold_11
7,648001,656000,7999,False,128,scaffold_11
8,1025001,1034000,8999,False,128,scaffold_11
9,1423001,1426000,2999,False,128,scaffold_11
10,1474001,1477000,2999,False,128,scaffold_11
11,2702001,2872000,169999,False,128,scaffold_11
12,3213001,3254000,40999,False,128,scaffold_11
13,3331001,3370000,38999,False,128,scaffold_11
14,3702001,3926000,223999,False,128,scaffold_11
15,4319001,4710000,390999,False,128,scaffold_11
16,4713001,4766820,53819,True,128,scaffold_11
0,1,370000,369999,True,128,scaffold_12
1,474001,537000,62999,False,128,scaffold_12
2,579001,856000,276999,False,128,scaffold_12
3,867001,1354000,486999,False,128,scaffold_12
4,1720001,1733000,12999,False,128,scaffold_12
5,2571001,2609000,37999,False,128,scaffold_12
0,1,342000,341999,True,129,scaffold_1
1,482001,498000,15999,False,129,scaffold_1
2,571001,643000,71999,False,129,scaffold_1
3,686001,759000,72999,False,129,scaffold_1
4,1281001,1292000,10999,False,129,scaffold_1
5,1615001,1660000,44999,False,129,scaffold_1
6,1818001,1898000,79999,False,129,scaffold_1
7,1954001,1964000,9999,False,129,scaffold_1
8,1965001,1984000,18999,False,129,scaffold_1
9,1988001,1993000,4999,False,129,scaffold_1
10,2449001,2517000,67999,False,129,scaffold_1
11,2729001,2746000,16999,False,129,scaffold_1
12,3173001,3209000,35999,False,129,scaffold_1
13,3712001,3734000,21999,False,129,scaffold_1
14,3922001,3941000,18999,False,129,scaffold_1
15,4062001,4112000,49999,False,129,scaffold_1
16,4315001,4354000,38999,False,129,scaffold_1
17,4927001,4998000,70999,False,129,scaffold_1
18,5481001,5511000,29999,False,129,scaffold_1
19,5536001,5569000,32999,False,129,scaffold_1
20,6108001,6153000,44999,False,129,scaffold_1
21,6228001,6379000,150999,False,129,scaffold_1
22,6384001,6509000,124999,False,129,scaffold_1
23,6545001,6554000,8999,False,129,scaffold_1
24,7037001,7247000,209999,False,129,scaffold_1
25,7248001,7584000,335999,False,129,scaffold_1
26,7590001,8477000,886999,False,129,scaffold_1
27,8478001,8656000,177999,False,129,scaffold_1
28,8658001,9584000,925999,False,129,scaffold_1
29,9586001,10355000,768999,False,129,scaffold_1
30,10461001,10625000,163999,False,129,scaffold_1
31,10808001,10811000,2999,False,129,scaffold_1
32,10836001,10858000,21999,False,129,scaffold_1
33,11345001,11504000,158999,False,129,scaffold_1
34,11560001,11951000,390999,False,129,scaffold_1
35,12184001,12204000,19999,False,129,scaffold_1
36,12652001,12722000,69999,False,129,scaffold_1
37,12777001,12888000,110999,False,129,scaffold_1
38,13113001,13212000,98999,False,129,scaffold_1
39,13347001,13404000,56999,False,129,scaffold_1
40,14290001,14309000,18999,False,129,scaffold_1
41,14471001,14479000,7999,False,129,scaffold_1
0,21001,48000,26999,False,129,scaffold_2
1,93001,159000,65999,False,129,scaffold_2
2,168001,177000,8999,False,129,scaffold_2
3,311001,318000,6999,False,129,scaffold_2
4,330001,374000,43999,False,129,scaffold_2
5,2336001,2358000,21999,False,129,scaffold_2
6,2404001,2424000,19999,False,129,scaffold_2
7,2441001,2554000,112999,False,129,scaffold_2
8,2645001,2689000,43999,False,129,scaffold_2
9,2694001,2742000,47999,False,129,scaffold_2
10,2777001,2788000,10999,False,129,scaffold_2
11,2842001,2852000,9999,False,129,scaffold_2
12,2868001,2902000,33999,False,129,scaffold_2
13,2993001,3012000,18999,False,129,scaffold_2
14,3450001,3465000,14999,False,129,scaffold_2
15,3759001,3783000,23999,False,129,scaffold_2
16,4384001,4409000,24999,False,129,scaffold_2
17,4427001,4457000,29999,False,129,scaffold_2
18,4517001,4656000,138999,False,129,scaffold_2
19,4784001,4790000,5999,False,129,scaffold_2
20,5022001,5031000,8999,False,129,scaffold_2
21,5033001,5061000,27999,False,129,scaffold_2
22,5372001,5392000,19999,False,129,scaffold_2
23,5433001,5476000,42999,False,129,scaffold_2
24,5491001,5513000,21999,False,129,scaffold_2
25,5672001,5704000,31999,False,129,scaffold_2
26,5719001,5757000,37999,False,129,scaffold_2
27,5841001,5887000,45999,False,129,scaffold_2
28,6261001,6330000,68999,False,129,scaffold_2
29,6331001,6350000,18999,False,129,scaffold_2
30,6427001,6449000,21999,False,129,scaffold_2
31,6592001,6628000,35999,False,129,scaffold_2
32,7018001,7037000,18999,False,129,scaffold_2
33,7439001,7472000,32999,False,129,scaffold_2
34,7550001,7561000,10999,False,129,scaffold_2
35,7563001,7697000,133999,False,129,scaffold_2
36,7786001,7890000,103999,False,129,scaffold_2
37,7934001,7966000,31999,False,129,scaffold_2
38,7984001,8161000,176999,False,129,scaffold_2
39,8261001,8295000,33999,False,129,scaffold_2
40,8331001,8333000,1999,False,129,scaffold_2
41,8346001,8389000,42999,False,129,scaffold_2
42,8436001,8454000,17999,False,129,scaffold_2
43,8509001,8562000,52999,False,129,scaffold_2
44,10710001,10730000,19999,False,129,scaffold_2
45,11367001,11375000,7999,False,129,scaffold_2
46,11520001,11785000,264999,False,129,scaffold_2
0,1,2000,1999,True,129,scaffold_3
1,51001,55000,3999,False,129,scaffold_3
2,102001,104000,1999,False,129,scaffold_3
3,203001,207000,3999,False,129,scaffold_3
4,798001,901000,102999,False,129,scaffold_3
5,2083001,2108000,24999,False,129,scaffold_3
6,2291001,2321000,29999,False,129,scaffold_3
7,2485001,2533000,47999,False,129,scaffold_3
8,3769001,3816000,46999,False,129,scaffold_3
9,3826001,3840000,13999,False,129,scaffold_3
10,4108001,4403000,294999,False,129,scaffold_3
11,4416001,4518000,101999,False,129,scaffold_3
12,4547001,4558000,10999,False,129,scaffold_3
13,4653001,4679000,25999,False,129,scaffold_3
14,5492001,5509000,16999,False,129,scaffold_3
15,5990001,6023000,32999,False,129,scaffold_3
16,6909001,6962000,52999,False,129,scaffold_3
17,6980001,7089000,108999,False,129,scaffold_3
18,7339001,7362000,22999,False,129,scaffold_3
19,7516001,7556000,39999,False,129,scaffold_3
20,7692001,7847000,154999,False,129,scaffold_3
21,8177001,8255000,77999,False,129,scaffold_3
22,8462001,8527000,64999,False,129,scaffold_3
23,8575001,8594000,18999,False,129,scaffold_3
24,9968001,9995000,26999,False,129,scaffold_3
25,10461001,10485000,23999,False,129,scaffold_3
26,10587001,11166000,578999,False,129,scaffold_3
0,11001,13000,1999,False,129,scaffold_4
1,17001,32000,14999,False,129,scaffold_4
2,48001,86000,37999,False,129,scaffold_4
3,135001,146000,10999,False,129,scaffold_4
4,147001,151000,3999,False,129,scaffold_4
5,155001,160000,4999,False,129,scaffold_4
6,161001,215000,53999,False,129,scaffold_4
7,217001,226000,8999,False,129,scaffold_4
8,227001,266000,38999,False,129,scaffold_4
9,291001,311000,19999,False,129,scaffold_4
10,313001,344000,30999,False,129,scaffold_4
11,355001,374000,18999,False,129,scaffold_4
12,375001,380000,4999,False,129,scaffold_4
13,389001,410000,20999,False,129,scaffold_4
14,412001,425000,12999,False,129,scaffold_4
15,429001,498000,68999,False,129,scaffold_4
16,545001,592000,46999,False,129,scaffold_4
17,608001,661000,52999,False,129,scaffold_4
18,670001,691000,20999,False,129,scaffold_4
19,695001,697000,1999,False,129,scaffold_4
20,701001,714000,12999,False,129,scaffold_4
21,1121001,1136000,14999,False,129,scaffold_4
22,1137001,1186000,48999,False,129,scaffold_4
23,1199001,1226000,26999,False,129,scaffold_4
24,1235001,1246000,10999,False,129,scaffold_4
25,1248001,1253000,4999,False,129,scaffold_4
26,1254001,1262000,7999,False,129,scaffold_4
27,1265001,1279000,13999,False,129,scaffold_4
28,1283001,1320000,36999,False,129,scaffold_4
29,1372001,1597000,224999,False,129,scaffold_4
30,1613001,1849000,235999,False,129,scaffold_4
31,1850001,1957000,106999,False,129,scaffold_4
32,1958001,2004000,45999,False,129,scaffold_4
33,2021001,2069000,47999,False,129,scaffold_4
34,2071001,2117000,45999,False,129,scaffold_4
35,2219001,2246000,26999,False,129,scaffold_4
36,2247001,2279000,31999,False,129,scaffold_4
37,2284001,2310000,25999,False,129,scaffold_4
38,2312001,2340000,27999,False,129,scaffold_4
39,2430001,2442000,11999,False,129,scaffold_4
40,2476001,2536000,59999,False,129,scaffold_4
41,2556001,2581000,24999,False,129,scaffold_4
42,2599001,2635000,35999,False,129,scaffold_4
43,3336001,3632000,295999,False,129,scaffold_4
44,3650001,3760000,109999,False,129,scaffold_4
45,4944001,4985000,40999,False,129,scaffold_4
46,5476001,5506000,29999,False,129,scaffold_4
47,5515001,5620000,104999,False,129,scaffold_4
48,5661001,5784000,122999,False,129,scaffold_4
49,5786001,5824000,37999,False,129,scaffold_4
50,6145001,6191000,45999,False,129,scaffold_4
51,6797001,6817000,19999,False,129,scaffold_4
52,6900001,6924000,23999,False,129,scaffold_4
53,7036001,7062000,25999,False,129,scaffold_4
54,7232001,7266000,33999,False,129,scaffold_4
55,8846001,9699000,852999,False,129,scaffold_4
56,9703001,9845951,142950,True,129,scaffold_4
0,178001,180000,1999,False,129,scaffold_5
1,189001,204000,14999,False,129,scaffold_5
2,296001,300000,3999,False,129,scaffold_5
3,318001,383000,64999,False,129,scaffold_5
4,463001,523000,59999,False,129,scaffold_5
5,839001,842000,2999,False,129,scaffold_5
6,933001,947000,13999,False,129,scaffold_5
7,1062001,1068000,5999,False,129,scaffold_5
8,2475001,2493000,17999,False,129,scaffold_5
9,2562001,2582000,19999,False,129,scaffold_5
10,2619001,2738000,118999,False,129,scaffold_5
11,2814001,2871000,56999,False,129,scaffold_5
12,3133001,3185000,51999,False,129,scaffold_5
13,3217001,3249000,31999,False,129,scaffold_5
14,3322001,3500000,177999,False,129,scaffold_5
15,3962001,4101000,138999,False,129,scaffold_5
16,4121001,4220000,98999,False,129,scaffold_5
17,4246001,4262000,15999,False,129,scaffold_5
18,4446001,4497000,50999,False,129,scaffold_5
19,4603001,4680000,76999,False,129,scaffold_5
20,4691001,4751000,59999,False,129,scaffold_5
21,4752001,4862000,109999,False,129,scaffold_5
22,4883001,4919000,35999,False,129,scaffold_5
23,5287001,5312000,24999,False,129,scaffold_5
24,5314001,5346000,31999,False,129,scaffold_5
25,5725001,5737000,11999,False,129,scaffold_5
26,6510001,6629000,118999,False,129,scaffold_5
27,7372001,7386000,13999,False,129,scaffold_5
28,7578001,7610000,31999,False,129,scaffold_5
29,7621001,7652000,30999,False,129,scaffold_5
30,8584001,8603000,18999,False,129,scaffold_5
31,8670001,8689000,18999,False,129,scaffold_5
32,8713001,9364176,651175,True,129,scaffold_5
0,78001,114000,35999,False,129,scaffold_6
1,240001,254000,13999,False,129,scaffold_6
2,1239001,1255000,15999,False,129,scaffold_6
3,1478001,1546000,67999,False,129,scaffold_6
4,1867001,1906000,38999,False,129,scaffold_6
5,2025001,2087000,61999,False,129,scaffold_6
6,2129001,2195000,65999,False,129,scaffold_6
7,2336001,2595000,258999,False,129,scaffold_6
8,2596001,2653000,56999,False,129,scaffold_6
9,2655001,2691000,35999,False,129,scaffold_6
10,2713001,2852000,138999,False,129,scaffold_6
11,2928001,3016000,87999,False,129,scaffold_6
12,3114001,3177000,62999,False,129,scaffold_6
13,3223001,3319000,95999,False,129,scaffold_6
14,3407001,3428000,20999,False,129,scaffold_6
15,3458001,3767000,308999,False,129,scaffold_6
16,3898001,3913000,14999,False,129,scaffold_6
17,4018001,4072000,53999,False,129,scaffold_6
18,4073001,4192000,118999,False,129,scaffold_6
19,6010001,6060000,49999,False,129,scaffold_6
20,7263001,7337000,73999,False,129,scaffold_6
21,7389001,7436000,46999,False,129,scaffold_6
22,7549001,7796000,246999,False,129,scaffold_6
23,7811001,8268281,457280,True,129,scaffold_6
0,13001,31000,17999,False,129,scaffold_7
1,200001,202000,1999,False,129,scaffold_7
2,323001,340000,16999,False,129,scaffold_7
3,342001,508000,165999,False,129,scaffold_7
4,554001,563000,8999,False,129,scaffold_7
5,571001,577000,5999,False,129,scaffold_7
6,706001,736000,29999,False,129,scaffold_7
7,743001,753000,9999,False,129,scaffold_7
8,764001,822000,57999,False,129,scaffold_7
9,859001,864000,4999,False,129,scaffold_7
10,964001,966000,1999,False,129,scaffold_7
11,968001,979000,10999,False,129,scaffold_7
12,982001,1044000,61999,False,129,scaffold_7
13,1048001,1104000,55999,False,129,scaffold_7
14,1204001,1512000,307999,False,129,scaffold_7
15,1588001,1688000,99999,False,129,scaffold_7
16,2851001,2869000,17999,False,129,scaffold_7
17,3325001,3370000,44999,False,129,scaffold_7
18,3596001,3766000,169999,False,129,scaffold_7
19,4415001,4535000,119999,False,129,scaffold_7
20,4658001,4733000,74999,False,129,scaffold_7
21,4979001,5149000,169999,False,129,scaffold_7
22,5500001,5512000,11999,False,129,scaffold_7
23,5609001,5627000,17999,False,129,scaffold_7
24,6955001,7270000,314999,False,129,scaffold_7
25,7271001,7502216,231215,True,129,scaffold_7
0,67001,85000,17999,False,129,scaffold_8
1,93001,102000,8999,False,129,scaffold_8
2,2444001,2470000,25999,False,129,scaffold_8
3,2492001,2513000,20999,False,129,scaffold_8
4,2661001,2683000,21999,False,129,scaffold_8
5,2742001,2757000,14999,False,129,scaffold_8
6,2799001,2844000,44999,False,129,scaffold_8
7,3059001,3125000,65999,False,129,scaffold_8
8,3126001,3526000,399999,False,129,scaffold_8
9,3584001,3612000,27999,False,129,scaffold_8
10,3615001,3938000,322999,False,129,scaffold_8
11,4038001,4105000,66999,False,129,scaffold_8
12,4414001,4425000,10999,False,129,scaffold_8
13,5085001,5136000,50999,False,129,scaffold_8
14,5199001,5241000,41999,False,129,scaffold_8
15,5654001,5692000,37999,False,129,scaffold_8
16,6322001,6334544,12543,True,129,scaffold_8
0,109001,117000,7999,False,129,scaffold_9
1,121001,138000,16999,False,129,scaffold_9
2,303001,315000,11999,False,129,scaffold_9
3,319001,334000,14999,False,129,scaffold_9
4,367001,411000,43999,False,129,scaffold_9
5,413001,434000,20999,False,129,scaffold_9
6,502001,531000,28999,False,129,scaffold_9
7,671001,696000,24999,False,129,scaffold_9
8,732001,742000,9999,False,129,scaffold_9
9,817001,842000,24999,False,129,scaffold_9
10,873001,986000,112999,False,129,scaffold_9
11,988001,995000,6999,False,129,scaffold_9
12,1001001,1007000,5999,False,129,scaffold_9
13,1009001,1031000,21999,False,129,scaffold_9
14,1035001,1085000,49999,False,129,scaffold_9
15,1087001,1150000,62999,False,129,scaffold_9
16,1151001,1164000,12999,False,129,scaffold_9
17,1312001,1377000,64999,False,129,scaffold_9
18,1487001,1499000,11999,False,129,scaffold_9
19,1762001,1790000,27999,False,129,scaffold_9
20,2599001,2616000,16999,False,129,scaffold_9
21,2737001,2803000,65999,False,129,scaffold_9
22,2871001,3381000,509999,False,129,scaffold_9
23,3383001,5107000,1723999,False,129,scaffold_9
24,5112001,5114000,1999,False,129,scaffold_9
25,5116001,5238000,121999,False,129,scaffold_9
26,5239001,5298000,58999,False,129,scaffold_9
27,5300001,5490000,189999,False,129,scaffold_9
28,5493001,6331288,838287,True,129,scaffold_9
0,1,199000,198999,True,129,scaffold_10
1,259001,414000,154999,False,129,scaffold_10
2,416001,482000,65999,False,129,scaffold_10
3,483001,582000,98999,False,129,scaffold_10
4,603001,754000,150999,False,129,scaffold_10
5,888001,917000,28999,False,129,scaffold_10
6,923001,963000,39999,False,129,scaffold_10
7,1087001,1145000,57999,False,129,scaffold_10
8,2141001,2167000,25999,False,129,scaffold_10
9,2273001,2290000,16999,False,129,scaffold_10
10,2346001,2368000,21999,False,129,scaffold_10
11,2735001,2749000,13999,False,129,scaffold_10
12,4053001,4091000,37999,False,129,scaffold_10
13,4154001,4174000,19999,False,129,scaffold_10
14,4443001,4462000,18999,False,129,scaffold_10
15,4467001,4477000,9999,False,129,scaffold_10
16,4515001,4523000,7999,False,129,scaffold_10
17,4526001,4548000,21999,False,129,scaffold_10
18,4576001,4595000,18999,False,129,scaffold_10
19,4680001,4688000,7999,False,129,scaffold_10
20,4734001,4751000,16999,False,129,scaffold_10
21,4752001,4766000,13999,False,129,scaffold_10
22,4768001,4776000,7999,False,129,scaffold_10
23,4798001,4824000,25999,False,129,scaffold_10
24,4827001,4843000,15999,False,129,scaffold_10
25,4848001,4861000,12999,False,129,scaffold_10
26,4865001,4866973,1972,True,129,scaffold_10
0,11001,34000,22999,False,129,scaffold_11
1,40001,92000,51999,False,129,scaffold_11
2,149001,167000,17999,False,129,scaffold_11
3,169001,235000,65999,False,129,scaffold_11
4,240001,248000,7999,False,129,scaffold_11
5,419001,431000,11999,False,129,scaffold_11
6,648001,656000,7999,False,129,scaffold_11
7,949001,951000,1999,False,129,scaffold_11
8,1025001,1034000,8999,False,129,scaffold_11
9,1423001,1427000,3999,False,129,scaffold_11
10,2701001,2876000,174999,False,129,scaffold_11
11,2983001,3011000,27999,False,129,scaffold_11
12,3188001,3259000,70999,False,129,scaffold_11
13,3329001,3383000,53999,False,129,scaffold_11
14,3448001,3477000,28999,False,129,scaffold_11
15,3702001,3927000,224999,False,129,scaffold_11
16,4133001,4159000,25999,False,129,scaffold_11
17,4181001,4216000,34999,False,129,scaffold_11
18,4255001,4710000,454999,False,129,scaffold_11
19,4713001,4766820,53819,True,129,scaffold_11
0,1,384000,383999,True,129,scaffold_12
1,403001,551000,147999,False,129,scaffold_12
2,576001,731000,154999,False,129,scaffold_12
3,739001,856000,116999,False,129,scaffold_12
4,865001,1468000,602999,False,129,scaffold_12
5,1720001,1733000,12999,False,129,scaffold_12
6,2531001,2547000,15999,False,129,scaffold_12
7,2559001,2566000,6999,False,129,scaffold_12
8,2571001,2619000,47999,False,129,scaffold_12
0,1,342000,341999,True,130,scaffold_1
1,482001,498000,15999,False,130,scaffold_1
2,571001,643000,71999,False,130,scaffold_1
3,686001,743000,56999,False,130,scaffold_1
4,1281001,1292000,10999,False,130,scaffold_1
5,1820001,1898000,77999,False,130,scaffold_1
6,1954001,1964000,9999,False,130,scaffold_1
7,1965001,1984000,18999,False,130,scaffold_1
8,2449001,2517000,67999,False,130,scaffold_1
9,2729001,2746000,16999,False,130,scaffold_1
10,3175001,3209000,33999,False,130,scaffold_1
11,3714001,3735000,20999,False,130,scaffold_1
12,3910001,3941000,30999,False,130,scaffold_1
13,4063001,4111000,47999,False,130,scaffold_1
14,4323001,4354000,30999,False,130,scaffold_1
15,4928001,4997000,68999,False,130,scaffold_1
16,5482001,5511000,28999,False,130,scaffold_1
17,5536001,5570000,33999,False,130,scaffold_1
18,6108001,6153000,44999,False,130,scaffold_1
19,6228001,6381000,152999,False,130,scaffold_1
20,6384001,6507000,122999,False,130,scaffold_1
21,6544001,6555000,10999,False,130,scaffold_1
22,7038001,7247000,208999,False,130,scaffold_1
23,7248001,7584000,335999,False,130,scaffold_1
24,7590001,8477000,886999,False,130,scaffold_1
25,8478001,8656000,177999,False,130,scaffold_1
26,8658001,9584000,925999,False,130,scaffold_1
27,9586001,10361000,774999,False,130,scaffold_1
28,10461001,10631000,169999,False,130,scaffold_1
29,10808001,10811000,2999,False,130,scaffold_1
30,10837001,10858000,20999,False,130,scaffold_1
31,11344001,11504000,159999,False,130,scaffold_1
32,11614001,11951000,336999,False,130,scaffold_1
33,12184001,12204000,19999,False,130,scaffold_1
34,12652001,12722000,69999,False,130,scaffold_1
35,12777001,12888000,110999,False,130,scaffold_1
36,13113001,13211000,97999,False,130,scaffold_1
37,13347001,13404000,56999,False,130,scaffold_1
38,14298001,14309000,10999,False,130,scaffold_1
39,14605001,14610000,4999,False,130,scaffold_1
0,21001,48000,26999,False,130,scaffold_2
1,117001,159000,41999,False,130,scaffold_2
2,168001,176000,7999,False,130,scaffold_2
3,316001,318000,1999,False,130,scaffold_2
4,330001,374000,43999,False,130,scaffold_2
5,2336001,2358000,21999,False,130,scaffold_2
6,2406001,2423000,16999,False,130,scaffold_2
7,2441001,2559000,117999,False,130,scaffold_2
8,2577001,2600000,22999,False,130,scaffold_2
9,2627001,2639000,11999,False,130,scaffold_2
10,2660001,2689000,28999,False,130,scaffold_2
11,2694001,2744000,49999,False,130,scaffold_2
12,2868001,2901000,32999,False,130,scaffold_2
13,2975001,3012000,36999,False,130,scaffold_2
14,3454001,3463000,8999,False,130,scaffold_2
15,3760001,3783000,22999,False,130,scaffold_2
16,4383001,4409000,25999,False,130,scaffold_2
17,4427001,4457000,29999,False,130,scaffold_2
18,4520001,4554000,33999,False,130,scaffold_2
19,4592001,4654000,61999,False,130,scaffold_2
20,4918001,4937000,18999,False,130,scaffold_2
21,5021001,5031000,9999,False,130,scaffold_2
22,5033001,5061000,27999,False,130,scaffold_2
23,5491001,5512000,20999,False,130,scaffold_2
24,5668001,5704000,35999,False,130,scaffold_2
25,5719001,5754000,34999,False,130,scaffold_2
26,6261001,6330000,68999,False,130,scaffold_2
27,6331001,6350000,18999,False,130,scaffold_2
28,6428001,6449000,20999,False,130,scaffold_2
29,7019001,7034000,14999,False,130,scaffold_2
30,7439001,7472000,32999,False,130,scaffold_2
31,7563001,7697000,133999,False,130,scaffold_2
32,7786001,7891000,104999,False,130,scaffold_2
33,7934001,8161000,226999,False,130,scaffold_2
34,8260001,8294000,33999,False,130,scaffold_2
35,8346001,8389000,42999,False,130,scaffold_2
36,8509001,8557000,47999,False,130,scaffold_2
37,9140001,9168000,27999,False,130,scaffold_2
38,11367001,11373000,5999,False,130,scaffold_2
39,11520001,11785000,264999,False,130,scaffold_2
0,800001,901000,100999,False,130,scaffold_3
1,960001,964000,3999,False,130,scaffold_3
2,2084001,2108000,23999,False,130,scaffold_3
3,2291001,2321000,29999,False,130,scaffold_3
4,2487001,2533000,45999,False,130,scaffold_3
5,2718001,2735000,16999,False,130,scaffold_3
6,3769001,3821000,51999,False,130,scaffold_3
7,3822001,3881000,58999,False,130,scaffold_3
8,4108001,4403000,294999,False,130,scaffold_3
9,4415001,4518000,102999,False,130,scaffold_3
10,4547001,4558000,10999,False,130,scaffold_3
11,4645001,4685000,39999,False,130,scaffold_3
12,6910001,6962000,51999,False,130,scaffold_3
13,6980001,7088000,107999,False,130,scaffold_3
14,7540001,7556000,15999,False,130,scaffold_3
15,7692001,7839000,146999,False,130,scaffold_3
16,8176001,8253000,76999,False,130,scaffold_3
17,8462001,8527000,64999,False,130,scaffold_3
18,8575001,8594000,18999,False,130,scaffold_3
19,9968001,9996000,27999,False,130,scaffold_3
20,10461001,10484000,22999,False,130,scaffold_3
21,10588001,11166000,577999,False,130,scaffold_3
0,17001,32000,14999,False,130,scaffold_4
1,48001,88000,39999,False,130,scaffold_4
2,136001,146000,9999,False,130,scaffold_4
3,147001,151000,3999,False,130,scaffold_4
4,161001,215000,53999,False,130,scaffold_4
5,218001,226000,7999,False,130,scaffold_4
6,227001,266000,38999,False,130,scaffold_4
7,295001,309000,13999,False,130,scaffold_4
8,316001,344000,27999,False,130,scaffold_4
9,345001,353000,7999,False,130,scaffold_4
10,355001,374000,18999,False,130,scaffold_4
11,375001,380000,4999,False,130,scaffold_4
12,393001,410000,16999,False,130,scaffold_4
13,412001,425000,12999,False,130,scaffold_4
14,429001,498000,68999,False,130,scaffold_4
15,545001,599000,53999,False,130,scaffold_4
16,600001,606000,5999,False,130,scaffold_4
17,608001,661000,52999,False,130,scaffold_4
18,670001,691000,20999,False,130,scaffold_4
19,701001,714000,12999,False,130,scaffold_4
20,1121001,1136000,14999,False,130,scaffold_4
21,1137001,1198000,60999,False,130,scaffold_4
22,1199001,1208000,8999,False,130,scaffold_4
23,1210001,1226000,15999,False,130,scaffold_4
24,1235001,1253000,17999,False,130,scaffold_4
25,1254001,1262000,7999,False,130,scaffold_4
26,1265001,1279000,13999,False,130,scaffold_4
27,1283001,1319000,35999,False,130,scaffold_4
28,1373001,1591000,217999,False,130,scaffold_4
29,1627001,1957000,329999,False,130,scaffold_4
30,1958001,2002000,43999,False,130,scaffold_4
31,2021001,2090000,68999,False,130,scaffold_4
32,2210001,2246000,35999,False,130,scaffold_4
33,2247001,2280000,32999,False,130,scaffold_4
34,2284001,2339000,54999,False,130,scaffold_4
35,2392001,2461000,68999,False,130,scaffold_4
36,2477001,2581000,103999,False,130,scaffold_4
37,2599001,2635000,35999,False,130,scaffold_4
38,3334001,3633000,298999,False,130,scaffold_4
39,3645001,3760000,114999,False,130,scaffold_4
40,4944001,4984000,39999,False,130,scaffold_4
41,5477001,5506000,28999,False,130,scaffold_4
42,5514001,5620000,105999,False,130,scaffold_4
43,5661001,5784000,122999,False,130,scaffold_4
44,6145001,6190000,44999,False,130,scaffold_4
45,6798001,6817000,18999,False,130,scaffold_4
46,6900001,6924000,23999,False,130,scaffold_4
47,7036001,7062000,25999,False,130,scaffold_4
48,8846001,9699000,852999,False,130,scaffold_4
49,9700001,9845951,145950,True,130,scaffold_4
0,318001,326000,7999,False,130,scaffold_5
1,327001,368000,40999,False,130,scaffold_5
2,463001,523000,59999,False,130,scaffold_5
3,933001,947000,13999,False,130,scaffold_5
4,2555001,2581000,25999,False,130,scaffold_5
5,2624001,2738000,113999,False,130,scaffold_5
6,2813001,2871000,57999,False,130,scaffold_5
7,3134001,3189000,54999,False,130,scaffold_5
8,3322001,3438000,115999,False,130,scaffold_5
9,3451001,3498000,46999,False,130,scaffold_5
10,3962001,4101000,138999,False,130,scaffold_5
11,4121001,4219000,97999,False,130,scaffold_5
12,4246001,4265000,18999,False,130,scaffold_5
13,4446001,4491000,44999,False,130,scaffold_5
14,4601001,4658000,56999,False,130,scaffold_5
15,4691001,4730000,38999,False,130,scaffold_5
16,4788001,4861000,72999,False,130,scaffold_5
17,4894001,4918000,23999,False,130,scaffold_5
18,5317001,5345000,27999,False,130,scaffold_5
19,6506001,6566000,59999,False,130,scaffold_5
20,7373001,7387000,13999,False,130,scaffold_5
21,7581001,7609000,27999,False,130,scaffold_5
22,7622001,7653000,30999,False,130,scaffold_5
23,8670001,8689000,18999,False,130,scaffold_5
24,8730001,9364176,634175,True,130,scaffold_5
0,79001,112000,32999,False,130,scaffold_6
1,240001,253000,12999,False,130,scaffold_6
2,1238001,1256000,17999,False,130,scaffold_6
3,1479001,1546000,66999,False,130,scaffold_6
4,1869001,1906000,36999,False,130,scaffold_6
5,2023001,2102000,78999,False,130,scaffold_6
6,2130001,2169000,38999,False,130,scaffold_6
7,2336001,2595000,258999,False,130,scaffold_6
8,2596001,2654000,57999,False,130,scaffold_6
9,2655001,2691000,35999,False,130,scaffold_6
10,2731001,2851000,119999,False,130,scaffold_6
11,2933001,3015000,81999,False,130,scaffold_6
12,3115001,3149000,33999,False,130,scaffold_6
13,3224001,3301000,76999,False,130,scaffold_6
14,3407001,3428000,20999,False,130,scaffold_6
15,3460001,3766000,305999,False,130,scaffold_6
16,3899001,3913000,13999,False,130,scaffold_6
17,4018001,4070000,51999,False,130,scaffold_6
18,4080001,4195000,114999,False,130,scaffold_6
19,6010001,6063000,52999,False,130,scaffold_6
20,7264001,7337000,72999,False,130,scaffold_6
21,7560001,7796000,235999,False,130,scaffold_6
22,7811001,8268281,457280,True,130,scaffold_6
0,1,7000,6999,True,130,scaffold_7
1,13001,31000,17999,False,130,scaffold_7
2,169001,171000,1999,False,130,scaffold_7
3,320001,340000,19999,False,130,scaffold_7
4,342001,507000,164999,False,130,scaffold_7
5,553001,563000,9999,False,130,scaffold_7
6,571001,577000,5999,False,130,scaffold_7
7,706001,736000,29999,False,130,scaffold_7
8,741001,753000,11999,False,130,scaffold_7
9,764001,829000,64999,False,130,scaffold_7
10,859001,864000,4999,False,130,scaffold_7
11,953001,963000,9999,False,130,scaffold_7
12,964001,980000,15999,False,130,scaffold_7
13,982001,1044000,61999,False,130,scaffold_7
14,1048001,1104000,55999,False,130,scaffold_7
15,1203001,1512000,308999,False,130,scaffold_7
16,1588001,1688000,99999,False,130,scaffold_7
17,3297001,3312000,14999,False,130,scaffold_7
18,3326001,3369000,42999,False,130,scaffold_7
19,3591001,3659000,67999,False,130,scaffold_7
20,3717001,3766000,48999,False,130,scaffold_7
21,4418001,4535000,116999,False,130,scaffold_7
22,4639001,4648000,8999,False,130,scaffold_7
23,4657001,4682000,24999,False,130,scaffold_7
24,4687001,4734000,46999,False,130,scaffold_7
25,4979001,5030000,50999,False,130,scaffold_7
26,5073001,5148000,74999,False,130,scaffold_7
27,5490001,5514000,23999,False,130,scaffold_7
28,5609001,5627000,17999,False,130,scaffold_7
29,6955001,7270000,314999,False,130,scaffold_7
30,7271001,7502216,231215,True,130,scaffold_7
0,66001,85000,18999,False,130,scaffold_8
1,312001,314000,1999,False,130,scaffold_8
2,2445001,2469000,23999,False,130,scaffold_8
3,2492001,2528000,35999,False,130,scaffold_8
4,2537001,2549000,11999,False,130,scaffold_8
5,2664001,2675000,10999,False,130,scaffold_8
6,2742001,2757000,14999,False,130,scaffold_8
7,2799001,2844000,44999,False,130,scaffold_8
8,3060001,3125000,64999,False,130,scaffold_8
9,3126001,3525000,398999,False,130,scaffold_8
10,3584001,3612000,27999,False,130,scaffold_8
11,3615001,3913000,297999,False,130,scaffold_8
12,4039001,4099000,59999,False,130,scaffold_8
13,4205001,4220000,14999,False,130,scaffold_8
14,5095001,5137000,41999,False,130,scaffold_8
15,5197001,5241000,43999,False,130,scaffold_8
16,6324001,6334544,10543,True,130,scaffold_8
0,109001,117000,7999,False,130,scaffold_9
1,367001,411000,43999,False,130,scaffold_9
2,413001,434000,20999,False,130,scaffold_9
3,501001,531000,29999,False,130,scaffold_9
4,670001,697000,26999,False,130,scaffold_9
5,731001,742000,10999,False,130,scaffold_9
6,794001,803000,8999,False,130,scaffold_9
7,817001,843000,25999,False,130,scaffold_9
8,855001,862000,6999,False,130,scaffold_9
9,873001,986000,112999,False,130,scaffold_9
10,987001,995000,7999,False,130,scaffold_9
11,1001001,1007000,5999,False,130,scaffold_9
12,1010001,1031000,20999,False,130,scaffold_9
13,1037001,1085000,47999,False,130,scaffold_9
14,1087001,1150000,62999,False,130,scaffold_9
15,1151001,1160000,8999,False,130,scaffold_9
16,1312001,1377000,64999,False,130,scaffold_9
17,1599001,1613000,13999,False,130,scaffold_9
18,1767001,1790000,22999,False,130,scaffold_9
19,2601001,2616000,14999,False,130,scaffold_9
20,2783001,2802000,18999,False,130,scaffold_9
21,2870001,3381000,510999,False,130,scaffold_9
22,3383001,5107000,1723999,False,130,scaffold_9
23,5112001,5114000,1999,False,130,scaffold_9
24,5116001,5238000,121999,False,130,scaffold_9
25,5239001,5298000,58999,False,130,scaffold_9
26,5299001,5490000,190999,False,130,scaffold_9
27,5493001,6331288,838287,True,130,scaffold_9
0,1,199000,198999,True,130,scaffold_10
1,259001,414000,154999,False,130,scaffold_10
2,415001,482000,66999,False,130,scaffold_10
3,483001,581000,97999,False,130,scaffold_10
4,603001,754000,150999,False,130,scaffold_10
5,888001,916000,27999,False,130,scaffold_10
6,924001,962000,37999,False,130,scaffold_10
7,1087001,1145000,57999,False,130,scaffold_10
8,2088001,2103000,14999,False,130,scaffold_10
9,2141001,2167000,25999,False,130,scaffold_10
10,2346001,2368000,21999,False,130,scaffold_10
11,3264001,3268000,3999,False,130,scaffold_10
12,4054001,4091000,36999,False,130,scaffold_10
13,4154001,4174000,19999,False,130,scaffold_10
14,4508001,4513000,4999,False,130,scaffold_10
15,4515001,4548000,32999,False,130,scaffold_10
16,4576001,4596000,19999,False,130,scaffold_10
17,4681001,4688000,6999,False,130,scaffold_10
18,4734001,4766000,31999,False,130,scaffold_10
19,4769001,4776000,6999,False,130,scaffold_10
20,4798001,4824000,25999,False,130,scaffold_10
21,4827001,4843000,15999,False,130,scaffold_10
22,4848001,4861000,12999,False,130,scaffold_10
23,4865001,4866973,1972,True,130,scaffold_10
0,10001,34000,23999,False,130,scaffold_11
1,40001,93000,52999,False,130,scaffold_11
2,149001,167000,17999,False,130,scaffold_11
3,169001,191000,21999,False,130,scaffold_11
4,213001,235000,21999,False,130,scaffold_11
5,240001,248000,7999,False,130,scaffold_11
6,419001,431000,11999,False,130,scaffold_11
7,648001,656000,7999,False,130,scaffold_11
8,1025001,1034000,8999,False,130,scaffold_11
9,1423001,1427000,3999,False,130,scaffold_11
10,1474001,1477000,2999,False,130,scaffold_11
11,2701001,2877000,175999,False,130,scaffold_11
12,2983001,3011000,27999,False,130,scaffold_11
13,3193001,3262000,68999,False,130,scaffold_11
14,3329001,3383000,53999,False,130,scaffold_11
15,3702001,3927000,224999,False,130,scaffold_11
16,4005001,4110000,104999,False,130,scaffold_11
17,4134001,4155000,20999,False,130,scaffold_11
18,4301001,4710000,408999,False,130,scaffold_11
19,4713001,4766820,53819,True,130,scaffold_11
0,1,370000,369999,True,130,scaffold_12
1,474001,856000,381999,False,130,scaffold_12
2,865001,1430000,564999,False,130,scaffold_12
3,1720001,1733000,12999,False,130,scaffold_12
4,2138001,2161000,22999,False,130,scaffold_12
5,2559001,2567000,7999,False,130,scaffold_12
6,2571001,2610000,38999,False,130,scaffold_12
0,1,342000,341999,True,131,scaffold_1
1,482001,498000,15999,False,131,scaffold_1
2,571001,643000,71999,False,131,scaffold_1
3,686001,743000,56999,False,131,scaffold_1
4,1281001,1292000,10999,False,131,scaffold_1
5,1954001,1964000,9999,False,131,scaffold_1
6,1965001,1984000,18999,False,131,scaffold_1
7,2449001,2517000,67999,False,131,scaffold_1
8,2729001,2746000,16999,False,131,scaffold_1
9,3176001,3208000,31999,False,131,scaffold_1
10,3714001,3734000,19999,False,131,scaffold_1
11,3915001,3941000,25999,False,131,scaffold_1
12,4062001,4111000,48999,False,131,scaffold_1
13,4322001,4354000,31999,False,131,scaffold_1
14,4928001,4999000,70999,False,131,scaffold_1
15,5482001,5511000,28999,False,131,scaffold_1
16,6108001,6153000,44999,False,131,scaffold_1
17,6228001,6318000,89999,False,131,scaffold_1
18,6321001,6507000,185999,False,131,scaffold_1
19,6548001,6552000,3999,False,131,scaffold_1
20,7038001,7247000,208999,False,131,scaffold_1
21,7248001,7584000,335999,False,131,scaffold_1
22,7590001,8477000,886999,False,131,scaffold_1
23,8478001,8656000,177999,False,131,scaffold_1
24,8658001,9584000,925999,False,131,scaffold_1
25,9586001,10355000,768999,False,131,scaffold_1
26,10461001,10631000,169999,False,131,scaffold_1
27,10832001,10858000,25999,False,131,scaffold_1
28,11348001,11504000,155999,False,131,scaffold_1
29,11613001,11781000,167999,False,131,scaffold_1
30,11788001,11951000,162999,False,131,scaffold_1
31,12184001,12204000,19999,False,131,scaffold_1
32,12662001,12722000,59999,False,131,scaffold_1
33,12775001,12888000,112999,False,131,scaffold_1
34,13113001,13211000,97999,False,131,scaffold_1
35,13347001,13378000,30999,False,131,scaffold_1
36,13396001,13403000,6999,False,131,scaffold_1
37,14290001,14309000,18999,False,131,scaffold_1
38,14471001,14479000,7999,False,131,scaffold_1
39,14605001,14610000,4999,False,131,scaffold_1
0,21001,48000,26999,False,131,scaffold_2
1,93001,159000,65999,False,131,scaffold_2
2,165001,177000,11999,False,131,scaffold_2
3,303001,318000,14999,False,131,scaffold_2
4,332001,374000,41999,False,131,scaffold_2
5,2336001,2358000,21999,False,131,scaffold_2
6,2441001,2553000,111999,False,131,scaffold_2
7,2660001,2689000,28999,False,131,scaffold_2
8,2694001,2742000,47999,False,131,scaffold_2
9,2777001,2788000,10999,False,131,scaffold_2
10,2994001,3012000,17999,False,131,scaffold_2
11,3452001,3465000,12999,False,131,scaffold_2
12,3767001,3782000,14999,False,131,scaffold_2
13,4385001,4409000,23999,False,131,scaffold_2
14,4429001,4456000,26999,False,131,scaffold_2
15,4521001,4554000,32999,False,131,scaffold_2
16,4598001,4653000,54999,False,131,scaffold_2
17,5022001,5061000,38999,False,131,scaffold_2
18,5491001,5511000,19999,False,131,scaffold_2
19,5672001,5704000,31999,False,131,scaffold_2
20,6261001,6330000,68999,False,131,scaffold_2
21,6331001,6341000,9999,False,131,scaffold_2
22,7439001,7472000,32999,False,131,scaffold_2
23,7563001,7697000,133999,False,131,scaffold_2
24,7786001,7890000,103999,False,131,scaffold_2
25,7934001,8161000,226999,False,131,scaffold_2
26,8265001,8294000,28999,False,131,scaffold_2
27,8331001,8333000,1999,False,131,scaffold_2
28,8346001,8389000,42999,False,131,scaffold_2
29,8509001,8559000,49999,False,131,scaffold_2
30,11367001,11374000,6999,False,131,scaffold_2
31,11520001,11785000,264999,False,131,scaffold_2
0,1,2000,1999,True,131,scaffold_3
1,51001,55000,3999,False,131,scaffold_3
2,799001,901000,101999,False,131,scaffold_3
3,2084001,2108000,23999,False,131,scaffold_3
4,2110001,2115000,4999,False,131,scaffold_3
5,2291001,2321000,29999,False,131,scaffold_3
6,2488001,2533000,44999,False,131,scaffold_3
7,3827001,3889000,61999,False,131,scaffold_3
8,4108001,4397000,288999,False,131,scaffold_3
9,4418001,4518000,99999,False,131,scaffold_3
10,4547001,4558000,10999,False,131,scaffold_3
11,4652001,4678000,25999,False,131,scaffold_3
12,5990001,6022000,31999,False,131,scaffold_3
13,6910001,6962000,51999,False,131,scaffold_3
14,6979001,7075000,95999,False,131,scaffold_3
15,7522001,7556000,33999,False,131,scaffold_3
16,7692001,7798000,105999,False,131,scaffold_3
17,7822001,7839000,16999,False,131,scaffold_3
18,8184001,8253000,68999,False,131,scaffold_3
19,8462001,8527000,64999,False,131,scaffold_3
20,8575001,8594000,18999,False,131,scaffold_3
21,9968001,9996000,27999,False,131,scaffold_3
22,10461001,10483000,21999,False,131,scaffold_3
23,10587001,11165000,577999,False,131,scaffold_3
0,17001,29000,11999,False,131,scaffold_4
1,30001,32000,1999,False,131,scaffold_4
2,49001,88000,38999,False,131,scaffold_4
3,136001,146000,9999,False,131,scaffold_4
4,147001,151000,3999,False,131,scaffold_4
5,155001,160000,4999,False,131,scaffold_4
6,161001,215000,53999,False,131,scaffold_4
7,217001,226000,8999,False,131,scaffold_4
8,227001,241000,13999,False,131,scaffold_4
9,242001,266000,23999,False,131,scaffold_4
10,355001,374000,18999,False,131,scaffold_4
11,375001,380000,4999,False,131,scaffold_4
12,412001,425000,12999,False,131,scaffold_4
13,429001,498000,68999,False,131,scaffold_4
14,545001,606000,60999,False,131,scaffold_4
15,608001,661000,52999,False,131,scaffold_4
16,670001,691000,20999,False,131,scaffold_4
17,701001,727000,25999,False,131,scaffold_4
18,1121001,1136000,14999,False,131,scaffold_4
19,1137001,1179000,41999,False,131,scaffold_4
20,1199001,1208000,8999,False,131,scaffold_4
21,1210001,1226000,15999,False,131,scaffold_4
22,1235001,1245000,9999,False,131,scaffold_4
23,1254001,1262000,7999,False,131,scaffold_4
24,1265001,1279000,13999,False,131,scaffold_4
25,1283001,1336000,52999,False,131,scaffold_4
26,1375001,1591000,215999,False,131,scaffold_4
27,1613001,1694000,80999,False,131,scaffold_4
28,1744001,1869000,124999,False,131,scaffold_4
29,1904001,1957000,52999,False,131,scaffold_4
30,1958001,1992000,33999,False,131,scaffold_4
31,2035001,2068000,32999,False,131,scaffold_4
32,2071001,2117000,45999,False,131,scaffold_4
33,2247001,2279000,31999,False,131,scaffold_4
34,2284001,2339000,54999,False,131,scaffold_4
35,2476001,2535000,58999,False,131,scaffold_4
36,2599001,2635000,35999,False,131,scaffold_4
37,3334001,3633000,298999,False,131,scaffold_4
38,3676001,3761000,84999,False,131,scaffold_4
39,4944001,4984000,39999,False,131,scaffold_4
40,5477001,5506000,28999,False,131,scaffold_4
41,5514001,5620000,105999,False,131,scaffold_4
42,5661001,5784000,122999,False,131,scaffold_4
43,6148001,6191000,42999,False,131,scaffold_4
44,6908001,6924000,15999,False,131,scaffold_4
45,7036001,7062000,25999,False,131,scaffold_4
46,8846001,9699000,852999,False,131,scaffold_4
47,9700001,9845951,145950,True,131,scaffold_4
0,318001,382000,63999,False,131,scaffold_5
1,464001,489000,24999,False,131,scaffold_5
2,493001,523000,29999,False,131,scaffold_5
3,933001,947000,13999,False,131,scaffold_5
4,2564001,2581000,16999,False,131,scaffold_5
5,2625001,2741000,115999,False,131,scaffold_5
6,2816001,2871000,54999,False,131,scaffold_5
7,3138001,3185000,46999,False,131,scaffold_5
8,3322001,3438000,115999,False,131,scaffold_5
9,3451001,3494000,42999,False,131,scaffold_5
10,3962001,4101000,138999,False,131,scaffold_5
11,4121001,4219000,97999,False,131,scaffold_5
12,4246001,4262000,15999,False,131,scaffold_5
13,4445001,4488000,42999,False,131,scaffold_5
14,4602001,4656000,53999,False,131,scaffold_5
15,4691001,4718000,26999,False,131,scaffold_5
16,4789001,4810000,20999,False,131,scaffold_5
17,4811001,4861000,49999,False,131,scaffold_5
18,4892001,4919000,26999,False,131,scaffold_5
19,5314001,5346000,31999,False,131,scaffold_5
20,6510001,6566000,55999,False,131,scaffold_5
21,7097001,7100000,2999,False,131,scaffold_5
22,7580001,7609000,28999,False,131,scaffold_5
23,7621001,7656000,34999,False,131,scaffold_5
24,8674001,8689000,14999,False,131,scaffold_5
25,8730001,9363000,632999,False,131,scaffold_5
0,79001,85000,5999,False,131,scaffold_6
1,86001,113000,26999,False,131,scaffold_6
2,239001,254000,14999,False,131,scaffold_6
3,1229001,1256000,26999,False,131,scaffold_6
4,1479001,1546000,66999,False,131,scaffold_6
5,1874001,1883000,8999,False,131,scaffold_6
6,2023001,2088000,64999,False,131,scaffold_6
7,2130001,2169000,38999,False,131,scaffold_6
8,2350001,2595000,244999,False,131,scaffold_6
9,2596001,2689000,92999,False,131,scaffold_6
10,2731001,2851000,119999,False,131,scaffold_6
11,2934001,3014000,79999,False,131,scaffold_6
12,3115001,3172000,56999,False,131,scaffold_6
13,3224001,3301000,76999,False,131,scaffold_6
14,3406001,3428000,21999,False,131,scaffold_6
15,3459001,3765000,305999,False,131,scaffold_6
16,3901001,3912000,10999,False,131,scaffold_6
17,4018001,4071000,52999,False,131,scaffold_6
18,4085001,4193000,107999,False,131,scaffold_6
19,6010001,6062000,51999,False,131,scaffold_6
20,7284001,7337000,52999,False,131,scaffold_6
21,7550001,8268281,718280,True,131,scaffold_6
0,14001,34000,19999,False,131,scaffold_7
1,169001,171000,1999,False,131,scaffold_7
2,323001,340000,16999,False,131,scaffold_7
3,342001,508000,165999,False,131,scaffold_7
4,554001,563000,8999,False,131,scaffold_7
5,571001,577000,5999,False,131,scaffold_7
6,706001,736000,29999,False,131,scaffold_7
7,764001,829000,64999,False,131,scaffold_7
8,859001,864000,4999,False,131,scaffold_7
9,887001,937000,49999,False,131,scaffold_7
10,964001,966000,1999,False,131,scaffold_7
11,968001,980000,11999,False,131,scaffold_7
12,982001,1044000,61999,False,131,scaffold_7
13,1191001,1460000,268999,False,131,scaffold_7
14,1461001,1512000,50999,False,131,scaffold_7
15,1588001,1688000,99999,False,131,scaffold_7
16,3325001,3369000,43999,False,131,scaffold_7
17,3596001,3653000,56999,False,131,scaffold_7
18,4415001,4517000,101999,False,131,scaffold_7
19,4658001,4731000,72999,False,131,scaffold_7
20,4979001,5029000,49999,False,131,scaffold_7
21,5031001,5113000,81999,False,131,scaffold_7
22,5495001,5512000,16999,False,131,scaffold_7
23,6953001,7270000,316999,False,131,scaffold_7
24,7271001,7502216,231215,True,131,scaffold_7
0,66001,85000,18999,False,131,scaffold_8
1,2492001,2529000,36999,False,131,scaffold_8
2,2537001,2548000,10999,False,131,scaffold_8
3,2652001,2683000,30999,False,131,scaffold_8
4,2742001,2757000,14999,False,131,scaffold_8
5,2808001,2844000,35999,False,131,scaffold_8
6,3059001,3125000,65999,False,131,scaffold_8
7,3126001,3525000,398999,False,131,scaffold_8
8,3581001,3612000,30999,False,131,scaffold_8
9,3615001,3913000,297999,False,131,scaffold_8
10,4039001,4105000,65999,False,131,scaffold_8
11,5125001,5135000,9999,False,131,scaffold_8
12,5200001,5241000,40999,False,131,scaffold_8
13,6321001,6334544,13543,True,131,scaffold_8
0,109001,117000,7999,False,131,scaffold_9
1,121001,136000,14999,False,131,scaffold_9
2,303001,315000,11999,False,131,scaffold_9
3,319001,332000,12999,False,131,scaffold_9
4,367001,411000,43999,False,131,scaffold_9
5,413001,434000,20999,False,131,scaffold_9
6,503001,531000,27999,False,131,scaffold_9
7,670001,696000,25999,False,131,scaffold_9
8,732001,742000,9999,False,131,scaffold_9
9,794001,803000,8999,False,131,scaffold_9
10,816001,843000,26999,False,131,scaffold_9
11,886001,986000,99999,False,131,scaffold_9
12,987001,995000,7999,False,131,scaffold_9
13,1001001,1007000,5999,False,131,scaffold_9
14,1009001,1031000,21999,False,131,scaffold_9
15,1035001,1085000,49999,False,131,scaffold_9
16,1087001,1150000,62999,False,131,scaffold_9
17,1151001,1164000,12999,False,131,scaffold_9
18,1312001,1377000,64999,False,131,scaffold_9
19,1764001,1791000,26999,False,131,scaffold_9
20,2601001,2616000,14999,False,131,scaffold_9
21,2781001,2803000,21999,False,131,scaffold_9
22,2870001,3381000,510999,False,131,scaffold_9
23,3383001,5107000,1723999,False,131,scaffold_9
24,5112001,5114000,1999,False,131,scaffold_9
25,5116001,5238000,121999,False,131,scaffold_9
26,5239001,5298000,58999,False,131,scaffold_9
27,5300001,6331288,1031287,True,131,scaffold_9
0,1,198000,197999,True,131,scaffold_10
1,293001,405000,111999,False,131,scaffold_10
2,472001,482000,9999,False,131,scaffold_10
3,483001,576000,92999,False,131,scaffold_10
4,603001,752000,148999,False,131,scaffold_10
5,888001,917000,28999,False,131,scaffold_10
6,923001,962000,38999,False,131,scaffold_10
7,1088001,1112000,23999,False,131,scaffold_10
8,2144001,2166000,21999,False,131,scaffold_10
9,2346001,2367000,20999,False,131,scaffold_10
10,4002001,4010000,7999,False,131,scaffold_10
11,4054001,4092000,37999,False,131,scaffold_10
12,4154001,4174000,19999,False,131,scaffold_10
13,4443001,4462000,18999,False,131,scaffold_10
14,4467001,4477000,9999,False,131,scaffold_10
15,4515001,4523000,7999,False,131,scaffold_10
16,4526001,4548000,21999,False,131,scaffold_10
17,4554001,4562000,7999,False,131,scaffold_10
18,4576001,4596000,19999,False,131,scaffold_10
19,4681001,4688000,6999,False,131,scaffold_10
20,4734001,4751000,16999,False,131,scaffold_10
21,4752001,4776000,23999,False,131,scaffold_10
22,4798001,4824000,25999,False,131,scaffold_10
23,4828001,4843000,14999,False,131,scaffold_10
24,4848001,4861000,12999,False,131,scaffold_10
25,4865001,4866973,1972,True,131,scaffold_10
0,10001,93000,82999,False,131,scaffold_11
1,149001,167000,17999,False,131,scaffold_11
2,169001,191000,21999,False,131,scaffold_11
3,213001,235000,21999,False,131,scaffold_11
4,240001,245000,4999,False,131,scaffold_11
5,419001,431000,11999,False,131,scaffold_11
6,648001,656000,7999,False,131,scaffold_11
7,1025001,1034000,8999,False,131,scaffold_11
8,1423001,1426000,2999,False,131,scaffold_11
9,2701001,2876000,174999,False,131,scaffold_11
10,3188001,3254000,65999,False,131,scaffold_11
11,3331001,3383000,51999,False,131,scaffold_11
12,3702001,3926000,223999,False,131,scaffold_11
13,4133001,4159000,25999,False,131,scaffold_11
14,4300001,4710000,409999,False,131,scaffold_11
15,4712001,4766820,54819,True,131,scaffold_11
0,1,370000,369999,True,131,scaffold_12
1,473001,545000,71999,False,131,scaffold_12
2,580001,756000,175999,False,131,scaffold_12
3,775001,856000,80999,False,131,scaffold_12
4,865001,1430000,564999,False,131,scaffold_12
5,1720001,1733000,12999,False,131,scaffold_12
6,2571001,2612000,40999,False,131,scaffold_12
7,2685001,2698000,12999,False,131,scaffold_12
0,1,342000,341999,True,132,scaffold_1
1,482001,498000,15999,False,132,scaffold_1
2,571001,643000,71999,False,132,scaffold_1
3,686001,743000,56999,False,132,scaffold_1
4,1281001,1292000,10999,False,132,scaffold_1
5,1827001,1898000,70999,False,132,scaffold_1
6,1954001,1964000,9999,False,132,scaffold_1
7,1965001,1984000,18999,False,132,scaffold_1
8,2449001,2517000,67999,False,132,scaffold_1
9,2729001,2746000,16999,False,132,scaffold_1
10,3181001,3208000,26999,False,132,scaffold_1
11,3715001,3734000,18999,False,132,scaffold_1
12,3916001,3941000,24999,False,132,scaffold_1
13,4062001,4112000,49999,False,132,scaffold_1
14,4322001,4354000,31999,False,132,scaffold_1
15,4928001,4984000,55999,False,132,scaffold_1
16,5483001,5511000,27999,False,132,scaffold_1
17,5538001,5569000,30999,False,132,scaffold_1
18,6108001,6153000,44999,False,132,scaffold_1
19,6228001,6507000,278999,False,132,scaffold_1
20,6545001,6554000,8999,False,132,scaffold_1
21,7038001,7247000,208999,False,132,scaffold_1
22,7248001,7583000,334999,False,132,scaffold_1
23,7590001,8477000,886999,False,132,scaffold_1
24,8478001,8656000,177999,False,132,scaffold_1
25,8658001,9584000,925999,False,132,scaffold_1
26,9586001,10356000,769999,False,132,scaffold_1
27,10461001,10636000,174999,False,132,scaffold_1
28,10808001,10811000,2999,False,132,scaffold_1
29,11351001,11504000,152999,False,132,scaffold_1
30,11614001,11951000,336999,False,132,scaffold_1
31,12184001,12204000,19999,False,132,scaffold_1
32,12664001,12722000,57999,False,132,scaffold_1
33,12777001,12888000,110999,False,132,scaffold_1
34,13113001,13211000,97999,False,132,scaffold_1
35,13347001,13404000,56999,False,132,scaffold_1
0,21001,48000,26999,False,132,scaffold_2
1,93001,159000,65999,False,132,scaffold_2
2,168001,176000,7999,False,132,scaffold_2
3,297001,318000,20999,False,132,scaffold_2
4,333001,374000,40999,False,132,scaffold_2
5,2336001,2358000,21999,False,132,scaffold_2
6,2398001,2424000,25999,False,132,scaffold_2
7,2441001,2553000,111999,False,132,scaffold_2
8,2660001,2689000,28999,False,132,scaffold_2
9,2694001,2742000,47999,False,132,scaffold_2
10,2766001,2788000,21999,False,132,scaffold_2
11,2868001,2897000,28999,False,132,scaffold_2
12,2993001,3012000,18999,False,132,scaffold_2
13,3454001,3464000,9999,False,132,scaffold_2
14,3756001,3783000,26999,False,132,scaffold_2
15,4385001,4409000,23999,False,132,scaffold_2
16,4429001,4456000,26999,False,132,scaffold_2
17,4521001,4581000,59999,False,132,scaffold_2
18,4591001,4654000,62999,False,132,scaffold_2
19,4918001,4937000,18999,False,132,scaffold_2
20,5022001,5031000,8999,False,132,scaffold_2
21,5033001,5061000,27999,False,132,scaffold_2
22,5491001,5511000,19999,False,132,scaffold_2
23,5672001,5704000,31999,False,132,scaffold_2
24,6261001,6330000,68999,False,132,scaffold_2
25,6331001,6350000,18999,False,132,scaffold_2
26,6430001,6448000,17999,False,132,scaffold_2
27,7439001,7472000,32999,False,132,scaffold_2
28,7563001,7697000,133999,False,132,scaffold_2
29,7786001,7890000,103999,False,132,scaffold_2
30,7934001,7969000,34999,False,132,scaffold_2
31,7982001,8132000,149999,False,132,scaffold_2
32,8265001,8293000,27999,False,132,scaffold_2
33,8331001,8333000,1999,False,132,scaffold_2
34,8340001,8344000,3999,False,132,scaffold_2
35,8346001,8389000,42999,False,132,scaffold_2
36,8509001,8538000,28999,False,132,scaffold_2
37,11367001,11371000,3999,False,132,scaffold_2
38,11520001,11785000,264999,False,132,scaffold_2
0,1,2000,1999,True,132,scaffold_3
1,51001,55000,3999,False,132,scaffold_3
2,203001,207000,3999,False,132,scaffold_3
3,800001,900000,99999,False,132,scaffold_3
4,2085001,2108000,22999,False,132,scaffold_3
5,2291001,2321000,29999,False,132,scaffold_3
6,2493001,2533000,39999,False,132,scaffold_3
7,3261001,3271000,9999,False,132,scaffold_3
8,3773001,3808000,34999,False,132,scaffold_3
9,3826001,3874000,47999,False,132,scaffold_3
10,4108001,4403000,294999,False,132,scaffold_3
11,4410001,4518000,107999,False,132,scaffold_3
12,4546001,4558000,11999,False,132,scaffold_3
13,4647001,4680000,32999,False,132,scaffold_3
14,5494001,5509000,14999,False,132,scaffold_3
15,5990001,6019000,28999,False,132,scaffold_3
16,6910001,6962000,51999,False,132,scaffold_3
17,6963001,6976000,12999,False,132,scaffold_3
18,6977001,7080000,102999,False,132,scaffold_3
19,7538001,7556000,17999,False,132,scaffold_3
20,7692001,7730000,37999,False,132,scaffold_3
21,7822001,7839000,16999,False,132,scaffold_3
22,8176001,8253000,76999,False,132,scaffold_3
23,8462001,8527000,64999,False,132,scaffold_3
24,8575001,8594000,18999,False,132,scaffold_3
25,9968001,9996000,27999,False,132,scaffold_3
26,10461001,10483000,21999,False,132,scaffold_3
27,10587001,11167000,579999,False,132,scaffold_3
0,21001,32000,10999,False,132,scaffold_4
1,48001,88000,39999,False,132,scaffold_4
2,155001,215000,59999,False,132,scaffold_4
3,217001,226000,8999,False,132,scaffold_4
4,227001,241000,13999,False,132,scaffold_4
5,242001,266000,23999,False,132,scaffold_4
6,291001,310000,18999,False,132,scaffold_4
7,313001,344000,30999,False,132,scaffold_4
8,355001,374000,18999,False,132,scaffold_4
9,375001,380000,4999,False,132,scaffold_4
10,412001,425000,12999,False,132,scaffold_4
11,429001,498000,68999,False,132,scaffold_4
12,542001,606000,63999,False,132,scaffold_4
13,608001,691000,82999,False,132,scaffold_4
14,701001,717000,15999,False,132,scaffold_4
15,1120001,1136000,15999,False,132,scaffold_4
16,1137001,1178000,40999,False,132,scaffold_4
17,1199001,1208000,8999,False,132,scaffold_4
18,1210001,1226000,15999,False,132,scaffold_4
19,1235001,1253000,17999,False,132,scaffold_4
20,1269001,1279000,9999,False,132,scaffold_4
21,1283001,1315000,31999,False,132,scaffold_4
22,1371001,1591000,219999,False,132,scaffold_4
23,1749001,1817000,67999,False,132,scaffold_4
24,1824001,1868000,43999,False,132,scaffold_4
25,1904001,1957000,52999,False,132,scaffold_4
26,1958001,1990000,31999,False,132,scaffold_4
27,2036001,2065000,28999,False,132,scaffold_4
28,2256001,2279000,22999,False,132,scaffold_4
29,2284001,2310000,25999,False,132,scaffold_4
30,2312001,2340000,27999,False,132,scaffold_4
31,2391001,2442000,50999,False,132,scaffold_4
32,2480001,2533000,52999,False,132,scaffold_4
33,3336001,3633000,296999,False,132,scaffold_4
34,3676001,3760000,83999,False,132,scaffold_4
35,4942001,4984000,41999,False,132,scaffold_4
36,5477001,5506000,28999,False,132,scaffold_4
37,5514001,5620000,105999,False,132,scaffold_4
38,5667001,5784000,116999,False,132,scaffold_4
39,6806001,6817000,10999,False,132,scaffold_4
40,6907001,6924000,16999,False,132,scaffold_4
41,7036001,7062000,25999,False,132,scaffold_4
42,8846001,9699000,852999,False,132,scaffold_4
43,9700001,9845951,145950,True,132,scaffold_4
0,296001,299000,2999,False,132,scaffold_5
1,318001,326000,7999,False,132,scaffold_5
2,327001,368000,40999,False,132,scaffold_5
3,463001,523000,59999,False,132,scaffold_5
4,933001,947000,13999,False,132,scaffold_5
5,1062001,1068000,5999,False,132,scaffold_5
6,1658001,1661000,2999,False,132,scaffold_5
7,2565001,2581000,15999,False,132,scaffold_5
8,2625001,2737000,111999,False,132,scaffold_5
9,2816001,2871000,54999,False,132,scaffold_5
10,3136001,3185000,48999,False,132,scaffold_5
11,3322001,3438000,115999,False,132,scaffold_5
12,3450001,3497000,46999,False,132,scaffold_5
13,3963001,4101000,137999,False,132,scaffold_5
14,4121001,4219000,97999,False,132,scaffold_5
15,4243001,4265000,21999,False,132,scaffold_5
16,4446001,4496000,49999,False,132,scaffold_5
17,4601001,4681000,79999,False,132,scaffold_5
18,4690001,4717000,26999,False,132,scaffold_5
19,4762001,4861000,98999,False,132,scaffold_5
20,5318001,5346000,27999,False,132,scaffold_5
21,7373001,7386000,12999,False,132,scaffold_5
22,7581001,7609000,27999,False,132,scaffold_5
23,7622001,7642000,19999,False,132,scaffold_5
24,8674001,8689000,14999,False,132,scaffold_5
25,8730001,9363000,632999,False,132,scaffold_5
0,79001,84000,4999,False,132,scaffold_6
1,86001,113000,26999,False,132,scaffold_6
2,238001,254000,15999,False,132,scaffold_6
3,543001,546000,2999,False,132,scaffold_6
4,1237001,1257000,19999,False,132,scaffold_6
5,1287001,1314000,26999,False,132,scaffold_6
6,1479001,1546000,66999,False,132,scaffold_6
7,2023001,2086000,62999,False,132,scaffold_6
8,2130001,2169000,38999,False,132,scaffold_6
9,2371001,2595000,223999,False,132,scaffold_6
10,2596001,2653000,56999,False,132,scaffold_6
11,2660001,2691000,30999,False,132,scaffold_6
12,2731001,2853000,121999,False,132,scaffold_6
13,2935001,3014000,78999,False,132,scaffold_6
14,3115001,3174000,58999,False,132,scaffold_6
15,3224001,3301000,76999,False,132,scaffold_6
16,3408001,3427000,18999,False,132,scaffold_6
17,3461001,3766000,304999,False,132,scaffold_6
18,3901001,3912000,10999,False,132,scaffold_6
19,4018001,4069000,50999,False,132,scaffold_6
20,4083001,4193000,109999,False,132,scaffold_6
21,6011001,6060000,48999,False,132,scaffold_6
22,7264001,7337000,72999,False,132,scaffold_6
23,7557001,7796000,238999,False,132,scaffold_6
24,7811001,8268281,457280,True,132,scaffold_6
0,1,7000,6999,True,132,scaffold_7
1,13001,31000,17999,False,132,scaffold_7
2,323001,340000,16999,False,132,scaffold_7
3,342001,508000,165999,False,132,scaffold_7
4,554001,563000,8999,False,132,scaffold_7
5,571001,577000,5999,False,132,scaffold_7
6,706001,736000,29999,False,132,scaffold_7
7,764001,809000,44999,False,132,scaffold_7
8,859001,864000,4999,False,132,scaffold_7
9,982001,1044000,61999,False,132,scaffold_7
10,1048001,1104000,55999,False,132,scaffold_7
11,1191001,1512000,320999,False,132,scaffold_7
12,1588001,1688000,99999,False,132,scaffold_7
13,3326001,3369000,42999,False,132,scaffold_7
14,3528001,3550000,21999,False,132,scaffold_7
15,3594001,3649000,54999,False,132,scaffold_7
16,4416001,4534000,117999,False,132,scaffold_7
17,4658001,4682000,23999,False,132,scaffold_7
18,4978001,5029000,50999,False,132,scaffold_7
19,5077001,5148000,70999,False,132,scaffold_7
20,5484001,5515000,30999,False,132,scaffold_7
21,5609001,5626000,16999,False,132,scaffold_7
22,6955001,7270000,314999,False,132,scaffold_7
23,7271001,7502216,231215,True,132,scaffold_7
0,1,7000,6999,True,132,scaffold_8
1,67001,85000,17999,False,132,scaffold_8
2,722001,725000,2999,False,132,scaffold_8
3,2741001,2757000,15999,False,132,scaffold_8
4,2827001,2842000,14999,False,132,scaffold_8
5,3059001,3125000,65999,False,132,scaffold_8
6,3126001,3525000,398999,False,132,scaffold_8
7,3584001,3612000,27999,False,132,scaffold_8
8,3615001,3913000,297999,False,132,scaffold_8
9,4061001,4099000,37999,False,132,scaffold_8
10,5199001,5241000,41999,False,132,scaffold_8
11,6330001,6334544,4543,True,132,scaffold_8
0,109001,117000,7999,False,132,scaffold_9
1,301001,315000,13999,False,132,scaffold_9
2,319001,334000,14999,False,132,scaffold_9
3,366001,411000,44999,False,132,scaffold_9
4,413001,434000,20999,False,132,scaffold_9
5,502001,531000,28999,False,132,scaffold_9
6,548001,563000,14999,False,132,scaffold_9
7,652001,665000,12999,False,132,scaffold_9
8,670001,696000,25999,False,132,scaffold_9
9,732001,742000,9999,False,132,scaffold_9
10,794001,803000,8999,False,132,scaffold_9
11,817001,842000,24999,False,132,scaffold_9
12,850001,862000,11999,False,132,scaffold_9
13,872001,986000,113999,False,132,scaffold_9
14,988001,995000,6999,False,132,scaffold_9
15,1010001,1031000,20999,False,132,scaffold_9
16,1035001,1085000,49999,False,132,scaffold_9
17,1087001,1164000,76999,False,132,scaffold_9
18,1313001,1377000,63999,False,132,scaffold_9
19,1487001,1499000,11999,False,132,scaffold_9
20,1766001,1790000,23999,False,132,scaffold_9
21,2599001,2616000,16999,False,132,scaffold_9
22,2781001,2802000,20999,False,132,scaffold_9
23,2872001,3381000,508999,False,132,scaffold_9
24,3383001,5100000,1716999,False,132,scaffold_9
25,5101001,5107000,5999,False,132,scaffold_9
26,5112001,5238000,125999,False,132,scaffold_9
27,5239001,5491000,251999,False,132,scaffold_9
28,5493001,6331288,838287,True,132,scaffold_9
0,1,203000,202999,True,132,scaffold_10
1,206001,211000,4999,False,132,scaffold_10
2,375001,406000,30999,False,132,scaffold_10
3,472001,482000,9999,False,132,scaffold_10
4,483001,580000,96999,False,132,scaffold_10
5,603001,750000,146999,False,132,scaffold_10
6,888001,917000,28999,False,132,scaffold_10
7,923001,962000,38999,False,132,scaffold_10
8,1087001,1105000,17999,False,132,scaffold_10
9,2346001,2367000,20999,False,132,scaffold_10
10,4054001,4091000,36999,False,132,scaffold_10
11,4154001,4174000,19999,False,132,scaffold_10
12,4515001,4523000,7999,False,132,scaffold_10
13,4526001,4548000,21999,False,132,scaffold_10
14,4554001,4562000,7999,False,132,scaffold_10
15,4576001,4596000,19999,False,132,scaffold_10
16,4680001,4688000,7999,False,132,scaffold_10
17,4734001,4766000,31999,False,132,scaffold_10
18,4769001,4776000,6999,False,132,scaffold_10
19,4798001,4824000,25999,False,132,scaffold_10
20,4827001,4843000,15999,False,132,scaffold_10
21,4848001,4861000,12999,False,132,scaffold_10
22,4865001,4866973,1972,True,132,scaffold_10
0,10001,34000,23999,False,132,scaffold_11
1,38001,93000,54999,False,132,scaffold_11
2,149001,167000,17999,False,132,scaffold_11
3,169001,191000,21999,False,132,scaffold_11
4,213001,235000,21999,False,132,scaffold_11
5,240001,248000,7999,False,132,scaffold_11
6,419001,431000,11999,False,132,scaffold_11
7,648001,656000,7999,False,132,scaffold_11
8,781001,785000,3999,False,132,scaffold_11
9,1025001,1034000,8999,False,132,scaffold_11
10,2701001,2872000,170999,False,132,scaffold_11
11,3189001,3254000,64999,False,132,scaffold_11
12,3331001,3383000,51999,False,132,scaffold_11
13,3702001,3926000,223999,False,132,scaffold_11
14,4318001,4710000,391999,False,132,scaffold_11
15,4713001,4766820,53819,True,132,scaffold_11
0,1,242000,241999,True,132,scaffold_12
1,250001,370000,119999,False,132,scaffold_12
2,473001,537000,63999,False,132,scaffold_12
3,580001,856000,275999,False,132,scaffold_12
4,865001,1449000,583999,False,132,scaffold_12
5,1720001,1733000,12999,False,132,scaffold_12
6,2571001,2618000,46999,False,132,scaffold_12
0,1,342000,341999,True,133,scaffold_1
1,481001,498000,16999,False,133,scaffold_1
2,570001,643000,72999,False,133,scaffold_1
3,686001,751000,64999,False,133,scaffold_1
4,872001,901000,28999,False,133,scaffold_1
5,1176001,1195000,18999,False,133,scaffold_1
6,1281001,1292000,10999,False,133,scaffold_1
7,1605001,1660000,54999,False,133,scaffold_1
8,1661001,1696000,34999,False,133,scaffold_1
9,1725001,1936000,210999,False,133,scaffold_1
10,1950001,1984000,33999,False,133,scaffold_1
11,1986001,2016000,29999,False,133,scaffold_1
12,2363001,2415000,51999,False,133,scaffold_1
13,2449001,2518000,68999,False,133,scaffold_1
14,2564001,2581000,16999,False,133,scaffold_1
15,2725001,2746000,20999,False,133,scaffold_1
16,3172001,3212000,39999,False,133,scaffold_1
17,3444001,3503000,58999,False,133,scaffold_1
18,3578001,3619000,40999,False,133,scaffold_1
19,3705001,3879000,173999,False,133,scaffold_1
20,3901001,3941000,39999,False,133,scaffold_1
21,3951001,4028000,76999,False,133,scaffold_1
22,4061001,4112000,50999,False,133,scaffold_1
23,4314001,4424000,109999,False,133,scaffold_1
24,4469001,4550000,80999,False,133,scaffold_1
25,4706001,4790000,83999,False,133,scaffold_1
26,4796001,4868000,71999,False,133,scaffold_1
27,4918001,5025000,106999,False,133,scaffold_1
28,5084001,5113000,28999,False,133,scaffold_1
29,5436001,5457000,20999,False,133,scaffold_1
30,5481001,5521000,39999,False,133,scaffold_1
31,5535001,5587000,51999,False,133,scaffold_1
32,5854001,5873000,18999,False,133,scaffold_1
33,6108001,6153000,44999,False,133,scaffold_1
34,6154001,6185000,30999,False,133,scaffold_1
35,6201001,6536000,334999,False,133,scaffold_1
36,6540001,6575000,34999,False,133,scaffold_1
37,7038001,7247000,208999,False,133,scaffold_1
38,7248001,7589000,340999,False,133,scaffold_1
39,7590001,8656000,1065999,False,133,scaffold_1
40,8658001,9584000,925999,False,133,scaffold_1
41,9586001,10364000,777999,False,133,scaffold_1
42,10446001,10639000,192999,False,133,scaffold_1
43,10808001,10811000,2999,False,133,scaffold_1
44,10837001,10856000,18999,False,133,scaffold_1
45,10920001,10990000,69999,False,133,scaffold_1
46,11014001,11031000,16999,False,133,scaffold_1
47,11123001,11190000,66999,False,133,scaffold_1
48,11263001,11951000,687999,False,133,scaffold_1
49,12184001,12206000,21999,False,133,scaffold_1
50,12425001,12449000,23999,False,133,scaffold_1
51,12520001,12582000,61999,False,133,scaffold_1
52,12624001,12888000,263999,False,133,scaffold_1
53,12965001,13052000,86999,False,133,scaffold_1
54,13111001,13216000,104999,False,133,scaffold_1
55,13345001,13454000,108999,False,133,scaffold_1
56,13558001,13583000,24999,False,133,scaffold_1
57,13662001,13703000,40999,False,133,scaffold_1
58,13746001,13766000,19999,False,133,scaffold_1
59,13791001,13845000,53999,False,133,scaffold_1
60,13846001,13875000,28999,False,133,scaffold_1
61,13959001,13976000,16999,False,133,scaffold_1
62,14289001,14313000,23999,False,133,scaffold_1
63,14471001,14475000,3999,False,133,scaffold_1
64,14647001,14664000,16999,False,133,scaffold_1
0,1,48000,47999,True,133,scaffold_2
1,93001,153000,59999,False,133,scaffold_2
2,154001,159000,4999,False,133,scaffold_2
3,168001,177000,8999,False,133,scaffold_2
4,303001,318000,14999,False,133,scaffold_2
5,332001,374000,41999,False,133,scaffold_2
6,379001,381000,1999,False,133,scaffold_2
7,1164001,1202000,37999,False,133,scaffold_2
8,1244001,1259000,14999,False,133,scaffold_2
9,1354001,1417000,62999,False,133,scaffold_2
10,2085001,2132000,46999,False,133,scaffold_2
11,2336001,2600000,263999,False,133,scaffold_2
12,2660001,2689000,28999,False,133,scaffold_2
13,2694001,2746000,51999,False,133,scaffold_2
14,2777001,2788000,10999,False,133,scaffold_2
15,2790001,2857000,66999,False,133,scaffold_2
16,2868001,2911000,42999,False,133,scaffold_2
17,2974001,3021000,46999,False,133,scaffold_2
18,3022001,3064000,41999,False,133,scaffold_2
19,3174001,3187000,12999,False,133,scaffold_2
20,3274001,3281000,6999,False,133,scaffold_2
21,3332001,3390000,57999,False,133,scaffold_2
22,3452001,3575000,122999,False,133,scaffold_2
23,3638001,3712000,73999,False,133,scaffold_2
24,3754001,3931000,176999,False,133,scaffold_2
25,4242001,4409000,166999,False,133,scaffold_2
26,4426001,4461000,34999,False,133,scaffold_2
27,4511001,4791000,279999,False,133,scaffold_2
28,4793001,4806000,12999,False,133,scaffold_2
29,4917001,4968000,50999,False,133,scaffold_2
30,5019001,5068000,48999,False,133,scaffold_2
31,5080001,5104000,23999,False,133,scaffold_2
32,5177001,5224000,46999,False,133,scaffold_2
33,5344001,5488000,143999,False,133,scaffold_2
34,5490001,5515000,24999,False,133,scaffold_2
35,5609001,5763000,153999,False,133,scaffold_2
36,5840001,5892000,51999,False,133,scaffold_2
37,5915001,6059000,143999,False,133,scaffold_2
38,6106001,6195000,88999,False,133,scaffold_2
39,6244001,6330000,85999,False,133,scaffold_2
40,6331001,6351000,19999,False,133,scaffold_2
41,6370001,6449000,78999,False,133,scaffold_2
42,6590001,6628000,37999,False,133,scaffold_2
43,6705001,6721000,15999,False,133,scaffold_2
44,6947001,6979000,31999,False,133,scaffold_2
45,7001001,7039000,37999,False,133,scaffold_2
46,7049001,7097000,47999,False,133,scaffold_2
47,7385001,7472000,86999,False,133,scaffold_2
48,7491001,7513000,21999,False,133,scaffold_2
49,7549001,7561000,11999,False,133,scaffold_2
50,7563001,7726000,162999,False,133,scaffold_2
51,7764001,7920000,155999,False,133,scaffold_2
52,7933001,8315000,381999,False,133,scaffold_2
53,8341001,8345000,3999,False,133,scaffold_2
54,8346001,8455000,108999,False,133,scaffold_2
55,8467001,8494000,26999,False,133,scaffold_2
56,8495001,8565000,69999,False,133,scaffold_2
57,9009001,9047000,37999,False,133,scaffold_2
58,9139001,9173000,33999,False,133,scaffold_2
59,9303001,9382000,78999,False,133,scaffold_2
60,9843001,9899000,55999,False,133,scaffold_2
61,10713001,10730000,16999,False,133,scaffold_2
62,11394001,11422000,27999,False,133,scaffold_2
63,11518001,11786000,267999,False,133,scaffold_2
0,218001,224000,5999,False,133,scaffold_3
1,798001,901000,102999,False,133,scaffold_3
2,1584001,1620000,35999,False,133,scaffold_3
3,1635001,1671000,35999,False,133,scaffold_3
4,1957001,1980000,22999,False,133,scaffold_3
5,2006001,2108000,101999,False,133,scaffold_3
6,2109001,2143000,33999,False,133,scaffold_3
7,2291001,2340000,48999,False,133,scaffold_3
8,2433001,2533000,99999,False,133,scaffold_3
9,2534001,2558000,23999,False,133,scaffold_3
10,2644001,2760000,115999,False,133,scaffold_3
11,2897001,2920000,22999,False,133,scaffold_3
12,3055001,3062000,6999,False,133,scaffold_3
13,3066001,3157000,90999,False,133,scaffold_3
14,3226001,3274000,47999,False,133,scaffold_3
15,3563001,3736000,172999,False,133,scaffold_3
16,3768001,3891000,122999,False,133,scaffold_3
17,3932001,3946000,13999,False,133,scaffold_3
18,3994001,4403000,408999,False,133,scaffold_3
19,4410001,4519000,108999,False,133,scaffold_3
20,4547001,4557000,9999,False,133,scaffold_3
21,4640001,4680000,39999,False,133,scaffold_3
22,4855001,4905000,49999,False,133,scaffold_3
23,4997001,5037000,39999,False,133,scaffold_3
24,5066001,5125000,58999,False,133,scaffold_3
25,5157001,5209000,51999,False,133,scaffold_3
26,5231001,5279000,47999,False,133,scaffold_3
27,5378001,5459000,80999,False,133,scaffold_3
28,5488001,5509000,20999,False,133,scaffold_3
29,5563001,5676000,112999,False,133,scaffold_3
30,5678001,5686000,7999,False,133,scaffold_3
31,5705001,5761000,55999,False,133,scaffold_3
32,5805001,6085000,279999,False,133,scaffold_3
33,6742001,6805000,62999,False,133,scaffold_3
34,6886001,7097000,210999,False,133,scaffold_3
35,7255001,7315000,59999,False,133,scaffold_3
36,7336001,7445000,108999,False,133,scaffold_3
37,7462001,7563000,100999,False,133,scaffold_3
38,7589001,7635000,45999,False,133,scaffold_3
39,7689001,7856000,166999,False,133,scaffold_3
40,8028001,8116000,87999,False,133,scaffold_3
41,8184001,8253000,68999,False,133,scaffold_3
42,8427001,8449000,21999,False,133,scaffold_3
43,8462001,8528000,65999,False,133,scaffold_3
44,8575001,8590000,14999,False,133,scaffold_3
45,8957001,9080000,122999,False,133,scaffold_3
46,9107001,9248000,140999,False,133,scaffold_3
47,9645001,9691000,45999,False,133,scaffold_3
48,9968001,9996000,27999,False,133,scaffold_3
49,10461001,10484000,22999,False,133,scaffold_3
50,10587001,11166000,578999,False,133,scaffold_3
0,1,7000,6999,True,133,scaffold_4
1,11001,13000,1999,False,133,scaffold_4
2,17001,32000,14999,False,133,scaffold_4
3,48001,88000,39999,False,133,scaffold_4
4,92001,115000,22999,False,133,scaffold_4
5,121001,146000,24999,False,133,scaffold_4
6,147001,151000,3999,False,133,scaffold_4
7,155001,215000,59999,False,133,scaffold_4
8,217001,226000,8999,False,133,scaffold_4
9,227001,264000,36999,False,133,scaffold_4
10,283001,307000,23999,False,133,scaffold_4
11,318001,353000,34999,False,133,scaffold_4
12,355001,374000,18999,False,133,scaffold_4
13,375001,380000,4999,False,133,scaffold_4
14,412001,425000,12999,False,133,scaffold_4
15,429001,501000,71999,False,133,scaffold_4
16,542001,592000,49999,False,133,scaffold_4
17,608001,691000,82999,False,133,scaffold_4
18,695001,697000,1999,False,133,scaffold_4
19,701001,714000,12999,False,133,scaffold_4
20,1113001,1136000,22999,False,133,scaffold_4
21,1138001,1226000,87999,False,133,scaffold_4
22,1229001,1234000,4999,False,133,scaffold_4
23,1235001,1253000,17999,False,133,scaffold_4
24,1254001,1279000,24999,False,133,scaffold_4
25,1283001,1336000,52999,False,133,scaffold_4
26,1354001,1601000,246999,False,133,scaffold_4
27,1613001,2129000,515999,False,133,scaffold_4
28,2138001,2185000,46999,False,133,scaffold_4
29,2188001,2206000,17999,False,133,scaffold_4
30,2255001,2268000,12999,False,133,scaffold_4
31,2269001,2281000,11999,False,133,scaffold_4
32,2283001,2460000,176999,False,133,scaffold_4
33,2476001,2635000,158999,False,133,scaffold_4
34,2654001,2675000,20999,False,133,scaffold_4
35,2676001,2796000,119999,False,133,scaffold_4
36,2892001,3145000,252999,False,133,scaffold_4
37,3188001,3775000,586999,False,133,scaffold_4
38,4011001,4044000,32999,False,133,scaffold_4
39,4055001,4105000,49999,False,133,scaffold_4
40,4245001,4306000,60999,False,133,scaffold_4
41,4900001,5095000,194999,False,133,scaffold_4
42,5173001,5224000,50999,False,133,scaffold_4
43,5292001,5506000,213999,False,133,scaffold_4
44,5514001,5784000,269999,False,133,scaffold_4
45,5786001,5828000,41999,False,133,scaffold_4
46,5952001,5980000,27999,False,133,scaffold_4
47,6145001,6197000,51999,False,133,scaffold_4
48,6315001,6379000,63999,False,133,scaffold_4
49,6487001,6506000,18999,False,133,scaffold_4
50,6754001,6817000,62999,False,133,scaffold_4
51,6839001,6865000,25999,False,133,scaffold_4
52,6898001,6924000,25999,False,133,scaffold_4
53,6950001,6995000,44999,False,133,scaffold_4
54,7036001,7174000,137999,False,133,scaffold_4
55,7207001,7429000,221999,False,133,scaffold_4
56,7629001,7666000,36999,False,133,scaffold_4
57,7856001,7916000,59999,False,133,scaffold_4
58,7985001,7997000,11999,False,133,scaffold_4
59,8845001,9699000,853999,False,133,scaffold_4
60,9701001,9737000,35999,False,133,scaffold_4
61,9738001,9845951,107950,True,133,scaffold_4
0,1,4000,3999,True,133,scaffold_5
1,28001,32000,3999,False,133,scaffold_5
2,191001,204000,12999,False,133,scaffold_5
3,320001,392000,71999,False,133,scaffold_5
4,463001,526000,62999,False,133,scaffold_5
5,670001,699000,28999,False,133,scaffold_5
6,932001,947000,14999,False,133,scaffold_5
7,1362001,1387000,24999,False,133,scaffold_5
8,1626001,1641000,14999,False,133,scaffold_5
9,2088001,2104000,15999,False,133,scaffold_5
10,2255001,2299000,43999,False,133,scaffold_5
11,2474001,2494000,19999,False,133,scaffold_5
12,2552001,2896000,343999,False,133,scaffold_5
13,3133001,3514000,380999,False,133,scaffold_5
14,3616001,3658000,41999,False,133,scaffold_5
15,3834001,3908000,73999,False,133,scaffold_5
16,3962001,4101000,138999,False,133,scaffold_5
17,4121001,4223000,101999,False,133,scaffold_5
18,4226001,4321000,94999,False,133,scaffold_5
19,4446001,4553000,106999,False,133,scaffold_5
20,4573001,4862000,288999,False,133,scaffold_5
21,4883001,4924000,40999,False,133,scaffold_5
22,4971001,4993000,21999,False,133,scaffold_5
23,5059001,5103000,43999,False,133,scaffold_5
24,5197001,5346000,148999,False,133,scaffold_5
25,5721001,5738000,16999,False,133,scaffold_5
26,6392001,6670000,277999,False,133,scaffold_5
27,6882001,6906000,23999,False,133,scaffold_5
28,7176001,7189000,12999,False,133,scaffold_5
29,7294001,7328000,33999,False,133,scaffold_5
30,7360001,7386000,25999,False,133,scaffold_5
31,7406001,7440000,33999,False,133,scaffold_5
32,7454001,7486000,31999,False,133,scaffold_5
33,7559001,7619000,59999,False,133,scaffold_5
34,7621001,7747000,125999,False,133,scaffold_5
35,8415001,8464000,48999,False,133,scaffold_5
36,8549001,8616000,66999,False,133,scaffold_5
37,8638001,8689000,50999,False,133,scaffold_5
38,8705001,9364176,659175,True,133,scaffold_5
0,79001,84000,4999,False,133,scaffold_6
1,86001,114000,27999,False,133,scaffold_6
2,162001,208000,45999,False,133,scaffold_6
3,239001,254000,14999,False,133,scaffold_6
4,256001,262000,5999,False,133,scaffold_6
5,264001,297000,32999,False,133,scaffold_6
6,466001,490000,23999,False,133,scaffold_6
7,618001,664000,45999,False,133,scaffold_6
8,731001,753000,21999,False,133,scaffold_6
9,781001,800000,18999,False,133,scaffold_6
10,908001,956000,47999,False,133,scaffold_6
11,975001,1038000,62999,False,133,scaffold_6
12,1119001,1226000,106999,False,133,scaffold_6
13,1229001,1263000,33999,False,133,scaffold_6
14,1285001,1314000,28999,False,133,scaffold_6
15,1432001,1471000,38999,False,133,scaffold_6
16,1476001,1547000,70999,False,133,scaffold_6
17,1559001,1595000,35999,False,133,scaffold_6
18,1649001,1716000,66999,False,133,scaffold_6
19,1793001,1906000,112999,False,133,scaffold_6
20,1907001,1932000,24999,False,133,scaffold_6
21,1978001,2019000,40999,False,133,scaffold_6
22,2023001,2103000,79999,False,133,scaffold_6
23,2129001,2213000,83999,False,133,scaffold_6
24,2236001,2284000,47999,False,133,scaffold_6
25,2332001,2595000,262999,False,133,scaffold_6
26,2596001,2872000,275999,False,133,scaffold_6
27,2927001,3032000,104999,False,133,scaffold_6
28,3097001,3210000,112999,False,133,scaffold_6
29,3222001,3350000,127999,False,133,scaffold_6
30,3351001,3795000,443999,False,133,scaffold_6
31,3883001,3913000,29999,False,133,scaffold_6
32,3965001,3998000,32999,False,133,scaffold_6
33,4017001,4204000,186999,False,133,scaffold_6
34,4838001,4916000,77999,False,133,scaffold_6
35,4944001,4995000,50999,False,133,scaffold_6
36,5862001,5969000,106999,False,133,scaffold_6
37,6004001,6087000,82999,False,133,scaffold_6
38,6123001,6190000,66999,False,133,scaffold_6
39,6766001,6804000,37999,False,133,scaffold_6
40,7187001,7338000,150999,False,133,scaffold_6
41,7389001,7447000,57999,False,133,scaffold_6
42,7531001,8268281,737280,True,133,scaffold_6
0,14001,34000,19999,False,133,scaffold_7
1,323001,340000,16999,False,133,scaffold_7
2,342001,508000,165999,False,133,scaffold_7
3,554001,563000,8999,False,133,scaffold_7
4,571001,577000,5999,False,133,scaffold_7
5,706001,736000,29999,False,133,scaffold_7
6,737001,753000,15999,False,133,scaffold_7
7,764001,829000,64999,False,133,scaffold_7
8,830001,843000,12999,False,133,scaffold_7
9,859001,864000,4999,False,133,scaffold_7
10,865001,948000,82999,False,133,scaffold_7
11,949001,963000,13999,False,133,scaffold_7
12,964001,966000,1999,False,133,scaffold_7
13,968001,980000,11999,False,133,scaffold_7
14,982001,1044000,61999,False,133,scaffold_7
15,1048001,1104000,55999,False,133,scaffold_7
16,1160001,1187000,26999,False,133,scaffold_7
17,1191001,1460000,268999,False,133,scaffold_7
18,1461001,1508000,46999,False,133,scaffold_7
19,1588001,1721000,132999,False,133,scaffold_7
20,1727001,1757000,29999,False,133,scaffold_7
21,1758001,1782000,23999,False,133,scaffold_7
22,1849001,1897000,47999,False,133,scaffold_7
23,1972001,2015000,42999,False,133,scaffold_7
24,2393001,2410000,16999,False,133,scaffold_7
25,2441001,2461000,19999,False,133,scaffold_7
26,2516001,2602000,85999,False,133,scaffold_7
27,2679001,2712000,32999,False,133,scaffold_7
28,2804001,2842000,37999,False,133,scaffold_7
29,3006001,3023000,16999,False,133,scaffold_7
30,3201001,3228000,26999,False,133,scaffold_7
31,3297001,3399000,101999,False,133,scaffold_7
32,3520001,3767000,246999,False,133,scaffold_7
33,4026001,4048000,21999,False,133,scaffold_7
34,4322001,4364000,41999,False,133,scaffold_7
35,4414001,4580000,165999,False,133,scaffold_7
36,4658001,4874000,215999,False,133,scaffold_7
37,4978001,5169000,190999,False,133,scaffold_7
38,5471001,5598000,126999,False,133,scaffold_7
39,5609001,5645000,35999,False,133,scaffold_7
40,5814001,5834000,19999,False,133,scaffold_7
41,6167001,6200000,32999,False,133,scaffold_7
42,6559001,6718000,158999,False,133,scaffold_7
43,6750001,6797000,46999,False,133,scaffold_7
44,6816001,6839000,22999,False,133,scaffold_7
45,6949001,7270000,320999,False,133,scaffold_7
46,7271001,7502216,231215,True,133,scaffold_7
0,1,7000,6999,True,133,scaffold_8
1,66001,85000,18999,False,133,scaffold_8
2,1367001,1424000,56999,False,133,scaffold_8
3,1859001,1931000,71999,False,133,scaffold_8
4,2414001,2531000,116999,False,133,scaffold_8
5,2535001,2601000,65999,False,133,scaffold_8
6,2651001,2844000,192999,False,133,scaffold_8
7,2845001,2910000,64999,False,133,scaffold_8
8,2948001,3938000,989999,False,133,scaffold_8
9,4006001,4148000,141999,False,133,scaffold_8
10,4203001,4268000,64999,False,133,scaffold_8
11,4395001,4432000,36999,False,133,scaffold_8
12,4470001,4487000,16999,False,133,scaffold_8
13,4609001,4646000,36999,False,133,scaffold_8
14,4724001,4777000,52999,False,133,scaffold_8
15,4796001,4917000,120999,False,133,scaffold_8
16,4990001,5019000,28999,False,133,scaffold_8
17,5068001,5241000,172999,False,133,scaffold_8
18,5579001,5596000,16999,False,133,scaffold_8
19,5651001,5723000,71999,False,133,scaffold_8
20,5750001,5774000,23999,False,133,scaffold_8
21,5776001,5801000,24999,False,133,scaffold_8
22,5837001,5879000,41999,False,133,scaffold_8
23,5881001,5907000,25999,False,133,scaffold_8
24,6025001,6077000,51999,False,133,scaffold_8
25,6238001,6308000,69999,False,133,scaffold_8
26,6319001,6334544,15543,True,133,scaffold_8
0,1001,22000,20999,False,133,scaffold_9
1,109001,117000,7999,False,133,scaffold_9
2,319001,333000,13999,False,133,scaffold_9
3,366001,411000,44999,False,133,scaffold_9
4,413001,434000,20999,False,133,scaffold_9
5,484001,531000,46999,False,133,scaffold_9
6,547001,563000,15999,False,133,scaffold_9
7,654001,659000,4999,False,133,scaffold_9
8,660001,665000,4999,False,133,scaffold_9
9,669001,696000,26999,False,133,scaffold_9
10,733001,741000,7999,False,133,scaffold_9
11,793001,801000,7999,False,133,scaffold_9
12,808001,842000,33999,False,133,scaffold_9
13,873001,986000,112999,False,133,scaffold_9
14,988001,995000,6999,False,133,scaffold_9
15,1001001,1006000,4999,False,133,scaffold_9
16,1009001,1085000,75999,False,133,scaffold_9
17,1087001,1160000,72999,False,133,scaffold_9
18,1202001,1230000,27999,False,133,scaffold_9
19,1312001,1383000,70999,False,133,scaffold_9
20,1428001,1435000,6999,False,133,scaffold_9
21,1486001,1586000,99999,False,133,scaffold_9
22,1587001,1625000,37999,False,133,scaffold_9
23,1637001,1692000,54999,False,133,scaffold_9
24,1748001,1811000,62999,False,133,scaffold_9
25,1815001,1855000,39999,False,133,scaffold_9
26,1885001,1959000,73999,False,133,scaffold_9
27,1987001,2058000,70999,False,133,scaffold_9
28,2075001,2171000,95999,False,133,scaffold_9
29,2174001,2353000,178999,False,133,scaffold_9
30,2388001,2447000,58999,False,133,scaffold_9
31,2516001,2582000,65999,False,133,scaffold_9
32,2584001,2673000,88999,False,133,scaffold_9
33,2674001,2700000,25999,False,133,scaffold_9
34,2735001,3381000,645999,False,133,scaffold_9
35,3383001,5099000,1715999,False,133,scaffold_9
36,5101001,5107000,5999,False,133,scaffold_9
37,5112001,5238000,125999,False,133,scaffold_9
38,5239001,5298000,58999,False,133,scaffold_9
39,5299001,6331288,1032287,True,133,scaffold_9
0,1,136000,135999,True,133,scaffold_10
1,137001,414000,276999,False,133,scaffold_10
2,415001,482000,66999,False,133,scaffold_10
3,483001,585000,101999,False,133,scaffold_10
4,596001,795000,198999,False,133,scaffold_10
5,811001,877000,65999,False,133,scaffold_10
6,888001,1069000,180999,False,133,scaffold_10
7,1083001,1153000,69999,False,133,scaffold_10
8,1311001,1354000,42999,False,133,scaffold_10
9,1370001,1465000,94999,False,133,scaffold_10
10,1500001,1531000,30999,False,133,scaffold_10
11,1631001,1663000,31999,False,133,scaffold_10
12,1701001,1759000,57999,False,133,scaffold_10
13,1805001,1817000,11999,False,133,scaffold_10
14,1862001,1923000,60999,False,133,scaffold_10
15,2076001,2109000,32999,False,133,scaffold_10
16,2140001,2230000,89999,False,133,scaffold_10
17,2266001,2331000,64999,False,133,scaffold_10
18,2334001,2471000,136999,False,133,scaffold_10
19,2501001,2520000,18999,False,133,scaffold_10
20,2521001,2657000,135999,False,133,scaffold_10
21,2672001,2812000,139999,False,133,scaffold_10
22,2941001,2954000,12999,False,133,scaffold_10
23,3154001,3177000,22999,False,133,scaffold_10
24,4053001,4091000,37999,False,133,scaffold_10
25,4154001,4174000,19999,False,133,scaffold_10
26,4335001,4365000,29999,False,133,scaffold_10
27,4443001,4462000,18999,False,133,scaffold_10
28,4467001,4477000,9999,False,133,scaffold_10
29,4478001,4502000,23999,False,133,scaffold_10
30,4503001,4513000,9999,False,133,scaffold_10
31,4515001,4523000,7999,False,133,scaffold_10
32,4526001,4548000,21999,False,133,scaffold_10
33,4554001,4562000,7999,False,133,scaffold_10
34,4576001,4595000,18999,False,133,scaffold_10
35,4729001,4732000,2999,False,133,scaffold_10
36,4734001,4776000,41999,False,133,scaffold_10
37,4798001,4824000,25999,False,133,scaffold_10
38,4828001,4843000,14999,False,133,scaffold_10
39,4848001,4861000,12999,False,133,scaffold_10
40,4865001,4866973,1972,True,133,scaffold_10
0,10001,34000,23999,False,133,scaffold_11
1,41001,99000,57999,False,133,scaffold_11
2,149001,167000,17999,False,133,scaffold_11
3,169001,190000,20999,False,133,scaffold_11
4,213001,235000,21999,False,133,scaffold_11
5,240001,248000,7999,False,133,scaffold_11
6,296001,314000,17999,False,133,scaffold_11
7,419001,431000,11999,False,133,scaffold_11
8,648001,656000,7999,False,133,scaffold_11
9,860001,867000,6999,False,133,scaffold_11
10,1025001,1034000,8999,False,133,scaffold_11
11,1219001,1245000,25999,False,133,scaffold_11
12,1304001,1314000,9999,False,133,scaffold_11
13,1315001,1341000,25999,False,133,scaffold_11
14,1403001,1409000,5999,False,133,scaffold_11
15,1423001,1426000,2999,False,133,scaffold_11
16,1431001,1449000,17999,False,133,scaffold_11
17,1474001,1477000,2999,False,133,scaffold_11
18,1526001,1543000,16999,False,133,scaffold_11
19,1679001,1693000,13999,False,133,scaffold_11
20,1855001,1870000,14999,False,133,scaffold_11
21,1871001,1884000,12999,False,133,scaffold_11
22,1967001,2034000,66999,False,133,scaffold_11
23,2035001,2058000,22999,False,133,scaffold_11
24,2116001,2172000,55999,False,133,scaffold_11
25,2177001,2221000,43999,False,133,scaffold_11
26,2674001,2911000,236999,False,133,scaffold_11
27,2952001,3026000,73999,False,133,scaffold_11
28,3083001,3183000,99999,False,133,scaffold_11
29,3184001,3385000,200999,False,133,scaffold_11
30,3418001,3479000,60999,False,133,scaffold_11
31,3518001,3972000,453999,False,133,scaffold_11
32,3983001,4159000,175999,False,133,scaffold_11
33,4179001,4710000,530999,False,133,scaffold_11
34,4713001,4766820,53819,True,133,scaffold_11
0,1,1497000,1496999,True,133,scaffold_12
1,1643001,1664000,20999,False,133,scaffold_12
2,1718001,1735000,16999,False,133,scaffold_12
3,1784001,1812000,27999,False,133,scaffold_12
4,1878001,1995000,116999,False,133,scaffold_12
5,2024001,2041000,16999,False,133,scaffold_12
6,2043001,2087000,43999,False,133,scaffold_12
7,2088001,2103000,14999,False,133,scaffold_12
8,2136001,2180000,43999,False,133,scaffold_12
9,2340001,2377000,36999,False,133,scaffold_12
10,2571001,2609000,37999,False,133,scaffold_12
11,2672001,2682000,9999,False,133,scaffold_12
12,2685001,2699000,13999,False,133,scaffold_12
0,1,445000,444999,True,134,scaffold_1
1,481001,498000,16999,False,134,scaffold_1
2,571001,657000,85999,False,134,scaffold_1
3,686001,756000,69999,False,134,scaffold_1
4,862001,869000,6999,False,134,scaffold_1
5,870001,902000,31999,False,134,scaffold_1
6,1554001,1579000,24999,False,134,scaffold_1
7,1607001,1660000,52999,False,134,scaffold_1
8,1661001,1696000,34999,False,134,scaffold_1
9,1816001,1964000,147999,False,134,scaffold_1
10,1965001,1985000,19999,False,134,scaffold_1
11,1987001,2015000,27999,False,134,scaffold_1
12,2355001,2388000,32999,False,134,scaffold_1
13,2449001,2519000,69999,False,134,scaffold_1
14,2547001,2582000,34999,False,134,scaffold_1
15,2729001,2746000,16999,False,134,scaffold_1
16,2908001,2920000,11999,False,134,scaffold_1
17,3172001,3209000,36999,False,134,scaffold_1
18,3442001,3514000,71999,False,134,scaffold_1
19,3576001,3622000,45999,False,134,scaffold_1
20,3711001,3894000,182999,False,134,scaffold_1
21,3901001,4032000,130999,False,134,scaffold_1
22,4060001,4133000,72999,False,134,scaffold_1
23,4314001,4375000,60999,False,134,scaffold_1
24,4642001,4670000,27999,False,134,scaffold_1
25,4707001,4790000,82999,False,134,scaffold_1
26,4796001,4814000,17999,False,134,scaffold_1
27,4907001,5027000,119999,False,134,scaffold_1
28,5049001,5066000,16999,False,134,scaffold_1
29,5087001,5116000,28999,False,134,scaffold_1
30,5438001,5450000,11999,False,134,scaffold_1
31,5481001,5513000,31999,False,134,scaffold_1
32,5534001,5591000,56999,False,134,scaffold_1
33,5858001,5873000,14999,False,134,scaffold_1
34,6108001,6153000,44999,False,134,scaffold_1
35,6154001,6178000,23999,False,134,scaffold_1
36,6202001,6575000,372999,False,134,scaffold_1
37,6812001,6851000,38999,False,134,scaffold_1
38,7038001,7247000,208999,False,134,scaffold_1
39,7248001,7589000,340999,False,134,scaffold_1
40,7590001,8656000,1065999,False,134,scaffold_1
41,8658001,9584000,925999,False,134,scaffold_1
42,9586001,10356000,769999,False,134,scaffold_1
43,10440001,10639000,198999,False,134,scaffold_1
44,10839001,10857000,17999,False,134,scaffold_1
45,10916001,10966000,49999,False,134,scaffold_1
46,11014001,11036000,21999,False,134,scaffold_1
47,11123001,11196000,72999,False,134,scaffold_1
48,11270001,11508000,237999,False,134,scaffold_1
49,11555001,11952000,396999,False,134,scaffold_1
50,12184001,12205000,20999,False,134,scaffold_1
51,12407001,12450000,42999,False,134,scaffold_1
52,12488001,12547000,58999,False,134,scaffold_1
53,12625001,12950000,324999,False,134,scaffold_1
54,12965001,13002000,36999,False,134,scaffold_1
55,13013001,13059000,45999,False,134,scaffold_1
56,13102001,13216000,113999,False,134,scaffold_1
57,13344001,13455000,110999,False,134,scaffold_1
58,13570001,13589000,18999,False,134,scaffold_1
59,13591001,13611000,19999,False,134,scaffold_1
60,13668001,13709000,40999,False,134,scaffold_1
61,13797001,13845000,47999,False,134,scaffold_1
62,13913001,13927000,13999,False,134,scaffold_1
63,13959001,13973000,13999,False,134,scaffold_1
64,14285001,14310000,24999,False,134,scaffold_1
65,14648001,14664000,15999,False,134,scaffold_1
66,14671001,14674000,2999,False,134,scaffold_1
0,17001,48000,30999,False,134,scaffold_2
1,93001,159000,65999,False,134,scaffold_2
2,168001,177000,8999,False,134,scaffold_2
3,303001,318000,14999,False,134,scaffold_2
4,330001,374000,43999,False,134,scaffold_2
5,379001,381000,1999,False,134,scaffold_2
6,459001,476000,16999,False,134,scaffold_2
7,733001,739000,5999,False,134,scaffold_2
8,1353001,1416000,62999,False,134,scaffold_2
9,2085001,2111000,25999,False,134,scaffold_2
10,2336001,2424000,87999,False,134,scaffold_2
11,2441001,2609000,167999,False,134,scaffold_2
12,2660001,2689000,28999,False,134,scaffold_2
13,2694001,2745000,50999,False,134,scaffold_2
14,2766001,2776000,9999,False,134,scaffold_2
15,2777001,2856000,78999,False,134,scaffold_2
16,2868001,3021000,152999,False,134,scaffold_2
17,3174001,3186000,11999,False,134,scaffold_2
18,3331001,3385000,53999,False,134,scaffold_2
19,3450001,3550000,99999,False,134,scaffold_2
20,3654001,3691000,36999,False,134,scaffold_2
21,3754001,3789000,34999,False,134,scaffold_2
22,4242001,4320000,77999,False,134,scaffold_2
23,4336001,4409000,72999,False,134,scaffold_2
24,4426001,4790000,363999,False,134,scaffold_2
25,4793001,4805000,11999,False,134,scaffold_2
26,4917001,4965000,47999,False,134,scaffold_2
27,4971001,4981000,9999,False,134,scaffold_2
28,5020001,5068000,47999,False,134,scaffold_2
29,5080001,5104000,23999,False,134,scaffold_2
30,5256001,5267000,10999,False,134,scaffold_2
31,5351001,5398000,46999,False,134,scaffold_2
32,5413001,5481000,67999,False,134,scaffold_2
33,5490001,5564000,73999,False,134,scaffold_2
34,5616001,5758000,141999,False,134,scaffold_2
35,5828001,5888000,59999,False,134,scaffold_2
36,5908001,5994000,85999,False,134,scaffold_2
37,6005001,6058000,52999,False,134,scaffold_2
38,6121001,6202000,80999,False,134,scaffold_2
39,6226001,6343000,116999,False,134,scaffold_2
40,6371001,6466000,94999,False,134,scaffold_2
41,6590001,6628000,37999,False,134,scaffold_2
42,6945001,6979000,33999,False,134,scaffold_2
43,7001001,7039000,37999,False,134,scaffold_2
44,7063001,7097000,33999,False,134,scaffold_2
45,7162001,7200000,37999,False,134,scaffold_2
46,7341001,7473000,131999,False,134,scaffold_2
47,7491001,7518000,26999,False,134,scaffold_2
48,7548001,7561000,12999,False,134,scaffold_2
49,7563001,7698000,134999,False,134,scaffold_2
50,7720001,8199000,478999,False,134,scaffold_2
51,8259001,8321000,61999,False,134,scaffold_2
52,8331001,8333000,1999,False,134,scaffold_2
53,8334001,8344000,9999,False,134,scaffold_2
54,8346001,8455000,108999,False,134,scaffold_2
55,8490001,8494000,3999,False,134,scaffold_2
56,8495001,8565000,69999,False,134,scaffold_2
57,9004001,9047000,42999,False,134,scaffold_2
58,9141001,9168000,26999,False,134,scaffold_2
59,9238001,9340000,101999,False,134,scaffold_2
60,9601001,9628000,26999,False,134,scaffold_2
61,9790001,9828000,37999,False,134,scaffold_2
62,9839001,9904000,64999,False,134,scaffold_2
63,9928001,9937000,8999,False,134,scaffold_2
64,10001001,10047000,45999,False,134,scaffold_2
65,10187001,10201000,13999,False,134,scaffold_2
66,10410001,10427000,16999,False,134,scaffold_2
67,10639001,10730000,90999,False,134,scaffold_2
68,10774001,10806000,31999,False,134,scaffold_2
69,11395001,11413000,17999,False,134,scaffold_2
70,11520001,11786000,265999,False,134,scaffold_2
71,11798001,11802476,4475,True,134,scaffold_2
0,618001,646000,27999,False,134,scaffold_3
1,800001,900000,99999,False,134,scaffold_3
2,1584001,1616000,31999,False,134,scaffold_3
3,1906001,1919000,12999,False,134,scaffold_3
4,2008001,2147000,138999,False,134,scaffold_3
5,2288001,2336000,47999,False,134,scaffold_3
6,2380001,2428000,47999,False,134,scaffold_3
7,2433001,2533000,99999,False,134,scaffold_3
8,2648001,2761000,112999,False,134,scaffold_3
9,3110001,3163000,52999,False,134,scaffold_3
10,3213001,3291000,77999,False,134,scaffold_3
11,3498001,3513000,14999,False,134,scaffold_3
12,3558001,3597000,38999,False,134,scaffold_3
13,3602001,3737000,134999,False,134,scaffold_3
14,3769001,3891000,121999,False,134,scaffold_3
15,3910001,3921000,10999,False,134,scaffold_3
16,3922001,4039000,116999,False,134,scaffold_3
17,4040001,4403000,362999,False,134,scaffold_3
18,4415001,4520000,104999,False,134,scaffold_3
19,4547001,4558000,10999,False,134,scaffold_3
20,4652001,4680000,27999,False,134,scaffold_3
21,4857001,4912000,54999,False,134,scaffold_3
22,5000001,5022000,21999,False,134,scaffold_3
23,5156001,5228000,71999,False,134,scaffold_3
24,5235001,5274000,38999,False,134,scaffold_3
25,5380001,5509000,128999,False,134,scaffold_3
26,5563001,5675000,111999,False,134,scaffold_3
27,5702001,5722000,19999,False,134,scaffold_3
28,5744001,5766000,21999,False,134,scaffold_3
29,5768001,6026000,257999,False,134,scaffold_3
30,6218001,6245000,26999,False,134,scaffold_3
31,6742001,6787000,44999,False,134,scaffold_3
32,6887001,7098000,210999,False,134,scaffold_3
33,7110001,7157000,46999,False,134,scaffold_3
34,7254001,7322000,67999,False,134,scaffold_3
35,7333001,7413000,79999,False,134,scaffold_3
36,7449001,7459000,9999,False,134,scaffold_3
37,7483001,7563000,79999,False,134,scaffold_3
38,7590001,7621000,30999,False,134,scaffold_3
39,7656001,7856000,199999,False,134,scaffold_3
40,8045001,8116000,70999,False,134,scaffold_3
41,8121001,8156000,34999,False,134,scaffold_3
42,8184001,8258000,73999,False,134,scaffold_3
43,8398001,8447000,48999,False,134,scaffold_3
44,8462001,8527000,64999,False,134,scaffold_3
45,8575001,8597000,21999,False,134,scaffold_3
46,8757001,8771000,13999,False,134,scaffold_3
47,8962001,9078000,115999,False,134,scaffold_3
48,9106001,9171000,64999,False,134,scaffold_3
49,9211001,9246000,34999,False,134,scaffold_3
50,9968001,9995000,26999,False,134,scaffold_3
51,10042001,10087000,44999,False,134,scaffold_3
52,10461001,10486000,24999,False,134,scaffold_3
53,10550001,10571000,20999,False,134,scaffold_3
54,10574001,11164000,589999,False,134,scaffold_3
0,11001,13000,1999,False,134,scaffold_4
1,17001,32000,14999,False,134,scaffold_4
2,48001,88000,39999,False,134,scaffold_4
3,127001,146000,18999,False,134,scaffold_4
4,147001,151000,3999,False,134,scaffold_4
5,155001,160000,4999,False,134,scaffold_4
6,161001,215000,53999,False,134,scaffold_4
7,217001,226000,8999,False,134,scaffold_4
8,227001,266000,38999,False,134,scaffold_4
9,283001,311000,27999,False,134,scaffold_4
10,313001,344000,30999,False,134,scaffold_4
11,355001,374000,18999,False,134,scaffold_4
12,375001,380000,4999,False,134,scaffold_4
13,390001,410000,19999,False,134,scaffold_4
14,412001,425000,12999,False,134,scaffold_4
15,429001,498000,68999,False,134,scaffold_4
16,545001,592000,46999,False,134,scaffold_4
17,608001,691000,82999,False,134,scaffold_4
18,695001,697000,1999,False,134,scaffold_4
19,701001,714000,12999,False,134,scaffold_4
20,1121001,1136000,14999,False,134,scaffold_4
21,1137001,1198000,60999,False,134,scaffold_4
22,1199001,1226000,26999,False,134,scaffold_4
23,1229001,1234000,4999,False,134,scaffold_4
24,1235001,1253000,17999,False,134,scaffold_4
25,1254001,1264000,9999,False,134,scaffold_4
26,1265001,1279000,13999,False,134,scaffold_4
27,1283001,1336000,52999,False,134,scaffold_4
28,1372001,1604000,231999,False,134,scaffold_4
29,1613001,2118000,504999,False,134,scaffold_4
30,2119001,2185000,65999,False,134,scaffold_4
31,2188001,2279000,90999,False,134,scaffold_4
32,2284001,2340000,55999,False,134,scaffold_4
33,2342001,2460000,117999,False,134,scaffold_4
34,2476001,2635000,158999,False,134,scaffold_4
35,2678001,2815000,136999,False,134,scaffold_4
36,2891001,2990000,98999,False,134,scaffold_4
37,3033001,3133000,99999,False,134,scaffold_4
38,3160001,3782000,621999,False,134,scaffold_4
39,4006001,4045000,38999,False,134,scaffold_4
40,4051001,4105000,53999,False,134,scaffold_4
41,4180001,4197000,16999,False,134,scaffold_4
42,4242001,4306000,63999,False,134,scaffold_4
43,4901001,5095000,193999,False,134,scaffold_4
44,5171001,5224000,52999,False,134,scaffold_4
45,5293001,5329000,35999,False,134,scaffold_4
46,5338001,5506000,167999,False,134,scaffold_4
47,5514001,5784000,269999,False,134,scaffold_4
48,5786001,5828000,41999,False,134,scaffold_4
49,5897001,5900000,2999,False,134,scaffold_4
50,5905001,5910000,4999,False,134,scaffold_4
51,5926001,5971000,44999,False,134,scaffold_4
52,6049001,6113000,63999,False,134,scaffold_4
53,6148001,6195000,46999,False,134,scaffold_4
54,6214001,6245000,30999,False,134,scaffold_4
55,6330001,6384000,53999,False,134,scaffold_4
56,6764001,6817000,52999,False,134,scaffold_4
57,6898001,6924000,25999,False,134,scaffold_4
58,6950001,6995000,44999,False,134,scaffold_4
59,7036001,7124000,87999,False,134,scaffold_4
60,7129001,7174000,44999,False,134,scaffold_4
61,7192001,7397000,204999,False,134,scaffold_4
62,7629001,7666000,36999,False,134,scaffold_4
63,7860001,7913000,52999,False,134,scaffold_4
64,7985001,7998000,12999,False,134,scaffold_4
65,8051001,8102000,50999,False,134,scaffold_4
66,8657001,8674000,16999,False,134,scaffold_4
67,8845001,9699000,853999,False,134,scaffold_4
68,9701001,9845951,144950,True,134,scaffold_4
0,1,4000,3999,True,134,scaffold_5
1,143001,175000,31999,False,134,scaffold_5
2,318001,383000,64999,False,134,scaffold_5
3,463001,524000,60999,False,134,scaffold_5
4,669001,697000,27999,False,134,scaffold_5
5,836001,842000,5999,False,134,scaffold_5
6,933001,947000,13999,False,134,scaffold_5
7,1654001,1661000,6999,False,134,scaffold_5
8,2088001,2104000,15999,False,134,scaffold_5
9,2256001,2278000,21999,False,134,scaffold_5
10,2472001,2494000,21999,False,134,scaffold_5
11,2552001,2902000,349999,False,134,scaffold_5
12,3133001,3519000,385999,False,134,scaffold_5
13,3616001,3663000,46999,False,134,scaffold_5
14,3844001,3946000,101999,False,134,scaffold_5
15,3962001,4101000,138999,False,134,scaffold_5
16,4119001,4357000,237999,False,134,scaffold_5
17,4446001,4924000,477999,False,134,scaffold_5
18,4972001,4990000,17999,False,134,scaffold_5
19,5059001,5097000,37999,False,134,scaffold_5
20,5217001,5346000,128999,False,134,scaffold_5
21,5515001,5527000,11999,False,134,scaffold_5
22,5719001,5738000,18999,False,134,scaffold_5
23,5866001,5888000,21999,False,134,scaffold_5
24,6392001,6721000,328999,False,134,scaffold_5
25,7046001,7086000,39999,False,134,scaffold_5
26,7172001,7330000,157999,False,134,scaffold_5
27,7334001,7386000,51999,False,134,scaffold_5
28,7454001,7515000,60999,False,134,scaffold_5
29,7526001,7750000,223999,False,134,scaffold_5
30,7791001,7803000,11999,False,134,scaffold_5
31,8089001,8096000,6999,False,134,scaffold_5
32,8400001,8463000,62999,False,134,scaffold_5
33,8553001,8616000,62999,False,134,scaffold_5
34,8637001,8687000,49999,False,134,scaffold_5
35,8703001,9364176,661175,True,134,scaffold_5
0,79001,114000,34999,False,134,scaffold_6
1,147001,208000,60999,False,134,scaffold_6
2,239001,254000,14999,False,134,scaffold_6
3,256001,262000,5999,False,134,scaffold_6
4,265001,297000,31999,False,134,scaffold_6
5,467001,496000,28999,False,134,scaffold_6
6,553001,568000,14999,False,134,scaffold_6
7,781001,808000,26999,False,134,scaffold_6
8,910001,956000,45999,False,134,scaffold_6
9,964001,1038000,73999,False,134,scaffold_6
10,1120001,1226000,105999,False,134,scaffold_6
11,1229001,1265000,35999,False,134,scaffold_6
12,1284001,1311000,26999,False,134,scaffold_6
13,1426001,1597000,170999,False,134,scaffold_6
14,1658001,1713000,54999,False,134,scaffold_6
15,1837001,1906000,68999,False,134,scaffold_6
16,1978001,2019000,40999,False,134,scaffold_6
17,2023001,2213000,189999,False,134,scaffold_6
18,2236001,2283000,46999,False,134,scaffold_6
19,2309001,2595000,285999,False,134,scaffold_6
20,2596001,2872000,275999,False,134,scaffold_6
21,2927001,3208000,280999,False,134,scaffold_6
22,3223001,3350000,126999,False,134,scaffold_6
23,3351001,3795000,443999,False,134,scaffold_6
24,3895001,3926000,30999,False,134,scaffold_6
25,3965001,3995000,29999,False,134,scaffold_6
26,4018001,4072000,53999,False,134,scaffold_6
27,4073001,4195000,121999,False,134,scaffold_6
28,4839001,4916000,76999,False,134,scaffold_6
29,4925001,4996000,70999,False,134,scaffold_6
30,5704001,5788000,83999,False,134,scaffold_6
31,5861001,5972000,110999,False,134,scaffold_6
32,5991001,6088000,96999,False,134,scaffold_6
33,6123001,6190000,66999,False,134,scaffold_6
34,6765001,6804000,38999,False,134,scaffold_6
35,6923001,6942000,18999,False,134,scaffold_6
36,7221001,7248000,26999,False,134,scaffold_6
37,7258001,7337000,78999,False,134,scaffold_6
38,7386001,7488000,101999,False,134,scaffold_6
39,7535001,8268281,733280,True,134,scaffold_6
0,1,8000,7999,True,134,scaffold_7
1,13001,34000,20999,False,134,scaffold_7
2,321001,340000,18999,False,134,scaffold_7
3,342001,508000,165999,False,134,scaffold_7
4,571001,577000,5999,False,134,scaffold_7
5,706001,753000,46999,False,134,scaffold_7
6,764001,809000,44999,False,134,scaffold_7
7,859001,864000,4999,False,134,scaffold_7
8,875001,963000,87999,False,134,scaffold_7
9,964001,966000,1999,False,134,scaffold_7
10,968001,980000,11999,False,134,scaffold_7
11,982001,1044000,61999,False,134,scaffold_7
12,1048001,1104000,55999,False,134,scaffold_7
13,1191001,1512000,320999,False,134,scaffold_7
14,1588001,1721000,132999,False,134,scaffold_7
15,1739001,1782000,42999,False,134,scaffold_7
16,1849001,1894000,44999,False,134,scaffold_7
17,1975001,2015000,39999,False,134,scaffold_7
18,2543001,2593000,49999,False,134,scaffold_7
19,2639001,2701000,61999,False,134,scaffold_7
20,2807001,2842000,34999,False,134,scaffold_7
21,3293001,3370000,76999,False,134,scaffold_7
22,3519001,3777000,257999,False,134,scaffold_7
23,3919001,3924000,4999,False,134,scaffold_7
24,4021001,4060000,38999,False,134,scaffold_7
25,4322001,4369000,46999,False,134,scaffold_7
26,4415001,4580000,164999,False,134,scaffold_7
27,4631001,4963000,331999,False,134,scaffold_7
28,4978001,5168000,189999,False,134,scaffold_7
29,5471001,5538000,66999,False,134,scaffold_7
30,5608001,5645000,36999,False,134,scaffold_7
31,6075001,6094000,18999,False,134,scaffold_7
32,6096001,6202000,105999,False,134,scaffold_7
33,6570001,6675000,104999,False,134,scaffold_7
34,6752001,6786000,33999,False,134,scaffold_7
35,6954001,7502216,548215,True,134,scaffold_7
0,1,7000,6999,True,134,scaffold_8
1,67001,85000,17999,False,134,scaffold_8
2,1858001,1932000,73999,False,134,scaffold_8
3,2089001,2153000,63999,False,134,scaffold_8
4,2432001,2530000,97999,False,134,scaffold_8
5,2536001,2551000,14999,False,134,scaffold_8
6,2651001,2916000,264999,False,134,scaffold_8
7,2951001,3566000,614999,False,134,scaffold_8
8,3574001,3612000,37999,False,134,scaffold_8
9,3615001,3947000,331999,False,134,scaffold_8
10,4011001,4221000,209999,False,134,scaffold_8
11,4394001,4429000,34999,False,134,scaffold_8
12,4729001,4777000,47999,False,134,scaffold_8
13,4800001,4924000,123999,False,134,scaffold_8
14,5072001,5244000,171999,False,134,scaffold_8
15,5528001,5548000,19999,False,134,scaffold_8
16,5576001,5596000,19999,False,134,scaffold_8
17,5651001,5710000,58999,False,134,scaffold_8
18,5750001,5775000,24999,False,134,scaffold_8
19,5776001,5801000,24999,False,134,scaffold_8
20,5885001,5908000,22999,False,134,scaffold_8
21,5960001,5995000,34999,False,134,scaffold_8
22,6223001,6307000,83999,False,134,scaffold_8
23,6319001,6334544,15543,True,134,scaffold_8
0,1001,22000,20999,False,134,scaffold_9
1,109001,117000,7999,False,134,scaffold_9
2,303001,315000,11999,False,134,scaffold_9
3,319001,333000,13999,False,134,scaffold_9
4,367001,411000,43999,False,134,scaffold_9
5,413001,434000,20999,False,134,scaffold_9
6,503001,531000,27999,False,134,scaffold_9
7,548001,561000,12999,False,134,scaffold_9
8,670001,696000,25999,False,134,scaffold_9
9,815001,842000,26999,False,134,scaffold_9
10,873001,986000,112999,False,134,scaffold_9
11,988001,995000,6999,False,134,scaffold_9
12,1001001,1007000,5999,False,134,scaffold_9
13,1009001,1085000,75999,False,134,scaffold_9
14,1087001,1160000,72999,False,134,scaffold_9
15,1202001,1231000,28999,False,134,scaffold_9
16,1312001,1383000,70999,False,134,scaffold_9
17,1428001,1441000,12999,False,134,scaffold_9
18,1541001,1584000,42999,False,134,scaffold_9
19,1637001,1692000,54999,False,134,scaffold_9
20,1748001,1811000,62999,False,134,scaffold_9
21,1814001,1857000,42999,False,134,scaffold_9
22,1987001,2171000,183999,False,134,scaffold_9
23,2173001,2365000,191999,False,134,scaffold_9
24,2389001,2499000,109999,False,134,scaffold_9
25,2516001,2582000,65999,False,134,scaffold_9
26,2598001,2673000,74999,False,134,scaffold_9
27,2735001,3381000,645999,False,134,scaffold_9
28,3383001,5107000,1723999,False,134,scaffold_9
29,5112001,5114000,1999,False,134,scaffold_9
30,5116001,5237000,120999,False,134,scaffold_9
31,5239001,5298000,58999,False,134,scaffold_9
32,5300001,5491000,190999,False,134,scaffold_9
33,5493001,6331288,838287,True,134,scaffold_9
0,1,136000,135999,True,134,scaffold_10
1,137001,414000,276999,False,134,scaffold_10
2,415001,482000,66999,False,134,scaffold_10
3,483001,576000,92999,False,134,scaffold_10
4,597001,797000,199999,False,134,scaffold_10
5,812001,877000,64999,False,134,scaffold_10
6,888001,1069000,180999,False,134,scaffold_10
7,1073001,1154000,80999,False,134,scaffold_10
8,1276001,1353000,76999,False,134,scaffold_10
9,1371001,1466000,94999,False,134,scaffold_10
10,1499001,1529000,29999,False,134,scaffold_10
11,1603001,1623000,19999,False,134,scaffold_10
12,1636001,1674000,37999,False,134,scaffold_10
13,1695001,1728000,32999,False,134,scaffold_10
14,1803001,1817000,13999,False,134,scaffold_10
15,1862001,1919000,56999,False,134,scaffold_10
16,2040001,2061000,20999,False,134,scaffold_10
17,2077001,2111000,33999,False,134,scaffold_10
18,2138001,2170000,31999,False,134,scaffold_10
19,2198001,2333000,134999,False,134,scaffold_10
20,2334001,2476000,141999,False,134,scaffold_10
21,2509001,2520000,10999,False,134,scaffold_10
22,2521001,2653000,131999,False,134,scaffold_10
23,2672001,2749000,76999,False,134,scaffold_10
24,2784001,2812000,27999,False,134,scaffold_10
25,2817001,2846000,28999,False,134,scaffold_10
26,3124001,3134000,9999,False,134,scaffold_10
27,4052001,4091000,38999,False,134,scaffold_10
28,4154001,4174000,19999,False,134,scaffold_10
29,4334001,4365000,30999,False,134,scaffold_10
30,4445001,4462000,16999,False,134,scaffold_10
31,4467001,4502000,34999,False,134,scaffold_10
32,4503001,4513000,9999,False,134,scaffold_10
33,4515001,4523000,7999,False,134,scaffold_10
34,4526001,4548000,21999,False,134,scaffold_10
35,4576001,4595000,18999,False,134,scaffold_10
36,4681001,4688000,6999,False,134,scaffold_10
37,4734001,4776000,41999,False,134,scaffold_10
38,4798001,4824000,25999,False,134,scaffold_10
39,4827001,4843000,15999,False,134,scaffold_10
40,4848001,4861000,12999,False,134,scaffold_10
0,10001,89000,78999,False,134,scaffold_11
1,148001,167000,18999,False,134,scaffold_11
2,169001,191000,21999,False,134,scaffold_11
3,213001,236000,22999,False,134,scaffold_11
4,240001,252000,11999,False,134,scaffold_11
5,419001,431000,11999,False,134,scaffold_11
6,648001,657000,8999,False,134,scaffold_11
7,1025001,1034000,8999,False,134,scaffold_11
8,1316001,1358000,41999,False,134,scaffold_11
9,1386001,1398000,11999,False,134,scaffold_11
10,1423001,1427000,3999,False,134,scaffold_11
11,1431001,1451000,19999,False,134,scaffold_11
12,1474001,1478000,3999,False,134,scaffold_11
13,1526001,1546000,19999,False,134,scaffold_11
14,2035001,2058000,22999,False,134,scaffold_11
15,2116001,2172000,55999,False,134,scaffold_11
16,2204001,2221000,16999,False,134,scaffold_11
17,2695001,2909000,213999,False,134,scaffold_11
18,2952001,3032000,79999,False,134,scaffold_11
19,3062001,3183000,120999,False,134,scaffold_11
20,3184001,3385000,200999,False,134,scaffold_11
21,3434001,3479000,44999,False,134,scaffold_11
22,3521001,3972000,450999,False,134,scaffold_11
23,3985001,4710000,724999,False,134,scaffold_11
24,4713001,4766820,53819,True,134,scaffold_11
0,1,1498000,1497999,True,134,scaffold_12
1,1638001,1677000,38999,False,134,scaffold_12
2,1720001,1733000,12999,False,134,scaffold_12
3,1784001,1809000,24999,False,134,scaffold_12
4,1918001,1970000,51999,False,134,scaffold_12
5,1971001,2001000,29999,False,134,scaffold_12
6,2024001,2041000,16999,False,134,scaffold_12
7,2043001,2102000,58999,False,134,scaffold_12
8,2131001,2177000,45999,False,134,scaffold_12
9,2285001,2301000,15999,False,134,scaffold_12
10,2340001,2378000,37999,False,134,scaffold_12
11,2559001,2566000,6999,False,134,scaffold_12
12,2571001,2612000,40999,False,134,scaffold_12
13,2675001,2682000,6999,False,134,scaffold_12
14,2685001,2698000,12999,False,134,scaffold_12
0,1,660000,659999,True,135,scaffold_1
1,686001,752000,65999,False,135,scaffold_1
2,792001,849000,56999,False,135,scaffold_1
3,1178001,1292000,113999,False,135,scaffold_1
4,1531001,1585000,53999,False,135,scaffold_1
5,1606001,1696000,89999,False,135,scaffold_1
6,1725001,1964000,238999,False,135,scaffold_1
7,1965001,1985000,19999,False,135,scaffold_1
8,1988001,2015000,26999,False,135,scaffold_1
9,2267001,2330000,62999,False,135,scaffold_1
10,2342001,2421000,78999,False,135,scaffold_1
11,2449001,2520000,70999,False,135,scaffold_1
12,2543001,2780000,236999,False,135,scaffold_1
13,2879001,3213000,333999,False,135,scaffold_1
14,3292001,3353000,60999,False,135,scaffold_1
15,3444001,3639000,194999,False,135,scaffold_1
16,3702001,4599000,896999,False,135,scaffold_1
17,4639001,4790000,150999,False,135,scaffold_1
18,4796001,5074000,277999,False,135,scaffold_1
19,5087001,5125000,37999,False,135,scaffold_1
20,5139001,5199000,59999,False,135,scaffold_1
21,5344001,5521000,176999,False,135,scaffold_1
22,5535001,5619000,83999,False,135,scaffold_1
23,5723001,5746000,22999,False,135,scaffold_1
24,5849001,5917000,67999,False,135,scaffold_1
25,6048001,6071000,22999,False,135,scaffold_1
26,6108001,6153000,44999,False,135,scaffold_1
27,6154001,6177000,22999,False,135,scaffold_1
28,6201001,6615000,413999,False,135,scaffold_1
29,6630001,6661000,30999,False,135,scaffold_1
30,6809001,6878000,68999,False,135,scaffold_1
31,6930001,7247000,316999,False,135,scaffold_1
32,7248001,7589000,340999,False,135,scaffold_1
33,7590001,8656000,1065999,False,135,scaffold_1
34,8658001,9584000,925999,False,135,scaffold_1
35,9586001,10788000,1201999,False,135,scaffold_1
36,10833001,10991000,157999,False,135,scaffold_1
37,11014001,11220000,205999,False,135,scaffold_1
38,11274001,11965000,690999,False,135,scaffold_1
39,12056001,12115000,58999,False,135,scaffold_1
40,12146001,12243000,96999,False,135,scaffold_1
41,12329001,12365000,35999,False,135,scaffold_1
42,12385001,12396000,10999,False,135,scaffold_1
43,12425001,12888000,462999,False,135,scaffold_1
44,12904001,12950000,45999,False,135,scaffold_1
45,12965001,13217000,251999,False,135,scaffold_1
46,13321001,13447000,125999,False,135,scaffold_1
47,13474001,13496000,21999,False,135,scaffold_1
48,13517001,13583000,65999,False,135,scaffold_1
49,13813001,13829000,15999,False,135,scaffold_1
50,13958001,13966000,7999,False,135,scaffold_1
51,14285001,14313000,27999,False,135,scaffold_1
52,14657001,14664000,6999,False,135,scaffold_1
0,1,48000,47999,True,135,scaffold_2
1,67001,91000,23999,False,135,scaffold_2
2,92001,159000,66999,False,135,scaffold_2
3,168001,177000,8999,False,135,scaffold_2
4,296001,318000,21999,False,135,scaffold_2
5,332001,374000,41999,False,135,scaffold_2
6,459001,550000,90999,False,135,scaffold_2
7,720001,739000,18999,False,135,scaffold_2
8,1019001,1074000,54999,False,135,scaffold_2
9,1144001,1162000,17999,False,135,scaffold_2
10,1164001,1191000,26999,False,135,scaffold_2
11,1352001,1415000,62999,False,135,scaffold_2
12,1518001,1557000,38999,False,135,scaffold_2
13,1593001,1613000,19999,False,135,scaffold_2
14,1922001,1958000,35999,False,135,scaffold_2
15,2085001,2132000,46999,False,135,scaffold_2
16,2302001,2637000,334999,False,135,scaffold_2
17,2655001,2689000,33999,False,135,scaffold_2
18,2694001,2746000,51999,False,135,scaffold_2
19,2766001,2788000,21999,False,135,scaffold_2
20,2796001,2866000,69999,False,135,scaffold_2
21,2868001,3021000,152999,False,135,scaffold_2
22,3022001,3089000,66999,False,135,scaffold_2
23,3252001,3284000,31999,False,135,scaffold_2
24,3330001,3414000,83999,False,135,scaffold_2
25,3450001,3549000,98999,False,135,scaffold_2
26,3608001,3719000,110999,False,135,scaffold_2
27,3754001,3877000,122999,False,135,scaffold_2
28,3881001,3931000,49999,False,135,scaffold_2
29,4095001,4194000,98999,False,135,scaffold_2
30,4221001,4790000,568999,False,135,scaffold_2
31,4793001,4814000,20999,False,135,scaffold_2
32,4876001,4962000,85999,False,135,scaffold_2
33,5017001,5104000,86999,False,135,scaffold_2
34,5125001,5268000,142999,False,135,scaffold_2
35,5285001,5314000,28999,False,135,scaffold_2
36,5348001,5759000,410999,False,135,scaffold_2
37,5830001,6079000,248999,False,135,scaffold_2
38,6090001,6330000,239999,False,135,scaffold_2
39,6331001,6352000,20999,False,135,scaffold_2
40,6365001,6628000,262999,False,135,scaffold_2
41,6696001,6997000,300999,False,135,scaffold_2
42,7000001,7233000,232999,False,135,scaffold_2
43,7259001,7473000,213999,False,135,scaffold_2
44,7491001,7518000,26999,False,135,scaffold_2
45,7544001,7561000,16999,False,135,scaffold_2
46,7563001,8327000,763999,False,135,scaffold_2
47,8331001,8333000,1999,False,135,scaffold_2
48,8334001,8344000,9999,False,135,scaffold_2
49,8346001,8493000,146999,False,135,scaffold_2
50,8495001,8696000,200999,False,135,scaffold_2
51,8725001,8838000,112999,False,135,scaffold_2
52,8933001,9095000,161999,False,135,scaffold_2
53,9140001,9175000,34999,False,135,scaffold_2
54,9236001,9498000,261999,False,135,scaffold_2
55,9564001,9900000,335999,False,135,scaffold_2
56,9928001,9937000,8999,False,135,scaffold_2
57,10001001,10081000,79999,False,135,scaffold_2
58,10188001,10246000,57999,False,135,scaffold_2
59,10309001,10354000,44999,False,135,scaffold_2
60,10402001,10504000,101999,False,135,scaffold_2
61,10523001,10571000,47999,False,135,scaffold_2
62,10675001,10730000,54999,False,135,scaffold_2
63,10776001,10817000,40999,False,135,scaffold_2
64,10995001,10998000,2999,False,135,scaffold_2
65,11000001,11097000,96999,False,135,scaffold_2
66,11150001,11290000,139999,False,135,scaffold_2
67,11328001,11365000,36999,False,135,scaffold_2
68,11366001,11802476,436475,True,135,scaffold_2
0,373001,383000,9999,False,135,scaffold_3
1,618001,646000,27999,False,135,scaffold_3
2,798001,901000,102999,False,135,scaffold_3
3,1153001,1162000,8999,False,135,scaffold_3
4,1163001,1191000,27999,False,135,scaffold_3
5,1903001,1923000,19999,False,135,scaffold_3
6,1936001,1980000,43999,False,135,scaffold_3
7,2007001,2108000,100999,False,135,scaffold_3
8,2109001,2203000,93999,False,135,scaffold_3
9,2205001,2245000,39999,False,135,scaffold_3
10,2249001,2339000,89999,False,135,scaffold_3
11,2376001,2428000,51999,False,135,scaffold_3
12,2433001,2533000,99999,False,135,scaffold_3
13,2594001,2606000,11999,False,135,scaffold_3
14,2647001,2816000,168999,False,135,scaffold_3
15,2886001,2934000,47999,False,135,scaffold_3
16,3103001,3347000,243999,False,135,scaffold_3
17,3361001,3440000,78999,False,135,scaffold_3
18,3475001,4403000,927999,False,135,scaffold_3
19,4414001,4522000,107999,False,135,scaffold_3
20,4546001,4558000,11999,False,135,scaffold_3
21,4567001,4687000,119999,False,135,scaffold_3
22,4695001,4721000,25999,False,135,scaffold_3
23,4744001,4926000,181999,False,135,scaffold_3
24,4997001,5224000,226999,False,135,scaffold_3
25,5234001,5317000,82999,False,135,scaffold_3
26,5347001,5509000,161999,False,135,scaffold_3
27,5511001,5537000,25999,False,135,scaffold_3
28,5561001,5669000,107999,False,135,scaffold_3
29,5702001,5737000,34999,False,135,scaffold_3
30,5777001,6093000,315999,False,135,scaffold_3
31,6217001,6245000,27999,False,135,scaffold_3
32,6477001,6581000,103999,False,135,scaffold_3
33,6659001,7157000,497999,False,135,scaffold_3
34,7230001,7322000,91999,False,135,scaffold_3
35,7332001,7445000,112999,False,135,scaffold_3
36,7449001,7460000,10999,False,135,scaffold_3
37,7462001,7480000,17999,False,135,scaffold_3
38,7483001,7563000,79999,False,135,scaffold_3
39,7577001,7622000,44999,False,135,scaffold_3
40,7656001,7961000,304999,False,135,scaffold_3
41,8028001,8109000,80999,False,135,scaffold_3
42,8175001,8642000,466999,False,135,scaffold_3
43,8653001,8717000,63999,False,135,scaffold_3
44,8758001,8805000,46999,False,135,scaffold_3
45,8840001,8895000,54999,False,135,scaffold_3
46,8955001,9081000,125999,False,135,scaffold_3
47,9091001,9102000,10999,False,135,scaffold_3
48,9105001,9171000,65999,False,135,scaffold_3
49,9199001,9247000,47999,False,135,scaffold_3
50,9439001,9617000,177999,False,135,scaffold_3
51,9646001,9684000,37999,False,135,scaffold_3
52,9701001,9720000,18999,False,135,scaffold_3
53,9816001,9906000,89999,False,135,scaffold_3
54,9966001,10090000,123999,False,135,scaffold_3
55,10233001,10275000,41999,False,135,scaffold_3
56,10277001,10397000,119999,False,135,scaffold_3
57,10461001,10486000,24999,False,135,scaffold_3
58,10550001,11182071,632070,True,135,scaffold_3
0,11001,13000,1999,False,135,scaffold_4
1,17001,29000,11999,False,135,scaffold_4
2,49001,88000,38999,False,135,scaffold_4
3,120001,146000,25999,False,135,scaffold_4
4,147001,151000,3999,False,135,scaffold_4
5,155001,160000,4999,False,135,scaffold_4
6,161001,215000,53999,False,135,scaffold_4
7,218001,226000,7999,False,135,scaffold_4
8,227001,270000,42999,False,135,scaffold_4
9,283001,310000,26999,False,135,scaffold_4
10,318001,344000,25999,False,135,scaffold_4
11,345001,353000,7999,False,135,scaffold_4
12,355001,374000,18999,False,135,scaffold_4
13,392001,410000,17999,False,135,scaffold_4
14,412001,425000,12999,False,135,scaffold_4
15,429001,500000,70999,False,135,scaffold_4
16,541001,592000,50999,False,135,scaffold_4
17,600001,606000,5999,False,135,scaffold_4
18,608001,691000,82999,False,135,scaffold_4
19,1053001,1062000,8999,False,135,scaffold_4
20,1087001,1097000,9999,False,135,scaffold_4
21,1120001,1226000,105999,False,135,scaffold_4
22,1239001,1279000,39999,False,135,scaffold_4
23,1283001,1604000,320999,False,135,scaffold_4
24,1608001,1611000,2999,False,135,scaffold_4
25,1613001,1957000,343999,False,135,scaffold_4
26,1958001,2129000,170999,False,135,scaffold_4
27,2148001,2206000,57999,False,135,scaffold_4
28,2219001,2280000,60999,False,135,scaffold_4
29,2283001,2462000,178999,False,135,scaffold_4
30,2477001,2818000,340999,False,135,scaffold_4
31,2852001,3146000,293999,False,135,scaffold_4
32,3155001,4045000,889999,False,135,scaffold_4
33,4055001,4107000,51999,False,135,scaffold_4
34,4172001,4197000,24999,False,135,scaffold_4
35,4234001,4306000,71999,False,135,scaffold_4
36,4706001,4750000,43999,False,135,scaffold_4
37,4811001,5102000,290999,False,135,scaffold_4
38,5145001,5243000,97999,False,135,scaffold_4
39,5266001,5506000,239999,False,135,scaffold_4
40,5514001,5784000,269999,False,135,scaffold_4
41,5786001,6113000,326999,False,135,scaffold_4
42,6145001,6538000,392999,False,135,scaffold_4
43,6544001,6612000,67999,False,135,scaffold_4
44,6623001,6673000,49999,False,135,scaffold_4
45,6705001,6833000,127999,False,135,scaffold_4
46,6842001,6924000,81999,False,135,scaffold_4
47,6926001,6932000,5999,False,135,scaffold_4
48,6943001,6995000,51999,False,135,scaffold_4
49,7036001,7403000,366999,False,135,scaffold_4
50,7457001,7477000,19999,False,135,scaffold_4
51,7628001,7667000,38999,False,135,scaffold_4
52,7733001,7780000,46999,False,135,scaffold_4
53,7853001,7926000,72999,False,135,scaffold_4
54,7967001,8002000,34999,False,135,scaffold_4
55,8266001,8309000,42999,False,135,scaffold_4
56,8389001,8414000,24999,False,135,scaffold_4
57,8520001,8581000,60999,False,135,scaffold_4
58,8624001,8679000,54999,False,135,scaffold_4
59,8743001,8829000,85999,False,135,scaffold_4
60,8845001,9699000,853999,False,135,scaffold_4
61,9700001,9845951,145950,True,135,scaffold_4
0,1,4000,3999,True,135,scaffold_5
1,127001,173000,45999,False,135,scaffold_5
2,321001,427000,105999,False,135,scaffold_5
3,442001,525000,82999,False,135,scaffold_5
4,669001,697000,27999,False,135,scaffold_5
5,933001,947000,13999,False,135,scaffold_5
6,1626001,1661000,34999,False,135,scaffold_5
7,2083001,2104000,20999,False,135,scaffold_5
8,2256001,2303000,46999,False,135,scaffold_5
9,2376001,2515000,138999,False,135,scaffold_5
10,2516001,2905000,388999,False,135,scaffold_5
11,2920001,3028000,107999,False,135,scaffold_5
12,3049001,3080000,30999,False,135,scaffold_5
13,3091001,3519000,427999,False,135,scaffold_5
14,3532001,3564000,31999,False,135,scaffold_5
15,3616001,3669000,52999,False,135,scaffold_5
16,3713001,3946000,232999,False,135,scaffold_5
17,3961001,5346000,1384999,False,135,scaffold_5
18,5348001,5398000,49999,False,135,scaffold_5
19,5405001,5459000,53999,False,135,scaffold_5
20,5490001,5541000,50999,False,135,scaffold_5
21,5689001,5768000,78999,False,135,scaffold_5
22,5857001,5907000,49999,False,135,scaffold_5
23,6131001,6239000,107999,False,135,scaffold_5
24,6326001,6345000,18999,False,135,scaffold_5
25,6390001,6732000,341999,False,135,scaffold_5
26,6759001,6942000,182999,False,135,scaffold_5
27,7034001,7085000,50999,False,135,scaffold_5
28,7167001,7386000,218999,False,135,scaffold_5
29,7406001,7451000,44999,False,135,scaffold_5
30,7454001,7512000,57999,False,135,scaffold_5
31,7544001,7758000,213999,False,135,scaffold_5
32,7760001,7775000,14999,False,135,scaffold_5
33,7846001,8048000,201999,False,135,scaffold_5
34,8130001,8200000,69999,False,135,scaffold_5
35,8258001,8314000,55999,False,135,scaffold_5
36,8370001,8471000,100999,False,135,scaffold_5
37,8540001,8617000,76999,False,135,scaffold_5
38,8633001,9364176,731175,True,135,scaffold_5
0,1001,39000,37999,False,135,scaffold_6
1,78001,84000,5999,False,135,scaffold_6
2,86001,121000,34999,False,135,scaffold_6
3,147001,208000,60999,False,135,scaffold_6
4,240001,254000,13999,False,135,scaffold_6
5,256001,263000,6999,False,135,scaffold_6
6,264001,325000,60999,False,135,scaffold_6
7,701001,716000,14999,False,135,scaffold_6
8,965001,1039000,73999,False,135,scaffold_6
9,1121001,1226000,104999,False,135,scaffold_6
10,1229001,1263000,33999,False,135,scaffold_6
11,1284001,1311000,26999,False,135,scaffold_6
12,1428001,1626000,197999,False,135,scaffold_6
13,1657001,2019000,361999,False,135,scaffold_6
14,2023001,2212000,188999,False,135,scaffold_6
15,2235001,2284000,48999,False,135,scaffold_6
16,2310001,2595000,284999,False,135,scaffold_6
17,2596001,2872000,275999,False,135,scaffold_6
18,2926001,3808000,881999,False,135,scaffold_6
19,3810001,3926000,115999,False,135,scaffold_6
20,3965001,4195000,229999,False,135,scaffold_6
21,4273001,4306000,32999,False,135,scaffold_6
22,4608001,4672000,63999,False,135,scaffold_6
23,4769001,4795000,25999,False,135,scaffold_6
24,4807001,4916000,108999,False,135,scaffold_6
25,4924001,4996000,71999,False,135,scaffold_6
26,5068001,5184000,115999,False,135,scaffold_6
27,5201001,5257000,55999,False,135,scaffold_6
28,5287001,5327000,39999,False,135,scaffold_6
29,5368001,5407000,38999,False,135,scaffold_6
30,5434001,5470000,35999,False,135,scaffold_6
31,5559001,5788000,228999,False,135,scaffold_6
32,5861001,5972000,110999,False,135,scaffold_6
33,6008001,6084000,75999,False,135,scaffold_6
34,6123001,6277000,153999,False,135,scaffold_6
35,6560001,6611000,50999,False,135,scaffold_6
36,6685001,6804000,118999,False,135,scaffold_6
37,6898001,6953000,54999,False,135,scaffold_6
38,7053001,7143000,89999,False,135,scaffold_6
39,7166001,7339000,172999,False,135,scaffold_6
40,7374001,7484000,109999,False,135,scaffold_6
41,7531001,8268281,737280,True,135,scaffold_6
0,1,12000,11999,True,135,scaffold_7
1,13001,34000,20999,False,135,scaffold_7
2,50001,60000,9999,False,135,scaffold_7
3,323001,340000,16999,False,135,scaffold_7
4,342001,509000,166999,False,135,scaffold_7
5,656001,724000,67999,False,135,scaffold_7
6,725001,736000,10999,False,135,scaffold_7
7,737001,753000,15999,False,135,scaffold_7
8,764001,829000,64999,False,135,scaffold_7
9,858001,864000,5999,False,135,scaffold_7
10,868001,938000,69999,False,135,scaffold_7
11,953001,963000,9999,False,135,scaffold_7
12,964001,966000,1999,False,135,scaffold_7
13,968001,981000,12999,False,135,scaffold_7
14,982001,1044000,61999,False,135,scaffold_7
15,1048001,1136000,87999,False,135,scaffold_7
16,1138001,1148000,9999,False,135,scaffold_7
17,1166001,1512000,345999,False,135,scaffold_7
18,1588001,1695000,106999,False,135,scaffold_7
19,1739001,1780000,40999,False,135,scaffold_7
20,1850001,1901000,50999,False,135,scaffold_7
21,1974001,2015000,40999,False,135,scaffold_7
22,2222001,2272000,49999,False,135,scaffold_7
23,2427001,2711000,283999,False,135,scaffold_7
24,2804001,2962000,157999,False,135,scaffold_7
25,3002001,3265000,262999,False,135,scaffold_7
26,3296001,3985000,688999,False,135,scaffold_7
27,4021001,4152000,130999,False,135,scaffold_7
28,4179001,4188000,8999,False,135,scaffold_7
29,4204001,4512000,307999,False,135,scaffold_7
30,4529001,5232000,702999,False,135,scaffold_7
31,5278001,5340000,61999,False,135,scaffold_7
32,5369001,5645000,275999,False,135,scaffold_7
33,5719001,5760000,40999,False,135,scaffold_7
34,5950001,5981000,30999,False,135,scaffold_7
35,6057001,6094000,36999,False,135,scaffold_7
36,6096001,6433000,336999,False,135,scaffold_7
37,6466001,6523000,56999,False,135,scaffold_7
38,6544001,6684000,139999,False,135,scaffold_7
39,6694001,6866000,171999,False,135,scaffold_7
40,6903001,6932000,28999,False,135,scaffold_7
41,6954001,7270000,315999,False,135,scaffold_7
42,7271001,7502216,231215,True,135,scaffold_7
0,1,6000,5999,True,135,scaffold_8
1,66001,87000,20999,False,135,scaffold_8
2,335001,355000,19999,False,135,scaffold_8
3,820001,822000,1999,False,135,scaffold_8
4,869001,871000,1999,False,135,scaffold_8
5,1358001,1422000,63999,False,135,scaffold_8
6,1733001,1762000,28999,False,135,scaffold_8
7,1815001,1978000,162999,False,135,scaffold_8
8,2057001,2172000,114999,False,135,scaffold_8
9,2223001,2844000,620999,False,135,scaffold_8
10,2846001,4275000,1428999,False,135,scaffold_8
11,4328001,4433000,104999,False,135,scaffold_8
12,4565001,4701000,135999,False,135,scaffold_8
13,4719001,4777000,57999,False,135,scaffold_8
14,4797001,4956000,158999,False,135,scaffold_8
15,4982001,5247000,264999,False,135,scaffold_8
16,5355001,5488000,132999,False,135,scaffold_8
17,5501001,5596000,94999,False,135,scaffold_8
18,5649001,5710000,60999,False,135,scaffold_8
19,5751001,5775000,23999,False,135,scaffold_8
20,5776001,5801000,24999,False,135,scaffold_8
21,5841001,6007000,165999,False,135,scaffold_8
22,6025001,6334544,309543,True,135,scaffold_8
0,1,22000,21999,True,135,scaffold_9
1,109001,140000,30999,False,135,scaffold_9
2,302001,411000,108999,False,135,scaffold_9
3,413001,434000,20999,False,135,scaffold_9
4,483001,531000,47999,False,135,scaffold_9
5,671001,697000,25999,False,135,scaffold_9
6,731001,741000,9999,False,135,scaffold_9
7,817001,842000,24999,False,135,scaffold_9
8,883001,986000,102999,False,135,scaffold_9
9,987001,995000,7999,False,135,scaffold_9
10,1001001,1160000,158999,False,135,scaffold_9
11,1313001,1377000,63999,False,135,scaffold_9
12,1546001,1592000,45999,False,135,scaffold_9
13,1599001,1615000,15999,False,135,scaffold_9
14,1617001,1679000,61999,False,135,scaffold_9
15,1747001,1806000,58999,False,135,scaffold_9
16,1970001,2065000,94999,False,135,scaffold_9
17,2073001,2561000,487999,False,135,scaffold_9
18,2594001,3381000,786999,False,135,scaffold_9
19,3383001,5107000,1723999,False,135,scaffold_9
20,5112001,5114000,1999,False,135,scaffold_9
21,5116001,5238000,121999,False,135,scaffold_9
22,5239001,5298000,58999,False,135,scaffold_9
23,5299001,5490000,190999,False,135,scaffold_9
24,5493001,6331288,838287,True,135,scaffold_9
0,1,482000,481999,True,135,scaffold_10
1,483001,582000,98999,False,135,scaffold_10
2,597001,879000,281999,False,135,scaffold_10
3,888001,1069000,180999,False,135,scaffold_10
4,1072001,1208000,135999,False,135,scaffold_10
5,1235001,1476000,240999,False,135,scaffold_10
6,1512001,1756000,243999,False,135,scaffold_10
7,1861001,1946000,84999,False,135,scaffold_10
8,2002001,2111000,108999,False,135,scaffold_10
9,2136001,2177000,40999,False,135,scaffold_10
10,2198001,2325000,126999,False,135,scaffold_10
11,2346001,2471000,124999,False,135,scaffold_10
12,2521001,2653000,131999,False,135,scaffold_10
13,2673001,2750000,76999,False,135,scaffold_10
14,2787001,2812000,24999,False,135,scaffold_10
15,2817001,2867000,49999,False,135,scaffold_10
16,3114001,3132000,17999,False,135,scaffold_10
17,3414001,3423000,8999,False,135,scaffold_10
18,3463001,3476000,12999,False,135,scaffold_10
19,3636001,3669000,32999,False,135,scaffold_10
20,3779001,3795000,15999,False,135,scaffold_10
21,4001001,4016000,14999,False,135,scaffold_10
22,4050001,4093000,42999,False,135,scaffold_10
23,4154001,4181000,26999,False,135,scaffold_10
24,4316001,4365000,48999,False,135,scaffold_10
25,4443001,4463000,19999,False,135,scaffold_10
26,4467001,4477000,9999,False,135,scaffold_10
27,4478001,4502000,23999,False,135,scaffold_10
28,4503001,4513000,9999,False,135,scaffold_10
29,4515001,4523000,7999,False,135,scaffold_10
30,4526001,4548000,21999,False,135,scaffold_10
31,4565001,4596000,30999,False,135,scaffold_10
32,4734001,4776000,41999,False,135,scaffold_10
33,4798001,4824000,25999,False,135,scaffold_10
34,4828001,4846000,17999,False,135,scaffold_10
35,4848001,4861000,12999,False,135,scaffold_10
36,4865001,4866973,1972,True,135,scaffold_10
0,10001,92000,81999,False,135,scaffold_11
1,132001,167000,34999,False,135,scaffold_11
2,169001,192000,22999,False,135,scaffold_11
3,213001,236000,22999,False,135,scaffold_11
4,240001,252000,11999,False,135,scaffold_11
5,297001,314000,16999,False,135,scaffold_11
6,419001,431000,11999,False,135,scaffold_11
7,648001,656000,7999,False,135,scaffold_11
8,1025001,1034000,8999,False,135,scaffold_11
9,1873001,1917000,43999,False,135,scaffold_11
10,2048001,2058000,9999,False,135,scaffold_11
11,2090001,2172000,81999,False,135,scaffold_11
12,2179001,2225000,45999,False,135,scaffold_11
13,2345001,2427000,81999,False,135,scaffold_11
14,2453001,2627000,173999,False,135,scaffold_11
15,2662001,2920000,257999,False,135,scaffold_11
16,2946001,3038000,91999,False,135,scaffold_11
17,3060001,3175000,114999,False,135,scaffold_11
18,3188001,3297000,108999,False,135,scaffold_11
19,3299001,3383000,83999,False,135,scaffold_11
20,3417001,3479000,61999,False,135,scaffold_11
21,3486001,3508000,21999,False,135,scaffold_11
22,3521001,4710000,1188999,False,135,scaffold_11
23,4713001,4766820,53819,True,135,scaffold_11
0,1,1469000,1468999,True,135,scaffold_12
1,1552001,1601000,48999,False,135,scaffold_12
2,1637001,1676000,38999,False,135,scaffold_12
3,1719001,1752000,32999,False,135,scaffold_12
4,1783001,1812000,28999,False,135,scaffold_12
5,1934001,1962000,27999,False,135,scaffold_12
6,1973001,2002000,28999,False,135,scaffold_12
7,2017001,2041000,23999,False,135,scaffold_12
8,2043001,2103000,59999,False,135,scaffold_12
9,2130001,2166000,35999,False,135,scaffold_12
10,2340001,2380000,39999,False,135,scaffold_12
11,2571001,2618000,46999,False,135,scaffold_12
12,2660001,2682000,21999,False,135,scaffold_12
0,1,342000,341999,True,136,scaffold_1
1,482001,498000,15999,False,136,scaffold_1
2,574001,643000,68999,False,136,scaffold_1
3,686001,759000,72999,False,136,scaffold_1
4,1281001,1292000,10999,False,136,scaffold_1
5,1954001,1964000,9999,False,136,scaffold_1
6,1965001,1984000,18999,False,136,scaffold_1
7,2449001,2517000,67999,False,136,scaffold_1
8,2729001,2746000,16999,False,136,scaffold_1
9,3179001,3208000,28999,False,136,scaffold_1
10,3715001,3733000,17999,False,136,scaffold_1
11,3916001,3941000,24999,False,136,scaffold_1
12,4063001,4111000,47999,False,136,scaffold_1
13,4315001,4354000,38999,False,136,scaffold_1
14,4929001,4963000,33999,False,136,scaffold_1
15,4969001,4983000,13999,False,136,scaffold_1
16,5484001,5511000,26999,False,136,scaffold_1
17,6108001,6153000,44999,False,136,scaffold_1
18,6228001,6381000,152999,False,136,scaffold_1
19,6384001,6507000,122999,False,136,scaffold_1
20,6545001,6554000,8999,False,136,scaffold_1
21,7038001,7247000,208999,False,136,scaffold_1
22,7248001,7584000,335999,False,136,scaffold_1
23,7590001,8656000,1065999,False,136,scaffold_1
24,8658001,9584000,925999,False,136,scaffold_1
25,9586001,10355000,768999,False,136,scaffold_1
26,10461001,10630000,168999,False,136,scaffold_1
27,10808001,10811000,2999,False,136,scaffold_1
28,10836001,10858000,21999,False,136,scaffold_1
29,11351001,11504000,152999,False,136,scaffold_1
30,11643001,11951000,307999,False,136,scaffold_1
31,12184001,12204000,19999,False,136,scaffold_1
32,12664001,12722000,57999,False,136,scaffold_1
33,12777001,12888000,110999,False,136,scaffold_1
34,13113001,13135000,21999,False,136,scaffold_1
35,13178001,13211000,32999,False,136,scaffold_1
36,13347001,13404000,56999,False,136,scaffold_1
37,14294001,14307000,12999,False,136,scaffold_1
38,14560001,14562000,1999,False,136,scaffold_1
0,22001,48000,25999,False,136,scaffold_2
1,93001,159000,65999,False,136,scaffold_2
2,168001,177000,8999,False,136,scaffold_2
3,302001,318000,15999,False,136,scaffold_2
4,333001,374000,40999,False,136,scaffold_2
5,2336001,2358000,21999,False,136,scaffold_2
6,2406001,2423000,16999,False,136,scaffold_2
7,2441001,2553000,111999,False,136,scaffold_2
8,2660001,2689000,28999,False,136,scaffold_2
9,2694001,2742000,47999,False,136,scaffold_2
10,2868001,2899000,30999,False,136,scaffold_2
11,2997001,3009000,11999,False,136,scaffold_2
12,3174001,3187000,12999,False,136,scaffold_2
13,3454001,3463000,8999,False,136,scaffold_2
14,3769001,3781000,11999,False,136,scaffold_2
15,4383001,4409000,25999,False,136,scaffold_2
16,4428001,4457000,28999,False,136,scaffold_2
17,4521001,4558000,36999,False,136,scaffold_2
18,4604001,4654000,49999,False,136,scaffold_2
19,5021001,5031000,9999,False,136,scaffold_2
20,5033001,5061000,27999,False,136,scaffold_2
21,5491001,5511000,19999,False,136,scaffold_2
22,5672001,5704000,31999,False,136,scaffold_2
23,6261001,6330000,68999,False,136,scaffold_2
24,6331001,6342000,10999,False,136,scaffold_2
25,7439001,7473000,33999,False,136,scaffold_2
26,7563001,7697000,133999,False,136,scaffold_2
27,7786001,7891000,104999,False,136,scaffold_2
28,7933001,7966000,32999,False,136,scaffold_2
29,7984001,8088000,103999,False,136,scaffold_2
30,8331001,8333000,1999,False,136,scaffold_2
31,8341001,8344000,2999,False,136,scaffold_2
32,8346001,8388000,41999,False,136,scaffold_2
33,8509001,8561000,51999,False,136,scaffold_2
34,11367001,11374000,6999,False,136,scaffold_2
35,11520001,11786000,265999,False,136,scaffold_2
0,1,2000,1999,True,136,scaffold_3
1,51001,55000,3999,False,136,scaffold_3
2,800001,900000,99999,False,136,scaffold_3
3,2085001,2108000,22999,False,136,scaffold_3
4,2291001,2321000,29999,False,136,scaffold_3
5,2510001,2533000,22999,False,136,scaffold_3
6,4149001,4383000,233999,False,136,scaffold_3
7,4418001,4518000,99999,False,136,scaffold_3
8,4547001,4558000,10999,False,136,scaffold_3
9,4652001,4681000,28999,False,136,scaffold_3
10,6911001,6962000,50999,False,136,scaffold_3
11,6963001,7077000,113999,False,136,scaffold_3
12,7540001,7556000,15999,False,136,scaffold_3
13,7692001,7727000,34999,False,136,scaffold_3
14,7822001,7838000,15999,False,136,scaffold_3
15,8205001,8255000,49999,False,136,scaffold_3
16,8462001,8527000,64999,False,136,scaffold_3
17,8575001,8593000,17999,False,136,scaffold_3
18,9968001,9995000,26999,False,136,scaffold_3
19,10461001,10484000,22999,False,136,scaffold_3
20,10587001,11165000,577999,False,136,scaffold_3
0,3001,7000,3999,False,136,scaffold_4
1,17001,32000,14999,False,136,scaffold_4
2,48001,88000,39999,False,136,scaffold_4
3,135001,146000,10999,False,136,scaffold_4
4,147001,151000,3999,False,136,scaffold_4
5,155001,160000,4999,False,136,scaffold_4
6,161001,215000,53999,False,136,scaffold_4
7,217001,226000,8999,False,136,scaffold_4
8,227001,266000,38999,False,136,scaffold_4
9,316001,344000,27999,False,136,scaffold_4
10,355001,374000,18999,False,136,scaffold_4
11,375001,380000,4999,False,136,scaffold_4
12,412001,425000,12999,False,136,scaffold_4
13,429001,498000,68999,False,136,scaffold_4
14,545001,592000,46999,False,136,scaffold_4
15,608001,661000,52999,False,136,scaffold_4
16,670001,691000,20999,False,136,scaffold_4
17,701001,714000,12999,False,136,scaffold_4
18,1121001,1136000,14999,False,136,scaffold_4
19,1137001,1180000,42999,False,136,scaffold_4
20,1199001,1208000,8999,False,136,scaffold_4
21,1210001,1226000,15999,False,136,scaffold_4
22,1235001,1253000,17999,False,136,scaffold_4
23,1254001,1262000,7999,False,136,scaffold_4
24,1265001,1279000,13999,False,136,scaffold_4
25,1283001,1314000,30999,False,136,scaffold_4
26,1372001,1591000,218999,False,136,scaffold_4
27,1749001,1816000,66999,False,136,scaffold_4
28,1904001,1957000,52999,False,136,scaffold_4
29,2036001,2065000,28999,False,136,scaffold_4
30,2210001,2246000,35999,False,136,scaffold_4
31,2247001,2281000,33999,False,136,scaffold_4
32,2284001,2310000,25999,False,136,scaffold_4
33,2312001,2340000,27999,False,136,scaffold_4
34,2476001,2581000,104999,False,136,scaffold_4
35,3335001,3632000,296999,False,136,scaffold_4
36,3676001,3760000,83999,False,136,scaffold_4
37,4944001,4985000,40999,False,136,scaffold_4
38,5477001,5506000,28999,False,136,scaffold_4
39,5514001,5620000,105999,False,136,scaffold_4
40,5667001,5784000,116999,False,136,scaffold_4
41,6805001,6817000,11999,False,136,scaffold_4
42,7036001,7062000,25999,False,136,scaffold_4
43,8846001,9699000,852999,False,136,scaffold_4
44,9700001,9845951,145950,True,136,scaffold_4
0,318001,326000,7999,False,136,scaffold_5
1,327001,368000,40999,False,136,scaffold_5
2,469001,479000,9999,False,136,scaffold_5
3,508001,523000,14999,False,136,scaffold_5
4,933001,947000,13999,False,136,scaffold_5
5,1062001,1068000,5999,False,136,scaffold_5
6,2564001,2583000,18999,False,136,scaffold_5
7,2625001,2738000,112999,False,136,scaffold_5
8,2816001,2871000,54999,False,136,scaffold_5
9,3138001,3185000,46999,False,136,scaffold_5
10,3322001,3438000,115999,False,136,scaffold_5
11,3451001,3497000,45999,False,136,scaffold_5
12,3963001,4101000,137999,False,136,scaffold_5
13,4121001,4142000,20999,False,136,scaffold_5
14,4155001,4219000,63999,False,136,scaffold_5
15,4246001,4263000,16999,False,136,scaffold_5
16,4446001,4483000,36999,False,136,scaffold_5
17,4603001,4649000,45999,False,136,scaffold_5
18,4691001,4717000,25999,False,136,scaffold_5
19,4813001,4861000,47999,False,136,scaffold_5
20,4904001,4918000,13999,False,136,scaffold_5
21,5314001,5346000,31999,False,136,scaffold_5
22,6550001,6566000,15999,False,136,scaffold_5
23,7373001,7386000,12999,False,136,scaffold_5
24,7581001,7609000,27999,False,136,scaffold_5
25,8730001,9363000,632999,False,136,scaffold_5
26,9364001,9364176,175,True,136,scaffold_5
0,79001,84000,4999,False,136,scaffold_6
1,86001,112000,25999,False,136,scaffold_6
2,240001,253000,12999,False,136,scaffold_6
3,267001,278000,10999,False,136,scaffold_6
4,1237001,1256000,18999,False,136,scaffold_6
5,1287001,1314000,26999,False,136,scaffold_6
6,1479001,1546000,66999,False,136,scaffold_6
7,2030001,2086000,55999,False,136,scaffold_6
8,2130001,2179000,48999,False,136,scaffold_6
9,2368001,2595000,226999,False,136,scaffold_6
10,2596001,2653000,56999,False,136,scaffold_6
11,2660001,2691000,30999,False,136,scaffold_6
12,2731001,2852000,120999,False,136,scaffold_6
13,2935001,3014000,78999,False,136,scaffold_6
14,3115001,3149000,33999,False,136,scaffold_6
15,3224001,3301000,76999,False,136,scaffold_6
16,3408001,3427000,18999,False,136,scaffold_6
17,3460001,3521000,60999,False,136,scaffold_6
18,3527001,3766000,238999,False,136,scaffold_6
19,3901001,3912000,10999,False,136,scaffold_6
20,4019001,4042000,22999,False,136,scaffold_6
21,4085001,4193000,107999,False,136,scaffold_6
22,6011001,6060000,48999,False,136,scaffold_6
23,7285001,7337000,51999,False,136,scaffold_6
24,7560001,7795000,234999,False,136,scaffold_6
25,7811001,8268281,457280,True,136,scaffold_6
0,13001,34000,20999,False,136,scaffold_7
1,243001,249000,5999,False,136,scaffold_7
2,323001,340000,16999,False,136,scaffold_7
3,342001,507000,164999,False,136,scaffold_7
4,554001,563000,8999,False,136,scaffold_7
5,706001,736000,29999,False,136,scaffold_7
6,741001,753000,11999,False,136,scaffold_7
7,764001,809000,44999,False,136,scaffold_7
8,859001,864000,4999,False,136,scaffold_7
9,964001,966000,1999,False,136,scaffold_7
10,968001,981000,12999,False,136,scaffold_7
11,982001,1044000,61999,False,136,scaffold_7
12,1067001,1099000,31999,False,136,scaffold_7
13,1191001,1512000,320999,False,136,scaffold_7
14,1588001,1688000,99999,False,136,scaffold_7
15,3326001,3369000,42999,False,136,scaffold_7
16,3596001,3649000,52999,False,136,scaffold_7
17,4416001,4535000,118999,False,136,scaffold_7
18,4658001,4681000,22999,False,136,scaffold_7
19,4979001,5056000,76999,False,136,scaffold_7
20,5073001,5149000,75999,False,136,scaffold_7
21,5609001,5625000,15999,False,136,scaffold_7
22,6955001,7270000,314999,False,136,scaffold_7
23,7271001,7502216,231215,True,136,scaffold_7
0,67001,85000,17999,False,136,scaffold_8
1,93001,101000,7999,False,136,scaffold_8
2,2445001,2469000,23999,False,136,scaffold_8
3,2495001,2502000,6999,False,136,scaffold_8
4,2656001,2683000,26999,False,136,scaffold_8
5,2745001,2756000,10999,False,136,scaffold_8
6,3060001,3525000,464999,False,136,scaffold_8
7,3584001,3612000,27999,False,136,scaffold_8
8,3615001,3937000,321999,False,136,scaffold_8
9,5127001,5131000,3999,False,136,scaffold_8
10,5200001,5241000,40999,False,136,scaffold_8
11,6330001,6334544,4543,True,136,scaffold_8
0,109001,117000,7999,False,136,scaffold_9
1,302001,315000,12999,False,136,scaffold_9
2,319001,332000,12999,False,136,scaffold_9
3,367001,411000,43999,False,136,scaffold_9
4,413001,436000,22999,False,136,scaffold_9
5,504001,531000,26999,False,136,scaffold_9
6,660001,665000,4999,False,136,scaffold_9
7,670001,696000,25999,False,136,scaffold_9
8,732001,742000,9999,False,136,scaffold_9
9,816001,843000,26999,False,136,scaffold_9
10,850001,862000,11999,False,136,scaffold_9
11,873001,986000,112999,False,136,scaffold_9
12,988001,995000,6999,False,136,scaffold_9
13,1001001,1007000,5999,False,136,scaffold_9
14,1010001,1031000,20999,False,136,scaffold_9
15,1035001,1085000,49999,False,136,scaffold_9
16,1087001,1150000,62999,False,136,scaffold_9
17,1151001,1164000,12999,False,136,scaffold_9
18,1312001,1377000,64999,False,136,scaffold_9
19,1767001,1790000,22999,False,136,scaffold_9
20,2601001,2616000,14999,False,136,scaffold_9
21,2872001,3381000,508999,False,136,scaffold_9
22,3383001,5099000,1715999,False,136,scaffold_9
23,5101001,5107000,5999,False,136,scaffold_9
24,5112001,5114000,1999,False,136,scaffold_9
25,5116001,5237000,120999,False,136,scaffold_9
26,5239001,5298000,58999,False,136,scaffold_9
27,5300001,5490000,189999,False,136,scaffold_9
28,5493001,6331288,838287,True,136,scaffold_9
0,1,199000,198999,True,136,scaffold_10
1,375001,414000,38999,False,136,scaffold_10
2,472001,482000,9999,False,136,scaffold_10
3,483001,580000,96999,False,136,scaffold_10
4,603001,753000,149999,False,136,scaffold_10
5,888001,917000,28999,False,136,scaffold_10
6,924001,962000,37999,False,136,scaffold_10
7,1087001,1112000,24999,False,136,scaffold_10
8,2346001,2366000,19999,False,136,scaffold_10
9,4053001,4091000,37999,False,136,scaffold_10
10,4154001,4174000,19999,False,136,scaffold_10
11,4444001,4460000,15999,False,136,scaffold_10
12,4467001,4476000,8999,False,136,scaffold_10
13,4515001,4523000,7999,False,136,scaffold_10
14,4526001,4547000,20999,False,136,scaffold_10
15,4574001,4596000,21999,False,136,scaffold_10
16,4680001,4688000,7999,False,136,scaffold_10
17,4734001,4766000,31999,False,136,scaffold_10
18,4769001,4776000,6999,False,136,scaffold_10
19,4798001,4824000,25999,False,136,scaffold_10
20,4828001,4843000,14999,False,136,scaffold_10
21,4848001,4861000,12999,False,136,scaffold_10
22,4865001,4866973,1972,True,136,scaffold_10
0,10001,34000,23999,False,136,scaffold_11
1,40001,91000,50999,False,136,scaffold_11
2,148001,167000,18999,False,136,scaffold_11
3,169001,191000,21999,False,136,scaffold_11
4,211001,235000,23999,False,136,scaffold_11
5,240001,245000,4999,False,136,scaffold_11
6,419001,431000,11999,False,136,scaffold_11
7,649001,656000,6999,False,136,scaffold_11
8,1025001,1034000,8999,False,136,scaffold_11
9,1423001,1426000,2999,False,136,scaffold_11
10,2701001,2873000,171999,False,136,scaffold_11
11,3189001,3255000,65999,False,136,scaffold_11
12,3330001,3364000,33999,False,136,scaffold_11
13,3702001,3927000,224999,False,136,scaffold_11
14,4322001,4710000,387999,False,136,scaffold_11
15,4713001,4766820,53819,True,136,scaffold_11
0,1,369000,368999,True,136,scaffold_12
1,475001,491000,15999,False,136,scaffold_12
2,582001,857000,274999,False,136,scaffold_12
3,863001,1354000,490999,False,136,scaffold_12
4,1720001,1733000,12999,False,136,scaffold_12
5,2571001,2618000,46999,False,136,scaffold_12
6,2685001,2699000,13999,False,136,scaffold_12
0,1,342000,341999,True,137,scaffold_1
1,482001,498000,15999,False,137,scaffold_1
2,574001,643000,68999,False,137,scaffold_1
3,686001,713000,26999,False,137,scaffold_1
4,731001,742000,10999,False,137,scaffold_1
5,1281001,1292000,10999,False,137,scaffold_1
6,1954001,1984000,29999,False,137,scaffold_1
7,2449001,2515000,65999,False,137,scaffold_1
8,2729001,2746000,16999,False,137,scaffold_1
9,3181001,3208000,26999,False,137,scaffold_1
10,3715001,3734000,18999,False,137,scaffold_1
11,3916001,3941000,24999,False,137,scaffold_1
12,4062001,4112000,49999,False,137,scaffold_1
13,4322001,4354000,31999,False,137,scaffold_1
14,4928001,4991000,62999,False,137,scaffold_1
15,5484001,5511000,26999,False,137,scaffold_1
16,6108001,6153000,44999,False,137,scaffold_1
17,6228001,6381000,152999,False,137,scaffold_1
18,6384001,6507000,122999,False,137,scaffold_1
19,6545001,6554000,8999,False,137,scaffold_1
20,7038001,7247000,208999,False,137,scaffold_1
21,7248001,7588000,339999,False,137,scaffold_1
22,7590001,8656000,1065999,False,137,scaffold_1
23,8658001,9584000,925999,False,137,scaffold_1
24,9586001,10356000,769999,False,137,scaffold_1
25,10461001,10630000,168999,False,137,scaffold_1
26,10808001,10811000,2999,False,137,scaffold_1
27,10836001,10858000,21999,False,137,scaffold_1
28,11351001,11504000,152999,False,137,scaffold_1
29,11643001,11951000,307999,False,137,scaffold_1
30,12184001,12204000,19999,False,137,scaffold_1
31,12667001,12722000,54999,False,137,scaffold_1
32,12777001,12888000,110999,False,137,scaffold_1
33,13115001,13134000,18999,False,137,scaffold_1
34,13180001,13211000,30999,False,137,scaffold_1
35,13347001,13377000,29999,False,137,scaffold_1
36,14294001,14309000,14999,False,137,scaffold_1
0,22001,48000,25999,False,137,scaffold_2
1,95001,159000,63999,False,137,scaffold_2
2,168001,177000,8999,False,137,scaffold_2
3,303001,318000,14999,False,137,scaffold_2
4,331001,374000,42999,False,137,scaffold_2
5,2336001,2358000,21999,False,137,scaffold_2
6,2405001,2415000,9999,False,137,scaffold_2
7,2416001,2424000,7999,False,137,scaffold_2
8,2441001,2553000,111999,False,137,scaffold_2
9,2660001,2689000,28999,False,137,scaffold_2
10,2694001,2745000,50999,False,137,scaffold_2
11,2766001,2788000,21999,False,137,scaffold_2
12,2996001,3010000,13999,False,137,scaffold_2
13,3174001,3180000,5999,False,137,scaffold_2
14,3454001,3463000,8999,False,137,scaffold_2
15,3767001,3781000,13999,False,137,scaffold_2
16,4385001,4409000,23999,False,137,scaffold_2
17,4429001,4456000,26999,False,137,scaffold_2
18,4521001,4554000,32999,False,137,scaffold_2
19,4597001,4653000,55999,False,137,scaffold_2
20,5022001,5031000,8999,False,137,scaffold_2
21,5033001,5061000,27999,False,137,scaffold_2
22,5491001,5511000,19999,False,137,scaffold_2
23,5672001,5704000,31999,False,137,scaffold_2
24,6261001,6330000,68999,False,137,scaffold_2
25,6331001,6342000,10999,False,137,scaffold_2
26,7439001,7472000,32999,False,137,scaffold_2
27,7563001,7697000,133999,False,137,scaffold_2
28,7786001,7890000,103999,False,137,scaffold_2
29,7934001,7965000,30999,False,137,scaffold_2
30,7985001,8132000,146999,False,137,scaffold_2
31,8331001,8333000,1999,False,137,scaffold_2
32,8346001,8389000,42999,False,137,scaffold_2
33,8509001,8535000,25999,False,137,scaffold_2
34,11367001,11373000,5999,False,137,scaffold_2
35,11520001,11785000,264999,False,137,scaffold_2
0,51001,55000,3999,False,137,scaffold_3
1,102001,104000,1999,False,137,scaffold_3
2,799001,900000,100999,False,137,scaffold_3
3,2085001,2108000,22999,False,137,scaffold_3
4,2291001,2321000,29999,False,137,scaffold_3
5,2508001,2533000,24999,False,137,scaffold_3
6,4150001,4403000,252999,False,137,scaffold_3
7,4410001,4518000,107999,False,137,scaffold_3
8,4547001,4558000,10999,False,137,scaffold_3
9,4653001,4678000,24999,False,137,scaffold_3
10,5708001,5711000,2999,False,137,scaffold_3
11,6911001,6962000,50999,False,137,scaffold_3
12,6980001,7036000,55999,False,137,scaffold_3
13,7540001,7556000,15999,False,137,scaffold_3
14,7693001,7729000,35999,False,137,scaffold_3
15,7822001,7838000,15999,False,137,scaffold_3
16,8208001,8253000,44999,False,137,scaffold_3
17,8462001,8527000,64999,False,137,scaffold_3
18,8575001,8593000,17999,False,137,scaffold_3
19,9968001,9996000,27999,False,137,scaffold_3
20,10461001,10483000,21999,False,137,scaffold_3
21,10587001,11162000,574999,False,137,scaffold_3
0,17001,32000,14999,False,137,scaffold_4
1,48001,88000,39999,False,137,scaffold_4
2,147001,151000,3999,False,137,scaffold_4
3,155001,160000,4999,False,137,scaffold_4
4,161001,215000,53999,False,137,scaffold_4
5,218001,226000,7999,False,137,scaffold_4
6,227001,266000,38999,False,137,scaffold_4
7,291001,307000,15999,False,137,scaffold_4
8,319001,344000,24999,False,137,scaffold_4
9,355001,374000,18999,False,137,scaffold_4
10,375001,380000,4999,False,137,scaffold_4
11,412001,425000,12999,False,137,scaffold_4
12,429001,498000,68999,False,137,scaffold_4
13,545001,599000,53999,False,137,scaffold_4
14,600001,606000,5999,False,137,scaffold_4
15,608001,661000,52999,False,137,scaffold_4
16,670001,691000,20999,False,137,scaffold_4
17,701001,714000,12999,False,137,scaffold_4
18,1120001,1136000,15999,False,137,scaffold_4
19,1137001,1178000,40999,False,137,scaffold_4
20,1199001,1208000,8999,False,137,scaffold_4
21,1210001,1226000,15999,False,137,scaffold_4
22,1235001,1253000,17999,False,137,scaffold_4
23,1254001,1262000,7999,False,137,scaffold_4
24,1265001,1279000,13999,False,137,scaffold_4
25,1283001,1319000,35999,False,137,scaffold_4
26,1372001,1591000,218999,False,137,scaffold_4
27,1749001,1817000,67999,False,137,scaffold_4
28,1940001,1957000,16999,False,137,scaffold_4
29,2211001,2246000,34999,False,137,scaffold_4
30,2247001,2268000,20999,False,137,scaffold_4
31,2269001,2280000,10999,False,137,scaffold_4
32,2284001,2340000,55999,False,137,scaffold_4
33,2480001,2533000,52999,False,137,scaffold_4
34,3335001,3632000,296999,False,137,scaffold_4
35,3676001,3759000,82999,False,137,scaffold_4
36,4944001,4984000,39999,False,137,scaffold_4
37,5477001,5506000,28999,False,137,scaffold_4
38,5516001,5620000,103999,False,137,scaffold_4
39,5669001,5784000,114999,False,137,scaffold_4
40,5786001,5812000,25999,False,137,scaffold_4
41,6149001,6167000,17999,False,137,scaffold_4
42,6180001,6181000,999,False,137,scaffold_4
43,6182001,6188000,5999,False,137,scaffold_4
44,6804001,6817000,12999,False,137,scaffold_4
45,6910001,6924000,13999,False,137,scaffold_4
46,7037001,7062000,24999,False,137,scaffold_4
47,8849001,9699000,849999,False,137,scaffold_4
48,9700001,9845951,145950,True,137,scaffold_4
0,190001,204000,13999,False,137,scaffold_5
1,318001,368000,49999,False,137,scaffold_5
2,466001,484000,17999,False,137,scaffold_5
3,495001,523000,27999,False,137,scaffold_5
4,933001,947000,13999,False,137,scaffold_5
5,1062001,1068000,5999,False,137,scaffold_5
6,2564001,2581000,16999,False,137,scaffold_5
7,2624001,2732000,107999,False,137,scaffold_5
8,2816001,2871000,54999,False,137,scaffold_5
9,3135001,3185000,49999,False,137,scaffold_5
10,3322001,3438000,115999,False,137,scaffold_5
11,3451001,3497000,45999,False,137,scaffold_5
12,3962001,4101000,138999,False,137,scaffold_5
13,4121001,4142000,20999,False,137,scaffold_5
14,4155001,4219000,63999,False,137,scaffold_5
15,4246001,4262000,15999,False,137,scaffold_5
16,4446001,4483000,36999,False,137,scaffold_5
17,4601001,4650000,48999,False,137,scaffold_5
18,4691001,4717000,25999,False,137,scaffold_5
19,4789001,4861000,71999,False,137,scaffold_5
20,4904001,4917000,12999,False,137,scaffold_5
21,5318001,5346000,27999,False,137,scaffold_5
22,7581001,7609000,27999,False,137,scaffold_5
23,8730001,9363000,632999,False,137,scaffold_5
0,79001,84000,4999,False,137,scaffold_6
1,86001,112000,25999,False,137,scaffold_6
2,240001,253000,12999,False,137,scaffold_6
3,267001,283000,15999,False,137,scaffold_6
4,1237001,1256000,18999,False,137,scaffold_6
5,1479001,1546000,66999,False,137,scaffold_6
6,2025001,2080000,54999,False,137,scaffold_6
7,2130001,2168000,37999,False,137,scaffold_6
8,2371001,2595000,223999,False,137,scaffold_6
9,2596001,2653000,56999,False,137,scaffold_6
10,2660001,2691000,30999,False,137,scaffold_6
11,2731001,2852000,120999,False,137,scaffold_6
12,2928001,3014000,85999,False,137,scaffold_6
13,3115001,3149000,33999,False,137,scaffold_6
14,3224001,3300000,75999,False,137,scaffold_6
15,3411001,3427000,15999,False,137,scaffold_6
16,3462001,3766000,303999,False,137,scaffold_6
17,3901001,3912000,10999,False,137,scaffold_6
18,4019001,4040000,20999,False,137,scaffold_6
19,4085001,4193000,107999,False,137,scaffold_6
20,6010001,6060000,49999,False,137,scaffold_6
21,7270001,7336000,65999,False,137,scaffold_6
22,7560001,7795000,234999,False,137,scaffold_6
23,7811001,8268281,457280,True,137,scaffold_6
0,1,7000,6999,True,137,scaffold_7
1,13001,31000,17999,False,137,scaffold_7
2,323001,340000,16999,False,137,scaffold_7
3,342001,507000,164999,False,137,scaffold_7
4,554001,563000,8999,False,137,scaffold_7
5,571001,577000,5999,False,137,scaffold_7
6,706001,736000,29999,False,137,scaffold_7
7,764001,809000,44999,False,137,scaffold_7
8,859001,864000,4999,False,137,scaffold_7
9,968001,980000,11999,False,137,scaffold_7
10,982001,1044000,61999,False,137,scaffold_7
11,1048001,1104000,55999,False,137,scaffold_7
12,1204001,1460000,255999,False,137,scaffold_7
13,1461001,1512000,50999,False,137,scaffold_7
14,1588001,1688000,99999,False,137,scaffold_7
15,3326001,3369000,42999,False,137,scaffold_7
16,3595001,3649000,53999,False,137,scaffold_7
17,4418001,4517000,98999,False,137,scaffold_7
18,4658001,4682000,23999,False,137,scaffold_7
19,4979001,5030000,50999,False,137,scaffold_7
20,5077001,5114000,36999,False,137,scaffold_7
21,6955001,7270000,314999,False,137,scaffold_7
22,7271001,7502216,231215,True,137,scaffold_7
0,2001,6000,3999,False,137,scaffold_8
1,67001,85000,17999,False,137,scaffold_8
2,2445001,2469000,23999,False,137,scaffold_8
3,2662001,2683000,20999,False,137,scaffold_8
4,2742001,2757000,14999,False,137,scaffold_8
5,3060001,3125000,64999,False,137,scaffold_8
6,3126001,3525000,398999,False,137,scaffold_8
7,3584001,3612000,27999,False,137,scaffold_8
8,3615001,3913000,297999,False,137,scaffold_8
9,5200001,5241000,40999,False,137,scaffold_8
10,6331001,6334544,3543,True,137,scaffold_8
0,109001,117000,7999,False,137,scaffold_9
1,303001,315000,11999,False,137,scaffold_9
2,319001,333000,13999,False,137,scaffold_9
3,367001,404000,36999,False,137,scaffold_9
4,413001,434000,20999,False,137,scaffold_9
5,502001,531000,28999,False,137,scaffold_9
6,548001,561000,12999,False,137,scaffold_9
7,670001,696000,25999,False,137,scaffold_9
8,732001,742000,9999,False,137,scaffold_9
9,815001,842000,26999,False,137,scaffold_9
10,872001,986000,113999,False,137,scaffold_9
11,988001,995000,6999,False,137,scaffold_9
12,1001001,1007000,5999,False,137,scaffold_9
13,1009001,1031000,21999,False,137,scaffold_9
14,1035001,1085000,49999,False,137,scaffold_9
15,1087001,1162000,74999,False,137,scaffold_9
16,1312001,1377000,64999,False,137,scaffold_9
17,1767001,1790000,22999,False,137,scaffold_9
18,2601001,2616000,14999,False,137,scaffold_9
19,2874001,3381000,506999,False,137,scaffold_9
20,3383001,5107000,1723999,False,137,scaffold_9
21,5112001,5115000,2999,False,137,scaffold_9
22,5116001,5238000,121999,False,137,scaffold_9
23,5239001,5298000,58999,False,137,scaffold_9
24,5300001,5490000,189999,False,137,scaffold_9
25,5493001,6331288,838287,True,137,scaffold_9
0,1,199000,198999,True,137,scaffold_10
1,375001,414000,38999,False,137,scaffold_10
2,472001,482000,9999,False,137,scaffold_10
3,483001,576000,92999,False,137,scaffold_10
4,603001,750000,146999,False,137,scaffold_10
5,888001,916000,27999,False,137,scaffold_10
6,924001,962000,37999,False,137,scaffold_10
7,1087001,1105000,17999,False,137,scaffold_10
8,4053001,4091000,37999,False,137,scaffold_10
9,4154001,4174000,19999,False,137,scaffold_10
10,4445001,4462000,16999,False,137,scaffold_10
11,4507001,4513000,5999,False,137,scaffold_10
12,4515001,4523000,7999,False,137,scaffold_10
13,4526001,4548000,21999,False,137,scaffold_10
14,4576001,4596000,19999,False,137,scaffold_10
15,4681001,4688000,6999,False,137,scaffold_10
16,4735001,4766000,30999,False,137,scaffold_10
17,4769001,4776000,6999,False,137,scaffold_10
18,4798001,4824000,25999,False,137,scaffold_10
19,4827001,4843000,15999,False,137,scaffold_10
20,4848001,4861000,12999,False,137,scaffold_10
21,4865001,4866973,1972,True,137,scaffold_10
0,10001,34000,23999,False,137,scaffold_11
1,40001,93000,52999,False,137,scaffold_11
2,149001,167000,17999,False,137,scaffold_11
3,169001,191000,21999,False,137,scaffold_11
4,213001,235000,21999,False,137,scaffold_11
5,240001,248000,7999,False,137,scaffold_11
6,419001,431000,11999,False,137,scaffold_11
7,648001,656000,7999,False,137,scaffold_11
8,1025001,1034000,8999,False,137,scaffold_11
9,1305001,1307000,1999,False,137,scaffold_11
10,1423001,1426000,2999,False,137,scaffold_11
11,1474001,1477000,2999,False,137,scaffold_11
12,2701001,2872000,170999,False,137,scaffold_11
13,3188001,3254000,65999,False,137,scaffold_11
14,3331001,3383000,51999,False,137,scaffold_11
15,3702001,3926000,223999,False,137,scaffold_11
16,4321001,4710000,388999,False,137,scaffold_11
17,4713001,4766820,53819,True,137,scaffold_11
0,1,241000,240999,True,137,scaffold_12
1,250001,369000,118999,False,137,scaffold_12
2,474001,536000,61999,False,137,scaffold_12
3,582001,856000,273999,False,137,scaffold_12
4,867001,1354000,486999,False,137,scaffold_12
5,1720001,1733000,12999,False,137,scaffold_12
6,2571001,2612000,40999,False,137,scaffold_12
7,2685001,2699000,13999,False,137,scaffold_12
0,1,397000,396999,True,138,scaffold_1
1,482001,498000,15999,False,138,scaffold_1
2,511001,544000,32999,False,138,scaffold_1
3,554001,659000,104999,False,138,scaffold_1
4,686001,753000,66999,False,138,scaffold_1
5,883001,894000,10999,False,138,scaffold_1
6,1168001,1195000,26999,False,138,scaffold_1
7,1271001,1292000,20999,False,138,scaffold_1
8,1606001,1696000,89999,False,138,scaffold_1
9,1725001,1937000,211999,False,138,scaffold_1
10,1950001,1964000,13999,False,138,scaffold_1
11,1965001,1984000,18999,False,138,scaffold_1
12,1986001,2019000,32999,False,138,scaffold_1
13,2353001,2387000,33999,False,138,scaffold_1
14,2449001,2518000,68999,False,138,scaffold_1
15,2561001,2582000,20999,False,138,scaffold_1
16,2716001,2746000,29999,False,138,scaffold_1
17,2962001,3023000,60999,False,138,scaffold_1
18,3172001,3232000,59999,False,138,scaffold_1
19,3445001,3500000,54999,False,138,scaffold_1
20,3576001,3620000,43999,False,138,scaffold_1
21,3702001,3941000,238999,False,138,scaffold_1
22,3952001,4030000,77999,False,138,scaffold_1
23,4061001,4153000,91999,False,138,scaffold_1
24,4314001,4448000,133999,False,138,scaffold_1
25,4463001,4544000,80999,False,138,scaffold_1
26,4650001,4669000,18999,False,138,scaffold_1
27,4682001,4791000,108999,False,138,scaffold_1
28,4796001,4867000,70999,False,138,scaffold_1
29,4907001,5026000,118999,False,138,scaffold_1
30,5040001,5065000,24999,False,138,scaffold_1
31,5087001,5122000,34999,False,138,scaffold_1
32,5436001,5459000,22999,False,138,scaffold_1
33,5479001,5521000,41999,False,138,scaffold_1
34,5535001,5579000,43999,False,138,scaffold_1
35,5850001,5876000,25999,False,138,scaffold_1
36,6108001,6153000,44999,False,138,scaffold_1
37,6154001,6176000,21999,False,138,scaffold_1
38,6201001,6382000,180999,False,138,scaffold_1
39,6384001,6575000,190999,False,138,scaffold_1
40,6831001,6851000,19999,False,138,scaffold_1
41,6939001,6953000,13999,False,138,scaffold_1
42,7038001,7247000,208999,False,138,scaffold_1
43,7248001,7589000,340999,False,138,scaffold_1
44,7590001,8656000,1065999,False,138,scaffold_1
45,8658001,9584000,925999,False,138,scaffold_1
46,9586001,10363000,776999,False,138,scaffold_1
47,10449001,10640000,190999,False,138,scaffold_1
48,10808001,10811000,2999,False,138,scaffold_1
49,10837001,10857000,19999,False,138,scaffold_1
50,10917001,10940000,22999,False,138,scaffold_1
51,11014001,11046000,31999,False,138,scaffold_1
52,11122001,11208000,85999,False,138,scaffold_1
53,11271001,11512000,240999,False,138,scaffold_1
54,11555001,11957000,401999,False,138,scaffold_1
55,12170001,12204000,33999,False,138,scaffold_1
56,12338001,12363000,24999,False,138,scaffold_1
57,12425001,12448000,22999,False,138,scaffold_1
58,12496001,12585000,88999,False,138,scaffold_1
59,12624001,12758000,133999,False,138,scaffold_1
60,12775001,12888000,112999,False,138,scaffold_1
61,12966001,13067000,100999,False,138,scaffold_1
62,13109001,13212000,102999,False,138,scaffold_1
63,13347001,13455000,107999,False,138,scaffold_1
64,13558001,13590000,31999,False,138,scaffold_1
65,13592001,13598000,5999,False,138,scaffold_1
66,13810001,13845000,34999,False,138,scaffold_1
67,13948001,13955000,6999,False,138,scaffold_1
68,13959001,13976000,16999,False,138,scaffold_1
69,14285001,14310000,24999,False,138,scaffold_1
70,14671001,14674000,2999,False,138,scaffold_1
71,14787001,14794116,7115,True,138,scaffold_1
0,8001,48000,39999,False,138,scaffold_2
1,93001,159000,65999,False,138,scaffold_2
2,168001,177000,8999,False,138,scaffold_2
3,297001,318000,20999,False,138,scaffold_2
4,332001,374000,41999,False,138,scaffold_2
5,1353001,1415000,61999,False,138,scaffold_2
6,1527001,1554000,26999,False,138,scaffold_2
7,1841001,1897000,55999,False,138,scaffold_2
8,2085001,2132000,46999,False,138,scaffold_2
9,2302001,2334000,31999,False,138,scaffold_2
10,2336001,2638000,301999,False,138,scaffold_2
11,2652001,2689000,36999,False,138,scaffold_2
12,2694001,2747000,52999,False,138,scaffold_2
13,2766001,2776000,9999,False,138,scaffold_2
14,2777001,2788000,10999,False,138,scaffold_2
15,2833001,2856000,22999,False,138,scaffold_2
16,2878001,3013000,134999,False,138,scaffold_2
17,3022001,3048000,25999,False,138,scaffold_2
18,3272001,3284000,11999,False,138,scaffold_2
19,3332001,3390000,57999,False,138,scaffold_2
20,3449001,3574000,124999,False,138,scaffold_2
21,3658001,3712000,53999,False,138,scaffold_2
22,3754001,3792000,37999,False,138,scaffold_2
23,3858001,3936000,77999,False,138,scaffold_2
24,4243001,4409000,165999,False,138,scaffold_2
25,4426001,4462000,35999,False,138,scaffold_2
26,4472001,4790000,317999,False,138,scaffold_2
27,4793001,4808000,14999,False,138,scaffold_2
28,4916001,4982000,65999,False,138,scaffold_2
29,5020001,5068000,47999,False,138,scaffold_2
30,5079001,5104000,24999,False,138,scaffold_2
31,5181001,5222000,40999,False,138,scaffold_2
32,5285001,5314000,28999,False,138,scaffold_2
33,5350001,5564000,213999,False,138,scaffold_2
34,5607001,5758000,150999,False,138,scaffold_2
35,5827001,5888000,60999,False,138,scaffold_2
36,5908001,5993000,84999,False,138,scaffold_2
37,6005001,6058000,52999,False,138,scaffold_2
38,6122001,6351000,228999,False,138,scaffold_2
39,6370001,6469000,98999,False,138,scaffold_2
40,6588001,6629000,40999,False,138,scaffold_2
41,6940001,6979000,38999,False,138,scaffold_2
42,7011001,7047000,35999,False,138,scaffold_2
43,7049001,7097000,47999,False,138,scaffold_2
44,7110001,7220000,109999,False,138,scaffold_2
45,7384001,7475000,90999,False,138,scaffold_2
46,7491001,7516000,24999,False,138,scaffold_2
47,7549001,7561000,11999,False,138,scaffold_2
48,7563001,8329000,765999,False,138,scaffold_2
49,8331001,8333000,1999,False,138,scaffold_2
50,8334001,8344000,9999,False,138,scaffold_2
51,8346001,8493000,146999,False,138,scaffold_2
52,8495001,8564000,68999,False,138,scaffold_2
53,8996001,9047000,50999,False,138,scaffold_2
54,9140001,9180000,39999,False,138,scaffold_2
55,9282001,9382000,99999,False,138,scaffold_2
56,9601001,9639000,37999,False,138,scaffold_2
57,9752001,9828000,75999,False,138,scaffold_2
58,9830001,9903000,72999,False,138,scaffold_2
59,9930001,9938000,7999,False,138,scaffold_2
60,10017001,10053000,35999,False,138,scaffold_2
61,10333001,10350000,16999,False,138,scaffold_2
62,10404001,10466000,61999,False,138,scaffold_2
63,10635001,10658000,22999,False,138,scaffold_2
64,10774001,10815000,40999,False,138,scaffold_2
65,10995001,10998000,2999,False,138,scaffold_2
66,11029001,11066000,36999,False,138,scaffold_2
67,11355001,11426000,70999,False,138,scaffold_2
68,11469001,11498000,28999,False,138,scaffold_2
69,11520001,11786000,265999,False,138,scaffold_2
70,11797001,11802476,5475,True,138,scaffold_2
0,618001,646000,27999,False,138,scaffold_3
1,798001,900000,101999,False,138,scaffold_3
2,1958001,1984000,25999,False,138,scaffold_3
3,2007001,2147000,139999,False,138,scaffold_3
4,2288001,2336000,47999,False,138,scaffold_3
5,2389001,2428000,38999,False,138,scaffold_3
6,2433001,2533000,99999,False,138,scaffold_3
7,2534001,2558000,23999,False,138,scaffold_3
8,2647001,2761000,113999,False,138,scaffold_3
9,2893001,2925000,31999,False,138,scaffold_3
10,3066001,3281000,214999,False,138,scaffold_3
11,3410001,3426000,15999,False,138,scaffold_3
12,3560001,3583000,22999,False,138,scaffold_3
13,3602001,3734000,131999,False,138,scaffold_3
14,3768001,3891000,122999,False,138,scaffold_3
15,3908001,3921000,12999,False,138,scaffold_3
16,3922001,4035000,112999,False,138,scaffold_3
17,4066001,4403000,336999,False,138,scaffold_3
18,4410001,4522000,111999,False,138,scaffold_3
19,4546001,4558000,11999,False,138,scaffold_3
20,4652001,4680000,27999,False,138,scaffold_3
21,4854001,4912000,57999,False,138,scaffold_3
22,4999001,5030000,30999,False,138,scaffold_3
23,5071001,5279000,207999,False,138,scaffold_3
24,5380001,5395000,14999,False,138,scaffold_3
25,5431001,5509000,77999,False,138,scaffold_3
26,5579001,5676000,96999,False,138,scaffold_3
27,5804001,6050000,245999,False,138,scaffold_3
28,6741001,6785000,43999,False,138,scaffold_3
29,6886001,7157000,270999,False,138,scaffold_3
30,7254001,7320000,65999,False,138,scaffold_3
31,7336001,7445000,108999,False,138,scaffold_3
32,7449001,7460000,10999,False,138,scaffold_3
33,7462001,7480000,17999,False,138,scaffold_3
34,7483001,7563000,79999,False,138,scaffold_3
35,7576001,7630000,53999,False,138,scaffold_3
36,7656001,7855000,198999,False,138,scaffold_3
37,8044001,8116000,71999,False,138,scaffold_3
38,8176001,8280000,103999,False,138,scaffold_3
39,8396001,8448000,51999,False,138,scaffold_3
40,8462001,8528000,65999,False,138,scaffold_3
41,8574001,8596000,21999,False,138,scaffold_3
42,8955001,9080000,124999,False,138,scaffold_3
43,9110001,9168000,57999,False,138,scaffold_3
44,9199001,9239000,39999,False,138,scaffold_3
45,9555001,9579000,23999,False,138,scaffold_3
46,9659001,9692000,32999,False,138,scaffold_3
47,9968001,9995000,26999,False,138,scaffold_3
48,10065001,10089000,23999,False,138,scaffold_3
49,10461001,10485000,23999,False,138,scaffold_3
50,10587001,11182071,595070,True,138,scaffold_3
0,11001,13000,1999,False,138,scaffold_4
1,17001,32000,14999,False,138,scaffold_4
2,48001,88000,39999,False,138,scaffold_4
3,106001,115000,8999,False,138,scaffold_4
4,132001,146000,13999,False,138,scaffold_4
5,147001,151000,3999,False,138,scaffold_4
6,155001,160000,4999,False,138,scaffold_4
7,161001,215000,53999,False,138,scaffold_4
8,217001,226000,8999,False,138,scaffold_4
9,227001,266000,38999,False,138,scaffold_4
10,288001,344000,55999,False,138,scaffold_4
11,355001,374000,18999,False,138,scaffold_4
12,412001,425000,12999,False,138,scaffold_4
13,429001,502000,72999,False,138,scaffold_4
14,542001,599000,56999,False,138,scaffold_4
15,600001,606000,5999,False,138,scaffold_4
16,608001,691000,82999,False,138,scaffold_4
17,695001,697000,1999,False,138,scaffold_4
18,700001,714000,13999,False,138,scaffold_4
19,1121001,1136000,14999,False,138,scaffold_4
20,1138001,1226000,87999,False,138,scaffold_4
21,1238001,1253000,14999,False,138,scaffold_4
22,1254001,1260000,5999,False,138,scaffold_4
23,1268001,1279000,10999,False,138,scaffold_4
24,1283001,1604000,320999,False,138,scaffold_4
25,1609001,1611000,1999,False,138,scaffold_4
26,1613001,2185000,571999,False,138,scaffold_4
27,2188001,2218000,29999,False,138,scaffold_4
28,2219001,2279000,59999,False,138,scaffold_4
29,2283001,2461000,177999,False,138,scaffold_4
30,2476001,2813000,336999,False,138,scaffold_4
31,2895001,3136000,240999,False,138,scaffold_4
32,3159001,3774000,614999,False,138,scaffold_4
33,4010001,4046000,35999,False,138,scaffold_4
34,4050001,4106000,55999,False,138,scaffold_4
35,4220001,4306000,85999,False,138,scaffold_4
36,4900001,5105000,204999,False,138,scaffold_4
37,5171001,5244000,72999,False,138,scaffold_4
38,5289001,5506000,216999,False,138,scaffold_4
39,5514001,5784000,269999,False,138,scaffold_4
40,5786001,5826000,39999,False,138,scaffold_4
41,5884001,5965000,80999,False,138,scaffold_4
42,6063001,6117000,53999,False,138,scaffold_4
43,6148001,6296000,147999,False,138,scaffold_4
44,6327001,6441000,113999,False,138,scaffold_4
45,6754001,6817000,62999,False,138,scaffold_4
46,6842001,6924000,81999,False,138,scaffold_4
47,6926001,6995000,68999,False,138,scaffold_4
48,7036001,7174000,137999,False,138,scaffold_4
49,7207001,7429000,221999,False,138,scaffold_4
50,7629001,7666000,36999,False,138,scaffold_4
51,7861001,7913000,51999,False,138,scaffold_4
52,7975001,7999000,23999,False,138,scaffold_4
53,8049001,8077000,27999,False,138,scaffold_4
54,8844001,9699000,854999,False,138,scaffold_4
55,9700001,9845951,145950,True,138,scaffold_4
0,150001,174000,23999,False,138,scaffold_5
1,189001,204000,14999,False,138,scaffold_5
2,319001,419000,99999,False,138,scaffold_5
3,463001,526000,62999,False,138,scaffold_5
4,639001,649000,9999,False,138,scaffold_5
5,669001,697000,27999,False,138,scaffold_5
6,927001,947000,19999,False,138,scaffold_5
7,1667001,1684000,16999,False,138,scaffold_5
8,2091001,2104000,12999,False,138,scaffold_5
9,2255001,2300000,44999,False,138,scaffold_5
10,2381001,2412000,30999,False,138,scaffold_5
11,2467001,2493000,25999,False,138,scaffold_5
12,2509001,2515000,5999,False,138,scaffold_5
13,2516001,2530000,13999,False,138,scaffold_5
14,2543001,2894000,350999,False,138,scaffold_5
15,3133001,3550000,416999,False,138,scaffold_5
16,3615001,3658000,42999,False,138,scaffold_5
17,3841001,3945000,103999,False,138,scaffold_5
18,3962001,4101000,138999,False,138,scaffold_5
19,4120001,4221000,100999,False,138,scaffold_5
20,4227001,4362000,134999,False,138,scaffold_5
21,4445001,4992000,546999,False,138,scaffold_5
22,5059001,5087000,27999,False,138,scaffold_5
23,5199001,5346000,146999,False,138,scaffold_5
24,5497001,5528000,30999,False,138,scaffold_5
25,5720001,5738000,17999,False,138,scaffold_5
26,5860001,5894000,33999,False,138,scaffold_5
27,6393001,6689000,295999,False,138,scaffold_5
28,6783001,6803000,19999,False,138,scaffold_5
29,6807001,6854000,46999,False,138,scaffold_5
30,6881001,6965000,83999,False,138,scaffold_5
31,7173001,7208000,34999,False,138,scaffold_5
32,7259001,7332000,72999,False,138,scaffold_5
33,7334001,7364000,29999,False,138,scaffold_5
34,7454001,7512000,57999,False,138,scaffold_5
35,7523001,7619000,95999,False,138,scaffold_5
36,7620001,7806000,185999,False,138,scaffold_5
37,8027001,8036000,8999,False,138,scaffold_5
38,8411001,8427000,15999,False,138,scaffold_5
39,8549001,8616000,66999,False,138,scaffold_5
40,8640001,8689000,48999,False,138,scaffold_5
41,8707001,9364176,657175,True,138,scaffold_5
0,79001,85000,5999,False,138,scaffold_6
1,86001,114000,27999,False,138,scaffold_6
2,151001,208000,56999,False,138,scaffold_6
3,240001,254000,13999,False,138,scaffold_6
4,256001,263000,6999,False,138,scaffold_6
5,264001,293000,28999,False,138,scaffold_6
6,468001,482000,13999,False,138,scaffold_6
7,553001,558000,4999,False,138,scaffold_6
8,731001,755000,23999,False,138,scaffold_6
9,782001,802000,19999,False,138,scaffold_6
10,966001,1037000,70999,False,138,scaffold_6
11,1147001,1198000,50999,False,138,scaffold_6
12,1231001,1264000,32999,False,138,scaffold_6
13,1284001,1307000,22999,False,138,scaffold_6
14,1421001,1598000,176999,False,138,scaffold_6
15,1658001,1716000,57999,False,138,scaffold_6
16,1837001,1906000,68999,False,138,scaffold_6
17,1907001,1933000,25999,False,138,scaffold_6
18,1976001,2019000,42999,False,138,scaffold_6
19,2023001,2104000,80999,False,138,scaffold_6
20,2124001,2215000,90999,False,138,scaffold_6
21,2237001,2283000,45999,False,138,scaffold_6
22,2315001,2852000,536999,False,138,scaffold_6
23,2934001,3210000,275999,False,138,scaffold_6
24,3223001,3350000,126999,False,138,scaffold_6
25,3351001,3800000,448999,False,138,scaffold_6
26,3810001,3933000,122999,False,138,scaffold_6
27,3960001,3995000,34999,False,138,scaffold_6
28,4018001,4072000,53999,False,138,scaffold_6
29,4073001,4195000,121999,False,138,scaffold_6
30,4837001,4918000,80999,False,138,scaffold_6
31,4924001,4996000,71999,False,138,scaffold_6
32,5695001,5744000,48999,False,138,scaffold_6
33,5861001,5972000,110999,False,138,scaffold_6
34,5992001,6192000,199999,False,138,scaffold_6
35,6766001,6804000,37999,False,138,scaffold_6
36,6912001,6942000,29999,False,138,scaffold_6
37,6974001,7009000,34999,False,138,scaffold_6
38,7221001,7248000,26999,False,138,scaffold_6
39,7256001,7341000,84999,False,138,scaffold_6
40,7382001,7479000,96999,False,138,scaffold_6
41,7541001,8268281,727280,True,138,scaffold_6
0,13001,34000,20999,False,138,scaffold_7
1,50001,60000,9999,False,138,scaffold_7
2,323001,340000,16999,False,138,scaffold_7
3,342001,508000,165999,False,138,scaffold_7
4,571001,577000,5999,False,138,scaffold_7
5,656001,703000,46999,False,138,scaffold_7
6,706001,736000,29999,False,138,scaffold_7
7,739001,753000,13999,False,138,scaffold_7
8,764001,809000,44999,False,138,scaffold_7
9,859001,864000,4999,False,138,scaffold_7
10,868001,872000,3999,False,138,scaffold_7
11,875001,948000,72999,False,138,scaffold_7
12,949001,966000,16999,False,138,scaffold_7
13,968001,980000,11999,False,138,scaffold_7
14,982001,1044000,61999,False,138,scaffold_7
15,1048001,1104000,55999,False,138,scaffold_7
16,1174001,1179000,4999,False,138,scaffold_7
17,1182001,1187000,4999,False,138,scaffold_7
18,1191001,1460000,268999,False,138,scaffold_7
19,1461001,1513000,51999,False,138,scaffold_7
20,1588001,1695000,106999,False,138,scaffold_7
21,1727001,1782000,54999,False,138,scaffold_7
22,1852001,1902000,49999,False,138,scaffold_7
23,1976001,2008000,31999,False,138,scaffold_7
24,2443001,2601000,157999,False,138,scaffold_7
25,2639001,2712000,72999,False,138,scaffold_7
26,3198001,3269000,70999,False,138,scaffold_7
27,3296001,3408000,111999,False,138,scaffold_7
28,3518001,3809000,290999,False,138,scaffold_7
29,4025001,4045000,19999,False,138,scaffold_7
30,4322001,4385000,62999,False,138,scaffold_7
31,4405001,4515000,109999,False,138,scaffold_7
32,4524001,4597000,72999,False,138,scaffold_7
33,4630001,4790000,159999,False,138,scaffold_7
34,4824001,4912000,87999,False,138,scaffold_7
35,4932001,5168000,235999,False,138,scaffold_7
36,5470001,5536000,65999,False,138,scaffold_7
37,5623001,5661000,37999,False,138,scaffold_7
38,6052001,6094000,41999,False,138,scaffold_7
39,6096001,6248000,151999,False,138,scaffold_7
40,6329001,6364000,34999,False,138,scaffold_7
41,6576001,6676000,99999,False,138,scaffold_7
42,6694001,6715000,20999,False,138,scaffold_7
43,6748001,6839000,90999,False,138,scaffold_7
44,6948001,7502216,554215,True,138,scaffold_7
0,1,6000,5999,True,138,scaffold_8
1,66001,85000,18999,False,138,scaffold_8
2,96001,101000,4999,False,138,scaffold_8
3,113001,116000,2999,False,138,scaffold_8
4,1858001,1930000,71999,False,138,scaffold_8
5,2066001,2154000,87999,False,138,scaffold_8
6,2413001,2529000,115999,False,138,scaffold_8
7,2536001,2583000,46999,False,138,scaffold_8
8,2647001,2683000,35999,False,138,scaffold_8
9,2684001,2923000,238999,False,138,scaffold_8
10,2945001,3556000,610999,False,138,scaffold_8
11,3577001,3614000,36999,False,138,scaffold_8
12,3615001,3947000,331999,False,138,scaffold_8
13,3999001,4221000,221999,False,138,scaffold_8
14,4395001,4432000,36999,False,138,scaffold_8
15,4565001,4591000,25999,False,138,scaffold_8
16,4609001,4644000,34999,False,138,scaffold_8
17,4726001,4777000,50999,False,138,scaffold_8
18,4901001,4915000,13999,False,138,scaffold_8
19,4983001,5049000,65999,False,138,scaffold_8
20,5073001,5246000,172999,False,138,scaffold_8
21,5524001,5597000,72999,False,138,scaffold_8
22,5658001,5710000,51999,False,138,scaffold_8
23,5750001,5774000,23999,False,138,scaffold_8
24,5776001,5803000,26999,False,138,scaffold_8
25,5837001,5904000,66999,False,138,scaffold_8
26,6025001,6111000,85999,False,138,scaffold_8
27,6219001,6301000,81999,False,138,scaffold_8
28,6322001,6334544,12543,True,138,scaffold_8
0,109001,118000,8999,False,138,scaffold_9
1,121001,137000,15999,False,138,scaffold_9
2,366001,411000,44999,False,138,scaffold_9
3,413001,434000,20999,False,138,scaffold_9
4,501001,531000,29999,False,138,scaffold_9
5,547001,563000,15999,False,138,scaffold_9
6,671001,697000,25999,False,138,scaffold_9
7,732001,742000,9999,False,138,scaffold_9
8,794001,803000,8999,False,138,scaffold_9
9,815001,841000,25999,False,138,scaffold_9
10,852001,862000,9999,False,138,scaffold_9
11,872001,986000,113999,False,138,scaffold_9
12,987001,995000,7999,False,138,scaffold_9
13,1001001,1085000,83999,False,138,scaffold_9
14,1087001,1150000,62999,False,138,scaffold_9
15,1151001,1176000,24999,False,138,scaffold_9
16,1312001,1395000,82999,False,138,scaffold_9
17,1428001,1437000,8999,False,138,scaffold_9
18,1456001,1467000,10999,False,138,scaffold_9
19,1506001,1586000,79999,False,138,scaffold_9
20,1599001,1622000,22999,False,138,scaffold_9
21,1637001,1692000,54999,False,138,scaffold_9
22,1747001,1807000,59999,False,138,scaffold_9
23,1823001,1857000,33999,False,138,scaffold_9
24,1918001,1959000,40999,False,138,scaffold_9
25,1970001,2135000,164999,False,138,scaffold_9
26,2136001,2364000,227999,False,138,scaffold_9
27,2387001,2447000,59999,False,138,scaffold_9
28,2511001,2579000,67999,False,138,scaffold_9
29,2598001,2671000,72999,False,138,scaffold_9
30,2713001,3381000,667999,False,138,scaffold_9
31,3383001,5107000,1723999,False,138,scaffold_9
32,5112001,5114000,1999,False,138,scaffold_9
33,5116001,5237000,120999,False,138,scaffold_9
34,5239001,5298000,58999,False,138,scaffold_9
35,5300001,5490000,189999,False,138,scaffold_9
36,5493001,6331288,838287,True,138,scaffold_9
0,1,414000,413999,True,138,scaffold_10
1,415001,482000,66999,False,138,scaffold_10
2,483001,582000,98999,False,138,scaffold_10
3,602001,796000,193999,False,138,scaffold_10
4,811001,877000,65999,False,138,scaffold_10
5,888001,921000,32999,False,138,scaffold_10
6,923001,1069000,145999,False,138,scaffold_10
7,1073001,1154000,80999,False,138,scaffold_10
8,1276001,1354000,77999,False,138,scaffold_10
9,1370001,1468000,97999,False,138,scaffold_10
10,1500001,1527000,26999,False,138,scaffold_10
11,1695001,1760000,64999,False,138,scaffold_10
12,1861001,1917000,55999,False,138,scaffold_10
13,2088001,2103000,14999,False,138,scaffold_10
14,2131001,2333000,201999,False,138,scaffold_10
15,2334001,2471000,136999,False,138,scaffold_10
16,2521001,2653000,131999,False,138,scaffold_10
17,2673001,2698000,24999,False,138,scaffold_10
18,2714001,2751000,36999,False,138,scaffold_10
19,2754001,2812000,57999,False,138,scaffold_10
20,2817001,2860000,42999,False,138,scaffold_10
21,2942001,2956000,13999,False,138,scaffold_10
22,3111001,3132000,20999,False,138,scaffold_10
23,3153001,3186000,32999,False,138,scaffold_10
24,3394001,3423000,28999,False,138,scaffold_10
25,3463001,3476000,12999,False,138,scaffold_10
26,3575001,3582000,6999,False,138,scaffold_10
27,3777001,3795000,17999,False,138,scaffold_10
28,4052001,4091000,38999,False,138,scaffold_10
29,4154001,4184000,29999,False,138,scaffold_10
30,4336001,4359000,22999,False,138,scaffold_10
31,4446001,4461000,14999,False,138,scaffold_10
32,4503001,4513000,9999,False,138,scaffold_10
33,4515001,4523000,7999,False,138,scaffold_10
34,4526001,4548000,21999,False,138,scaffold_10
35,4573001,4597000,23999,False,138,scaffold_10
36,4679001,4688000,8999,False,138,scaffold_10
37,4727001,4732000,4999,False,138,scaffold_10
38,4734001,4767000,32999,False,138,scaffold_10
39,4768001,4776000,7999,False,138,scaffold_10
40,4798001,4824000,25999,False,138,scaffold_10
41,4828001,4843000,14999,False,138,scaffold_10
42,4848001,4861000,12999,False,138,scaffold_10
43,4865001,4866973,1972,True,138,scaffold_10
0,10001,34000,23999,False,138,scaffold_11
1,40001,89000,48999,False,138,scaffold_11
2,149001,167000,17999,False,138,scaffold_11
3,169001,191000,21999,False,138,scaffold_11
4,213001,236000,22999,False,138,scaffold_11
5,240001,248000,7999,False,138,scaffold_11
6,419001,431000,11999,False,138,scaffold_11
7,646001,656000,9999,False,138,scaffold_11
8,1025001,1034000,8999,False,138,scaffold_11
9,1315001,1398000,82999,False,138,scaffold_11
10,1474001,1477000,2999,False,138,scaffold_11
11,1525001,1537000,11999,False,138,scaffold_11
12,1936001,2034000,97999,False,138,scaffold_11
13,2035001,2058000,22999,False,138,scaffold_11
14,2088001,2172000,83999,False,138,scaffold_11
15,2177001,2233000,55999,False,138,scaffold_11
16,2677001,2920000,242999,False,138,scaffold_11
17,2951001,3027000,75999,False,138,scaffold_11
18,3082001,3385000,302999,False,138,scaffold_11
19,3420001,3479000,58999,False,138,scaffold_11
20,3518001,3657000,138999,False,138,scaffold_11
21,3662001,3972000,309999,False,138,scaffold_11
22,3984001,4160000,175999,False,138,scaffold_11
23,4179001,4710000,530999,False,138,scaffold_11
24,4713001,4766820,53819,True,138,scaffold_11
0,1,1499000,1498999,True,138,scaffold_12
1,1639001,1666000,26999,False,138,scaffold_12
2,1720001,1733000,12999,False,138,scaffold_12
3,1783001,1812000,28999,False,138,scaffold_12
4,1878001,1961000,82999,False,138,scaffold_12
5,2043001,2103000,59999,False,138,scaffold_12
6,2130001,2192000,61999,False,138,scaffold_12
7,2337001,2378000,40999,False,138,scaffold_12
8,2571001,2609000,37999,False,138,scaffold_12
9,2685001,2698000,12999,False,138,scaffold_12
0,1,340000,339999,True,139,scaffold_1
1,482001,498000,15999,False,139,scaffold_1
2,571001,643000,71999,False,139,scaffold_1
3,686001,715000,28999,False,139,scaffold_1
4,723001,743000,19999,False,139,scaffold_1
5,1281001,1292000,10999,False,139,scaffold_1
6,1820001,1863000,42999,False,139,scaffold_1
7,1954001,1984000,29999,False,139,scaffold_1
8,2449001,2517000,67999,False,139,scaffold_1
9,2729001,2746000,16999,False,139,scaffold_1
10,3181001,3208000,26999,False,139,scaffold_1
11,3715001,3733000,17999,False,139,scaffold_1
12,3916001,3941000,24999,False,139,scaffold_1
13,4064001,4112000,47999,False,139,scaffold_1
14,4322001,4354000,31999,False,139,scaffold_1
15,4928001,4984000,55999,False,139,scaffold_1
16,5482001,5511000,28999,False,139,scaffold_1
17,6108001,6153000,44999,False,139,scaffold_1
18,6228001,6381000,152999,False,139,scaffold_1
19,6384001,6507000,122999,False,139,scaffold_1
20,6545001,6554000,8999,False,139,scaffold_1
21,7038001,7247000,208999,False,139,scaffold_1
22,7248001,7588000,339999,False,139,scaffold_1
23,7590001,8656000,1065999,False,139,scaffold_1
24,8658001,9584000,925999,False,139,scaffold_1
25,9586001,10354000,767999,False,139,scaffold_1
26,10461001,10632000,170999,False,139,scaffold_1
27,10808001,10811000,2999,False,139,scaffold_1
28,10836001,10858000,21999,False,139,scaffold_1
29,11351001,11504000,152999,False,139,scaffold_1
30,11614001,11962000,347999,False,139,scaffold_1
31,12184001,12204000,19999,False,139,scaffold_1
32,12678001,12722000,43999,False,139,scaffold_1
33,12777001,12888000,110999,False,139,scaffold_1
34,13113001,13150000,36999,False,139,scaffold_1
35,13178001,13211000,32999,False,139,scaffold_1
36,13347001,13377000,29999,False,139,scaffold_1
37,13900001,13903000,2999,False,139,scaffold_1
38,14285001,14307000,21999,False,139,scaffold_1
0,22001,48000,25999,False,139,scaffold_2
1,93001,159000,65999,False,139,scaffold_2
2,168001,176000,7999,False,139,scaffold_2
3,303001,318000,14999,False,139,scaffold_2
4,332001,374000,41999,False,139,scaffold_2
5,2336001,2358000,21999,False,139,scaffold_2
6,2404001,2424000,19999,False,139,scaffold_2
7,2441001,2553000,111999,False,139,scaffold_2
8,2660001,2689000,28999,False,139,scaffold_2
9,2694001,2742000,47999,False,139,scaffold_2
10,3174001,3186000,11999,False,139,scaffold_2
11,3454001,3463000,8999,False,139,scaffold_2
12,3754001,3783000,28999,False,139,scaffold_2
13,4385001,4409000,23999,False,139,scaffold_2
14,4428001,4457000,28999,False,139,scaffold_2
15,4524001,4553000,28999,False,139,scaffold_2
16,4606001,4654000,47999,False,139,scaffold_2
17,5022001,5031000,8999,False,139,scaffold_2
18,5033001,5061000,27999,False,139,scaffold_2
19,5491001,5511000,19999,False,139,scaffold_2
20,5672001,5704000,31999,False,139,scaffold_2
21,6261001,6330000,68999,False,139,scaffold_2
22,6331001,6342000,10999,False,139,scaffold_2
23,7439001,7472000,32999,False,139,scaffold_2
24,7563001,7697000,133999,False,139,scaffold_2
25,7786001,7890000,103999,False,139,scaffold_2
26,7934001,7965000,30999,False,139,scaffold_2
27,7985001,8101000,115999,False,139,scaffold_2
28,8103001,8108000,4999,False,139,scaffold_2
29,8331001,8333000,1999,False,139,scaffold_2
30,8335001,8345000,9999,False,139,scaffold_2
31,8346001,8389000,42999,False,139,scaffold_2
32,8509001,8536000,26999,False,139,scaffold_2
33,11367001,11374000,6999,False,139,scaffold_2
34,11520001,11785000,264999,False,139,scaffold_2
0,51001,55000,3999,False,139,scaffold_3
1,800001,900000,99999,False,139,scaffold_3
2,2085001,2108000,22999,False,139,scaffold_3
3,2291001,2321000,29999,False,139,scaffold_3
4,2510001,2533000,22999,False,139,scaffold_3
5,4150001,4385000,234999,False,139,scaffold_3
6,4391001,4394000,2999,False,139,scaffold_3
7,4418001,4518000,99999,False,139,scaffold_3
8,4547001,4558000,10999,False,139,scaffold_3
9,4653001,4678000,24999,False,139,scaffold_3
10,6911001,6962000,50999,False,139,scaffold_3
11,6979001,7075000,95999,False,139,scaffold_3
12,7525001,7556000,30999,False,139,scaffold_3
13,7692001,7726000,33999,False,139,scaffold_3
14,7822001,7840000,17999,False,139,scaffold_3
15,8208001,8253000,44999,False,139,scaffold_3
16,8462001,8527000,64999,False,139,scaffold_3
17,8575001,8593000,17999,False,139,scaffold_3
18,9968001,9996000,27999,False,139,scaffold_3
19,10461001,10483000,21999,False,139,scaffold_3
20,10587001,11167000,579999,False,139,scaffold_3
0,11001,16000,4999,False,139,scaffold_4
1,17001,32000,14999,False,139,scaffold_4
2,48001,88000,39999,False,139,scaffold_4
3,147001,151000,3999,False,139,scaffold_4
4,155001,160000,4999,False,139,scaffold_4
5,161001,215000,53999,False,139,scaffold_4
6,217001,226000,8999,False,139,scaffold_4
7,227001,266000,38999,False,139,scaffold_4
8,289001,307000,17999,False,139,scaffold_4
9,313001,344000,30999,False,139,scaffold_4
10,355001,374000,18999,False,139,scaffold_4
11,375001,380000,4999,False,139,scaffold_4
12,411001,425000,13999,False,139,scaffold_4
13,429001,498000,68999,False,139,scaffold_4
14,545001,599000,53999,False,139,scaffold_4
15,608001,691000,82999,False,139,scaffold_4
16,695001,697000,1999,False,139,scaffold_4
17,701001,713000,11999,False,139,scaffold_4
18,1121001,1136000,14999,False,139,scaffold_4
19,1137001,1178000,40999,False,139,scaffold_4
20,1199001,1208000,8999,False,139,scaffold_4
21,1210001,1226000,15999,False,139,scaffold_4
22,1235001,1245000,9999,False,139,scaffold_4
23,1254001,1262000,7999,False,139,scaffold_4
24,1265001,1279000,13999,False,139,scaffold_4
25,1283001,1314000,30999,False,139,scaffold_4
26,1358001,1591000,232999,False,139,scaffold_4
27,1749001,1817000,67999,False,139,scaffold_4
28,1904001,1957000,52999,False,139,scaffold_4
29,1958001,1998000,39999,False,139,scaffold_4
30,2036001,2065000,28999,False,139,scaffold_4
31,2210001,2218000,7999,False,139,scaffold_4
32,2247001,2281000,33999,False,139,scaffold_4
33,2284001,2340000,55999,False,139,scaffold_4
34,2476001,2535000,58999,False,139,scaffold_4
35,3335001,3633000,297999,False,139,scaffold_4
36,3676001,3760000,83999,False,139,scaffold_4
37,4944001,4984000,39999,False,139,scaffold_4
38,5477001,5506000,28999,False,139,scaffold_4
39,5514001,5620000,105999,False,139,scaffold_4
40,5667001,5784000,116999,False,139,scaffold_4
41,5786001,5805000,18999,False,139,scaffold_4
42,6146001,6191000,44999,False,139,scaffold_4
43,7036001,7062000,25999,False,139,scaffold_4
44,8849001,9699000,849999,False,139,scaffold_4
45,9701001,9845951,144950,True,139,scaffold_4
0,296001,299000,2999,False,139,scaffold_5
1,318001,326000,7999,False,139,scaffold_5
2,327001,369000,41999,False,139,scaffold_5
3,378001,379000,999,False,139,scaffold_5
4,468001,481000,12999,False,139,scaffold_5
5,508001,523000,14999,False,139,scaffold_5
6,836001,838000,1999,False,139,scaffold_5
7,839001,842000,2999,False,139,scaffold_5
8,933001,947000,13999,False,139,scaffold_5
9,2565001,2581000,15999,False,139,scaffold_5
10,2625001,2732000,106999,False,139,scaffold_5
11,2816001,2871000,54999,False,139,scaffold_5
12,3167001,3184000,16999,False,139,scaffold_5
13,3322001,3438000,115999,False,139,scaffold_5
14,3451001,3497000,45999,False,139,scaffold_5
15,3962001,4101000,138999,False,139,scaffold_5
16,4121001,4142000,20999,False,139,scaffold_5
17,4155001,4222000,66999,False,139,scaffold_5
18,4246001,4263000,16999,False,139,scaffold_5
19,4446001,4483000,36999,False,139,scaffold_5
20,4603001,4649000,45999,False,139,scaffold_5
21,4691001,4717000,25999,False,139,scaffold_5
22,4775001,4861000,85999,False,139,scaffold_5
23,4904001,4917000,12999,False,139,scaffold_5
24,5318001,5346000,27999,False,139,scaffold_5
25,6536001,6566000,29999,False,139,scaffold_5
26,7373001,7386000,12999,False,139,scaffold_5
27,7580001,7609000,28999,False,139,scaffold_5
28,7623001,7636000,12999,False,139,scaffold_5
29,8730001,9363000,632999,False,139,scaffold_5
0,79001,85000,5999,False,139,scaffold_6
1,86001,112000,25999,False,139,scaffold_6
2,240001,253000,12999,False,139,scaffold_6
3,256001,262000,5999,False,139,scaffold_6
4,267001,278000,10999,False,139,scaffold_6
5,1238001,1255000,16999,False,139,scaffold_6
6,1287001,1314000,26999,False,139,scaffold_6
7,1479001,1546000,66999,False,139,scaffold_6
8,2023001,2086000,62999,False,139,scaffold_6
9,2130001,2169000,38999,False,139,scaffold_6
10,2368001,2595000,226999,False,139,scaffold_6
11,2596001,2653000,56999,False,139,scaffold_6
12,2661001,2691000,29999,False,139,scaffold_6
13,2731001,2852000,120999,False,139,scaffold_6
14,2935001,3014000,78999,False,139,scaffold_6
15,3115001,3149000,33999,False,139,scaffold_6
16,3224001,3301000,76999,False,139,scaffold_6
17,3407001,3428000,20999,False,139,scaffold_6
18,3461001,3767000,305999,False,139,scaffold_6
19,3901001,3912000,10999,False,139,scaffold_6
20,4019001,4041000,21999,False,139,scaffold_6
21,4081001,4193000,111999,False,139,scaffold_6
22,6009001,6060000,50999,False,139,scaffold_6
23,7283001,7337000,53999,False,139,scaffold_6
24,7560001,7795000,234999,False,139,scaffold_6
25,7811001,8268281,457280,True,139,scaffold_6
0,1,7000,6999,True,139,scaffold_7
1,13001,31000,17999,False,139,scaffold_7
2,169001,171000,1999,False,139,scaffold_7
3,323001,340000,16999,False,139,scaffold_7
4,342001,508000,165999,False,139,scaffold_7
5,554001,563000,8999,False,139,scaffold_7
6,571001,577000,5999,False,139,scaffold_7
7,706001,736000,29999,False,139,scaffold_7
8,744001,753000,8999,False,139,scaffold_7
9,764001,809000,44999,False,139,scaffold_7
10,859001,864000,4999,False,139,scaffold_7
11,868001,898000,29999,False,139,scaffold_7
12,967001,980000,12999,False,139,scaffold_7
13,982001,1044000,61999,False,139,scaffold_7
14,1191001,1512000,320999,False,139,scaffold_7
15,1588001,1688000,99999,False,139,scaffold_7
16,3326001,3369000,42999,False,139,scaffold_7
17,3596001,3649000,52999,False,139,scaffold_7
18,4418001,4535000,116999,False,139,scaffold_7
19,4658001,4681000,22999,False,139,scaffold_7
20,4979001,5030000,50999,False,139,scaffold_7
21,5077001,5115000,37999,False,139,scaffold_7
22,5609001,5626000,16999,False,139,scaffold_7
23,6955001,7270000,314999,False,139,scaffold_7
24,7271001,7502216,231215,True,139,scaffold_7
0,66001,85000,18999,False,139,scaffold_8
1,722001,724000,1999,False,139,scaffold_8
2,2444001,2470000,25999,False,139,scaffold_8
3,2661001,2683000,21999,False,139,scaffold_8
4,2745001,2756000,10999,False,139,scaffold_8
5,2828001,2842000,13999,False,139,scaffold_8
6,3060001,3125000,64999,False,139,scaffold_8
7,3126001,3525000,398999,False,139,scaffold_8
8,3584001,3612000,27999,False,139,scaffold_8
9,3615001,3913000,297999,False,139,scaffold_8
10,5200001,5241000,40999,False,139,scaffold_8
11,6331001,6334544,3543,True,139,scaffold_8
0,109001,117000,7999,False,139,scaffold_9
1,303001,315000,11999,False,139,scaffold_9
2,319001,332000,12999,False,139,scaffold_9
3,367001,411000,43999,False,139,scaffold_9
4,413001,434000,20999,False,139,scaffold_9
5,436001,441000,4999,False,139,scaffold_9
6,504001,531000,26999,False,139,scaffold_9
7,653001,659000,5999,False,139,scaffold_9
8,660001,665000,4999,False,139,scaffold_9
9,671001,697000,25999,False,139,scaffold_9
10,732001,742000,9999,False,139,scaffold_9
11,815001,842000,26999,False,139,scaffold_9
12,850001,862000,11999,False,139,scaffold_9
13,872001,986000,113999,False,139,scaffold_9
14,988001,995000,6999,False,139,scaffold_9
15,1001001,1006000,4999,False,139,scaffold_9
16,1010001,1031000,20999,False,139,scaffold_9
17,1037001,1085000,47999,False,139,scaffold_9
18,1087001,1150000,62999,False,139,scaffold_9
19,1151001,1164000,12999,False,139,scaffold_9
20,1312001,1377000,64999,False,139,scaffold_9
21,1770001,1787000,16999,False,139,scaffold_9
22,2601001,2616000,14999,False,139,scaffold_9
23,2874001,3381000,506999,False,139,scaffold_9
24,3383001,5100000,1716999,False,139,scaffold_9
25,5101001,5107000,5999,False,139,scaffold_9
26,5112001,5238000,125999,False,139,scaffold_9
27,5239001,5298000,58999,False,139,scaffold_9
28,5299001,5491000,191999,False,139,scaffold_9
29,5492001,6331288,839287,True,139,scaffold_9
0,1,198000,197999,True,139,scaffold_10
1,375001,405000,29999,False,139,scaffold_10
2,472001,482000,9999,False,139,scaffold_10
3,483001,576000,92999,False,139,scaffold_10
4,603001,720000,116999,False,139,scaffold_10
5,888001,916000,27999,False,139,scaffold_10
6,924001,962000,37999,False,139,scaffold_10
7,1073001,1106000,32999,False,139,scaffold_10
8,2346001,2366000,19999,False,139,scaffold_10
9,4054001,4091000,36999,False,139,scaffold_10
10,4154001,4174000,19999,False,139,scaffold_10
11,4443001,4462000,18999,False,139,scaffold_10
12,4467001,4477000,9999,False,139,scaffold_10
13,4527001,4548000,20999,False,139,scaffold_10
14,4554001,4562000,7999,False,139,scaffold_10
15,4574001,4597000,22999,False,139,scaffold_10
16,4679001,4688000,8999,False,139,scaffold_10
17,4734001,4766000,31999,False,139,scaffold_10
18,4769001,4776000,6999,False,139,scaffold_10
19,4798001,4824000,25999,False,139,scaffold_10
20,4828001,4843000,14999,False,139,scaffold_10
21,4848001,4861000,12999,False,139,scaffold_10
0,10001,93000,82999,False,139,scaffold_11
1,149001,167000,17999,False,139,scaffold_11
2,169001,195000,25999,False,139,scaffold_11
3,203001,235000,31999,False,139,scaffold_11
4,419001,431000,11999,False,139,scaffold_11
5,648001,656000,7999,False,139,scaffold_11
6,1025001,1034000,8999,False,139,scaffold_11
7,1423001,1426000,2999,False,139,scaffold_11
8,2701001,2873000,171999,False,139,scaffold_11
9,3188001,3254000,65999,False,139,scaffold_11
10,3331001,3371000,39999,False,139,scaffold_11
11,3702001,3926000,223999,False,139,scaffold_11
12,4321001,4710000,388999,False,139,scaffold_11
13,4713001,4766820,53819,True,139,scaffold_11
0,1,369000,368999,True,139,scaffold_12
1,474001,537000,62999,False,139,scaffold_12
2,581001,856000,274999,False,139,scaffold_12
3,865001,1355000,489999,False,139,scaffold_12
4,1720001,1733000,12999,False,139,scaffold_12
5,2571001,2610000,38999,False,139,scaffold_12
0,1,342000,341999,True,140,scaffold_1
1,482001,498000,15999,False,140,scaffold_1
2,572001,643000,70999,False,140,scaffold_1
3,686001,743000,56999,False,140,scaffold_1
4,1281001,1292000,10999,False,140,scaffold_1
5,1613001,1660000,46999,False,140,scaffold_1
6,1819001,1898000,78999,False,140,scaffold_1
7,1954001,1984000,29999,False,140,scaffold_1
8,2449001,2517000,67999,False,140,scaffold_1
9,2727001,2746000,18999,False,140,scaffold_1
10,3180001,3208000,27999,False,140,scaffold_1
11,3715001,3733000,17999,False,140,scaffold_1
12,3913001,3941000,27999,False,140,scaffold_1
13,4062001,4111000,48999,False,140,scaffold_1
14,4322001,4354000,31999,False,140,scaffold_1
15,4928001,4996000,67999,False,140,scaffold_1
16,5483001,5511000,27999,False,140,scaffold_1
17,5536001,5569000,32999,False,140,scaffold_1
18,6108001,6153000,44999,False,140,scaffold_1
19,6228001,6381000,152999,False,140,scaffold_1
20,6384001,6507000,122999,False,140,scaffold_1
21,6545001,6554000,8999,False,140,scaffold_1
22,7038001,7247000,208999,False,140,scaffold_1
23,7248001,7583000,334999,False,140,scaffold_1
24,7590001,8477000,886999,False,140,scaffold_1
25,8478001,8656000,177999,False,140,scaffold_1
26,8658001,9584000,925999,False,140,scaffold_1
27,9586001,10355000,768999,False,140,scaffold_1
28,10460001,10631000,170999,False,140,scaffold_1
29,10808001,10811000,2999,False,140,scaffold_1
30,10836001,10858000,21999,False,140,scaffold_1
31,11351001,11504000,152999,False,140,scaffold_1
32,11609001,11951000,341999,False,140,scaffold_1
33,12184001,12204000,19999,False,140,scaffold_1
34,12661001,12722000,60999,False,140,scaffold_1
35,12776001,12888000,111999,False,140,scaffold_1
36,13113001,13211000,97999,False,140,scaffold_1
37,13347001,13403000,55999,False,140,scaffold_1
38,13841001,13844000,2999,False,140,scaffold_1
39,14007001,14009000,1999,False,140,scaffold_1
0,8001,48000,39999,False,140,scaffold_2
1,93001,159000,65999,False,140,scaffold_2
2,168001,177000,8999,False,140,scaffold_2
3,310001,318000,7999,False,140,scaffold_2
4,330001,374000,43999,False,140,scaffold_2
5,2336001,2358000,21999,False,140,scaffold_2
6,2404001,2424000,19999,False,140,scaffold_2
7,2441001,2553000,111999,False,140,scaffold_2
8,2645001,2689000,43999,False,140,scaffold_2
9,2694001,2745000,50999,False,140,scaffold_2
10,2868001,2900000,31999,False,140,scaffold_2
11,2993001,3021000,27999,False,140,scaffold_2
12,3454001,3464000,9999,False,140,scaffold_2
13,3766001,3782000,15999,False,140,scaffold_2
14,4385001,4409000,23999,False,140,scaffold_2
15,4426001,4457000,30999,False,140,scaffold_2
16,4521001,4654000,132999,False,140,scaffold_2
17,5022001,5031000,8999,False,140,scaffold_2
18,5033001,5061000,27999,False,140,scaffold_2
19,5491001,5511000,19999,False,140,scaffold_2
20,5672001,5704000,31999,False,140,scaffold_2
21,6261001,6350000,88999,False,140,scaffold_2
22,7021001,7030000,8999,False,140,scaffold_2
23,7439001,7472000,32999,False,140,scaffold_2
24,7563001,7697000,133999,False,140,scaffold_2
25,7786001,7891000,104999,False,140,scaffold_2
26,7934001,7969000,34999,False,140,scaffold_2
27,7982001,8161000,178999,False,140,scaffold_2
28,8331001,8333000,1999,False,140,scaffold_2
29,8340001,8345000,4999,False,140,scaffold_2
30,8346001,8390000,43999,False,140,scaffold_2
31,8436001,8452000,15999,False,140,scaffold_2
32,8509001,8535000,25999,False,140,scaffold_2
33,11366001,11374000,7999,False,140,scaffold_2
34,11520001,11785000,264999,False,140,scaffold_2
0,1,2000,1999,True,140,scaffold_3
1,51001,55000,3999,False,140,scaffold_3
2,102001,104000,1999,False,140,scaffold_3
3,528001,539000,10999,False,140,scaffold_3
4,618001,646000,27999,False,140,scaffold_3
5,800001,900000,99999,False,140,scaffold_3
6,2084001,2108000,23999,False,140,scaffold_3
7,2110001,2115000,4999,False,140,scaffold_3
8,2291001,2321000,29999,False,140,scaffold_3
9,2487001,2533000,45999,False,140,scaffold_3
10,4149001,4398000,248999,False,140,scaffold_3
11,4418001,4518000,99999,False,140,scaffold_3
12,4547001,4558000,10999,False,140,scaffold_3
13,4652001,4679000,26999,False,140,scaffold_3
14,5990001,6019000,28999,False,140,scaffold_3
15,6910001,6962000,51999,False,140,scaffold_3
16,6963001,6967000,3999,False,140,scaffold_3
17,6979001,7083000,103999,False,140,scaffold_3
18,7483001,7491000,7999,False,140,scaffold_3
19,7522001,7556000,33999,False,140,scaffold_3
20,7692001,7798000,105999,False,140,scaffold_3
21,7819001,7839000,19999,False,140,scaffold_3
22,8176001,8253000,76999,False,140,scaffold_3
23,8462001,8527000,64999,False,140,scaffold_3
24,8575001,8594000,18999,False,140,scaffold_3
25,9968001,9995000,26999,False,140,scaffold_3
26,10461001,10484000,22999,False,140,scaffold_3
27,10587001,11166000,578999,False,140,scaffold_3
0,17001,20000,2999,False,140,scaffold_4
1,21001,32000,10999,False,140,scaffold_4
2,48001,88000,39999,False,140,scaffold_4
3,121001,146000,24999,False,140,scaffold_4
4,147001,151000,3999,False,140,scaffold_4
5,155001,160000,4999,False,140,scaffold_4
6,161001,215000,53999,False,140,scaffold_4
7,217001,226000,8999,False,140,scaffold_4
8,227001,266000,38999,False,140,scaffold_4
9,318001,344000,25999,False,140,scaffold_4
10,355001,373000,17999,False,140,scaffold_4
11,375001,380000,4999,False,140,scaffold_4
12,412001,425000,12999,False,140,scaffold_4
13,429001,498000,68999,False,140,scaffold_4
14,545001,599000,53999,False,140,scaffold_4
15,600001,606000,5999,False,140,scaffold_4
16,608001,661000,52999,False,140,scaffold_4
17,670001,691000,20999,False,140,scaffold_4
18,701001,714000,12999,False,140,scaffold_4
19,1121001,1136000,14999,False,140,scaffold_4
20,1137001,1178000,40999,False,140,scaffold_4
21,1199001,1208000,8999,False,140,scaffold_4
22,1210001,1226000,15999,False,140,scaffold_4
23,1235001,1253000,17999,False,140,scaffold_4
24,1254001,1262000,7999,False,140,scaffold_4
25,1265001,1279000,13999,False,140,scaffold_4
26,1283001,1335000,51999,False,140,scaffold_4
27,1372001,1595000,222999,False,140,scaffold_4
28,1613001,1691000,77999,False,140,scaffold_4
29,1749001,1865000,115999,False,140,scaffold_4
30,1904001,1957000,52999,False,140,scaffold_4
31,1958001,2065000,106999,False,140,scaffold_4
32,2211001,2246000,34999,False,140,scaffold_4
33,2247001,2268000,20999,False,140,scaffold_4
34,2269001,2279000,9999,False,140,scaffold_4
35,2284001,2339000,54999,False,140,scaffold_4
36,2476001,2535000,58999,False,140,scaffold_4
37,2599001,2635000,35999,False,140,scaffold_4
38,3335001,3633000,297999,False,140,scaffold_4
39,3649001,3760000,110999,False,140,scaffold_4
40,4944001,4985000,40999,False,140,scaffold_4
41,5477001,5506000,28999,False,140,scaffold_4
42,5514001,5620000,105999,False,140,scaffold_4
43,5659001,5784000,124999,False,140,scaffold_4
44,6145001,6191000,45999,False,140,scaffold_4
45,6797001,6817000,19999,False,140,scaffold_4
46,7036001,7062000,25999,False,140,scaffold_4
47,8849001,9699000,849999,False,140,scaffold_4
48,9700001,9845951,145950,True,140,scaffold_4
0,322001,326000,3999,False,140,scaffold_5
1,327001,382000,54999,False,140,scaffold_5
2,464001,489000,24999,False,140,scaffold_5
3,495001,523000,27999,False,140,scaffold_5
4,839001,842000,2999,False,140,scaffold_5
5,933001,947000,13999,False,140,scaffold_5
6,1062001,1068000,5999,False,140,scaffold_5
7,2563001,2581000,17999,False,140,scaffold_5
8,2619001,2734000,114999,False,140,scaffold_5
9,2816001,2871000,54999,False,140,scaffold_5
10,3134001,3185000,50999,False,140,scaffold_5
11,3218001,3247000,28999,False,140,scaffold_5
12,3322001,3497000,174999,False,140,scaffold_5
13,3962001,4101000,138999,False,140,scaffold_5
14,4121001,4219000,97999,False,140,scaffold_5
15,4243001,4263000,19999,False,140,scaffold_5
16,4445001,4501000,55999,False,140,scaffold_5
17,4600001,4719000,118999,False,140,scaffold_5
18,4789001,4861000,71999,False,140,scaffold_5
19,4892001,4918000,25999,False,140,scaffold_5
20,5314001,5346000,31999,False,140,scaffold_5
21,7097001,7100000,2999,False,140,scaffold_5
22,7373001,7386000,12999,False,140,scaffold_5
23,7580001,7609000,28999,False,140,scaffold_5
24,8730001,9363000,632999,False,140,scaffold_5
25,9364001,9364176,175,True,140,scaffold_5
0,66001,75000,8999,False,140,scaffold_6
1,79001,85000,5999,False,140,scaffold_6
2,86001,114000,27999,False,140,scaffold_6
3,240001,254000,13999,False,140,scaffold_6
4,257001,262000,4999,False,140,scaffold_6
5,268001,277000,8999,False,140,scaffold_6
6,1229001,1256000,26999,False,140,scaffold_6
7,1479001,1546000,66999,False,140,scaffold_6
8,2023001,2087000,63999,False,140,scaffold_6
9,2130001,2179000,48999,False,140,scaffold_6
10,2371001,2595000,223999,False,140,scaffold_6
11,2596001,2654000,57999,False,140,scaffold_6
12,2655001,2691000,35999,False,140,scaffold_6
13,2713001,2872000,158999,False,140,scaffold_6
14,2933001,3015000,81999,False,140,scaffold_6
15,3115001,3174000,58999,False,140,scaffold_6
16,3223001,3301000,77999,False,140,scaffold_6
17,3403001,3428000,24999,False,140,scaffold_6
18,3462001,3766000,303999,False,140,scaffold_6
19,3901001,3912000,10999,False,140,scaffold_6
20,4018001,4064000,45999,False,140,scaffold_6
21,4081001,4193000,111999,False,140,scaffold_6
22,6010001,6060000,49999,False,140,scaffold_6
23,7263001,7339000,75999,False,140,scaffold_6
24,7541001,7798000,256999,False,140,scaffold_6
25,7811001,8268281,457280,True,140,scaffold_6
0,1,8000,7999,True,140,scaffold_7
1,13001,34000,20999,False,140,scaffold_7
2,323001,340000,16999,False,140,scaffold_7
3,342001,508000,165999,False,140,scaffold_7
4,554001,563000,8999,False,140,scaffold_7
5,571001,577000,5999,False,140,scaffold_7
6,706001,736000,29999,False,140,scaffold_7
7,743001,753000,9999,False,140,scaffold_7
8,764001,809000,44999,False,140,scaffold_7
9,859001,864000,4999,False,140,scaffold_7
10,867001,911000,43999,False,140,scaffold_7
11,964001,966000,1999,False,140,scaffold_7
12,968001,980000,11999,False,140,scaffold_7
13,982001,1044000,61999,False,140,scaffold_7
14,1048001,1104000,55999,False,140,scaffold_7
15,1191001,1460000,268999,False,140,scaffold_7
16,1461001,1512000,50999,False,140,scaffold_7
17,1588001,1688000,99999,False,140,scaffold_7
18,3326001,3370000,43999,False,140,scaffold_7
19,3596001,3652000,55999,False,140,scaffold_7
20,3717001,3766000,48999,False,140,scaffold_7
21,4415001,4536000,120999,False,140,scaffold_7
22,4658001,4682000,23999,False,140,scaffold_7
23,4979001,5115000,135999,False,140,scaffold_7
24,5609001,5626000,16999,False,140,scaffold_7
25,6954001,7270000,315999,False,140,scaffold_7
26,7271001,7502216,231215,True,140,scaffold_7
0,1,6000,5999,True,140,scaffold_8
1,67001,85000,17999,False,140,scaffold_8
2,2444001,2530000,85999,False,140,scaffold_8
3,2536001,2551000,14999,False,140,scaffold_8
4,2661001,2683000,21999,False,140,scaffold_8
5,2750001,2751000,999,False,140,scaffold_8
6,2827001,2844000,16999,False,140,scaffold_8
7,3060001,3525000,464999,False,140,scaffold_8
8,3584001,3612000,27999,False,140,scaffold_8
9,3615001,3913000,297999,False,140,scaffold_8
10,5199001,5241000,41999,False,140,scaffold_8
11,6320001,6334544,14543,True,140,scaffold_8
0,109001,118000,8999,False,140,scaffold_9
1,121001,138000,16999,False,140,scaffold_9
2,144001,148000,3999,False,140,scaffold_9
3,303001,315000,11999,False,140,scaffold_9
4,319001,332000,12999,False,140,scaffold_9
5,367001,411000,43999,False,140,scaffold_9
6,413001,434000,20999,False,140,scaffold_9
7,502001,531000,28999,False,140,scaffold_9
8,671001,697000,25999,False,140,scaffold_9
9,733001,740000,6999,False,140,scaffold_9
10,815001,842000,26999,False,140,scaffold_9
11,886001,986000,99999,False,140,scaffold_9
12,988001,995000,6999,False,140,scaffold_9
13,1001001,1007000,5999,False,140,scaffold_9
14,1009001,1031000,21999,False,140,scaffold_9
15,1035001,1085000,49999,False,140,scaffold_9
16,1087001,1150000,62999,False,140,scaffold_9
17,1151001,1161000,9999,False,140,scaffold_9
18,1312001,1377000,64999,False,140,scaffold_9
19,1599001,1609000,9999,False,140,scaffold_9
20,1766001,1791000,24999,False,140,scaffold_9
21,2601001,2616000,14999,False,140,scaffold_9
22,2737001,2803000,65999,False,140,scaffold_9
23,2870001,3381000,510999,False,140,scaffold_9
24,3383001,5099000,1715999,False,140,scaffold_9
25,5101001,5107000,5999,False,140,scaffold_9
26,5112001,5115000,2999,False,140,scaffold_9
27,5116001,5238000,121999,False,140,scaffold_9
28,5239001,5298000,58999,False,140,scaffold_9
29,5299001,5490000,190999,False,140,scaffold_9
30,5493001,6331288,838287,True,140,scaffold_9
0,1,232000,231999,True,140,scaffold_10
1,335001,414000,78999,False,140,scaffold_10
2,415001,429000,13999,False,140,scaffold_10
3,472001,482000,9999,False,140,scaffold_10
4,483001,576000,92999,False,140,scaffold_10
5,603001,754000,150999,False,140,scaffold_10
6,784001,793000,8999,False,140,scaffold_10
7,888001,917000,28999,False,140,scaffold_10
8,923001,962000,38999,False,140,scaffold_10
9,1073001,1112000,38999,False,140,scaffold_10
10,2146001,2166000,19999,False,140,scaffold_10
11,2346001,2368000,21999,False,140,scaffold_10
12,4054001,4091000,36999,False,140,scaffold_10
13,4154001,4174000,19999,False,140,scaffold_10
14,4443001,4462000,18999,False,140,scaffold_10
15,4467001,4477000,9999,False,140,scaffold_10
16,4503001,4513000,9999,False,140,scaffold_10
17,4515001,4523000,7999,False,140,scaffold_10
18,4526001,4548000,21999,False,140,scaffold_10
19,4574001,4595000,20999,False,140,scaffold_10
20,4680001,4688000,7999,False,140,scaffold_10
21,4734001,4751000,16999,False,140,scaffold_10
22,4752001,4766000,13999,False,140,scaffold_10
23,4769001,4776000,6999,False,140,scaffold_10
24,4798001,4824000,25999,False,140,scaffold_10
25,4827001,4843000,15999,False,140,scaffold_10
26,4848001,4861000,12999,False,140,scaffold_10
27,4865001,4866973,1972,True,140,scaffold_10
0,10001,34000,23999,False,140,scaffold_11
1,40001,93000,52999,False,140,scaffold_11
2,149001,167000,17999,False,140,scaffold_11
3,169001,235000,65999,False,140,scaffold_11
4,240001,249000,8999,False,140,scaffold_11
5,419001,431000,11999,False,140,scaffold_11
6,648001,656000,7999,False,140,scaffold_11
7,1025001,1034000,8999,False,140,scaffold_11
8,1423001,1426000,2999,False,140,scaffold_11
9,1474001,1477000,2999,False,140,scaffold_11
10,2701001,2877000,175999,False,140,scaffold_11
11,3211001,3256000,44999,False,140,scaffold_11
12,3328001,3383000,54999,False,140,scaffold_11
13,3702001,3928000,225999,False,140,scaffold_11
14,4009001,4071000,61999,False,140,scaffold_11
15,4134001,4159000,24999,False,140,scaffold_11
16,4258001,4710000,451999,False,140,scaffold_11
17,4712001,4766820,54819,True,140,scaffold_11
0,1,370000,369999,True,140,scaffold_12
1,474001,539000,64999,False,140,scaffold_12
2,582001,856000,273999,False,140,scaffold_12
3,865001,1447000,581999,False,140,scaffold_12
4,1720001,1733000,12999,False,140,scaffold_12
5,2571001,2610000,38999,False,140,scaffold_12
0,1,342000,341999,True,141,scaffold_1
1,482001,498000,15999,False,141,scaffold_1
2,571001,643000,71999,False,141,scaffold_1
3,686001,743000,56999,False,141,scaffold_1
4,1827001,1899000,71999,False,141,scaffold_1
5,1952001,1964000,11999,False,141,scaffold_1
6,1965001,1984000,18999,False,141,scaffold_1
7,2449001,2517000,67999,False,141,scaffold_1
8,2729001,2746000,16999,False,141,scaffold_1
9,3175001,3208000,32999,False,141,scaffold_1
10,3713001,3734000,20999,False,141,scaffold_1
11,3916001,3934000,17999,False,141,scaffold_1
12,4061001,4111000,49999,False,141,scaffold_1
13,4321001,4354000,32999,False,141,scaffold_1
14,4928001,4997000,68999,False,141,scaffold_1
15,5484001,5511000,26999,False,141,scaffold_1
16,5536001,5569000,32999,False,141,scaffold_1
17,6108001,6153000,44999,False,141,scaffold_1
18,6228001,6507000,278999,False,141,scaffold_1
19,6544001,6554000,9999,False,141,scaffold_1
20,7038001,7247000,208999,False,141,scaffold_1
21,7248001,7588000,339999,False,141,scaffold_1
22,7590001,8477000,886999,False,141,scaffold_1
23,8478001,8656000,177999,False,141,scaffold_1
24,8658001,9584000,925999,False,141,scaffold_1
25,9586001,10354000,767999,False,141,scaffold_1
26,10461001,10630000,168999,False,141,scaffold_1
27,10808001,10811000,2999,False,141,scaffold_1
28,10832001,10857000,24999,False,141,scaffold_1
29,11351001,11504000,152999,False,141,scaffold_1
30,11614001,11951000,336999,False,141,scaffold_1
31,12184001,12204000,19999,False,141,scaffold_1
32,12652001,12722000,69999,False,141,scaffold_1
33,12777001,12888000,110999,False,141,scaffold_1
34,13113001,13211000,97999,False,141,scaffold_1
35,13347001,13404000,56999,False,141,scaffold_1
0,21001,48000,26999,False,141,scaffold_2
1,95001,159000,63999,False,141,scaffold_2
2,300001,318000,17999,False,141,scaffold_2
3,333001,374000,40999,False,141,scaffold_2
4,2086001,2100000,13999,False,141,scaffold_2
5,2336001,2358000,21999,False,141,scaffold_2
6,2405001,2423000,17999,False,141,scaffold_2
7,2441001,2553000,111999,False,141,scaffold_2
8,2660001,2689000,28999,False,141,scaffold_2
9,2694001,2745000,50999,False,141,scaffold_2
10,2777001,2787000,9999,False,141,scaffold_2
11,2840001,2855000,14999,False,141,scaffold_2
12,2997001,3009000,11999,False,141,scaffold_2
13,3454001,3464000,9999,False,141,scaffold_2
14,3769001,3781000,11999,False,141,scaffold_2
15,4385001,4409000,23999,False,141,scaffold_2
16,4428001,4457000,28999,False,141,scaffold_2
17,4521001,4657000,135999,False,141,scaffold_2
18,4918001,4950000,31999,False,141,scaffold_2
19,5022001,5031000,8999,False,141,scaffold_2
20,5033001,5104000,70999,False,141,scaffold_2
21,5491001,5512000,20999,False,141,scaffold_2
22,5661001,5704000,42999,False,141,scaffold_2
23,5720001,5756000,35999,False,141,scaffold_2
24,5840001,5884000,43999,False,141,scaffold_2
25,6261001,6330000,68999,False,141,scaffold_2
26,6331001,6342000,10999,False,141,scaffold_2
27,6430001,6447000,16999,False,141,scaffold_2
28,7020001,7036000,15999,False,141,scaffold_2
29,7063001,7097000,33999,False,141,scaffold_2
30,7433001,7473000,39999,False,141,scaffold_2
31,7563001,7697000,133999,False,141,scaffold_2
32,7786001,7890000,103999,False,141,scaffold_2
33,7934001,7966000,31999,False,141,scaffold_2
34,7984001,8162000,177999,False,141,scaffold_2
35,8331001,8333000,1999,False,141,scaffold_2
36,8341001,8344000,2999,False,141,scaffold_2
37,8346001,8389000,42999,False,141,scaffold_2
38,8436001,8453000,16999,False,141,scaffold_2
39,8509001,8537000,27999,False,141,scaffold_2
40,11367001,11377000,9999,False,141,scaffold_2
41,11520001,11786000,265999,False,141,scaffold_2
0,51001,54000,2999,False,141,scaffold_3
1,102001,104000,1999,False,141,scaffold_3
2,203001,207000,3999,False,141,scaffold_3
3,799001,901000,101999,False,141,scaffold_3
4,2084001,2108000,23999,False,141,scaffold_3
5,2291001,2321000,29999,False,141,scaffold_3
6,2487001,2533000,45999,False,141,scaffold_3
7,3826001,3878000,51999,False,141,scaffold_3
8,4108001,4403000,294999,False,141,scaffold_3
9,4416001,4519000,102999,False,141,scaffold_3
10,4547001,4558000,10999,False,141,scaffold_3
11,4653001,4678000,24999,False,141,scaffold_3
12,5990001,6019000,28999,False,141,scaffold_3
13,6908001,6962000,53999,False,141,scaffold_3
14,6963001,7089000,125999,False,141,scaffold_3
15,7522001,7556000,33999,False,141,scaffold_3
16,7692001,7799000,106999,False,141,scaffold_3
17,7819001,7842000,22999,False,141,scaffold_3
18,8175001,8253000,77999,False,141,scaffold_3
19,8462001,8527000,64999,False,141,scaffold_3
20,8575001,8594000,18999,False,141,scaffold_3
21,9968001,9996000,27999,False,141,scaffold_3
22,10461001,10483000,21999,False,141,scaffold_3
23,10587001,11167000,579999,False,141,scaffold_3
0,17001,32000,14999,False,141,scaffold_4
1,49001,88000,38999,False,141,scaffold_4
2,121001,146000,24999,False,141,scaffold_4
3,147001,151000,3999,False,141,scaffold_4
4,155001,160000,4999,False,141,scaffold_4
5,161001,215000,53999,False,141,scaffold_4
6,218001,226000,7999,False,141,scaffold_4
7,227001,266000,38999,False,141,scaffold_4
8,355001,374000,18999,False,141,scaffold_4
9,375001,380000,4999,False,141,scaffold_4
10,394001,410000,15999,False,141,scaffold_4
11,411001,425000,13999,False,141,scaffold_4
12,429001,500000,70999,False,141,scaffold_4
13,544001,592000,47999,False,141,scaffold_4
14,593001,606000,12999,False,141,scaffold_4
15,608001,661000,52999,False,141,scaffold_4
16,670001,691000,20999,False,141,scaffold_4
17,695001,697000,1999,False,141,scaffold_4
18,701001,717000,15999,False,141,scaffold_4
19,1121001,1136000,14999,False,141,scaffold_4
20,1137001,1179000,41999,False,141,scaffold_4
21,1199001,1226000,26999,False,141,scaffold_4
22,1229001,1231000,1999,False,141,scaffold_4
23,1235001,1246000,10999,False,141,scaffold_4
24,1248001,1253000,4999,False,141,scaffold_4
25,1254001,1262000,7999,False,141,scaffold_4
26,1265001,1279000,13999,False,141,scaffold_4
27,1283001,1336000,52999,False,141,scaffold_4
28,1372001,1595000,222999,False,141,scaffold_4
29,1613001,1898000,284999,False,141,scaffold_4
30,1904001,1957000,52999,False,141,scaffold_4
31,1958001,2068000,109999,False,141,scaffold_4
32,2071001,2097000,25999,False,141,scaffold_4
33,2211001,2218000,6999,False,141,scaffold_4
34,2265001,2279000,13999,False,141,scaffold_4
35,2284001,2340000,55999,False,141,scaffold_4
36,2433001,2461000,27999,False,141,scaffold_4
37,2480001,2533000,52999,False,141,scaffold_4
38,3336001,3760000,423999,False,141,scaffold_4
39,4908001,4985000,76999,False,141,scaffold_4
40,5477001,5506000,28999,False,141,scaffold_4
41,5516001,5620000,103999,False,141,scaffold_4
42,5657001,5784000,126999,False,141,scaffold_4
43,5786001,5817000,30999,False,141,scaffold_4
44,6178001,6190000,11999,False,141,scaffold_4
45,6797001,6817000,19999,False,141,scaffold_4
46,6900001,6924000,23999,False,141,scaffold_4
47,7037001,7062000,24999,False,141,scaffold_4
48,8846001,9699000,852999,False,141,scaffold_4
49,9703001,9845951,142950,True,141,scaffold_4
0,1,4000,3999,True,141,scaffold_5
1,318001,326000,7999,False,141,scaffold_5
2,327001,368000,40999,False,141,scaffold_5
3,471001,475000,3999,False,141,scaffold_5
4,500001,523000,22999,False,141,scaffold_5
5,836001,842000,5999,False,141,scaffold_5
6,933001,947000,13999,False,141,scaffold_5
7,2475001,2492000,16999,False,141,scaffold_5
8,2564001,2582000,17999,False,141,scaffold_5
9,2625001,2734000,108999,False,141,scaffold_5
10,2814001,2871000,56999,False,141,scaffold_5
11,3137001,3185000,47999,False,141,scaffold_5
12,3322001,3438000,115999,False,141,scaffold_5
13,3450001,3499000,48999,False,141,scaffold_5
14,3962001,4101000,138999,False,141,scaffold_5
15,4121001,4219000,97999,False,141,scaffold_5
16,4232001,4272000,39999,False,141,scaffold_5
17,4446001,4483000,36999,False,141,scaffold_5
18,4603001,4679000,75999,False,141,scaffold_5
19,4691001,4717000,25999,False,141,scaffold_5
20,4790001,4861000,70999,False,141,scaffold_5
21,4904001,4917000,12999,False,141,scaffold_5
22,5288001,5312000,23999,False,141,scaffold_5
23,5314001,5346000,31999,False,141,scaffold_5
24,6409001,6418000,8999,False,141,scaffold_5
25,6508001,6566000,57999,False,141,scaffold_5
26,6590001,6626000,35999,False,141,scaffold_5
27,7372001,7387000,14999,False,141,scaffold_5
28,7580001,7619000,38999,False,141,scaffold_5
29,7620001,7654000,33999,False,141,scaffold_5
30,8730001,9363000,632999,False,141,scaffold_5
0,67001,74000,6999,False,141,scaffold_6
1,79001,84000,4999,False,141,scaffold_6
2,86001,113000,26999,False,141,scaffold_6
3,240001,255000,14999,False,141,scaffold_6
4,257001,262000,4999,False,141,scaffold_6
5,267001,283000,15999,False,141,scaffold_6
6,555001,565000,9999,False,141,scaffold_6
7,1228001,1257000,28999,False,141,scaffold_6
8,1479001,1546000,66999,False,141,scaffold_6
9,1870001,1906000,35999,False,141,scaffold_6
10,2023001,2088000,64999,False,141,scaffold_6
11,2130001,2191000,60999,False,141,scaffold_6
12,2345001,2595000,249999,False,141,scaffold_6
13,2596001,2653000,56999,False,141,scaffold_6
14,2660001,2691000,30999,False,141,scaffold_6
15,2731001,2872000,140999,False,141,scaffold_6
16,2927001,3014000,86999,False,141,scaffold_6
17,3113001,3149000,35999,False,141,scaffold_6
18,3223001,3301000,77999,False,141,scaffold_6
19,3406001,3432000,25999,False,141,scaffold_6
20,3461001,3767000,305999,False,141,scaffold_6
21,3901001,3912000,10999,False,141,scaffold_6
22,4018001,4072000,53999,False,141,scaffold_6
23,4073001,4193000,119999,False,141,scaffold_6
24,6011001,6060000,48999,False,141,scaffold_6
25,7263001,7337000,73999,False,141,scaffold_6
26,7393001,7414000,20999,False,141,scaffold_6
27,7549001,7796000,246999,False,141,scaffold_6
28,7811001,8268281,457280,True,141,scaffold_6
0,1,8000,7999,True,141,scaffold_7
1,13001,31000,17999,False,141,scaffold_7
2,323001,340000,16999,False,141,scaffold_7
3,342001,508000,165999,False,141,scaffold_7
4,554001,563000,8999,False,141,scaffold_7
5,571001,577000,5999,False,141,scaffold_7
6,650001,703000,52999,False,141,scaffold_7
7,706001,736000,29999,False,141,scaffold_7
8,764001,809000,44999,False,141,scaffold_7
9,859001,864000,4999,False,141,scaffold_7
10,982001,1044000,61999,False,141,scaffold_7
11,1071001,1078000,6999,False,141,scaffold_7
12,1191001,1459000,267999,False,141,scaffold_7
13,1461001,1512000,50999,False,141,scaffold_7
14,1588001,1695000,106999,False,141,scaffold_7
15,3325001,3369000,43999,False,141,scaffold_7
16,3539001,3546000,6999,False,141,scaffold_7
17,3594001,3649000,54999,False,141,scaffold_7
18,3718001,3765000,46999,False,141,scaffold_7
19,4415001,4536000,120999,False,141,scaffold_7
20,4658001,4735000,76999,False,141,scaffold_7
21,4978001,5146000,167999,False,141,scaffold_7
22,5483001,5536000,52999,False,141,scaffold_7
23,5609001,5627000,17999,False,141,scaffold_7
24,6955001,7270000,314999,False,141,scaffold_7
25,7271001,7502216,231215,True,141,scaffold_7
0,1,6000,5999,True,141,scaffold_8
1,67001,85000,17999,False,141,scaffold_8
2,93001,101000,7999,False,141,scaffold_8
3,2444001,2527000,82999,False,141,scaffold_8
4,2653001,2683000,29999,False,141,scaffold_8
5,2742001,2757000,14999,False,141,scaffold_8
6,2798001,2844000,45999,False,141,scaffold_8
7,3057001,3525000,467999,False,141,scaffold_8
8,3585001,3913000,327999,False,141,scaffold_8
9,5125001,5134000,8999,False,141,scaffold_8
10,5200001,5241000,40999,False,141,scaffold_8
11,6320001,6334544,14543,True,141,scaffold_8
0,109001,117000,7999,False,141,scaffold_9
1,303001,315000,11999,False,141,scaffold_9
2,319001,333000,13999,False,141,scaffold_9
3,367001,411000,43999,False,141,scaffold_9
4,413001,436000,22999,False,141,scaffold_9
5,502001,531000,28999,False,141,scaffold_9
6,653001,659000,5999,False,141,scaffold_9
7,660001,665000,4999,False,141,scaffold_9
8,671001,697000,25999,False,141,scaffold_9
9,732001,742000,9999,False,141,scaffold_9
10,815001,842000,26999,False,141,scaffold_9
11,873001,986000,112999,False,141,scaffold_9
12,988001,996000,7999,False,141,scaffold_9
13,1001001,1007000,5999,False,141,scaffold_9
14,1009001,1031000,21999,False,141,scaffold_9
15,1035001,1085000,49999,False,141,scaffold_9
16,1087001,1160000,72999,False,141,scaffold_9
17,1313001,1377000,63999,False,141,scaffold_9
18,1487001,1498000,10999,False,141,scaffold_9
19,1767001,1791000,23999,False,141,scaffold_9
20,2601001,2616000,14999,False,141,scaffold_9
21,2781001,2803000,21999,False,141,scaffold_9
22,2871001,3381000,509999,False,141,scaffold_9
23,3383001,5107000,1723999,False,141,scaffold_9
24,5112001,5115000,2999,False,141,scaffold_9
25,5116001,5238000,121999,False,141,scaffold_9
26,5239001,5298000,58999,False,141,scaffold_9
27,5300001,5490000,189999,False,141,scaffold_9
28,5493001,6331288,838287,True,141,scaffold_9
0,1,229000,228999,True,141,scaffold_10
1,336001,405000,68999,False,141,scaffold_10
2,472001,482000,9999,False,141,scaffold_10
3,483001,582000,98999,False,141,scaffold_10
4,603001,753000,149999,False,141,scaffold_10
5,888001,917000,28999,False,141,scaffold_10
6,924001,962000,37999,False,141,scaffold_10
7,1073001,1145000,71999,False,141,scaffold_10
8,2140001,2167000,26999,False,141,scaffold_10
9,2270001,2293000,22999,False,141,scaffold_10
10,2346001,2368000,21999,False,141,scaffold_10
11,3590001,3595000,4999,False,141,scaffold_10
12,4053001,4091000,37999,False,141,scaffold_10
13,4154001,4174000,19999,False,141,scaffold_10
14,4467001,4477000,9999,False,141,scaffold_10
15,4503001,4513000,9999,False,141,scaffold_10
16,4515001,4523000,7999,False,141,scaffold_10
17,4526001,4548000,21999,False,141,scaffold_10
18,4575001,4597000,21999,False,141,scaffold_10
19,4679001,4688000,8999,False,141,scaffold_10
20,4734001,4766000,31999,False,141,scaffold_10
21,4769001,4776000,6999,False,141,scaffold_10
22,4798001,4824000,25999,False,141,scaffold_10
23,4828001,4843000,14999,False,141,scaffold_10
24,4848001,4861000,12999,False,141,scaffold_10
25,4865001,4866973,1972,True,141,scaffold_10
0,10001,34000,23999,False,141,scaffold_11
1,38001,92000,53999,False,141,scaffold_11
2,149001,167000,17999,False,141,scaffold_11
3,169001,191000,21999,False,141,scaffold_11
4,213001,236000,22999,False,141,scaffold_11
5,240001,252000,11999,False,141,scaffold_11
6,419001,431000,11999,False,141,scaffold_11
7,609001,613000,3999,False,141,scaffold_11
8,648001,656000,7999,False,141,scaffold_11
9,1025001,1034000,8999,False,141,scaffold_11
10,1423001,1427000,3999,False,141,scaffold_11
11,2701001,2877000,175999,False,141,scaffold_11
12,2983001,3018000,34999,False,141,scaffold_11
13,3185001,3261000,75999,False,141,scaffold_11
14,3329001,3383000,53999,False,141,scaffold_11
15,3553001,3597000,43999,False,141,scaffold_11
16,3702001,3930000,227999,False,141,scaffold_11
17,4008001,4159000,150999,False,141,scaffold_11
18,4259001,4710000,450999,False,141,scaffold_11
19,4713001,4766820,53819,True,141,scaffold_11
0,1,370000,369999,True,141,scaffold_12
1,472001,537000,64999,False,141,scaffold_12
2,581001,857000,275999,False,141,scaffold_12
3,865001,1449000,583999,False,141,scaffold_12
4,1720001,1733000,12999,False,141,scaffold_12
5,2088001,2103000,14999,False,141,scaffold_12
6,2571001,2609000,37999,False,141,scaffold_12
7,2747001,2747968,967,True,141,scaffold_12
0,1,346000,345999,True,142,scaffold_1
1,482001,498000,15999,False,142,scaffold_1
2,570001,643000,72999,False,142,scaffold_1
3,686001,759000,72999,False,142,scaffold_1
4,1281001,1292000,10999,False,142,scaffold_1
5,1812001,1898000,85999,False,142,scaffold_1
6,1954001,1964000,9999,False,142,scaffold_1
7,1965001,1984000,18999,False,142,scaffold_1
8,1986001,1994000,7999,False,142,scaffold_1
9,2449001,2517000,67999,False,142,scaffold_1
10,2564001,2581000,16999,False,142,scaffold_1
11,2726001,2746000,19999,False,142,scaffold_1
12,3174001,3208000,33999,False,142,scaffold_1
13,3712001,3735000,22999,False,142,scaffold_1
14,3902001,3941000,38999,False,142,scaffold_1
15,4001001,4029000,27999,False,142,scaffold_1
16,4062001,4112000,49999,False,142,scaffold_1
17,4318001,4354000,35999,False,142,scaffold_1
18,4921001,4997000,75999,False,142,scaffold_1
19,5482001,5511000,28999,False,142,scaffold_1
20,5535001,5577000,41999,False,142,scaffold_1
21,6108001,6153000,44999,False,142,scaffold_1
22,6161001,6176000,14999,False,142,scaffold_1
23,6201001,6381000,179999,False,142,scaffold_1
24,6384001,6508000,123999,False,142,scaffold_1
25,6544001,6554000,9999,False,142,scaffold_1
26,7038001,7247000,208999,False,142,scaffold_1
27,7248001,7584000,335999,False,142,scaffold_1
28,7590001,8656000,1065999,False,142,scaffold_1
29,8658001,9584000,925999,False,142,scaffold_1
30,9586001,10362000,775999,False,142,scaffold_1
31,10461001,10638000,176999,False,142,scaffold_1
32,10808001,10811000,2999,False,142,scaffold_1
33,10832001,10858000,25999,False,142,scaffold_1
34,10918001,10940000,21999,False,142,scaffold_1
35,11351001,11509000,157999,False,142,scaffold_1
36,11614001,11962000,347999,False,142,scaffold_1
37,12184001,12204000,19999,False,142,scaffold_1
38,12652001,12723000,70999,False,142,scaffold_1
39,12777001,12888000,110999,False,142,scaffold_1
40,12971001,13001000,29999,False,142,scaffold_1
41,13113001,13211000,97999,False,142,scaffold_1
42,13347001,13404000,56999,False,142,scaffold_1
43,13842001,13844000,1999,False,142,scaffold_1
0,20001,48000,27999,False,142,scaffold_2
1,95001,159000,63999,False,142,scaffold_2
2,168001,177000,8999,False,142,scaffold_2
3,333001,374000,40999,False,142,scaffold_2
4,2336001,2379000,42999,False,142,scaffold_2
5,2441001,2553000,111999,False,142,scaffold_2
6,2658001,2689000,30999,False,142,scaffold_2
7,2694001,2745000,50999,False,142,scaffold_2
8,2837001,2855000,17999,False,142,scaffold_2
9,2868001,2900000,31999,False,142,scaffold_2
10,2975001,3013000,37999,False,142,scaffold_2
11,3368001,3383000,14999,False,142,scaffold_2
12,3457001,3460000,2999,False,142,scaffold_2
13,3754001,3783000,28999,False,142,scaffold_2
14,4382001,4409000,26999,False,142,scaffold_2
15,4426001,4457000,30999,False,142,scaffold_2
16,4520001,4656000,135999,False,142,scaffold_2
17,4918001,4943000,24999,False,142,scaffold_2
18,5022001,5031000,8999,False,142,scaffold_2
19,5033001,5061000,27999,False,142,scaffold_2
20,5080001,5104000,23999,False,142,scaffold_2
21,5370001,5392000,21999,False,142,scaffold_2
22,5491001,5515000,23999,False,142,scaffold_2
23,5667001,5704000,36999,False,142,scaffold_2
24,5719001,5757000,37999,False,142,scaffold_2
25,5840001,5887000,46999,False,142,scaffold_2
26,6260001,6330000,69999,False,142,scaffold_2
27,6331001,6342000,10999,False,142,scaffold_2
28,6428001,6448000,19999,False,142,scaffold_2
29,6592001,6628000,35999,False,142,scaffold_2
30,7017001,7038000,20999,False,142,scaffold_2
31,7434001,7472000,37999,False,142,scaffold_2
32,7491001,7512000,20999,False,142,scaffold_2
33,7548001,7561000,12999,False,142,scaffold_2
34,7563001,7697000,133999,False,142,scaffold_2
35,7785001,7891000,105999,False,142,scaffold_2
36,7934001,8161000,226999,False,142,scaffold_2
37,8261001,8313000,51999,False,142,scaffold_2
38,8331001,8333000,1999,False,142,scaffold_2
39,8335001,8344000,8999,False,142,scaffold_2
40,8346001,8454000,107999,False,142,scaffold_2
41,8506001,8562000,55999,False,142,scaffold_2
42,9140001,9167000,26999,False,142,scaffold_2
43,11367001,11380000,12999,False,142,scaffold_2
44,11520001,11785000,264999,False,142,scaffold_2
0,51001,55000,3999,False,142,scaffold_3
1,618001,646000,27999,False,142,scaffold_3
2,799001,901000,101999,False,142,scaffold_3
3,2052001,2108000,55999,False,142,scaffold_3
4,2291001,2321000,29999,False,142,scaffold_3
5,2487001,2533000,45999,False,142,scaffold_3
6,3261001,3267000,5999,False,142,scaffold_3
7,3768001,3821000,52999,False,142,scaffold_3
8,3822001,3891000,68999,False,142,scaffold_3
9,4108001,4403000,294999,False,142,scaffold_3
10,4410001,4519000,108999,False,142,scaffold_3
11,4547001,4558000,10999,False,142,scaffold_3
12,4643001,4684000,40999,False,142,scaffold_3
13,5974001,6016000,41999,False,142,scaffold_3
14,6743001,6781000,37999,False,142,scaffold_3
15,6909001,6962000,52999,False,142,scaffold_3
16,6963001,7090000,126999,False,142,scaffold_3
17,7336001,7398000,61999,False,142,scaffold_3
18,7522001,7556000,33999,False,142,scaffold_3
19,7691001,7856000,164999,False,142,scaffold_3
20,7910001,7929000,18999,False,142,scaffold_3
21,8183001,8254000,70999,False,142,scaffold_3
22,8462001,8527000,64999,False,142,scaffold_3
23,8574001,8594000,19999,False,142,scaffold_3
24,9968001,9996000,27999,False,142,scaffold_3
25,10277001,10290000,12999,False,142,scaffold_3
26,10461001,10484000,22999,False,142,scaffold_3
27,10587001,11165000,577999,False,142,scaffold_3
0,17001,29000,11999,False,142,scaffold_4
1,30001,32000,1999,False,142,scaffold_4
2,48001,89000,40999,False,142,scaffold_4
3,136001,146000,9999,False,142,scaffold_4
4,147001,151000,3999,False,142,scaffold_4
5,155001,160000,4999,False,142,scaffold_4
6,161001,215000,53999,False,142,scaffold_4
7,217001,226000,8999,False,142,scaffold_4
8,227001,266000,38999,False,142,scaffold_4
9,291001,307000,15999,False,142,scaffold_4
10,318001,344000,25999,False,142,scaffold_4
11,355001,374000,18999,False,142,scaffold_4
12,375001,380000,4999,False,142,scaffold_4
13,411001,425000,13999,False,142,scaffold_4
14,429001,498000,68999,False,142,scaffold_4
15,545001,592000,46999,False,142,scaffold_4
16,608001,691000,82999,False,142,scaffold_4
17,1121001,1136000,14999,False,142,scaffold_4
18,1138001,1198000,59999,False,142,scaffold_4
19,1199001,1208000,8999,False,142,scaffold_4
20,1210001,1226000,15999,False,142,scaffold_4
21,1235001,1253000,17999,False,142,scaffold_4
22,1284001,1318000,33999,False,142,scaffold_4
23,1371001,1591000,219999,False,142,scaffold_4
24,1613001,1648000,34999,False,142,scaffold_4
25,1680001,1691000,10999,False,142,scaffold_4
26,1723001,1849000,125999,False,142,scaffold_4
27,1850001,1870000,19999,False,142,scaffold_4
28,1904001,1957000,52999,False,142,scaffold_4
29,1958001,2003000,44999,False,142,scaffold_4
30,2036001,2065000,28999,False,142,scaffold_4
31,2283001,2339000,55999,False,142,scaffold_4
32,2476001,2635000,158999,False,142,scaffold_4
33,3335001,3633000,297999,False,142,scaffold_4
34,3645001,3759000,113999,False,142,scaffold_4
35,4901001,4999000,97999,False,142,scaffold_4
36,5171001,5223000,51999,False,142,scaffold_4
37,5477001,5506000,28999,False,142,scaffold_4
38,5514001,5620000,105999,False,142,scaffold_4
39,5658001,5784000,125999,False,142,scaffold_4
40,5786001,5813000,26999,False,142,scaffold_4
41,6145001,6191000,45999,False,142,scaffold_4
42,6804001,6817000,12999,False,142,scaffold_4
43,6901001,6924000,22999,False,142,scaffold_4
44,7036001,7079000,42999,False,142,scaffold_4
45,7199001,7294000,94999,False,142,scaffold_4
46,7641001,7664000,22999,False,142,scaffold_4
47,8846001,9699000,852999,False,142,scaffold_4
48,9700001,9845951,145950,True,142,scaffold_4
0,1,5000,4999,True,142,scaffold_5
1,145001,174000,28999,False,142,scaffold_5
2,321001,326000,4999,False,142,scaffold_5
3,327001,369000,41999,False,142,scaffold_5
4,459001,524000,64999,False,142,scaffold_5
5,760001,763000,2999,False,142,scaffold_5
6,933001,947000,13999,False,142,scaffold_5
7,2511001,2515000,3999,False,142,scaffold_5
8,2560001,2585000,24999,False,142,scaffold_5
9,2618001,2738000,119999,False,142,scaffold_5
10,2813001,2872000,58999,False,142,scaffold_5
11,3133001,3255000,121999,False,142,scaffold_5
12,3322001,3498000,175999,False,142,scaffold_5
13,3962001,4101000,138999,False,142,scaffold_5
14,4119001,4219000,99999,False,142,scaffold_5
15,4246001,4272000,25999,False,142,scaffold_5
16,4444001,4522000,77999,False,142,scaffold_5
17,4601001,4734000,132999,False,142,scaffold_5
18,4761001,4862000,100999,False,142,scaffold_5
19,4883001,4920000,36999,False,142,scaffold_5
20,5249001,5346000,96999,False,142,scaffold_5
21,6408001,6420000,11999,False,142,scaffold_5
22,6505001,6652000,146999,False,142,scaffold_5
23,7373001,7386000,12999,False,142,scaffold_5
24,7551001,7611000,59999,False,142,scaffold_5
25,7622001,7642000,19999,False,142,scaffold_5
26,8258001,8263000,4999,False,142,scaffold_5
27,8664001,8689000,24999,False,142,scaffold_5
28,8715001,9364176,649175,True,142,scaffold_5
0,78001,84000,5999,False,142,scaffold_6
1,86001,112000,25999,False,142,scaffold_6
2,241001,263000,21999,False,142,scaffold_6
3,267001,278000,10999,False,142,scaffold_6
4,1236001,1263000,26999,False,142,scaffold_6
5,1479001,1547000,67999,False,142,scaffold_6
6,1659001,1683000,23999,False,142,scaffold_6
7,1868001,1906000,37999,False,142,scaffold_6
8,2023001,2104000,80999,False,142,scaffold_6
9,2129001,2195000,65999,False,142,scaffold_6
10,2236001,2281000,44999,False,142,scaffold_6
11,2348001,2654000,305999,False,142,scaffold_6
12,2655001,2691000,35999,False,142,scaffold_6
13,2712001,2852000,139999,False,142,scaffold_6
14,2928001,3015000,86999,False,142,scaffold_6
15,3111001,3174000,62999,False,142,scaffold_6
16,3223001,3315000,91999,False,142,scaffold_6
17,3400001,3429000,28999,False,142,scaffold_6
18,3461001,3766000,304999,False,142,scaffold_6
19,3897001,3914000,16999,False,142,scaffold_6
20,4018001,4066000,47999,False,142,scaffold_6
21,4080001,4195000,114999,False,142,scaffold_6
22,6006001,6073000,66999,False,142,scaffold_6
23,7263001,7337000,73999,False,142,scaffold_6
24,7541001,8268281,727280,True,142,scaffold_6
0,323001,340000,16999,False,142,scaffold_7
1,342001,508000,165999,False,142,scaffold_7
2,571001,577000,5999,False,142,scaffold_7
3,706001,753000,46999,False,142,scaffold_7
4,764001,829000,64999,False,142,scaffold_7
5,830001,843000,12999,False,142,scaffold_7
6,858001,864000,5999,False,142,scaffold_7
7,964001,966000,1999,False,142,scaffold_7
8,968001,981000,12999,False,142,scaffold_7
9,982001,1031000,48999,False,142,scaffold_7
10,1034001,1044000,9999,False,142,scaffold_7
11,1061001,1099000,37999,False,142,scaffold_7
12,1191001,1512000,320999,False,142,scaffold_7
13,1588001,1689000,100999,False,142,scaffold_7
14,3304001,3311000,6999,False,142,scaffold_7
15,3325001,3372000,46999,False,142,scaffold_7
16,3520001,3767000,246999,False,142,scaffold_7
17,4415001,4536000,120999,False,142,scaffold_7
18,4658001,4734000,75999,False,142,scaffold_7
19,4978001,5149000,170999,False,142,scaffold_7
20,5482001,5536000,53999,False,142,scaffold_7
21,5609001,5627000,17999,False,142,scaffold_7
22,6954001,7270000,315999,False,142,scaffold_7
23,7271001,7502216,231215,True,142,scaffold_7
0,66001,85000,18999,False,142,scaffold_8
1,96001,101000,4999,False,142,scaffold_8
2,1905001,1927000,21999,False,142,scaffold_8
3,2414001,2471000,56999,False,142,scaffold_8
4,2490001,2528000,37999,False,142,scaffold_8
5,2536001,2551000,14999,False,142,scaffold_8
6,2650001,2683000,32999,False,142,scaffold_8
7,2745001,2756000,10999,False,142,scaffold_8
8,2798001,2844000,45999,False,142,scaffold_8
9,3059001,3525000,465999,False,142,scaffold_8
10,3587001,3611000,23999,False,142,scaffold_8
11,3620001,3946000,325999,False,142,scaffold_8
12,4038001,4104000,65999,False,142,scaffold_8
13,4400001,4429000,28999,False,142,scaffold_8
14,5086001,5136000,49999,False,142,scaffold_8
15,5187001,5241000,53999,False,142,scaffold_8
16,5652001,5692000,39999,False,142,scaffold_8
17,6329001,6334544,5543,True,142,scaffold_8
0,109001,117000,7999,False,142,scaffold_9
1,189001,194000,4999,False,142,scaffold_9
2,364001,411000,46999,False,142,scaffold_9
3,413001,434000,20999,False,142,scaffold_9
4,504001,531000,26999,False,142,scaffold_9
5,653001,659000,5999,False,142,scaffold_9
6,660001,665000,4999,False,142,scaffold_9
7,670001,696000,25999,False,142,scaffold_9
8,732001,742000,9999,False,142,scaffold_9
9,814001,843000,28999,False,142,scaffold_9
10,850001,862000,11999,False,142,scaffold_9
11,873001,986000,112999,False,142,scaffold_9
12,988001,995000,6999,False,142,scaffold_9
13,1001001,1007000,5999,False,142,scaffold_9
14,1010001,1031000,20999,False,142,scaffold_9
15,1035001,1085000,49999,False,142,scaffold_9
16,1087001,1150000,62999,False,142,scaffold_9
17,1151001,1165000,13999,False,142,scaffold_9
18,1313001,1377000,63999,False,142,scaffold_9
19,1767001,1796000,28999,False,142,scaffold_9
20,2599001,2616000,16999,False,142,scaffold_9
21,2731001,2823000,91999,False,142,scaffold_9
22,2870001,3381000,510999,False,142,scaffold_9
23,3383001,5099000,1715999,False,142,scaffold_9
24,5101001,5107000,5999,False,142,scaffold_9
25,5112001,5114000,1999,False,142,scaffold_9
26,5116001,5298000,181999,False,142,scaffold_9
27,5300001,6331288,1031287,True,142,scaffold_9
0,1,235000,234999,True,142,scaffold_10
1,335001,414000,78999,False,142,scaffold_10
2,416001,482000,65999,False,142,scaffold_10
3,483001,582000,98999,False,142,scaffold_10
4,603001,794000,190999,False,142,scaffold_10
5,888001,963000,74999,False,142,scaffold_10
6,1073001,1145000,71999,False,142,scaffold_10
7,2091001,2101000,9999,False,142,scaffold_10
8,2140001,2170000,29999,False,142,scaffold_10
9,2346001,2368000,21999,False,142,scaffold_10
10,4002001,4009000,6999,False,142,scaffold_10
11,4050001,4093000,42999,False,142,scaffold_10
12,4154001,4174000,19999,False,142,scaffold_10
13,4214001,4224000,9999,False,142,scaffold_10
14,4443001,4462000,18999,False,142,scaffold_10
15,4467001,4476000,8999,False,142,scaffold_10
16,4515001,4522000,6999,False,142,scaffold_10
17,4526001,4548000,21999,False,142,scaffold_10
18,4573001,4596000,22999,False,142,scaffold_10
19,4680001,4688000,7999,False,142,scaffold_10
20,4734001,4766000,31999,False,142,scaffold_10
21,4769001,4776000,6999,False,142,scaffold_10
22,4798001,4824000,25999,False,142,scaffold_10
23,4828001,4843000,14999,False,142,scaffold_10
24,4848001,4861000,12999,False,142,scaffold_10
25,4865001,4866973,1972,True,142,scaffold_10
0,10001,34000,23999,False,142,scaffold_11
1,40001,90000,49999,False,142,scaffold_11
2,149001,168000,18999,False,142,scaffold_11
3,169001,191000,21999,False,142,scaffold_11
4,213001,236000,22999,False,142,scaffold_11
5,419001,431000,11999,False,142,scaffold_11
6,649001,656000,6999,False,142,scaffold_11
7,1025001,1034000,8999,False,142,scaffold_11
8,1423001,1426000,2999,False,142,scaffold_11
9,1474001,1477000,2999,False,142,scaffold_11
10,2700001,2873000,172999,False,142,scaffold_11
11,2978001,3011000,32999,False,142,scaffold_11
12,3188001,3282000,93999,False,142,scaffold_11
13,3329001,3383000,53999,False,142,scaffold_11
14,3583001,3651000,67999,False,142,scaffold_11
15,3702001,3933000,230999,False,142,scaffold_11
16,4093001,4158000,64999,False,142,scaffold_11
17,4289001,4710000,420999,False,142,scaffold_11
18,4712001,4766820,54819,True,142,scaffold_11
0,1,368000,367999,True,142,scaffold_12
1,403001,551000,147999,False,142,scaffold_12
2,579001,856000,276999,False,142,scaffold_12
3,865001,1468000,602999,False,142,scaffold_12
4,1719001,1733000,13999,False,142,scaffold_12
5,2571001,2617000,45999,False,142,scaffold_12
0,1,340000,339999,True,143,scaffold_1
1,482001,498000,15999,False,143,scaffold_1
2,571001,643000,71999,False,143,scaffold_1
3,686001,743000,56999,False,143,scaffold_1
4,1281001,1292000,10999,False,143,scaffold_1
5,1954001,1964000,9999,False,143,scaffold_1
6,1965001,1984000,18999,False,143,scaffold_1
7,2449001,2517000,67999,False,143,scaffold_1
8,2729001,2745000,15999,False,143,scaffold_1
9,3179001,3208000,28999,False,143,scaffold_1
10,3716001,3732000,15999,False,143,scaffold_1
11,3917001,3934000,16999,False,143,scaffold_1
12,4063001,4111000,47999,False,143,scaffold_1
13,4323001,4354000,30999,False,143,scaffold_1
14,4929001,4963000,33999,False,143,scaffold_1
15,4969001,4983000,13999,False,143,scaffold_1
16,5484001,5511000,26999,False,143,scaffold_1
17,6108001,6153000,44999,False,143,scaffold_1
18,6228001,6381000,152999,False,143,scaffold_1
19,6383001,6507000,123999,False,143,scaffold_1
20,6545001,6554000,8999,False,143,scaffold_1
21,7038001,7247000,208999,False,143,scaffold_1
22,7248001,7588000,339999,False,143,scaffold_1
23,7590001,8656000,1065999,False,143,scaffold_1
24,8658001,9584000,925999,False,143,scaffold_1
25,9586001,10354000,767999,False,143,scaffold_1
26,10461001,10630000,168999,False,143,scaffold_1
27,10808001,10811000,2999,False,143,scaffold_1
28,10839001,10857000,17999,False,143,scaffold_1
29,11352001,11504000,151999,False,143,scaffold_1
30,11615001,11951000,335999,False,143,scaffold_1
31,12184001,12204000,19999,False,143,scaffold_1
32,12670001,12722000,51999,False,143,scaffold_1
33,12777001,12888000,110999,False,143,scaffold_1
34,13114001,13134000,19999,False,143,scaffold_1
35,13181001,13211000,29999,False,143,scaffold_1
36,13347001,13377000,29999,False,143,scaffold_1
37,13901001,13903000,1999,False,143,scaffold_1
38,14605001,14610000,4999,False,143,scaffold_1
0,22001,48000,25999,False,143,scaffold_2
1,117001,159000,41999,False,143,scaffold_2
2,168001,177000,8999,False,143,scaffold_2
3,306001,318000,11999,False,143,scaffold_2
4,330001,374000,43999,False,143,scaffold_2
5,2336001,2358000,21999,False,143,scaffold_2
6,2406001,2423000,16999,False,143,scaffold_2
7,2441001,2553000,111999,False,143,scaffold_2
8,2660001,2689000,28999,False,143,scaffold_2
9,2694001,2746000,51999,False,143,scaffold_2
10,2868001,2897000,28999,False,143,scaffold_2
11,2997001,3009000,11999,False,143,scaffold_2
12,3454001,3463000,8999,False,143,scaffold_2
13,3767001,3781000,13999,False,143,scaffold_2
14,4385001,4409000,23999,False,143,scaffold_2
15,4429001,4456000,26999,False,143,scaffold_2
16,4524001,4553000,28999,False,143,scaffold_2
17,4607001,4653000,45999,False,143,scaffold_2
18,5022001,5031000,8999,False,143,scaffold_2
19,5033001,5061000,27999,False,143,scaffold_2
20,5491001,5511000,19999,False,143,scaffold_2
21,5670001,5704000,33999,False,143,scaffold_2
22,6261001,6330000,68999,False,143,scaffold_2
23,6331001,6350000,18999,False,143,scaffold_2
24,7439001,7472000,32999,False,143,scaffold_2
25,7563001,7697000,133999,False,143,scaffold_2
26,7786001,7890000,103999,False,143,scaffold_2
27,7934001,7967000,32999,False,143,scaffold_2
28,7978001,8151000,172999,False,143,scaffold_2
29,8331001,8333000,1999,False,143,scaffold_2
30,8340001,8344000,3999,False,143,scaffold_2
31,8346001,8389000,42999,False,143,scaffold_2
32,8509001,8535000,25999,False,143,scaffold_2
33,11367001,11373000,5999,False,143,scaffold_2
34,11520001,11786000,265999,False,143,scaffold_2
0,51001,55000,3999,False,143,scaffold_3
1,102001,104000,1999,False,143,scaffold_3
2,799001,900000,100999,False,143,scaffold_3
3,960001,964000,3999,False,143,scaffold_3
4,2084001,2108000,23999,False,143,scaffold_3
5,2291001,2321000,29999,False,143,scaffold_3
6,2493001,2533000,39999,False,143,scaffold_3
7,4149001,4403000,253999,False,143,scaffold_3
8,4410001,4518000,107999,False,143,scaffold_3
9,4547001,4558000,10999,False,143,scaffold_3
10,4653001,4679000,25999,False,143,scaffold_3
11,5990001,6018000,27999,False,143,scaffold_3
12,6911001,6962000,50999,False,143,scaffold_3
13,6980001,7083000,102999,False,143,scaffold_3
14,7525001,7556000,30999,False,143,scaffold_3
15,7693001,7711000,17999,False,143,scaffold_3
16,7822001,7838000,15999,False,143,scaffold_3
17,8177001,8255000,77999,False,143,scaffold_3
18,8462001,8527000,64999,False,143,scaffold_3
19,8575001,8594000,18999,False,143,scaffold_3
20,9968001,9993000,24999,False,143,scaffold_3
21,10461001,10483000,21999,False,143,scaffold_3
22,10587001,11165000,577999,False,143,scaffold_3
0,17001,32000,14999,False,143,scaffold_4
1,48001,88000,39999,False,143,scaffold_4
2,155001,160000,4999,False,143,scaffold_4
3,161001,215000,53999,False,143,scaffold_4
4,218001,226000,7999,False,143,scaffold_4
5,227001,266000,38999,False,143,scaffold_4
6,294001,311000,16999,False,143,scaffold_4
7,313001,344000,30999,False,143,scaffold_4
8,355001,374000,18999,False,143,scaffold_4
9,375001,380000,4999,False,143,scaffold_4
10,390001,410000,19999,False,143,scaffold_4
11,412001,425000,12999,False,143,scaffold_4
12,429001,498000,68999,False,143,scaffold_4
13,545001,592000,46999,False,143,scaffold_4
14,593001,599000,5999,False,143,scaffold_4
15,608001,691000,82999,False,143,scaffold_4
16,701001,713000,11999,False,143,scaffold_4
17,1121001,1136000,14999,False,143,scaffold_4
18,1137001,1178000,40999,False,143,scaffold_4
19,1199001,1208000,8999,False,143,scaffold_4
20,1210001,1226000,15999,False,143,scaffold_4
21,1254001,1262000,7999,False,143,scaffold_4
22,1265001,1279000,13999,False,143,scaffold_4
23,1283001,1336000,52999,False,143,scaffold_4
24,1372001,1591000,218999,False,143,scaffold_4
25,1749001,1817000,67999,False,143,scaffold_4
26,1850001,1863000,12999,False,143,scaffold_4
27,1905001,1957000,51999,False,143,scaffold_4
28,1958001,1979000,20999,False,143,scaffold_4
29,2211001,2218000,6999,False,143,scaffold_4
30,2247001,2279000,31999,False,143,scaffold_4
31,2284001,2339000,54999,False,143,scaffold_4
32,2480001,2533000,52999,False,143,scaffold_4
33,3336001,3632000,295999,False,143,scaffold_4
34,3676001,3759000,82999,False,143,scaffold_4
35,4944001,4984000,39999,False,143,scaffold_4
36,5477001,5506000,28999,False,143,scaffold_4
37,5514001,5620000,105999,False,143,scaffold_4
38,5665001,5784000,118999,False,143,scaffold_4
39,6145001,6190000,44999,False,143,scaffold_4
40,6804001,6817000,12999,False,143,scaffold_4
41,7037001,7062000,24999,False,143,scaffold_4
42,8846001,9699000,852999,False,143,scaffold_4
43,9703001,9845951,142950,True,143,scaffold_4
0,178001,180000,1999,False,143,scaffold_5
1,193001,204000,10999,False,143,scaffold_5
2,318001,326000,7999,False,143,scaffold_5
3,327001,368000,40999,False,143,scaffold_5
4,469001,480000,10999,False,143,scaffold_5
5,498001,523000,24999,False,143,scaffold_5
6,669001,680000,10999,False,143,scaffold_5
7,933001,947000,13999,False,143,scaffold_5
8,2565001,2581000,15999,False,143,scaffold_5
9,2620001,2738000,117999,False,143,scaffold_5
10,2816001,2871000,54999,False,143,scaffold_5
11,3138001,3185000,46999,False,143,scaffold_5
12,3322001,3438000,115999,False,143,scaffold_5
13,3451001,3497000,45999,False,143,scaffold_5
14,3964001,4101000,136999,False,143,scaffold_5
15,4121001,4219000,97999,False,143,scaffold_5
16,4246001,4262000,15999,False,143,scaffold_5
17,4446001,4488000,41999,False,143,scaffold_5
18,4601001,4680000,78999,False,143,scaffold_5
19,4691001,4717000,25999,False,143,scaffold_5
20,4789001,4810000,20999,False,143,scaffold_5
21,4811001,4861000,49999,False,143,scaffold_5
22,4904001,4917000,12999,False,143,scaffold_5
23,5314001,5346000,31999,False,143,scaffold_5
24,6547001,6562000,14999,False,143,scaffold_5
25,7097001,7100000,2999,False,143,scaffold_5
26,7373001,7386000,12999,False,143,scaffold_5
27,7583001,7608000,24999,False,143,scaffold_5
28,8730001,9363000,632999,False,143,scaffold_5
0,79001,84000,4999,False,143,scaffold_6
1,86001,112000,25999,False,143,scaffold_6
2,240001,254000,13999,False,143,scaffold_6
3,257001,262000,4999,False,143,scaffold_6
4,267001,278000,10999,False,143,scaffold_6
5,1238001,1256000,17999,False,143,scaffold_6
6,1479001,1546000,66999,False,143,scaffold_6
7,2023001,2086000,62999,False,143,scaffold_6
8,2130001,2169000,38999,False,143,scaffold_6
9,2369001,2595000,225999,False,143,scaffold_6
10,2596001,2653000,56999,False,143,scaffold_6
11,2660001,2691000,30999,False,143,scaffold_6
12,2731001,2851000,119999,False,143,scaffold_6
13,2928001,3014000,85999,False,143,scaffold_6
14,3114001,3149000,34999,False,143,scaffold_6
15,3224001,3301000,76999,False,143,scaffold_6
16,3407001,3428000,20999,False,143,scaffold_6
17,3461001,3767000,305999,False,143,scaffold_6
18,3901001,3912000,10999,False,143,scaffold_6
19,4018001,4065000,46999,False,143,scaffold_6
20,4086001,4192000,105999,False,143,scaffold_6
21,6011001,6060000,48999,False,143,scaffold_6
22,7283001,7336000,52999,False,143,scaffold_6
23,7562001,7795000,232999,False,143,scaffold_6
24,7811001,8268281,457280,True,143,scaffold_6
0,1,7000,6999,True,143,scaffold_7
1,13001,34000,20999,False,143,scaffold_7
2,169001,171000,1999,False,143,scaffold_7
3,323001,340000,16999,False,143,scaffold_7
4,342001,508000,165999,False,143,scaffold_7
5,571001,577000,5999,False,143,scaffold_7
6,706001,736000,29999,False,143,scaffold_7
7,741001,753000,11999,False,143,scaffold_7
8,764001,809000,44999,False,143,scaffold_7
9,859001,864000,4999,False,143,scaffold_7
10,964001,966000,1999,False,143,scaffold_7
11,982001,1044000,61999,False,143,scaffold_7
12,1048001,1098000,49999,False,143,scaffold_7
13,1203001,1512000,308999,False,143,scaffold_7
14,1588001,1688000,99999,False,143,scaffold_7
15,3326001,3369000,42999,False,143,scaffold_7
16,3596001,3649000,52999,False,143,scaffold_7
17,4418001,4535000,116999,False,143,scaffold_7
18,4658001,4682000,23999,False,143,scaffold_7
19,4981001,4998000,16999,False,143,scaffold_7
20,5001001,5020000,18999,False,143,scaffold_7
21,5077001,5111000,33999,False,143,scaffold_7
22,5609001,5625000,15999,False,143,scaffold_7
23,6955001,7502216,547215,True,143,scaffold_7
0,67001,85000,17999,False,143,scaffold_8
1,93001,102000,8999,False,143,scaffold_8
2,2652001,2683000,30999,False,143,scaffold_8
3,2742001,2757000,14999,False,143,scaffold_8
4,2812001,2844000,31999,False,143,scaffold_8
5,3058001,3125000,66999,False,143,scaffold_8
6,3126001,3525000,398999,False,143,scaffold_8
7,3584001,3612000,27999,False,143,scaffold_8
8,3615001,3913000,297999,False,143,scaffold_8
9,5122001,5135000,12999,False,143,scaffold_8
10,5200001,5241000,40999,False,143,scaffold_8
11,6330001,6334544,4543,True,143,scaffold_8
0,109001,117000,7999,False,143,scaffold_9
1,121001,138000,16999,False,143,scaffold_9
2,144001,148000,3999,False,143,scaffold_9
3,303001,315000,11999,False,143,scaffold_9
4,319001,332000,12999,False,143,scaffold_9
5,367001,411000,43999,False,143,scaffold_9
6,413001,434000,20999,False,143,scaffold_9
7,504001,531000,26999,False,143,scaffold_9
8,548001,560000,11999,False,143,scaffold_9
9,652001,664000,11999,False,143,scaffold_9
10,671001,697000,25999,False,143,scaffold_9
11,732001,742000,9999,False,143,scaffold_9
12,817001,843000,25999,False,143,scaffold_9
13,873001,986000,112999,False,143,scaffold_9
14,988001,995000,6999,False,143,scaffold_9
15,1001001,1007000,5999,False,143,scaffold_9
16,1009001,1031000,21999,False,143,scaffold_9
17,1035001,1083000,47999,False,143,scaffold_9
18,1087001,1150000,62999,False,143,scaffold_9
19,1151001,1164000,12999,False,143,scaffold_9
20,1312001,1377000,64999,False,143,scaffold_9
21,1770001,1781000,10999,False,143,scaffold_9
22,2601001,2616000,14999,False,143,scaffold_9
23,2872001,3381000,508999,False,143,scaffold_9
24,3383001,5107000,1723999,False,143,scaffold_9
25,5112001,5115000,2999,False,143,scaffold_9
26,5116001,5237000,120999,False,143,scaffold_9
27,5239001,5298000,58999,False,143,scaffold_9
28,5300001,6331288,1031287,True,143,scaffold_9
0,1,197000,196999,True,143,scaffold_10
1,375001,414000,38999,False,143,scaffold_10
2,472001,482000,9999,False,143,scaffold_10
3,483001,576000,92999,False,143,scaffold_10
4,603001,751000,147999,False,143,scaffold_10
5,888001,917000,28999,False,143,scaffold_10
6,923001,962000,38999,False,143,scaffold_10
7,1087001,1112000,24999,False,143,scaffold_10
8,2346001,2366000,19999,False,143,scaffold_10
9,4002001,4010000,7999,False,143,scaffold_10
10,4055001,4090000,34999,False,143,scaffold_10
11,4154001,4174000,19999,False,143,scaffold_10
12,4506001,4513000,6999,False,143,scaffold_10
13,4515001,4523000,7999,False,143,scaffold_10
14,4526001,4548000,21999,False,143,scaffold_10
15,4576001,4596000,19999,False,143,scaffold_10
16,4680001,4688000,7999,False,143,scaffold_10
17,4734001,4751000,16999,False,143,scaffold_10
18,4752001,4766000,13999,False,143,scaffold_10
19,4768001,4776000,7999,False,143,scaffold_10
20,4798001,4824000,25999,False,143,scaffold_10
21,4827001,4843000,15999,False,143,scaffold_10
22,4848001,4861000,12999,False,143,scaffold_10
23,4865001,4866973,1972,True,143,scaffold_10
0,10001,34000,23999,False,143,scaffold_11
1,39001,93000,53999,False,143,scaffold_11
2,149001,167000,17999,False,143,scaffold_11
3,169001,189000,19999,False,143,scaffold_11
4,213001,235000,21999,False,143,scaffold_11
5,240001,247000,6999,False,143,scaffold_11
6,419001,431000,11999,False,143,scaffold_11
7,648001,656000,7999,False,143,scaffold_11
8,992001,994000,1999,False,143,scaffold_11
9,1025001,1034000,8999,False,143,scaffold_11
10,1423001,1427000,3999,False,143,scaffold_11
11,2701001,2873000,171999,False,143,scaffold_11
12,3212001,3259000,46999,False,143,scaffold_11
13,3331001,3365000,33999,False,143,scaffold_11
14,3702001,3927000,224999,False,143,scaffold_11
15,4321001,4710000,388999,False,143,scaffold_11
16,4713001,4766820,53819,True,143,scaffold_11
0,1,241000,240999,True,143,scaffold_12
1,250001,369000,118999,False,143,scaffold_12
2,474001,537000,62999,False,143,scaffold_12
3,582001,856000,273999,False,143,scaffold_12
4,865001,1354000,488999,False,143,scaffold_12
5,1720001,1733000,12999,False,143,scaffold_12
6,2559001,2566000,6999,False,143,scaffold_12
7,2571001,2609000,37999,False,143,scaffold_12
8,2747001,2747968,967,True,143,scaffold_12
0,1,342000,341999,True,144,scaffold_1
1,482001,498000,15999,False,144,scaffold_1
2,571001,643000,71999,False,144,scaffold_1
3,686001,759000,72999,False,144,scaffold_1
4,1281001,1292000,10999,False,144,scaffold_1
5,1615001,1660000,44999,False,144,scaffold_1
6,1814001,1898000,83999,False,144,scaffold_1
7,1954001,1964000,9999,False,144,scaffold_1
8,1965001,1984000,18999,False,144,scaffold_1
9,2449001,2517000,67999,False,144,scaffold_1
10,2569001,2579000,9999,False,144,scaffold_1
11,2729001,2746000,16999,False,144,scaffold_1
12,3172001,3209000,36999,False,144,scaffold_1
13,3714001,3739000,24999,False,144,scaffold_1
14,3917001,3934000,16999,False,144,scaffold_1
15,4062001,4112000,49999,False,144,scaffold_1
16,4315001,4354000,38999,False,144,scaffold_1
17,4927001,5009000,81999,False,144,scaffold_1
18,5483001,5511000,27999,False,144,scaffold_1
19,5536001,5570000,33999,False,144,scaffold_1
20,6108001,6153000,44999,False,144,scaffold_1
21,6228001,6507000,278999,False,144,scaffold_1
22,6544001,6554000,9999,False,144,scaffold_1
23,7038001,7247000,208999,False,144,scaffold_1
24,7248001,7588000,339999,False,144,scaffold_1
25,7590001,8477000,886999,False,144,scaffold_1
26,8478001,8656000,177999,False,144,scaffold_1
27,8658001,9584000,925999,False,144,scaffold_1
28,9586001,10356000,769999,False,144,scaffold_1
29,10461001,10622000,160999,False,144,scaffold_1
30,10840001,10856000,15999,False,144,scaffold_1
31,11276001,11504000,227999,False,144,scaffold_1
32,11563001,11575000,11999,False,144,scaffold_1
33,11609001,11951000,341999,False,144,scaffold_1
34,12184001,12204000,19999,False,144,scaffold_1
35,12652001,12722000,69999,False,144,scaffold_1
36,12777001,12889000,111999,False,144,scaffold_1
37,13113001,13211000,97999,False,144,scaffold_1
38,13347001,13431000,83999,False,144,scaffold_1
39,14285001,14308000,22999,False,144,scaffold_1
0,21001,48000,26999,False,144,scaffold_2
1,95001,159000,63999,False,144,scaffold_2
2,168001,177000,8999,False,144,scaffold_2
3,303001,318000,14999,False,144,scaffold_2
4,331001,374000,42999,False,144,scaffold_2
5,2336001,2358000,21999,False,144,scaffold_2
6,2410001,2415000,4999,False,144,scaffold_2
7,2416001,2421000,4999,False,144,scaffold_2
8,2440001,2600000,159999,False,144,scaffold_2
9,2660001,2689000,28999,False,144,scaffold_2
10,2694001,2742000,47999,False,144,scaffold_2
11,2780001,2788000,7999,False,144,scaffold_2
12,2868001,2900000,31999,False,144,scaffold_2
13,3333001,3344000,10999,False,144,scaffold_2
14,3451001,3466000,14999,False,144,scaffold_2
15,3767001,3782000,14999,False,144,scaffold_2
16,4385001,4409000,23999,False,144,scaffold_2
17,4429001,4456000,26999,False,144,scaffold_2
18,4520001,4556000,35999,False,144,scaffold_2
19,4591001,4657000,65999,False,144,scaffold_2
20,4919001,4936000,16999,False,144,scaffold_2
21,5021001,5031000,9999,False,144,scaffold_2
22,5033001,5061000,27999,False,144,scaffold_2
23,5358001,5393000,34999,False,144,scaffold_2
24,5491001,5512000,20999,False,144,scaffold_2
25,5667001,5757000,89999,False,144,scaffold_2
26,6261001,6330000,68999,False,144,scaffold_2
27,6331001,6342000,10999,False,144,scaffold_2
28,6429001,6449000,19999,False,144,scaffold_2
29,7018001,7036000,17999,False,144,scaffold_2
30,7439001,7472000,32999,False,144,scaffold_2
31,7563001,7697000,133999,False,144,scaffold_2
32,7786001,7891000,104999,False,144,scaffold_2
33,7934001,8160000,225999,False,144,scaffold_2
34,8331001,8333000,1999,False,144,scaffold_2
35,8346001,8396000,49999,False,144,scaffold_2
36,8415001,8453000,37999,False,144,scaffold_2
37,8509001,8563000,53999,False,144,scaffold_2
38,9140001,9175000,34999,False,144,scaffold_2
39,11367001,11377000,9999,False,144,scaffold_2
40,11520001,11785000,264999,False,144,scaffold_2
0,1,2000,1999,True,144,scaffold_3
1,51001,55000,3999,False,144,scaffold_3
2,102001,104000,1999,False,144,scaffold_3
3,618001,646000,27999,False,144,scaffold_3
4,799001,900000,100999,False,144,scaffold_3
5,2041001,2108000,66999,False,144,scaffold_3
6,2291001,2334000,42999,False,144,scaffold_3
7,2487001,2533000,45999,False,144,scaffold_3
8,3764001,3889000,124999,False,144,scaffold_3
9,4097001,4398000,300999,False,144,scaffold_3
10,4418001,4518000,99999,False,144,scaffold_3
11,4547001,4558000,10999,False,144,scaffold_3
12,4652001,4679000,26999,False,144,scaffold_3
13,5990001,6020000,29999,False,144,scaffold_3
14,6910001,6962000,51999,False,144,scaffold_3
15,6979001,7090000,110999,False,144,scaffold_3
16,7522001,7556000,33999,False,144,scaffold_3
17,7692001,7799000,106999,False,144,scaffold_3
18,7818001,7855000,36999,False,144,scaffold_3
19,8176001,8253000,76999,False,144,scaffold_3
20,8462001,8527000,64999,False,144,scaffold_3
21,8575001,8594000,18999,False,144,scaffold_3
22,9060001,9073000,12999,False,144,scaffold_3
23,9968001,9995000,26999,False,144,scaffold_3
24,10461001,10484000,22999,False,144,scaffold_3
25,10587001,11167000,579999,False,144,scaffold_3
0,17001,32000,14999,False,144,scaffold_4
1,48001,88000,39999,False,144,scaffold_4
2,132001,146000,13999,False,144,scaffold_4
3,147001,151000,3999,False,144,scaffold_4
4,155001,215000,59999,False,144,scaffold_4
5,217001,226000,8999,False,144,scaffold_4
6,227001,266000,38999,False,144,scaffold_4
7,318001,344000,25999,False,144,scaffold_4
8,355001,374000,18999,False,144,scaffold_4
9,375001,380000,4999,False,144,scaffold_4
10,390001,410000,19999,False,144,scaffold_4
11,411001,425000,13999,False,144,scaffold_4
12,429001,446000,16999,False,144,scaffold_4
13,449001,502000,52999,False,144,scaffold_4
14,542001,592000,49999,False,144,scaffold_4
15,608001,691000,82999,False,144,scaffold_4
16,701001,714000,12999,False,144,scaffold_4
17,1113001,1136000,22999,False,144,scaffold_4
18,1138001,1178000,39999,False,144,scaffold_4
19,1199001,1226000,26999,False,144,scaffold_4
20,1235001,1253000,17999,False,144,scaffold_4
21,1283001,1320000,36999,False,144,scaffold_4
22,1372001,1595000,222999,False,144,scaffold_4
23,1613001,1698000,84999,False,144,scaffold_4
24,1722001,1957000,234999,False,144,scaffold_4
25,1958001,2117000,158999,False,144,scaffold_4
26,2119001,2127000,7999,False,144,scaffold_4
27,2162001,2185000,22999,False,144,scaffold_4
28,2219001,2268000,48999,False,144,scaffold_4
29,2269001,2279000,9999,False,144,scaffold_4
30,2284001,2310000,25999,False,144,scaffold_4
31,2312001,2340000,27999,False,144,scaffold_4
32,2393001,2445000,51999,False,144,scaffold_4
33,2447001,2461000,13999,False,144,scaffold_4
34,2480001,2635000,154999,False,144,scaffold_4
35,3336001,3633000,296999,False,144,scaffold_4
36,3646001,3760000,113999,False,144,scaffold_4
37,4943001,5000000,56999,False,144,scaffold_4
38,5171001,5223000,51999,False,144,scaffold_4
39,5476001,5506000,29999,False,144,scaffold_4
40,5514001,5620000,105999,False,144,scaffold_4
41,5661001,5784000,122999,False,144,scaffold_4
42,5786001,5818000,31999,False,144,scaffold_4
43,6145001,6193000,47999,False,144,scaffold_4
44,6768001,6817000,48999,False,144,scaffold_4
45,6902001,6924000,21999,False,144,scaffold_4
46,6969001,6995000,25999,False,144,scaffold_4
47,7036001,7075000,38999,False,144,scaffold_4
48,8845001,9699000,853999,False,144,scaffold_4
49,9700001,9845951,145950,True,144,scaffold_4
0,1,4000,3999,True,144,scaffold_5
1,190001,204000,13999,False,144,scaffold_5
2,321001,326000,4999,False,144,scaffold_5
3,327001,382000,54999,False,144,scaffold_5
4,463001,523000,59999,False,144,scaffold_5
5,933001,947000,13999,False,144,scaffold_5
6,2475001,2494000,18999,False,144,scaffold_5
7,2510001,2515000,4999,False,144,scaffold_5
8,2564001,2582000,17999,False,144,scaffold_5
9,2619001,2734000,114999,False,144,scaffold_5
10,2813001,2871000,57999,False,144,scaffold_5
11,3133001,3186000,52999,False,144,scaffold_5
12,3216001,3259000,42999,False,144,scaffold_5
13,3310001,3509000,198999,False,144,scaffold_5
14,3962001,4101000,138999,False,144,scaffold_5
15,4121001,4219000,97999,False,144,scaffold_5
16,4233001,4262000,28999,False,144,scaffold_5
17,4446001,4494000,47999,False,144,scaffold_5
18,4601001,4681000,79999,False,144,scaffold_5
19,4691001,4861000,169999,False,144,scaffold_5
20,4904001,4921000,16999,False,144,scaffold_5
21,5259001,5274000,14999,False,144,scaffold_5
22,5318001,5344000,25999,False,144,scaffold_5
23,6409001,6420000,10999,False,144,scaffold_5
24,6479001,6653000,173999,False,144,scaffold_5
25,7372001,7386000,13999,False,144,scaffold_5
26,7580001,7619000,38999,False,144,scaffold_5
27,7622001,7656000,33999,False,144,scaffold_5
28,8659001,8689000,29999,False,144,scaffold_5
29,8713001,9364176,651175,True,144,scaffold_5
0,79001,85000,5999,False,144,scaffold_6
1,86001,114000,27999,False,144,scaffold_6
2,240001,254000,13999,False,144,scaffold_6
3,1229001,1257000,27999,False,144,scaffold_6
4,1479001,1546000,66999,False,144,scaffold_6
5,1565001,1588000,22999,False,144,scaffold_6
6,1843001,1906000,62999,False,144,scaffold_6
7,2023001,2088000,64999,False,144,scaffold_6
8,2128001,2195000,66999,False,144,scaffold_6
9,2336001,2595000,258999,False,144,scaffold_6
10,2596001,2691000,94999,False,144,scaffold_6
11,2712001,2852000,139999,False,144,scaffold_6
12,2934001,3015000,80999,False,144,scaffold_6
13,3115001,3177000,61999,False,144,scaffold_6
14,3223001,3301000,77999,False,144,scaffold_6
15,3407001,3428000,20999,False,144,scaffold_6
16,3461001,3766000,304999,False,144,scaffold_6
17,3900001,3912000,11999,False,144,scaffold_6
18,4018001,4072000,53999,False,144,scaffold_6
19,4073001,4193000,119999,False,144,scaffold_6
20,6010001,6060000,49999,False,144,scaffold_6
21,7263001,7337000,73999,False,144,scaffold_6
22,7392001,7436000,43999,False,144,scaffold_6
23,7550001,7795000,244999,False,144,scaffold_6
24,7811001,8268281,457280,True,144,scaffold_6
0,1,7000,6999,True,144,scaffold_7
1,13001,34000,20999,False,144,scaffold_7
2,323001,340000,16999,False,144,scaffold_7
3,342001,508000,165999,False,144,scaffold_7
4,554001,563000,8999,False,144,scaffold_7
5,571001,577000,5999,False,144,scaffold_7
6,706001,724000,17999,False,144,scaffold_7
7,725001,736000,10999,False,144,scaffold_7
8,764001,809000,44999,False,144,scaffold_7
9,859001,864000,4999,False,144,scaffold_7
10,964001,966000,1999,False,144,scaffold_7
11,968001,980000,11999,False,144,scaffold_7
12,982001,1044000,61999,False,144,scaffold_7
13,1048001,1080000,31999,False,144,scaffold_7
14,1191001,1512000,320999,False,144,scaffold_7
15,1588001,1695000,106999,False,144,scaffold_7
16,3326001,3369000,42999,False,144,scaffold_7
17,3593001,3649000,55999,False,144,scaffold_7
18,4415001,4535000,119999,False,144,scaffold_7
19,4658001,4733000,74999,False,144,scaffold_7
20,4979001,5149000,169999,False,144,scaffold_7
21,5482001,5536000,53999,False,144,scaffold_7
22,5609001,5647000,37999,False,144,scaffold_7
23,6954001,7270000,315999,False,144,scaffold_7
24,7271001,7502216,231215,True,144,scaffold_7
0,67001,85000,17999,False,144,scaffold_8
1,2443001,2471000,27999,False,144,scaffold_8
2,2491001,2525000,33999,False,144,scaffold_8
3,2650001,2683000,32999,False,144,scaffold_8
4,2740001,2757000,16999,False,144,scaffold_8
5,2808001,2844000,35999,False,144,scaffold_8
6,3058001,3525000,466999,False,144,scaffold_8
7,3580001,3612000,31999,False,144,scaffold_8
8,3615001,3939000,323999,False,144,scaffold_8
9,4039001,4106000,66999,False,144,scaffold_8
10,4401001,4426000,24999,False,144,scaffold_8
11,5088001,5136000,47999,False,144,scaffold_8
12,5182001,5241000,58999,False,144,scaffold_8
13,6319001,6334544,15543,True,144,scaffold_8
0,109001,117000,7999,False,144,scaffold_9
1,319001,331000,11999,False,144,scaffold_9
2,367001,411000,43999,False,144,scaffold_9
3,413001,434000,20999,False,144,scaffold_9
4,504001,531000,26999,False,144,scaffold_9
5,670001,696000,25999,False,144,scaffold_9
6,732001,742000,9999,False,144,scaffold_9
7,793001,803000,9999,False,144,scaffold_9
8,815001,842000,26999,False,144,scaffold_9
9,873001,986000,112999,False,144,scaffold_9
10,988001,995000,6999,False,144,scaffold_9
11,1001001,1007000,5999,False,144,scaffold_9
12,1009001,1031000,21999,False,144,scaffold_9
13,1035001,1085000,49999,False,144,scaffold_9
14,1087001,1150000,62999,False,144,scaffold_9
15,1151001,1160000,8999,False,144,scaffold_9
16,1313001,1377000,63999,False,144,scaffold_9
17,1428001,1435000,6999,False,144,scaffold_9
18,1764001,1791000,26999,False,144,scaffold_9
19,1970001,1978000,7999,False,144,scaffold_9
20,1987001,2057000,69999,False,144,scaffold_9
21,2594001,2616000,21999,False,144,scaffold_9
22,2782001,2823000,40999,False,144,scaffold_9
23,2870001,3381000,510999,False,144,scaffold_9
24,3383001,5107000,1723999,False,144,scaffold_9
25,5112001,5238000,125999,False,144,scaffold_9
26,5239001,5298000,58999,False,144,scaffold_9
27,5299001,6331288,1032287,True,144,scaffold_9
0,1,235000,234999,True,144,scaffold_10
1,279001,414000,134999,False,144,scaffold_10
2,415001,482000,66999,False,144,scaffold_10
3,483001,581000,97999,False,144,scaffold_10
4,603001,749000,145999,False,144,scaffold_10
5,888001,917000,28999,False,144,scaffold_10
6,923001,962000,38999,False,144,scaffold_10
7,1073001,1112000,38999,False,144,scaffold_10
8,2140001,2170000,29999,False,144,scaffold_10
9,2269001,2295000,25999,False,144,scaffold_10
10,2346001,2368000,21999,False,144,scaffold_10
11,2601001,2621000,19999,False,144,scaffold_10
12,4054001,4091000,36999,False,144,scaffold_10
13,4154001,4174000,19999,False,144,scaffold_10
14,4443001,4462000,18999,False,144,scaffold_10
15,4467001,4477000,9999,False,144,scaffold_10
16,4515001,4523000,7999,False,144,scaffold_10
17,4526001,4548000,21999,False,144,scaffold_10
18,4575001,4596000,20999,False,144,scaffold_10
19,4680001,4688000,7999,False,144,scaffold_10
20,4735001,4766000,30999,False,144,scaffold_10
21,4798001,4824000,25999,False,144,scaffold_10
22,4828001,4843000,14999,False,144,scaffold_10
23,4848001,4861000,12999,False,144,scaffold_10
24,4865001,4866973,1972,True,144,scaffold_10
0,11001,93000,81999,False,144,scaffold_11
1,149001,167000,17999,False,144,scaffold_11
2,169001,193000,23999,False,144,scaffold_11
3,213001,235000,21999,False,144,scaffold_11
4,240001,248000,7999,False,144,scaffold_11
5,419001,431000,11999,False,144,scaffold_11
6,648001,656000,7999,False,144,scaffold_11
7,1025001,1034000,8999,False,144,scaffold_11
8,1404001,1409000,4999,False,144,scaffold_11
9,1423001,1427000,3999,False,144,scaffold_11
10,1474001,1478000,3999,False,144,scaffold_11
11,2701001,2877000,175999,False,144,scaffold_11
12,2978001,3018000,39999,False,144,scaffold_11
13,3095001,3122000,26999,False,144,scaffold_11
14,3188001,3289000,100999,False,144,scaffold_11
15,3328001,3383000,54999,False,144,scaffold_11
16,3521001,3634000,112999,False,144,scaffold_11
17,3702001,3933000,230999,False,144,scaffold_11
18,4005001,4159000,153999,False,144,scaffold_11
19,4224001,4710000,485999,False,144,scaffold_11
20,4713001,4766820,53819,True,144,scaffold_11
0,1,370000,369999,True,144,scaffold_12
1,403001,551000,147999,False,144,scaffold_12
2,581001,1469000,887999,False,144,scaffold_12
3,1720001,1733000,12999,False,144,scaffold_12
4,2571001,2619000,47999,False,144,scaffold_12
0,1,342000,341999,True,145,scaffold_1
1,482001,498000,15999,False,145,scaffold_1
2,571001,643000,71999,False,145,scaffold_1
3,686001,715000,28999,False,145,scaffold_1
4,726001,743000,16999,False,145,scaffold_1
5,1281001,1292000,10999,False,145,scaffold_1
6,1827001,1899000,71999,False,145,scaffold_1
7,1954001,1964000,9999,False,145,scaffold_1
8,1965001,1984000,18999,False,145,scaffold_1
9,2449001,2517000,67999,False,145,scaffold_1
10,2729001,2746000,16999,False,145,scaffold_1
11,3180001,3209000,28999,False,145,scaffold_1
12,3714001,3734000,19999,False,145,scaffold_1
13,3912001,3941000,28999,False,145,scaffold_1
14,4063001,4112000,48999,False,145,scaffold_1
15,4314001,4354000,39999,False,145,scaffold_1
16,4927001,4997000,69999,False,145,scaffold_1
17,5484001,5511000,26999,False,145,scaffold_1
18,5537001,5569000,31999,False,145,scaffold_1
19,6108001,6153000,44999,False,145,scaffold_1
20,6228001,6381000,152999,False,145,scaffold_1
21,6384001,6508000,123999,False,145,scaffold_1
22,6545001,6554000,8999,False,145,scaffold_1
23,7038001,7247000,208999,False,145,scaffold_1
24,7248001,7589000,340999,False,145,scaffold_1
25,7590001,8656000,1065999,False,145,scaffold_1
26,8658001,9584000,925999,False,145,scaffold_1
27,9586001,10355000,768999,False,145,scaffold_1
28,10461001,10636000,174999,False,145,scaffold_1
29,10808001,10811000,2999,False,145,scaffold_1
30,10840001,10856000,15999,False,145,scaffold_1
31,11351001,11509000,157999,False,145,scaffold_1
32,11646001,11963000,316999,False,145,scaffold_1
33,12184001,12204000,19999,False,145,scaffold_1
34,12666001,12722000,55999,False,145,scaffold_1
35,12777001,12888000,110999,False,145,scaffold_1
36,13113001,13136000,22999,False,145,scaffold_1
37,13178001,13216000,37999,False,145,scaffold_1
38,13347001,13404000,56999,False,145,scaffold_1
39,14007001,14009000,1999,False,145,scaffold_1
40,14291001,14307000,15999,False,145,scaffold_1
41,14605001,14609000,3999,False,145,scaffold_1
0,1,48000,47999,True,145,scaffold_2
1,93001,159000,65999,False,145,scaffold_2
2,168001,177000,8999,False,145,scaffold_2
3,332001,374000,41999,False,145,scaffold_2
4,2336001,2358000,21999,False,145,scaffold_2
5,2404001,2424000,19999,False,145,scaffold_2
6,2437001,2553000,115999,False,145,scaffold_2
7,2660001,2689000,28999,False,145,scaffold_2
8,2694001,2742000,47999,False,145,scaffold_2
9,2868001,2899000,30999,False,145,scaffold_2
10,2993001,3012000,18999,False,145,scaffold_2
11,3174001,3186000,11999,False,145,scaffold_2
12,3452001,3465000,12999,False,145,scaffold_2
13,3761001,3783000,21999,False,145,scaffold_2
14,4385001,4409000,23999,False,145,scaffold_2
15,4426001,4457000,30999,False,145,scaffold_2
16,4521001,4554000,32999,False,145,scaffold_2
17,4604001,4654000,49999,False,145,scaffold_2
18,4783001,4790000,6999,False,145,scaffold_2
19,4793001,4798000,4999,False,145,scaffold_2
20,4918001,4938000,19999,False,145,scaffold_2
21,5022001,5061000,38999,False,145,scaffold_2
22,5491001,5511000,19999,False,145,scaffold_2
23,5658001,5704000,45999,False,145,scaffold_2
24,6261001,6330000,68999,False,145,scaffold_2
25,6331001,6342000,10999,False,145,scaffold_2
26,6428001,6449000,20999,False,145,scaffold_2
27,7439001,7473000,33999,False,145,scaffold_2
28,7563001,7697000,133999,False,145,scaffold_2
29,7786001,7891000,104999,False,145,scaffold_2
30,7934001,8136000,201999,False,145,scaffold_2
31,8331001,8333000,1999,False,145,scaffold_2
32,8346001,8403000,56999,False,145,scaffold_2
33,8414001,8453000,38999,False,145,scaffold_2
34,8509001,8535000,25999,False,145,scaffold_2
35,10995001,10998000,2999,False,145,scaffold_2
36,11367001,11373000,5999,False,145,scaffold_2
37,11520001,11786000,265999,False,145,scaffold_2
0,1,2000,1999,True,145,scaffold_3
1,51001,55000,3999,False,145,scaffold_3
2,102001,104000,1999,False,145,scaffold_3
3,618001,646000,27999,False,145,scaffold_3
4,799001,900000,100999,False,145,scaffold_3
5,2085001,2108000,22999,False,145,scaffold_3
6,2290001,2321000,30999,False,145,scaffold_3
7,2489001,2533000,43999,False,145,scaffold_3
8,3768001,3821000,52999,False,145,scaffold_3
9,3822001,3892000,69999,False,145,scaffold_3
10,4105001,4397000,291999,False,145,scaffold_3
11,4418001,4518000,99999,False,145,scaffold_3
12,4547001,4558000,10999,False,145,scaffold_3
13,4642001,4686000,43999,False,145,scaffold_3
14,5494001,5509000,14999,False,145,scaffold_3
15,6910001,6962000,51999,False,145,scaffold_3
16,6979001,7081000,101999,False,145,scaffold_3
17,7524001,7556000,31999,False,145,scaffold_3
18,7692001,7798000,105999,False,145,scaffold_3
19,7821001,7840000,18999,False,145,scaffold_3
20,8177001,8255000,77999,False,145,scaffold_3
21,8462001,8528000,65999,False,145,scaffold_3
22,8575001,8594000,18999,False,145,scaffold_3
23,9968001,9996000,27999,False,145,scaffold_3
24,10587001,11165000,577999,False,145,scaffold_3
0,17001,32000,14999,False,145,scaffold_4
1,48001,88000,39999,False,145,scaffold_4
2,121001,146000,24999,False,145,scaffold_4
3,147001,151000,3999,False,145,scaffold_4
4,155001,215000,59999,False,145,scaffold_4
5,217001,226000,8999,False,145,scaffold_4
6,227001,266000,38999,False,145,scaffold_4
7,291001,310000,18999,False,145,scaffold_4
8,313001,344000,30999,False,145,scaffold_4
9,355001,374000,18999,False,145,scaffold_4
10,375001,380000,4999,False,145,scaffold_4
11,412001,425000,12999,False,145,scaffold_4
12,429001,502000,72999,False,145,scaffold_4
13,542001,592000,49999,False,145,scaffold_4
14,593001,599000,5999,False,145,scaffold_4
15,608001,691000,82999,False,145,scaffold_4
16,701001,716000,14999,False,145,scaffold_4
17,1121001,1136000,14999,False,145,scaffold_4
18,1138001,1198000,59999,False,145,scaffold_4
19,1199001,1226000,26999,False,145,scaffold_4
20,1265001,1279000,13999,False,145,scaffold_4
21,1284001,1315000,30999,False,145,scaffold_4
22,1360001,1597000,236999,False,145,scaffold_4
23,1613001,1690000,76999,False,145,scaffold_4
24,1749001,1849000,99999,False,145,scaffold_4
25,1850001,1868000,17999,False,145,scaffold_4
26,1904001,1957000,52999,False,145,scaffold_4
27,1958001,1997000,38999,False,145,scaffold_4
28,2030001,2065000,34999,False,145,scaffold_4
29,2211001,2246000,34999,False,145,scaffold_4
30,2269001,2280000,10999,False,145,scaffold_4
31,2284001,2310000,25999,False,145,scaffold_4
32,2312001,2340000,27999,False,145,scaffold_4
33,2480001,2567000,86999,False,145,scaffold_4
34,3336001,3633000,296999,False,145,scaffold_4
35,3645001,3760000,114999,False,145,scaffold_4
36,4944001,4985000,40999,False,145,scaffold_4
37,5477001,5506000,28999,False,145,scaffold_4
38,5514001,5620000,105999,False,145,scaffold_4
39,5665001,5784000,118999,False,145,scaffold_4
40,6805001,6817000,11999,False,145,scaffold_4
41,7036001,7075000,38999,False,145,scaffold_4
42,8846001,9699000,852999,False,145,scaffold_4
43,9700001,9845951,145950,True,145,scaffold_4
0,1,4000,3999,True,145,scaffold_5
1,191001,204000,12999,False,145,scaffold_5
2,296001,300000,3999,False,145,scaffold_5
3,318001,326000,7999,False,145,scaffold_5
4,327001,401000,73999,False,145,scaffold_5
5,402001,409000,6999,False,145,scaffold_5
6,462001,523000,60999,False,145,scaffold_5
7,933001,947000,13999,False,145,scaffold_5
8,2552001,2582000,29999,False,145,scaffold_5
9,2624001,2738000,113999,False,145,scaffold_5
10,2813001,2871000,57999,False,145,scaffold_5
11,3137001,3185000,47999,False,145,scaffold_5
12,3322001,3438000,115999,False,145,scaffold_5
13,3451001,3497000,45999,False,145,scaffold_5
14,3962001,4101000,138999,False,145,scaffold_5
15,4121001,4220000,98999,False,145,scaffold_5
16,4246001,4262000,15999,False,145,scaffold_5
17,4446001,4484000,37999,False,145,scaffold_5
18,4601001,4657000,55999,False,145,scaffold_5
19,4691001,4717000,25999,False,145,scaffold_5
20,4761001,4861000,99999,False,145,scaffold_5
21,4892001,4918000,25999,False,145,scaffold_5
22,5318001,5344000,25999,False,145,scaffold_5
23,6509001,6600000,90999,False,145,scaffold_5
24,7373001,7387000,13999,False,145,scaffold_5
25,7454001,7480000,25999,False,145,scaffold_5
26,7571001,7619000,47999,False,145,scaffold_5
27,7622001,7637000,14999,False,145,scaffold_5
28,8258001,8263000,4999,False,145,scaffold_5
29,8726001,9363000,636999,False,145,scaffold_5
0,79001,84000,4999,False,145,scaffold_6
1,86001,112000,25999,False,145,scaffold_6
2,240001,253000,12999,False,145,scaffold_6
3,267001,278000,10999,False,145,scaffold_6
4,1238001,1255000,16999,False,145,scaffold_6
5,1479001,1547000,67999,False,145,scaffold_6
6,2023001,2087000,63999,False,145,scaffold_6
7,2129001,2191000,61999,False,145,scaffold_6
8,2350001,2595000,244999,False,145,scaffold_6
9,2596001,2653000,56999,False,145,scaffold_6
10,2657001,2691000,33999,False,145,scaffold_6
11,2713001,2851000,137999,False,145,scaffold_6
12,2936001,3015000,78999,False,145,scaffold_6
13,3116001,3149000,32999,False,145,scaffold_6
14,3223001,3303000,79999,False,145,scaffold_6
15,3406001,3430000,23999,False,145,scaffold_6
16,3461001,3786000,324999,False,145,scaffold_6
17,3901001,3912000,10999,False,145,scaffold_6
18,4021001,4033000,11999,False,145,scaffold_6
19,4081001,4193000,111999,False,145,scaffold_6
20,6010001,6062000,51999,False,145,scaffold_6
21,7282001,7339000,56999,False,145,scaffold_6
22,7560001,7796000,235999,False,145,scaffold_6
23,7811001,8268281,457280,True,145,scaffold_6
0,1,7000,6999,True,145,scaffold_7
1,13001,31000,17999,False,145,scaffold_7
2,169001,171000,1999,False,145,scaffold_7
3,323001,340000,16999,False,145,scaffold_7
4,342001,505000,162999,False,145,scaffold_7
5,553001,563000,9999,False,145,scaffold_7
6,571001,577000,5999,False,145,scaffold_7
7,657001,672000,14999,False,145,scaffold_7
8,706001,736000,29999,False,145,scaffold_7
9,764001,827000,62999,False,145,scaffold_7
10,859001,864000,4999,False,145,scaffold_7
11,964001,966000,1999,False,145,scaffold_7
12,968001,980000,11999,False,145,scaffold_7
13,982001,1044000,61999,False,145,scaffold_7
14,1048001,1100000,51999,False,145,scaffold_7
15,1191001,1460000,268999,False,145,scaffold_7
16,1461001,1512000,50999,False,145,scaffold_7
17,1588001,1688000,99999,False,145,scaffold_7
18,3326001,3371000,44999,False,145,scaffold_7
19,3595001,3767000,171999,False,145,scaffold_7
20,4415001,4535000,119999,False,145,scaffold_7
21,4658001,4734000,75999,False,145,scaffold_7
22,4979001,5149000,169999,False,145,scaffold_7
23,5484001,5534000,49999,False,145,scaffold_7
24,5609001,5626000,16999,False,145,scaffold_7
25,6955001,7502216,547215,True,145,scaffold_7
0,66001,85000,18999,False,145,scaffold_8
1,93001,101000,7999,False,145,scaffold_8
2,2444001,2527000,82999,False,145,scaffold_8
3,2539001,2548000,8999,False,145,scaffold_8
4,2652001,2683000,30999,False,145,scaffold_8
5,2745001,2756000,10999,False,145,scaffold_8
6,2798001,2844000,45999,False,145,scaffold_8
7,3060001,3125000,64999,False,145,scaffold_8
8,3126001,3525000,398999,False,145,scaffold_8
9,3584001,3612000,27999,False,145,scaffold_8
10,3615001,3913000,297999,False,145,scaffold_8
11,5126001,5133000,6999,False,145,scaffold_8
12,5199001,5241000,41999,False,145,scaffold_8
13,5760001,5774000,13999,False,145,scaffold_8
14,6326001,6334544,8543,True,145,scaffold_8
0,109001,117000,7999,False,145,scaffold_9
1,121001,134000,12999,False,145,scaffold_9
2,302001,315000,12999,False,145,scaffold_9
3,319001,332000,12999,False,145,scaffold_9
4,367001,411000,43999,False,145,scaffold_9
5,413001,434000,20999,False,145,scaffold_9
6,502001,531000,28999,False,145,scaffold_9
7,652001,664000,11999,False,145,scaffold_9
8,670001,696000,25999,False,145,scaffold_9
9,732001,742000,9999,False,145,scaffold_9
10,816001,842000,25999,False,145,scaffold_9
11,850001,862000,11999,False,145,scaffold_9
12,873001,986000,112999,False,145,scaffold_9
13,988001,995000,6999,False,145,scaffold_9
14,998001,1007000,8999,False,145,scaffold_9
15,1009001,1031000,21999,False,145,scaffold_9
16,1035001,1085000,49999,False,145,scaffold_9
17,1087001,1150000,62999,False,145,scaffold_9
18,1151001,1160000,8999,False,145,scaffold_9
19,1312001,1377000,64999,False,145,scaffold_9
20,2598001,2616000,17999,False,145,scaffold_9
21,2742001,2755000,12999,False,145,scaffold_9
22,2781001,2803000,21999,False,145,scaffold_9
23,2874001,3381000,506999,False,145,scaffold_9
24,3383001,5107000,1723999,False,145,scaffold_9
25,5112001,5114000,1999,False,145,scaffold_9
26,5116001,5238000,121999,False,145,scaffold_9
27,5239001,5298000,58999,False,145,scaffold_9
28,5299001,6331288,1032287,True,145,scaffold_9
0,1,136000,135999,True,145,scaffold_10
1,137001,198000,60999,False,145,scaffold_10
2,336001,405000,68999,False,145,scaffold_10
3,472001,482000,9999,False,145,scaffold_10
4,483001,580000,96999,False,145,scaffold_10
5,603001,756000,152999,False,145,scaffold_10
6,888001,921000,32999,False,145,scaffold_10
7,923001,962000,38999,False,145,scaffold_10
8,1087001,1105000,17999,False,145,scaffold_10
9,2346001,2368000,21999,False,145,scaffold_10
10,4053001,4091000,37999,False,145,scaffold_10
11,4154001,4174000,19999,False,145,scaffold_10
12,4506001,4513000,6999,False,145,scaffold_10
13,4515001,4523000,7999,False,145,scaffold_10
14,4526001,4548000,21999,False,145,scaffold_10
15,4576001,4595000,18999,False,145,scaffold_10
16,4734001,4766000,31999,False,145,scaffold_10
17,4767001,4776000,8999,False,145,scaffold_10
18,4798001,4824000,25999,False,145,scaffold_10
19,4828001,4843000,14999,False,145,scaffold_10
20,4848001,4861000,12999,False,145,scaffold_10
21,4865001,4866973,1972,True,145,scaffold_10
0,10001,34000,23999,False,145,scaffold_11
1,41001,93000,51999,False,145,scaffold_11
2,149001,167000,17999,False,145,scaffold_11
3,169001,192000,22999,False,145,scaffold_11
4,204001,235000,30999,False,145,scaffold_11
5,240001,248000,7999,False,145,scaffold_11
6,298001,312000,13999,False,145,scaffold_11
7,419001,431000,11999,False,145,scaffold_11
8,648001,656000,7999,False,145,scaffold_11
9,665001,669000,3999,False,145,scaffold_11
10,991001,994000,2999,False,145,scaffold_11
11,1025001,1034000,8999,False,145,scaffold_11
12,1403001,1409000,5999,False,145,scaffold_11
13,2701001,2873000,171999,False,145,scaffold_11
14,3214001,3259000,44999,False,145,scaffold_11
15,3332001,3383000,50999,False,145,scaffold_11
16,3702001,3926000,223999,False,145,scaffold_11
17,4134001,4156000,21999,False,145,scaffold_11
18,4313001,4710000,396999,False,145,scaffold_11
19,4712001,4766820,54819,True,145,scaffold_11
0,1,369000,368999,True,145,scaffold_12
1,406001,430000,23999,False,145,scaffold_12
2,474001,537000,62999,False,145,scaffold_12
3,582001,856000,273999,False,145,scaffold_12
4,865001,1427000,561999,False,145,scaffold_12
5,1720001,1733000,12999,False,145,scaffold_12
6,2571001,2612000,40999,False,145,scaffold_12
7,2685001,2699000,13999,False,145,scaffold_12
0,1,342000,341999,True,146,scaffold_1
1,482001,498000,15999,False,146,scaffold_1
2,574001,643000,68999,False,146,scaffold_1
3,686001,751000,64999,False,146,scaffold_1
4,1281001,1292000,10999,False,146,scaffold_1
5,1618001,1660000,41999,False,146,scaffold_1
6,1812001,1899000,86999,False,146,scaffold_1
7,1951001,1984000,32999,False,146,scaffold_1
8,1987001,2002000,14999,False,146,scaffold_1
9,2363001,2385000,21999,False,146,scaffold_1
10,2449001,2517000,67999,False,146,scaffold_1
11,2565001,2579000,13999,False,146,scaffold_1
12,2729001,2746000,16999,False,146,scaffold_1
13,3175001,3208000,32999,False,146,scaffold_1
14,3713001,3734000,20999,False,146,scaffold_1
15,3901001,3941000,39999,False,146,scaffold_1
16,3960001,4027000,66999,False,146,scaffold_1
17,4062001,4112000,49999,False,146,scaffold_1
18,4323001,4355000,31999,False,146,scaffold_1
19,4921001,5022000,100999,False,146,scaffold_1
20,5481001,5514000,32999,False,146,scaffold_1
21,5536001,5573000,36999,False,146,scaffold_1
22,6109001,6153000,43999,False,146,scaffold_1
23,6202001,6381000,178999,False,146,scaffold_1
24,6384001,6507000,122999,False,146,scaffold_1
25,6545001,6554000,8999,False,146,scaffold_1
26,7038001,7247000,208999,False,146,scaffold_1
27,7248001,7589000,340999,False,146,scaffold_1
28,7590001,8477000,886999,False,146,scaffold_1
29,8478001,8656000,177999,False,146,scaffold_1
30,8658001,9584000,925999,False,146,scaffold_1
31,9586001,10356000,769999,False,146,scaffold_1
32,10461001,10635000,173999,False,146,scaffold_1
33,10836001,10858000,21999,False,146,scaffold_1
34,11276001,11509000,232999,False,146,scaffold_1
35,11562001,11951000,388999,False,146,scaffold_1
36,12184001,12204000,19999,False,146,scaffold_1
37,12652001,12722000,69999,False,146,scaffold_1
38,12777001,12888000,110999,False,146,scaffold_1
39,13113001,13212000,98999,False,146,scaffold_1
40,13347001,13431000,83999,False,146,scaffold_1
41,13559001,13581000,21999,False,146,scaffold_1
42,13811001,13845000,33999,False,146,scaffold_1
43,14285001,14308000,22999,False,146,scaffold_1
44,14648001,14664000,15999,False,146,scaffold_1
0,22001,48000,25999,False,146,scaffold_2
1,116001,159000,42999,False,146,scaffold_2
2,165001,177000,11999,False,146,scaffold_2
3,333001,374000,40999,False,146,scaffold_2
4,2085001,2111000,25999,False,146,scaffold_2
5,2336001,2358000,21999,False,146,scaffold_2
6,2404001,2424000,19999,False,146,scaffold_2
7,2441001,2563000,121999,False,146,scaffold_2
8,2627001,2639000,11999,False,146,scaffold_2
9,2660001,2689000,28999,False,146,scaffold_2
10,2694001,2745000,50999,False,146,scaffold_2
11,2868001,2901000,32999,False,146,scaffold_2
12,2993001,3012000,18999,False,146,scaffold_2
13,3174001,3185000,10999,False,146,scaffold_2
14,3449001,3465000,15999,False,146,scaffold_2
15,3754001,3783000,28999,False,146,scaffold_2
16,4385001,4409000,23999,False,146,scaffold_2
17,4426001,4457000,30999,False,146,scaffold_2
18,4520001,4657000,136999,False,146,scaffold_2
19,4918001,4940000,21999,False,146,scaffold_2
20,5019001,5031000,11999,False,146,scaffold_2
21,5033001,5061000,27999,False,146,scaffold_2
22,5369001,5393000,23999,False,146,scaffold_2
23,5491001,5514000,22999,False,146,scaffold_2
24,5658001,5704000,45999,False,146,scaffold_2
25,5719001,5752000,32999,False,146,scaffold_2
26,5842001,5887000,44999,False,146,scaffold_2
27,5919001,5956000,36999,False,146,scaffold_2
28,6261001,6343000,81999,False,146,scaffold_2
29,6411001,6449000,37999,False,146,scaffold_2
30,6949001,6979000,29999,False,146,scaffold_2
31,7018001,7038000,19999,False,146,scaffold_2
32,7439001,7472000,32999,False,146,scaffold_2
33,7563001,7698000,134999,False,146,scaffold_2
34,7786001,7891000,104999,False,146,scaffold_2
35,7934001,8155000,220999,False,146,scaffold_2
36,8266001,8296000,29999,False,146,scaffold_2
37,8331001,8333000,1999,False,146,scaffold_2
38,8334001,8344000,9999,False,146,scaffold_2
39,8346001,8454000,107999,False,146,scaffold_2
40,8507001,8562000,54999,False,146,scaffold_2
41,10710001,10731000,20999,False,146,scaffold_2
42,11366001,11378000,11999,False,146,scaffold_2
43,11520001,11786000,265999,False,146,scaffold_2
0,798001,900000,101999,False,146,scaffold_3
1,960001,964000,3999,False,146,scaffold_3
2,2041001,2108000,66999,False,146,scaffold_3
3,2109001,2116000,6999,False,146,scaffold_3
4,2288001,2322000,33999,False,146,scaffold_3
5,2488001,2531000,42999,False,146,scaffold_3
6,2649001,2682000,32999,False,146,scaffold_3
7,2716001,2737000,20999,False,146,scaffold_3
8,3110001,3145000,34999,False,146,scaffold_3
9,3768001,3821000,52999,False,146,scaffold_3
10,3822001,3890000,67999,False,146,scaffold_3
11,4094001,4403000,308999,False,146,scaffold_3
12,4410001,4518000,107999,False,146,scaffold_3
13,4547001,4558000,10999,False,146,scaffold_3
14,4654001,4678000,23999,False,146,scaffold_3
15,5161001,5196000,34999,False,146,scaffold_3
16,5234001,5270000,35999,False,146,scaffold_3
17,5493001,5509000,15999,False,146,scaffold_3
18,5987001,6024000,36999,False,146,scaffold_3
19,6761001,6782000,20999,False,146,scaffold_3
20,6909001,6968000,58999,False,146,scaffold_3
21,6979001,7083000,103999,False,146,scaffold_3
22,7146001,7157000,10999,False,146,scaffold_3
23,7332001,7399000,66999,False,146,scaffold_3
24,7522001,7556000,33999,False,146,scaffold_3
25,7678001,7801000,122999,False,146,scaffold_3
26,7818001,7854000,35999,False,146,scaffold_3
27,8175001,8253000,77999,False,146,scaffold_3
28,8462001,8528000,65999,False,146,scaffold_3
29,8575001,8594000,18999,False,146,scaffold_3
30,9122001,9141000,18999,False,146,scaffold_3
31,9968001,9996000,27999,False,146,scaffold_3
32,10461001,10483000,21999,False,146,scaffold_3
33,10587001,11165000,577999,False,146,scaffold_3
0,17001,32000,14999,False,146,scaffold_4
1,48001,88000,39999,False,146,scaffold_4
2,105001,115000,9999,False,146,scaffold_4
3,121001,151000,29999,False,146,scaffold_4
4,155001,160000,4999,False,146,scaffold_4
5,161001,215000,53999,False,146,scaffold_4
6,217001,241000,23999,False,146,scaffold_4
7,242001,266000,23999,False,146,scaffold_4
8,288001,309000,20999,False,146,scaffold_4
9,316001,344000,27999,False,146,scaffold_4
10,355001,374000,18999,False,146,scaffold_4
11,390001,410000,19999,False,146,scaffold_4
12,412001,425000,12999,False,146,scaffold_4
13,429001,498000,68999,False,146,scaffold_4
14,542001,592000,49999,False,146,scaffold_4
15,608001,661000,52999,False,146,scaffold_4
16,670001,691000,20999,False,146,scaffold_4
17,695001,697000,1999,False,146,scaffold_4
18,701001,714000,12999,False,146,scaffold_4
19,1121001,1136000,14999,False,146,scaffold_4
20,1137001,1198000,60999,False,146,scaffold_4
21,1199001,1226000,26999,False,146,scaffold_4
22,1235001,1253000,17999,False,146,scaffold_4
23,1254001,1262000,7999,False,146,scaffold_4
24,1265001,1279000,13999,False,146,scaffold_4
25,1283001,1319000,35999,False,146,scaffold_4
26,1372001,1599000,226999,False,146,scaffold_4
27,1613001,1957000,343999,False,146,scaffold_4
28,1958001,2117000,158999,False,146,scaffold_4
29,2119001,2185000,65999,False,146,scaffold_4
30,2188001,2198000,9999,False,146,scaffold_4
31,2219001,2246000,26999,False,146,scaffold_4
32,2247001,2279000,31999,False,146,scaffold_4
33,2284001,2310000,25999,False,146,scaffold_4
34,2312001,2461000,148999,False,146,scaffold_4
35,2477001,2635000,157999,False,146,scaffold_4
36,2906001,2957000,50999,False,146,scaffold_4
37,3091001,3129000,37999,False,146,scaffold_4
38,3336001,3768000,431999,False,146,scaffold_4
39,4056001,4077000,20999,False,146,scaffold_4
40,4901001,5045000,143999,False,146,scaffold_4
41,5476001,5506000,29999,False,146,scaffold_4
42,5514001,5631000,116999,False,146,scaffold_4
43,5661001,5784000,122999,False,146,scaffold_4
44,5786001,5825000,38999,False,146,scaffold_4
45,6145001,6194000,48999,False,146,scaffold_4
46,6798001,6817000,18999,False,146,scaffold_4
47,6902001,6924000,21999,False,146,scaffold_4
48,6970001,6991000,20999,False,146,scaffold_4
49,7036001,7062000,25999,False,146,scaffold_4
50,7236001,7261000,24999,False,146,scaffold_4
51,7641001,7665000,23999,False,146,scaffold_4
52,8846001,9699000,852999,False,146,scaffold_4
53,9701001,9845951,144950,True,146,scaffold_4
0,318001,387000,68999,False,146,scaffold_5
1,463001,523000,59999,False,146,scaffold_5
2,669001,679000,9999,False,146,scaffold_5
3,933001,947000,13999,False,146,scaffold_5
4,2477001,2493000,15999,False,146,scaffold_5
5,2563001,2582000,18999,False,146,scaffold_5
6,2618001,2739000,120999,False,146,scaffold_5
7,2766001,2871000,104999,False,146,scaffold_5
8,3133001,3248000,114999,False,146,scaffold_5
9,3322001,3511000,188999,False,146,scaffold_5
10,3962001,4101000,138999,False,146,scaffold_5
11,4121001,4219000,97999,False,146,scaffold_5
12,4246001,4287000,40999,False,146,scaffold_5
13,4446001,4521000,74999,False,146,scaffold_5
14,4600001,4681000,80999,False,146,scaffold_5
15,4691001,4751000,59999,False,146,scaffold_5
16,4752001,4861000,108999,False,146,scaffold_5
17,4884001,4919000,34999,False,146,scaffold_5
18,5259001,5267000,7999,False,146,scaffold_5
19,5288001,5312000,23999,False,146,scaffold_5
20,5314001,5346000,31999,False,146,scaffold_5
21,6405001,6420000,14999,False,146,scaffold_5
22,6480001,6653000,172999,False,146,scaffold_5
23,7372001,7387000,14999,False,146,scaffold_5
24,7454001,7483000,28999,False,146,scaffold_5
25,7559001,7610000,50999,False,146,scaffold_5
26,7621001,7655000,33999,False,146,scaffold_5
27,7679001,7743000,63999,False,146,scaffold_5
28,8571001,8615000,43999,False,146,scaffold_5
29,8659001,8689000,29999,False,146,scaffold_5
30,8730001,9363000,632999,False,146,scaffold_5
0,79001,84000,4999,False,146,scaffold_6
1,86001,114000,27999,False,146,scaffold_6
2,172001,207000,34999,False,146,scaffold_6
3,240001,254000,13999,False,146,scaffold_6
4,257001,263000,5999,False,146,scaffold_6
5,264001,297000,32999,False,146,scaffold_6
6,1233001,1261000,27999,False,146,scaffold_6
7,1478001,1546000,67999,False,146,scaffold_6
8,1866001,1906000,39999,False,146,scaffold_6
9,2023001,2103000,79999,False,146,scaffold_6
10,2128001,2185000,56999,False,146,scaffold_6
11,2336001,2595000,258999,False,146,scaffold_6
12,2596001,2691000,94999,False,146,scaffold_6
13,2712001,2872000,159999,False,146,scaffold_6
14,2934001,3014000,79999,False,146,scaffold_6
15,3115001,3176000,60999,False,146,scaffold_6
16,3223001,3317000,93999,False,146,scaffold_6
17,3407001,3434000,26999,False,146,scaffold_6
18,3447001,3767000,319999,False,146,scaffold_6
19,3901001,3912000,10999,False,146,scaffold_6
20,4017001,4195000,177999,False,146,scaffold_6
21,4838001,4869000,30999,False,146,scaffold_6
22,6010001,6067000,56999,False,146,scaffold_6
23,7283001,7337000,53999,False,146,scaffold_6
24,7389001,7418000,28999,False,146,scaffold_6
25,7556001,8268281,712280,True,146,scaffold_6
0,13001,31000,17999,False,146,scaffold_7
1,323001,340000,16999,False,146,scaffold_7
2,342001,508000,165999,False,146,scaffold_7
3,554001,563000,8999,False,146,scaffold_7
4,571001,577000,5999,False,146,scaffold_7
5,706001,736000,29999,False,146,scaffold_7
6,764001,826000,61999,False,146,scaffold_7
7,859001,864000,4999,False,146,scaffold_7
8,875001,945000,69999,False,146,scaffold_7
9,960001,963000,2999,False,146,scaffold_7
10,964001,966000,1999,False,146,scaffold_7
11,968001,980000,11999,False,146,scaffold_7
12,982001,1044000,61999,False,146,scaffold_7
13,1048001,1099000,50999,False,146,scaffold_7
14,1191001,1512000,320999,False,146,scaffold_7
15,1588001,1696000,107999,False,146,scaffold_7
16,1762001,1782000,19999,False,146,scaffold_7
17,3325001,3369000,43999,False,146,scaffold_7
18,3522001,3766000,243999,False,146,scaffold_7
19,4415001,4535000,119999,False,146,scaffold_7
20,4658001,4682000,23999,False,146,scaffold_7
21,4978001,5149000,170999,False,146,scaffold_7
22,5482001,5536000,53999,False,146,scaffold_7
23,5609001,5647000,37999,False,146,scaffold_7
24,6954001,7270000,315999,False,146,scaffold_7
25,7271001,7502216,231215,True,146,scaffold_7
0,66001,85000,18999,False,146,scaffold_8
1,93001,101000,7999,False,146,scaffold_8
2,722001,724000,1999,False,146,scaffold_8
3,2444001,2528000,83999,False,146,scaffold_8
4,2536001,2552000,15999,False,146,scaffold_8
5,2652001,2683000,30999,False,146,scaffold_8
6,2741001,2844000,102999,False,146,scaffold_8
7,2846001,2874000,27999,False,146,scaffold_8
8,3057001,3529000,471999,False,146,scaffold_8
9,3579001,3612000,32999,False,146,scaffold_8
10,3615001,3913000,297999,False,146,scaffold_8
11,4037001,4118000,80999,False,146,scaffold_8
12,4401001,4432000,30999,False,146,scaffold_8
13,5085001,5136000,50999,False,146,scaffold_8
14,5186001,5241000,54999,False,146,scaffold_8
15,5750001,5774000,23999,False,146,scaffold_8
16,6324001,6334544,10543,True,146,scaffold_8
0,109001,117000,7999,False,146,scaffold_9
1,189001,194000,4999,False,146,scaffold_9
2,366001,411000,44999,False,146,scaffold_9
3,413001,434000,20999,False,146,scaffold_9
4,502001,531000,28999,False,146,scaffold_9
5,548001,563000,14999,False,146,scaffold_9
6,670001,697000,26999,False,146,scaffold_9
7,815001,842000,26999,False,146,scaffold_9
8,872001,986000,113999,False,146,scaffold_9
9,987001,995000,7999,False,146,scaffold_9
10,1001001,1007000,5999,False,146,scaffold_9
11,1009001,1085000,75999,False,146,scaffold_9
12,1087001,1150000,62999,False,146,scaffold_9
13,1151001,1166000,14999,False,146,scaffold_9
14,1312001,1377000,64999,False,146,scaffold_9
15,1428001,1433000,4999,False,146,scaffold_9
16,1552001,1592000,39999,False,146,scaffold_9
17,1596001,1621000,24999,False,146,scaffold_9
18,1749001,1791000,41999,False,146,scaffold_9
19,1987001,2058000,70999,False,146,scaffold_9
20,2075001,2133000,57999,False,146,scaffold_9
21,2136001,2167000,30999,False,146,scaffold_9
22,2597001,2616000,18999,False,146,scaffold_9
23,2770001,2824000,53999,False,146,scaffold_9
24,2844001,3381000,536999,False,146,scaffold_9
25,3383001,5107000,1723999,False,146,scaffold_9
26,5112001,5238000,125999,False,146,scaffold_9
27,5239001,5298000,58999,False,146,scaffold_9
28,5300001,5362000,61999,False,146,scaffold_9
29,5363001,5491000,127999,False,146,scaffold_9
30,5493001,6331288,838287,True,146,scaffold_9
0,1,414000,413999,True,146,scaffold_10
1,415001,482000,66999,False,146,scaffold_10
2,485001,582000,96999,False,146,scaffold_10
3,603001,794000,190999,False,146,scaffold_10
4,888001,917000,28999,False,146,scaffold_10
5,923001,962000,38999,False,146,scaffold_10
6,1073001,1113000,39999,False,146,scaffold_10
7,2088001,2103000,14999,False,146,scaffold_10
8,2140001,2175000,34999,False,146,scaffold_10
9,2268001,2300000,31999,False,146,scaffold_10
10,2346001,2450000,103999,False,146,scaffold_10
11,2558001,2575000,16999,False,146,scaffold_10
12,2600001,2624000,23999,False,146,scaffold_10
13,2674001,2699000,24999,False,146,scaffold_10
14,2715001,2749000,33999,False,146,scaffold_10
15,4053001,4091000,37999,False,146,scaffold_10
16,4154001,4174000,19999,False,146,scaffold_10
17,4443001,4462000,18999,False,146,scaffold_10
18,4467001,4477000,9999,False,146,scaffold_10
19,4503001,4513000,9999,False,146,scaffold_10
20,4527001,4548000,20999,False,146,scaffold_10
21,4554001,4562000,7999,False,146,scaffold_10
22,4565001,4596000,30999,False,146,scaffold_10
23,4681001,4688000,6999,False,146,scaffold_10
24,4734001,4776000,41999,False,146,scaffold_10
25,4798001,4824000,25999,False,146,scaffold_10
26,4827001,4843000,15999,False,146,scaffold_10
27,4848001,4861000,12999,False,146,scaffold_10
28,4865001,4866973,1972,True,146,scaffold_10
0,11001,90000,78999,False,146,scaffold_11
1,149001,167000,17999,False,146,scaffold_11
2,169001,191000,21999,False,146,scaffold_11
3,213001,235000,21999,False,146,scaffold_11
4,240001,249000,8999,False,146,scaffold_11
5,419001,431000,11999,False,146,scaffold_11
6,648001,656000,7999,False,146,scaffold_11
7,781001,785000,3999,False,146,scaffold_11
8,1025001,1034000,8999,False,146,scaffold_11
9,1129001,1131000,1999,False,146,scaffold_11
10,1359001,1372000,12999,False,146,scaffold_11
11,1423001,1426000,2999,False,146,scaffold_11
12,2701001,2877000,175999,False,146,scaffold_11
13,2954001,3018000,63999,False,146,scaffold_11
14,3093001,3134000,40999,False,146,scaffold_11
15,3187001,3293000,105999,False,146,scaffold_11
16,3327001,3383000,55999,False,146,scaffold_11
17,3423001,3480000,56999,False,146,scaffold_11
18,3520001,3651000,130999,False,146,scaffold_11
19,3702001,3933000,230999,False,146,scaffold_11
20,4009001,4159000,149999,False,146,scaffold_11
21,4180001,4710000,529999,False,146,scaffold_11
22,4713001,4766820,53819,True,146,scaffold_11
0,1,856000,855999,True,146,scaffold_12
1,865001,1469000,603999,False,146,scaffold_12
2,1720001,1733000,12999,False,146,scaffold_12
3,2043001,2087000,43999,False,146,scaffold_12
4,2088001,2102000,13999,False,146,scaffold_12
5,2137001,2165000,27999,False,146,scaffold_12
6,2350001,2380000,29999,False,146,scaffold_12
7,2571001,2609000,37999,False,146,scaffold_12
8,2685001,2699000,13999,False,146,scaffold_12
9,2747001,2747968,967,True,146,scaffold_12
0,1,61000,60999,True,147,scaffold_1
1,62001,346000,283999,False,147,scaffold_1
2,482001,498000,15999,False,147,scaffold_1
3,571001,604000,32999,False,147,scaffold_1
4,615001,641000,25999,False,147,scaffold_1
5,686001,782000,95999,False,147,scaffold_1
6,794001,933000,138999,False,147,scaffold_1
7,1168001,1201000,32999,False,147,scaffold_1
8,1281001,1292000,10999,False,147,scaffold_1
9,1608001,1660000,51999,False,147,scaffold_1
10,1661001,1696000,34999,False,147,scaffold_1
11,1725001,1740000,14999,False,147,scaffold_1
12,1742001,1786000,43999,False,147,scaffold_1
13,1828001,1964000,135999,False,147,scaffold_1
14,1965001,2017000,51999,False,147,scaffold_1
15,2272001,2304000,31999,False,147,scaffold_1
16,2342001,2415000,72999,False,147,scaffold_1
17,2450001,2520000,69999,False,147,scaffold_1
18,2563001,2582000,18999,False,147,scaffold_1
19,2720001,2746000,25999,False,147,scaffold_1
20,2961001,3031000,69999,False,147,scaffold_1
21,3171001,3241000,69999,False,147,scaffold_1
22,3278001,3336000,57999,False,147,scaffold_1
23,3443001,3499000,55999,False,147,scaffold_1
24,3544001,3566000,21999,False,147,scaffold_1
25,3575001,3604000,28999,False,147,scaffold_1
26,3703001,4078000,374999,False,147,scaffold_1
27,4079001,4148000,68999,False,147,scaffold_1
28,4306001,4444000,137999,False,147,scaffold_1
29,4462001,4549000,86999,False,147,scaffold_1
30,4629001,4790000,160999,False,147,scaffold_1
31,4796001,4898000,101999,False,147,scaffold_1
32,4906001,5066000,159999,False,147,scaffold_1
33,5087001,5123000,35999,False,147,scaffold_1
34,5139001,5199000,59999,False,147,scaffold_1
35,5436001,5457000,20999,False,147,scaffold_1
36,5481001,5521000,39999,False,147,scaffold_1
37,5535001,5593000,57999,False,147,scaffold_1
38,5853001,5944000,90999,False,147,scaffold_1
39,6108001,6153000,44999,False,147,scaffold_1
40,6154001,6185000,30999,False,147,scaffold_1
41,6216001,6575000,358999,False,147,scaffold_1
42,6717001,6738000,20999,False,147,scaffold_1
43,6924001,6953000,28999,False,147,scaffold_1
44,6969001,6991000,21999,False,147,scaffold_1
45,7038001,7247000,208999,False,147,scaffold_1
46,7248001,7584000,335999,False,147,scaffold_1
47,7586001,7589000,2999,False,147,scaffold_1
48,7590001,8401000,810999,False,147,scaffold_1
49,8402001,8477000,74999,False,147,scaffold_1
50,8478001,8626000,147999,False,147,scaffold_1
51,8628001,8656000,27999,False,147,scaffold_1
52,8658001,9505000,846999,False,147,scaffold_1
53,9506001,9584000,77999,False,147,scaffold_1
54,9586001,10364000,777999,False,147,scaffold_1
55,10391001,10427000,35999,False,147,scaffold_1
56,10460001,10623000,162999,False,147,scaffold_1
57,10839001,10855000,15999,False,147,scaffold_1
58,10916001,10956000,39999,False,147,scaffold_1
59,11014001,11075000,60999,False,147,scaffold_1
60,11123001,11255000,131999,False,147,scaffold_1
61,11263001,11690000,426999,False,147,scaffold_1
62,11692001,11963000,270999,False,147,scaffold_1
63,12184001,12243000,58999,False,147,scaffold_1
64,12329001,12380000,50999,False,147,scaffold_1
65,12382001,12396000,13999,False,147,scaffold_1
66,12410001,12582000,171999,False,147,scaffold_1
67,12629001,12886000,256999,False,147,scaffold_1
68,12913001,12997000,83999,False,147,scaffold_1
69,13011001,13075000,63999,False,147,scaffold_1
70,13113001,13216000,102999,False,147,scaffold_1
71,13322001,13456000,133999,False,147,scaffold_1
72,13554001,13590000,35999,False,147,scaffold_1
73,13591001,13608000,16999,False,147,scaffold_1
74,13668001,13710000,41999,False,147,scaffold_1
75,13786001,13845000,58999,False,147,scaffold_1
76,13847001,13927000,79999,False,147,scaffold_1
77,13958001,13977000,18999,False,147,scaffold_1
78,13979001,14005000,25999,False,147,scaffold_1
79,14007001,14029000,21999,False,147,scaffold_1
80,14285001,14313000,27999,False,147,scaffold_1
81,14524001,14576000,51999,False,147,scaffold_1
82,14649001,14664000,14999,False,147,scaffold_1
0,21001,48000,26999,False,147,scaffold_2
1,93001,159000,65999,False,147,scaffold_2
2,168001,177000,8999,False,147,scaffold_2
3,296001,318000,21999,False,147,scaffold_2
4,335001,374000,38999,False,147,scaffold_2
5,387001,406000,18999,False,147,scaffold_2
6,459001,545000,85999,False,147,scaffold_2
7,732001,739000,6999,False,147,scaffold_2
8,1234001,1259000,24999,False,147,scaffold_2
9,1355001,1417000,61999,False,147,scaffold_2
10,1438001,1557000,118999,False,147,scaffold_2
11,1588001,1658000,69999,False,147,scaffold_2
12,1805001,1861000,55999,False,147,scaffold_2
13,1875001,1900000,24999,False,147,scaffold_2
14,2085001,2132000,46999,False,147,scaffold_2
15,2302001,2334000,31999,False,147,scaffold_2
16,2336001,2424000,87999,False,147,scaffold_2
17,2436001,2609000,172999,False,147,scaffold_2
18,2658001,2689000,30999,False,147,scaffold_2
19,2694001,2747000,52999,False,147,scaffold_2
20,2766001,2857000,90999,False,147,scaffold_2
21,2868001,3012000,143999,False,147,scaffold_2
22,3028001,3043000,14999,False,147,scaffold_2
23,3174001,3187000,12999,False,147,scaffold_2
24,3253001,3266000,12999,False,147,scaffold_2
25,3311001,3383000,71999,False,147,scaffold_2
26,3448001,3461000,12999,False,147,scaffold_2
27,3478001,3712000,233999,False,147,scaffold_2
28,3749001,3933000,183999,False,147,scaffold_2
29,3991001,4001000,9999,False,147,scaffold_2
30,4003001,4038000,34999,False,147,scaffold_2
31,4100001,4146000,45999,False,147,scaffold_2
32,4221001,4409000,187999,False,147,scaffold_2
33,4433001,4791000,357999,False,147,scaffold_2
34,4793001,4811000,17999,False,147,scaffold_2
35,4908001,4980000,71999,False,147,scaffold_2
36,5011001,5104000,92999,False,147,scaffold_2
37,5173001,5224000,50999,False,147,scaffold_2
38,5254001,5278000,23999,False,147,scaffold_2
39,5285001,5312000,26999,False,147,scaffold_2
40,5348001,5564000,215999,False,147,scaffold_2
41,5605001,5779000,173999,False,147,scaffold_2
42,5812001,5994000,181999,False,147,scaffold_2
43,6011001,6059000,47999,False,147,scaffold_2
44,6061001,6081000,19999,False,147,scaffold_2
45,6095001,6200000,104999,False,147,scaffold_2
46,6261001,6330000,68999,False,147,scaffold_2
47,6365001,6482000,116999,False,147,scaffold_2
48,6575001,6629000,53999,False,147,scaffold_2
49,6693001,6727000,33999,False,147,scaffold_2
50,6824001,6863000,38999,False,147,scaffold_2
51,6938001,7097000,158999,False,147,scaffold_2
52,7350001,7473000,122999,False,147,scaffold_2
53,7491001,7518000,26999,False,147,scaffold_2
54,7548001,7561000,12999,False,147,scaffold_2
55,7563001,7891000,327999,False,147,scaffold_2
56,7934001,8230000,295999,False,147,scaffold_2
57,8260001,8319000,58999,False,147,scaffold_2
58,8346001,8493000,146999,False,147,scaffold_2
59,8495001,8565000,69999,False,147,scaffold_2
60,8998001,9045000,46999,False,147,scaffold_2
61,9140001,9265000,124999,False,147,scaffold_2
62,9303001,9358000,54999,False,147,scaffold_2
63,9359001,9382000,22999,False,147,scaffold_2
64,9601001,9636000,34999,False,147,scaffold_2
65,9768001,9828000,59999,False,147,scaffold_2
66,10339001,10357000,17999,False,147,scaffold_2
67,10404001,10495000,90999,False,147,scaffold_2
68,10641001,10698000,56999,False,147,scaffold_2
69,10713001,10731000,17999,False,147,scaffold_2
70,10859001,10885000,25999,False,147,scaffold_2
71,11046001,11111000,64999,False,147,scaffold_2
72,11314001,11425000,110999,False,147,scaffold_2
73,11452001,11495000,42999,False,147,scaffold_2
74,11548001,11786000,237999,False,147,scaffold_2
0,218001,232000,13999,False,147,scaffold_3
1,799001,922000,122999,False,147,scaffold_3
2,1154001,1162000,7999,False,147,scaffold_3
3,1635001,1665000,29999,False,147,scaffold_3
4,1667001,1670000,2999,False,147,scaffold_3
5,1687001,1717000,29999,False,147,scaffold_3
6,1893001,1984000,90999,False,147,scaffold_3
7,1987001,2147000,159999,False,147,scaffold_3
8,2168001,2182000,13999,False,147,scaffold_3
9,2205001,2336000,130999,False,147,scaffold_3
10,2382001,2428000,45999,False,147,scaffold_3
11,2433001,2533000,99999,False,147,scaffold_3
12,2534001,2606000,71999,False,147,scaffold_3
13,2646001,2925000,278999,False,147,scaffold_3
14,2985001,3019000,33999,False,147,scaffold_3
15,3051001,3062000,10999,False,147,scaffold_3
16,3066001,3342000,275999,False,147,scaffold_3
17,3409001,3451000,41999,False,147,scaffold_3
18,3474001,3515000,40999,False,147,scaffold_3
19,3560001,3734000,173999,False,147,scaffold_3
20,3768001,3817000,48999,False,147,scaffold_3
21,3828001,3851000,22999,False,147,scaffold_3
22,3926001,3945000,18999,False,147,scaffold_3
23,3974001,4404000,429999,False,147,scaffold_3
24,4416001,4522000,105999,False,147,scaffold_3
25,4547001,4558000,10999,False,147,scaffold_3
26,4659001,4680000,20999,False,147,scaffold_3
27,4856001,4925000,68999,False,147,scaffold_3
28,5044001,5279000,234999,False,147,scaffold_3
29,5363001,5509000,145999,False,147,scaffold_3
30,5511001,5535000,23999,False,147,scaffold_3
31,5546001,5675000,128999,False,147,scaffold_3
32,5678001,5763000,84999,False,147,scaffold_3
33,5764001,6062000,297999,False,147,scaffold_3
34,6229001,6244000,14999,False,147,scaffold_3
35,6741001,6807000,65999,False,147,scaffold_3
36,6887001,7090000,202999,False,147,scaffold_3
37,7110001,7157000,46999,False,147,scaffold_3
38,7230001,7328000,97999,False,147,scaffold_3
39,7332001,7446000,113999,False,147,scaffold_3
40,7449001,7460000,10999,False,147,scaffold_3
41,7462001,7557000,94999,False,147,scaffold_3
42,7575001,7650000,74999,False,147,scaffold_3
43,7656001,7887000,230999,False,147,scaffold_3
44,8028001,8115000,86999,False,147,scaffold_3
45,8121001,8160000,38999,False,147,scaffold_3
46,8183001,8300000,116999,False,147,scaffold_3
47,8334001,8362000,27999,False,147,scaffold_3
48,8398001,8449000,50999,False,147,scaffold_3
49,8464001,8627000,162999,False,147,scaffold_3
50,8655001,8677000,21999,False,147,scaffold_3
51,8757001,8801000,43999,False,147,scaffold_3
52,8954001,9247000,292999,False,147,scaffold_3
53,9459001,9579000,119999,False,147,scaffold_3
54,9645001,9691000,45999,False,147,scaffold_3
55,9775001,9812000,36999,False,147,scaffold_3
56,9966001,9996000,29999,False,147,scaffold_3
57,10068001,10085000,16999,False,147,scaffold_3
58,10590001,10852000,261999,False,147,scaffold_3
59,10854001,10971000,116999,False,147,scaffold_3
60,10972001,11168000,195999,False,147,scaffold_3
0,1,7000,6999,True,147,scaffold_4
1,11001,13000,1999,False,147,scaffold_4
2,14001,16000,1999,False,147,scaffold_4
3,17001,32000,14999,False,147,scaffold_4
4,48001,88000,39999,False,147,scaffold_4
5,106001,115000,8999,False,147,scaffold_4
6,132001,151000,18999,False,147,scaffold_4
7,155001,160000,4999,False,147,scaffold_4
8,161001,215000,53999,False,147,scaffold_4
9,217001,226000,8999,False,147,scaffold_4
10,242001,278000,35999,False,147,scaffold_4
11,288001,307000,18999,False,147,scaffold_4
12,318001,344000,25999,False,147,scaffold_4
13,345001,353000,7999,False,147,scaffold_4
14,355001,374000,18999,False,147,scaffold_4
15,412001,425000,12999,False,147,scaffold_4
16,429001,498000,68999,False,147,scaffold_4
17,541001,592000,50999,False,147,scaffold_4
18,608001,691000,82999,False,147,scaffold_4
19,701001,727000,25999,False,147,scaffold_4
20,1087001,1097000,9999,False,147,scaffold_4
21,1099001,1106000,6999,False,147,scaffold_4
22,1121001,1136000,14999,False,147,scaffold_4
23,1137001,1226000,88999,False,147,scaffold_4
24,1229001,1234000,4999,False,147,scaffold_4
25,1235001,1264000,28999,False,147,scaffold_4
26,1265001,1279000,13999,False,147,scaffold_4
27,1283001,1602000,318999,False,147,scaffold_4
28,1609001,1611000,1999,False,147,scaffold_4
29,1613001,2206000,592999,False,147,scaffold_4
30,2207001,2280000,72999,False,147,scaffold_4
31,2282001,2404000,121999,False,147,scaffold_4
32,2405001,2444000,38999,False,147,scaffold_4
33,2445001,2461000,15999,False,147,scaffold_4
34,2477001,2635000,157999,False,147,scaffold_4
35,2636001,2818000,181999,False,147,scaffold_4
36,2891001,3133000,241999,False,147,scaffold_4
37,3160001,3367000,206999,False,147,scaffold_4
38,3384001,3953000,568999,False,147,scaffold_4
39,3971001,3991000,19999,False,147,scaffold_4
40,3992001,4046000,53999,False,147,scaffold_4
41,4047001,4121000,73999,False,147,scaffold_4
42,4176001,4202000,25999,False,147,scaffold_4
43,4242001,4306000,63999,False,147,scaffold_4
44,4863001,5095000,231999,False,147,scaffold_4
45,5169001,5224000,54999,False,147,scaffold_4
46,5258001,5506000,247999,False,147,scaffold_4
47,5514001,5784000,269999,False,147,scaffold_4
48,5786001,5988000,201999,False,147,scaffold_4
49,6027001,6443000,415999,False,147,scaffold_4
50,6554001,6612000,57999,False,147,scaffold_4
51,6620001,6703000,82999,False,147,scaffold_4
52,6705001,6817000,111999,False,147,scaffold_4
53,6838001,6924000,85999,False,147,scaffold_4
54,6926001,6995000,68999,False,147,scaffold_4
55,7036001,7124000,87999,False,147,scaffold_4
56,7229001,7455000,225999,False,147,scaffold_4
57,7457001,7476000,18999,False,147,scaffold_4
58,7511001,7571000,59999,False,147,scaffold_4
59,7628001,7667000,38999,False,147,scaffold_4
60,7836001,7924000,87999,False,147,scaffold_4
61,7975001,8002000,26999,False,147,scaffold_4
62,8049001,8139000,89999,False,147,scaffold_4
63,8519001,8528000,8999,False,147,scaffold_4
64,8726001,8812000,85999,False,147,scaffold_4
65,8843001,9699000,855999,False,147,scaffold_4
66,9700001,9845951,145950,True,147,scaffold_4
0,319001,326000,6999,False,147,scaffold_5
1,327001,428000,100999,False,147,scaffold_5
2,460001,526000,65999,False,147,scaffold_5
3,617001,638000,20999,False,147,scaffold_5
4,639001,661000,21999,False,147,scaffold_5
5,669001,699000,29999,False,147,scaffold_5
6,803001,832000,28999,False,147,scaffold_5
7,932001,947000,14999,False,147,scaffold_5
8,1255001,1284000,28999,False,147,scaffold_5
9,1331001,1394000,62999,False,147,scaffold_5
10,1667001,1685000,17999,False,147,scaffold_5
11,1945001,1967000,21999,False,147,scaffold_5
12,2080001,2104000,23999,False,147,scaffold_5
13,2257001,2300000,42999,False,147,scaffold_5
14,2472001,2493000,20999,False,147,scaffold_5
15,2516001,2583000,66999,False,147,scaffold_5
16,2599001,2900000,300999,False,147,scaffold_5
17,3132001,3519000,386999,False,147,scaffold_5
18,3532001,3550000,17999,False,147,scaffold_5
19,3616001,3659000,42999,False,147,scaffold_5
20,3833001,3944000,110999,False,147,scaffold_5
21,3962001,4101000,138999,False,147,scaffold_5
22,4118001,4357000,238999,False,147,scaffold_5
23,4420001,4786000,365999,False,147,scaffold_5
24,4788001,4862000,73999,False,147,scaffold_5
25,4883001,4919000,35999,False,147,scaffold_5
26,4937001,4991000,53999,False,147,scaffold_5
27,5055001,5163000,107999,False,147,scaffold_5
28,5196001,5346000,149999,False,147,scaffold_5
29,5508001,5533000,24999,False,147,scaffold_5
30,5690001,5738000,47999,False,147,scaffold_5
31,6393001,6726000,332999,False,147,scaffold_5
32,6781001,6855000,73999,False,147,scaffold_5
33,6881001,6942000,60999,False,147,scaffold_5
34,7043001,7085000,41999,False,147,scaffold_5
35,7176001,7364000,187999,False,147,scaffold_5
36,7406001,7441000,34999,False,147,scaffold_5
37,7454001,7521000,66999,False,147,scaffold_5
38,7523001,7619000,95999,False,147,scaffold_5
39,7620001,7758000,137999,False,147,scaffold_5
40,7760001,7776000,15999,False,147,scaffold_5
41,7791001,7807000,15999,False,147,scaffold_5
42,7830001,7874000,43999,False,147,scaffold_5
43,8375001,8462000,86999,False,147,scaffold_5
44,8571001,8617000,45999,False,147,scaffold_5
45,8638001,8687000,48999,False,147,scaffold_5
46,8703001,9364176,661175,True,147,scaffold_5
0,78001,84000,5999,False,147,scaffold_6
1,86001,97000,10999,False,147,scaffold_6
2,98001,120000,21999,False,147,scaffold_6
3,150001,209000,58999,False,147,scaffold_6
4,241001,254000,12999,False,147,scaffold_6
5,257001,262000,4999,False,147,scaffold_6
6,264001,333000,68999,False,147,scaffold_6
7,378001,381000,2999,False,147,scaffold_6
8,456001,497000,40999,False,147,scaffold_6
9,636001,664000,27999,False,147,scaffold_6
10,698001,799000,100999,False,147,scaffold_6
11,833001,853000,19999,False,147,scaffold_6
12,893001,1039000,145999,False,147,scaffold_6
13,1120001,1266000,145999,False,147,scaffold_6
14,1284001,1311000,26999,False,147,scaffold_6
15,1348001,1367000,18999,False,147,scaffold_6
16,1429001,1604000,174999,False,147,scaffold_6
17,1655001,1756000,100999,False,147,scaffold_6
18,1793001,1935000,141999,False,147,scaffold_6
19,1976001,2019000,42999,False,147,scaffold_6
20,2023001,2215000,191999,False,147,scaffold_6
21,2236001,2283000,46999,False,147,scaffold_6
22,2307001,2872000,564999,False,147,scaffold_6
23,2927001,3114000,186999,False,147,scaffold_6
24,3115001,3210000,94999,False,147,scaffold_6
25,3223001,3350000,126999,False,147,scaffold_6
26,3351001,3764000,412999,False,147,scaffold_6
27,3810001,3849000,38999,False,147,scaffold_6
28,3878001,3926000,47999,False,147,scaffold_6
29,3942001,4092000,149999,False,147,scaffold_6
30,4094001,4204000,109999,False,147,scaffold_6
31,4448001,4484000,35999,False,147,scaffold_6
32,4701001,4720000,18999,False,147,scaffold_6
33,4736001,4756000,19999,False,147,scaffold_6
34,4802001,4918000,115999,False,147,scaffold_6
35,4925001,4997000,71999,False,147,scaffold_6
36,5289001,5313000,23999,False,147,scaffold_6
37,5720001,5743000,22999,False,147,scaffold_6
38,5777001,5785000,7999,False,147,scaffold_6
39,5861001,5912000,50999,False,147,scaffold_6
40,5914001,5972000,57999,False,147,scaffold_6
41,6021001,6191000,169999,False,147,scaffold_6
42,6206001,6277000,70999,False,147,scaffold_6
43,6486001,6505000,18999,False,147,scaffold_6
44,6653001,6710000,56999,False,147,scaffold_6
45,6765001,6804000,38999,False,147,scaffold_6
46,6833001,6859000,25999,False,147,scaffold_6
47,6909001,6942000,32999,False,147,scaffold_6
48,7186001,7337000,150999,False,147,scaffold_6
49,7383001,7436000,52999,False,147,scaffold_6
50,7531001,7608000,76999,False,147,scaffold_6
51,7609001,7890000,280999,False,147,scaffold_6
52,7891001,8268281,377280,True,147,scaffold_6
0,18001,31000,12999,False,147,scaffold_7
1,321001,340000,18999,False,147,scaffold_7
2,342001,508000,165999,False,147,scaffold_7
3,571001,577000,5999,False,147,scaffold_7
4,706001,736000,29999,False,147,scaffold_7
5,740001,753000,12999,False,147,scaffold_7
6,764001,821000,56999,False,147,scaffold_7
7,859001,864000,4999,False,147,scaffold_7
8,868001,872000,3999,False,147,scaffold_7
9,875001,927000,51999,False,147,scaffold_7
10,953001,966000,12999,False,147,scaffold_7
11,968001,981000,12999,False,147,scaffold_7
12,982001,1044000,61999,False,147,scaffold_7
13,1160001,1187000,26999,False,147,scaffold_7
14,1191001,1350000,158999,False,147,scaffold_7
15,1351001,1522000,170999,False,147,scaffold_7
16,1588001,1720000,131999,False,147,scaffold_7
17,1727001,1781000,53999,False,147,scaffold_7
18,1862001,1939000,76999,False,147,scaffold_7
19,1974001,1996000,21999,False,147,scaffold_7
20,1997001,2015000,17999,False,147,scaffold_7
21,2367001,2409000,41999,False,147,scaffold_7
22,2499001,2737000,237999,False,147,scaffold_7
23,2802001,2842000,39999,False,147,scaffold_7
24,2932001,2952000,19999,False,147,scaffold_7
25,3006001,3024000,17999,False,147,scaffold_7
26,3095001,3152000,56999,False,147,scaffold_7
27,3176001,3185000,8999,False,147,scaffold_7
28,3198001,3271000,72999,False,147,scaffold_7
29,3294001,3408000,113999,False,147,scaffold_7
30,3499001,3803000,303999,False,147,scaffold_7
31,3949001,3978000,28999,False,147,scaffold_7
32,4021001,4047000,25999,False,147,scaffold_7
33,4322001,4378000,55999,False,147,scaffold_7
34,4406001,4517000,110999,False,147,scaffold_7
35,4522001,4580000,57999,False,147,scaffold_7
36,4635001,4928000,292999,False,147,scaffold_7
37,4977001,5020000,42999,False,147,scaffold_7
38,5034001,5168000,133999,False,147,scaffold_7
39,5472001,5538000,65999,False,147,scaffold_7
40,5553001,5600000,46999,False,147,scaffold_7
41,5610001,5645000,34999,False,147,scaffold_7
42,5786001,5845000,58999,False,147,scaffold_7
43,5895001,5932000,36999,False,147,scaffold_7
44,5951001,5996000,44999,False,147,scaffold_7
45,6052001,6094000,41999,False,147,scaffold_7
46,6096001,6248000,151999,False,147,scaffold_7
47,6578001,6797000,218999,False,147,scaffold_7
48,6953001,7270000,316999,False,147,scaffold_7
49,7271001,7502216,231215,True,147,scaffold_7
0,3001,7000,3999,False,147,scaffold_8
1,67001,85000,17999,False,147,scaffold_8
2,1858001,1929000,70999,False,147,scaffold_8
3,2059001,2157000,97999,False,147,scaffold_8
4,2357001,2471000,113999,False,147,scaffold_8
5,2492001,2596000,103999,False,147,scaffold_8
6,2650001,2844000,193999,False,147,scaffold_8
7,2846001,3951000,1104999,False,147,scaffold_8
8,3968001,4267000,298999,False,147,scaffold_8
9,4394001,4429000,34999,False,147,scaffold_8
10,4567001,4589000,21999,False,147,scaffold_8
11,4608001,4680000,71999,False,147,scaffold_8
12,4719001,4960000,240999,False,147,scaffold_8
13,4984001,5057000,72999,False,147,scaffold_8
14,5067001,5153000,85999,False,147,scaffold_8
15,5179001,5245000,65999,False,147,scaffold_8
16,5357001,5475000,117999,False,147,scaffold_8
17,5524001,5597000,72999,False,147,scaffold_8
18,5657001,5692000,34999,False,147,scaffold_8
19,5728001,5804000,75999,False,147,scaffold_8
20,5820001,5879000,58999,False,147,scaffold_8
21,5881001,6115000,233999,False,147,scaffold_8
22,6184001,6308000,123999,False,147,scaffold_8
23,6320001,6334544,14543,True,147,scaffold_8
0,1,22000,21999,True,147,scaffold_9
1,366001,411000,44999,False,147,scaffold_9
2,413001,434000,20999,False,147,scaffold_9
3,547001,561000,13999,False,147,scaffold_9
4,647001,664000,16999,False,147,scaffold_9
5,670001,697000,26999,False,147,scaffold_9
6,735001,738000,2999,False,147,scaffold_9
7,817001,842000,24999,False,147,scaffold_9
8,850001,854000,3999,False,147,scaffold_9
9,872001,986000,113999,False,147,scaffold_9
10,987001,995000,7999,False,147,scaffold_9
11,1001001,1006000,4999,False,147,scaffold_9
12,1009001,1085000,75999,False,147,scaffold_9
13,1087001,1160000,72999,False,147,scaffold_9
14,1202001,1232000,29999,False,147,scaffold_9
15,1239001,1257000,17999,False,147,scaffold_9
16,1318001,1402000,83999,False,147,scaffold_9
17,1406001,1423000,16999,False,147,scaffold_9
18,1427001,1442000,14999,False,147,scaffold_9
19,1457001,1466000,8999,False,147,scaffold_9
20,1483001,1586000,102999,False,147,scaffold_9
21,1599001,1623000,23999,False,147,scaffold_9
22,1637001,1727000,89999,False,147,scaffold_9
23,1748001,1811000,62999,False,147,scaffold_9
24,1814001,1860000,45999,False,147,scaffold_9
25,1866001,1957000,90999,False,147,scaffold_9
26,1970001,2036000,65999,False,147,scaffold_9
27,2038001,2172000,133999,False,147,scaffold_9
28,2174001,2673000,498999,False,147,scaffold_9
29,2674001,2720000,45999,False,147,scaffold_9
30,2736001,3381000,644999,False,147,scaffold_9
31,3383001,4062000,678999,False,147,scaffold_9
32,4063001,4993000,929999,False,147,scaffold_9
33,4994001,5099000,104999,False,147,scaffold_9
34,5101001,5107000,5999,False,147,scaffold_9
35,5112001,5238000,125999,False,147,scaffold_9
36,5239001,5294000,54999,False,147,scaffold_9
37,5299001,5490000,190999,False,147,scaffold_9
38,5493001,6331288,838287,True,147,scaffold_9
0,1,414000,413999,True,147,scaffold_10
1,415001,746000,330999,False,147,scaffold_10
2,747001,797000,49999,False,147,scaffold_10
3,811001,833000,21999,False,147,scaffold_10
4,858001,881000,22999,False,147,scaffold_10
5,887001,1069000,181999,False,147,scaffold_10
6,1073001,1115000,41999,False,147,scaffold_10
7,1116001,1187000,70999,False,147,scaffold_10
8,1277001,1299000,21999,False,147,scaffold_10
9,1302001,1335000,32999,False,147,scaffold_10
10,1336001,1354000,17999,False,147,scaffold_10
11,1369001,1473000,103999,False,147,scaffold_10
12,1487001,1570000,82999,False,147,scaffold_10
13,1591001,1760000,168999,False,147,scaffold_10
14,1803001,1844000,40999,False,147,scaffold_10
15,1861001,1923000,61999,False,147,scaffold_10
16,2007001,2114000,106999,False,147,scaffold_10
17,2137001,2461000,323999,False,147,scaffold_10
18,2462001,2476000,13999,False,147,scaffold_10
19,2505001,2520000,14999,False,147,scaffold_10
20,2521001,2657000,135999,False,147,scaffold_10
21,2671001,2712000,40999,False,147,scaffold_10
22,2714001,2813000,98999,False,147,scaffold_10
23,2817001,2849000,31999,False,147,scaffold_10
24,2935001,2953000,17999,False,147,scaffold_10
25,3082001,3131000,48999,False,147,scaffold_10
26,3153001,3177000,23999,False,147,scaffold_10
27,3394001,3423000,28999,False,147,scaffold_10
28,3467001,3476000,8999,False,147,scaffold_10
29,3574001,3582000,7999,False,147,scaffold_10
30,3633001,3656000,22999,False,147,scaffold_10
31,3775001,3795000,19999,False,147,scaffold_10
32,4053001,4091000,37999,False,147,scaffold_10
33,4154001,4179000,24999,False,147,scaffold_10
34,4316001,4326000,9999,False,147,scaffold_10
35,4334001,4365000,30999,False,147,scaffold_10
36,4443001,4462000,18999,False,147,scaffold_10
37,4467001,4477000,9999,False,147,scaffold_10
38,4503001,4513000,9999,False,147,scaffold_10
39,4515001,4523000,7999,False,147,scaffold_10
40,4526001,4548000,21999,False,147,scaffold_10
41,4565001,4597000,31999,False,147,scaffold_10
42,4734001,4776000,41999,False,147,scaffold_10
43,4798001,4824000,25999,False,147,scaffold_10
44,4828001,4843000,14999,False,147,scaffold_10
45,4848001,4854000,5999,False,147,scaffold_10
0,10001,93000,82999,False,147,scaffold_11
1,147001,167000,19999,False,147,scaffold_11
2,169001,191000,21999,False,147,scaffold_11
3,214001,235000,20999,False,147,scaffold_11
4,240001,248000,7999,False,147,scaffold_11
5,648001,656000,7999,False,147,scaffold_11
6,1025001,1034000,8999,False,147,scaffold_11
7,1219001,1243000,23999,False,147,scaffold_11
8,1279001,1294000,14999,False,147,scaffold_11
9,1304001,1314000,9999,False,147,scaffold_11
10,1315001,1398000,82999,False,147,scaffold_11
11,1432001,1469000,36999,False,147,scaffold_11
12,1474001,1478000,3999,False,147,scaffold_11
13,1528001,1548000,19999,False,147,scaffold_11
14,1571001,1600000,28999,False,147,scaffold_11
15,1855001,2007000,151999,False,147,scaffold_11
16,2008001,2034000,25999,False,147,scaffold_11
17,2035001,2055000,19999,False,147,scaffold_11
18,2086001,2172000,85999,False,147,scaffold_11
19,2177001,2234000,56999,False,147,scaffold_11
20,2674001,2919000,244999,False,147,scaffold_11
21,2950001,3030000,79999,False,147,scaffold_11
22,3081001,3514000,432999,False,147,scaffold_11
23,3517001,3615000,97999,False,147,scaffold_11
24,3616001,3721000,104999,False,147,scaffold_11
25,3744001,4015000,270999,False,147,scaffold_11
26,4016001,4163000,146999,False,147,scaffold_11
27,4173001,4710000,536999,False,147,scaffold_11
28,4713001,4766820,53819,True,147,scaffold_11
0,1,1498000,1497999,True,147,scaffold_12
1,1571001,1586000,14999,False,147,scaffold_12
2,1721001,1738000,16999,False,147,scaffold_12
3,1784001,1810000,25999,False,147,scaffold_12
4,1825001,1902000,76999,False,147,scaffold_12
5,1903001,2005000,101999,False,147,scaffold_12
6,2006001,2015000,8999,False,147,scaffold_12
7,2016001,2108000,91999,False,147,scaffold_12
8,2130001,2184000,53999,False,147,scaffold_12
9,2340001,2379000,38999,False,147,scaffold_12
10,2571001,2610000,38999,False,147,scaffold_12
11,2685001,2699000,13999,False,147,scaffold_12
0,1,342000,341999,True,148,scaffold_1
1,482001,498000,15999,False,148,scaffold_1
2,572001,643000,70999,False,148,scaffold_1
3,686001,756000,69999,False,148,scaffold_1
4,873001,903000,29999,False,148,scaffold_1
5,1273001,1292000,18999,False,148,scaffold_1
6,1610001,1660000,49999,False,148,scaffold_1
7,1811001,1901000,89999,False,148,scaffold_1
8,1905001,1964000,58999,False,148,scaffold_1
9,1965001,1984000,18999,False,148,scaffold_1
10,1987001,2016000,28999,False,148,scaffold_1
11,2363001,2387000,23999,False,148,scaffold_1
12,2449001,2517000,67999,False,148,scaffold_1
13,2564001,2579000,14999,False,148,scaffold_1
14,2729001,2746000,16999,False,148,scaffold_1
15,3172001,3209000,36999,False,148,scaffold_1
16,3450001,3480000,29999,False,148,scaffold_1
17,3714001,3879000,164999,False,148,scaffold_1
18,3901001,4028000,126999,False,148,scaffold_1
19,4062001,4116000,53999,False,148,scaffold_1
20,4315001,4382000,66999,False,148,scaffold_1
21,4718001,4782000,63999,False,148,scaffold_1
22,4919001,5028000,108999,False,148,scaffold_1
23,5050001,5064000,13999,False,148,scaffold_1
24,5087001,5116000,28999,False,148,scaffold_1
25,5438001,5451000,12999,False,148,scaffold_1
26,5482001,5512000,29999,False,148,scaffold_1
27,5535001,5586000,50999,False,148,scaffold_1
28,6108001,6153000,44999,False,148,scaffold_1
29,6201001,6381000,179999,False,148,scaffold_1
30,6384001,6509000,124999,False,148,scaffold_1
31,6543001,6559000,15999,False,148,scaffold_1
32,6832001,6851000,18999,False,148,scaffold_1
33,7038001,7247000,208999,False,148,scaffold_1
34,7248001,7589000,340999,False,148,scaffold_1
35,7590001,8656000,1065999,False,148,scaffold_1
36,8658001,9584000,925999,False,148,scaffold_1
37,9586001,10362000,775999,False,148,scaffold_1
38,10447001,10638000,190999,False,148,scaffold_1
39,10808001,10811000,2999,False,148,scaffold_1
40,10840001,10856000,15999,False,148,scaffold_1
41,10919001,10940000,20999,False,148,scaffold_1
42,11014001,11050000,35999,False,148,scaffold_1
43,11133001,11195000,61999,False,148,scaffold_1
44,11272001,11504000,231999,False,148,scaffold_1
45,11555001,11951000,395999,False,148,scaffold_1
46,12184001,12204000,19999,False,148,scaffold_1
47,12425001,12449000,23999,False,148,scaffold_1
48,12490001,12585000,94999,False,148,scaffold_1
49,12625001,12888000,262999,False,148,scaffold_1
50,12967001,13002000,34999,False,148,scaffold_1
51,13113001,13216000,102999,False,148,scaffold_1
52,13347001,13448000,100999,False,148,scaffold_1
53,13557001,13585000,27999,False,148,scaffold_1
54,13651001,13659000,7999,False,148,scaffold_1
55,13668001,13709000,40999,False,148,scaffold_1
56,13796001,13845000,48999,False,148,scaffold_1
57,13959001,13976000,16999,False,148,scaffold_1
58,14285001,14309000,23999,False,148,scaffold_1
0,21001,48000,26999,False,148,scaffold_2
1,93001,159000,65999,False,148,scaffold_2
2,168001,177000,8999,False,148,scaffold_2
3,302001,318000,15999,False,148,scaffold_2
4,333001,374000,40999,False,148,scaffold_2
5,379001,381000,1999,False,148,scaffold_2
6,732001,739000,6999,False,148,scaffold_2
7,1354001,1415000,60999,False,148,scaffold_2
8,2085001,2132000,46999,False,148,scaffold_2
9,2336001,2389000,52999,False,148,scaffold_2
10,2403001,2600000,196999,False,148,scaffold_2
11,2627001,2639000,11999,False,148,scaffold_2
12,2645001,2689000,43999,False,148,scaffold_2
13,2694001,2746000,51999,False,148,scaffold_2
14,2766001,2857000,90999,False,148,scaffold_2
15,2877001,2905000,27999,False,148,scaffold_2
16,2974001,3021000,46999,False,148,scaffold_2
17,3022001,3045000,22999,False,148,scaffold_2
18,3330001,3344000,13999,False,148,scaffold_2
19,3451001,3466000,14999,False,148,scaffold_2
20,3526001,3549000,22999,False,148,scaffold_2
21,3658001,3695000,36999,False,148,scaffold_2
22,3754001,3784000,29999,False,148,scaffold_2
23,3907001,3931000,23999,False,148,scaffold_2
24,4243001,4278000,34999,False,148,scaffold_2
25,4296001,4409000,112999,False,148,scaffold_2
26,4425001,4458000,32999,False,148,scaffold_2
27,4474001,4685000,210999,False,148,scaffold_2
28,4710001,4790000,79999,False,148,scaffold_2
29,4918001,4959000,40999,False,148,scaffold_2
30,5019001,5031000,11999,False,148,scaffold_2
31,5033001,5104000,70999,False,148,scaffold_2
32,5286001,5316000,29999,False,148,scaffold_2
33,5360001,5488000,127999,False,148,scaffold_2
34,5490001,5513000,22999,False,148,scaffold_2
35,5524001,5563000,38999,False,148,scaffold_2
36,5622001,5760000,137999,False,148,scaffold_2
37,5830001,5993000,162999,False,148,scaffold_2
38,6123001,6140000,16999,False,148,scaffold_2
39,6261001,6330000,68999,False,148,scaffold_2
40,6331001,6342000,10999,False,148,scaffold_2
41,6384001,6452000,67999,False,148,scaffold_2
42,6590001,6628000,37999,False,148,scaffold_2
43,7005001,7047000,41999,False,148,scaffold_2
44,7049001,7097000,47999,False,148,scaffold_2
45,7428001,7473000,44999,False,148,scaffold_2
46,7492001,7503000,10999,False,148,scaffold_2
47,7549001,7561000,11999,False,148,scaffold_2
48,7563001,7697000,133999,False,148,scaffold_2
49,7783001,7917000,133999,False,148,scaffold_2
50,7933001,8162000,228999,False,148,scaffold_2
51,8260001,8328000,67999,False,148,scaffold_2
52,8331001,8333000,1999,False,148,scaffold_2
53,8346001,8455000,108999,False,148,scaffold_2
54,8495001,8564000,68999,False,148,scaffold_2
55,9034001,9045000,10999,False,148,scaffold_2
56,9371001,9380000,8999,False,148,scaffold_2
57,9601001,9636000,34999,False,148,scaffold_2
58,9864001,9901000,36999,False,148,scaffold_2
59,11367001,11381000,13999,False,148,scaffold_2
60,11398001,11410000,11999,False,148,scaffold_2
61,11520001,11786000,265999,False,148,scaffold_2
62,11797001,11802476,5475,True,148,scaffold_2
0,51001,55000,3999,False,148,scaffold_3
1,218001,227000,8999,False,148,scaffold_3
2,618001,646000,27999,False,148,scaffold_3
3,799001,901000,101999,False,148,scaffold_3
4,960001,963000,2999,False,148,scaffold_3
5,1085001,1091000,5999,False,148,scaffold_3
6,1635001,1672000,36999,False,148,scaffold_3
7,1957001,1980000,22999,False,148,scaffold_3
8,2007001,2108000,100999,False,148,scaffold_3
9,2109001,2126000,16999,False,148,scaffold_3
10,2291001,2325000,33999,False,148,scaffold_3
11,2433001,2532000,98999,False,148,scaffold_3
12,2646001,2761000,114999,False,148,scaffold_3
13,3064001,3146000,81999,False,148,scaffold_3
14,3213001,3277000,63999,False,148,scaffold_3
15,3603001,3734000,130999,False,148,scaffold_3
16,3769001,3821000,51999,False,148,scaffold_3
17,3822001,3890000,67999,False,148,scaffold_3
18,3922001,3954000,31999,False,148,scaffold_3
19,3998001,4034000,35999,False,148,scaffold_3
20,4070001,4404000,333999,False,148,scaffold_3
21,4416001,4518000,101999,False,148,scaffold_3
22,4546001,4558000,11999,False,148,scaffold_3
23,4653001,4680000,26999,False,148,scaffold_3
24,4855001,4886000,30999,False,148,scaffold_3
25,5082001,5273000,190999,False,148,scaffold_3
26,5489001,5509000,19999,False,148,scaffold_3
27,5586001,5676000,89999,False,148,scaffold_3
28,5805001,6026000,220999,False,148,scaffold_3
29,6742001,6785000,42999,False,148,scaffold_3
30,6888001,7094000,205999,False,148,scaffold_3
31,7112001,7157000,44999,False,148,scaffold_3
32,7253001,7317000,63999,False,148,scaffold_3
33,7336001,7418000,81999,False,148,scaffold_3
34,7449001,7458000,8999,False,148,scaffold_3
35,7483001,7563000,79999,False,148,scaffold_3
36,7678001,7801000,122999,False,148,scaffold_3
37,7818001,7854000,35999,False,148,scaffold_3
38,8028001,8116000,87999,False,148,scaffold_3
39,8121001,8156000,34999,False,148,scaffold_3
40,8176001,8253000,76999,False,148,scaffold_3
41,8395001,8447000,51999,False,148,scaffold_3
42,8462001,8527000,64999,False,148,scaffold_3
43,8575001,8596000,20999,False,148,scaffold_3
44,8956001,8980000,23999,False,148,scaffold_3
45,9010001,9079000,68999,False,148,scaffold_3
46,9121001,9164000,42999,False,148,scaffold_3
47,9201001,9209000,7999,False,148,scaffold_3
48,9211001,9215000,3999,False,148,scaffold_3
49,9968001,9996000,27999,False,148,scaffold_3
50,10461001,10485000,23999,False,148,scaffold_3
51,10551001,10571000,19999,False,148,scaffold_3
52,10574001,11167000,592999,False,148,scaffold_3
0,11001,13000,1999,False,148,scaffold_4
1,14001,32000,17999,False,148,scaffold_4
2,49001,88000,38999,False,148,scaffold_4
3,121001,131000,9999,False,148,scaffold_4
4,132001,146000,13999,False,148,scaffold_4
5,147001,151000,3999,False,148,scaffold_4
6,155001,160000,4999,False,148,scaffold_4
7,161001,215000,53999,False,148,scaffold_4
8,218001,226000,7999,False,148,scaffold_4
9,227001,267000,39999,False,148,scaffold_4
10,290001,307000,16999,False,148,scaffold_4
11,313001,353000,39999,False,148,scaffold_4
12,355001,374000,18999,False,148,scaffold_4
13,412001,425000,12999,False,148,scaffold_4
14,429001,498000,68999,False,148,scaffold_4
15,545001,592000,46999,False,148,scaffold_4
16,608001,691000,82999,False,148,scaffold_4
17,701001,714000,12999,False,148,scaffold_4
18,1121001,1198000,76999,False,148,scaffold_4
19,1199001,1226000,26999,False,148,scaffold_4
20,1229001,1234000,4999,False,148,scaffold_4
21,1235001,1253000,17999,False,148,scaffold_4
22,1283001,1604000,320999,False,148,scaffold_4
23,1613001,2206000,592999,False,148,scaffold_4
24,2219001,2281000,61999,False,148,scaffold_4
25,2282001,2461000,178999,False,148,scaffold_4
26,2476001,2635000,158999,False,148,scaffold_4
27,2654001,2675000,20999,False,148,scaffold_4
28,2676001,2813000,136999,False,148,scaffold_4
29,2891001,2959000,67999,False,148,scaffold_4
30,3030001,3132000,101999,False,148,scaffold_4
31,3205001,3774000,568999,False,148,scaffold_4
32,4010001,4046000,35999,False,148,scaffold_4
33,4051001,4105000,53999,False,148,scaffold_4
34,4245001,4306000,60999,False,148,scaffold_4
35,4900001,5054000,153999,False,148,scaffold_4
36,5172001,5224000,51999,False,148,scaffold_4
37,5291001,5506000,214999,False,148,scaffold_4
38,5514001,5784000,269999,False,148,scaffold_4
39,5786001,5828000,41999,False,148,scaffold_4
40,5932001,5969000,36999,False,148,scaffold_4
41,6068001,6113000,44999,False,148,scaffold_4
42,6146001,6197000,50999,False,148,scaffold_4
43,6214001,6245000,30999,False,148,scaffold_4
44,6286001,6373000,86999,False,148,scaffold_4
45,6762001,6817000,54999,False,148,scaffold_4
46,6894001,6924000,29999,False,148,scaffold_4
47,6950001,6995000,44999,False,148,scaffold_4
48,7036001,7124000,87999,False,148,scaffold_4
49,7148001,7173000,24999,False,148,scaffold_4
50,7225001,7300000,74999,False,148,scaffold_4
51,7352001,7428000,75999,False,148,scaffold_4
52,7629001,7665000,35999,False,148,scaffold_4
53,7857001,7913000,55999,False,148,scaffold_4
54,7985001,7998000,12999,False,148,scaffold_4
55,8846001,9699000,852999,False,148,scaffold_4
56,9700001,9845951,145950,True,148,scaffold_4
0,1,4000,3999,True,148,scaffold_5
1,318001,387000,68999,False,148,scaffold_5
2,463001,526000,62999,False,148,scaffold_5
3,670001,697000,26999,False,148,scaffold_5
4,933001,947000,13999,False,148,scaffold_5
5,1062001,1079000,16999,False,148,scaffold_5
6,1355001,1392000,36999,False,148,scaffold_5
7,2092001,2099000,6999,False,148,scaffold_5
8,2475001,2493000,17999,False,148,scaffold_5
9,2510001,2515000,4999,False,148,scaffold_5
10,2562001,2871000,308999,False,148,scaffold_5
11,3133001,3519000,385999,False,148,scaffold_5
12,3616001,3662000,45999,False,148,scaffold_5
13,3962001,4101000,138999,False,148,scaffold_5
14,4120001,4220000,99999,False,148,scaffold_5
15,4232001,4319000,86999,False,148,scaffold_5
16,4444001,4554000,109999,False,148,scaffold_5
17,4589001,4862000,272999,False,148,scaffold_5
18,4883001,4923000,39999,False,148,scaffold_5
19,5059001,5097000,37999,False,148,scaffold_5
20,5258001,5274000,15999,False,148,scaffold_5
21,5286001,5311000,24999,False,148,scaffold_5
22,5315001,5346000,30999,False,148,scaffold_5
23,5517001,5526000,8999,False,148,scaffold_5
24,5723001,5738000,14999,False,148,scaffold_5
25,6393001,6420000,26999,False,148,scaffold_5
26,6451001,6669000,217999,False,148,scaffold_5
27,7406001,7441000,34999,False,148,scaffold_5
28,7454001,7484000,29999,False,148,scaffold_5
29,7523001,7746000,222999,False,148,scaffold_5
30,8435001,8468000,32999,False,148,scaffold_5
31,8550001,8616000,65999,False,148,scaffold_5
32,8638001,8689000,50999,False,148,scaffold_5
33,8708001,9364176,656175,True,148,scaffold_5
0,67001,74000,6999,False,148,scaffold_6
1,78001,84000,5999,False,148,scaffold_6
2,86001,113000,26999,False,148,scaffold_6
3,168001,208000,39999,False,148,scaffold_6
4,240001,254000,13999,False,148,scaffold_6
5,257001,263000,5999,False,148,scaffold_6
6,264001,296000,31999,False,148,scaffold_6
7,468001,482000,13999,False,148,scaffold_6
8,833001,848000,14999,False,148,scaffold_6
9,1018001,1038000,19999,False,148,scaffold_6
10,1125001,1227000,101999,False,148,scaffold_6
11,1229001,1264000,34999,False,148,scaffold_6
12,1284001,1309000,24999,False,148,scaffold_6
13,1478001,1546000,67999,False,148,scaffold_6
14,1559001,1597000,37999,False,148,scaffold_6
15,1657001,1716000,58999,False,148,scaffold_6
16,1843001,1906000,62999,False,148,scaffold_6
17,2023001,2104000,80999,False,148,scaffold_6
18,2124001,2213000,88999,False,148,scaffold_6
19,2237001,2284000,46999,False,148,scaffold_6
20,2334001,2595000,260999,False,148,scaffold_6
21,2596001,2872000,275999,False,148,scaffold_6
22,2932001,3024000,91999,False,148,scaffold_6
23,3099001,3211000,111999,False,148,scaffold_6
24,3224001,3350000,125999,False,148,scaffold_6
25,3351001,3786000,434999,False,148,scaffold_6
26,3810001,3846000,35999,False,148,scaffold_6
27,3898001,3932000,33999,False,148,scaffold_6
28,4016001,4195000,178999,False,148,scaffold_6
29,4838001,4875000,36999,False,148,scaffold_6
30,4898001,4916000,17999,False,148,scaffold_6
31,4961001,4994000,32999,False,148,scaffold_6
32,5720001,5788000,67999,False,148,scaffold_6
33,5863001,5972000,108999,False,148,scaffold_6
34,6009001,6088000,78999,False,148,scaffold_6
35,6125001,6190000,64999,False,148,scaffold_6
36,6776001,6804000,27999,False,148,scaffold_6
37,7073001,7085000,11999,False,148,scaffold_6
38,7255001,7337000,81999,False,148,scaffold_6
39,7389001,7475000,85999,False,148,scaffold_6
40,7536001,8268281,732280,True,148,scaffold_6
0,13001,34000,20999,False,148,scaffold_7
1,321001,340000,18999,False,148,scaffold_7
2,342001,508000,165999,False,148,scaffold_7
3,553001,563000,9999,False,148,scaffold_7
4,571001,577000,5999,False,148,scaffold_7
5,706001,736000,29999,False,148,scaffold_7
6,764001,826000,61999,False,148,scaffold_7
7,859001,864000,4999,False,148,scaffold_7
8,875001,963000,87999,False,148,scaffold_7
9,964001,966000,1999,False,148,scaffold_7
10,968001,980000,11999,False,148,scaffold_7
11,982001,1044000,61999,False,148,scaffold_7
12,1048001,1088000,39999,False,148,scaffold_7
13,1192001,1512000,319999,False,148,scaffold_7
14,1588001,1721000,132999,False,148,scaffold_7
15,1727001,1757000,29999,False,148,scaffold_7
16,1758001,1782000,23999,False,148,scaffold_7
17,1850001,1896000,45999,False,148,scaffold_7
18,1973001,2017000,43999,False,148,scaffold_7
19,3305001,3369000,63999,False,148,scaffold_7
20,3524001,3808000,283999,False,148,scaffold_7
21,4415001,4512000,96999,False,148,scaffold_7
22,4658001,4734000,75999,False,148,scaffold_7
23,4896001,4909000,12999,False,148,scaffold_7
24,4979001,5169000,189999,False,148,scaffold_7
25,5482001,5536000,53999,False,148,scaffold_7
26,6075001,6094000,18999,False,148,scaffold_7
27,6171001,6202000,30999,False,148,scaffold_7
28,6580001,6676000,95999,False,148,scaffold_7
29,6953001,7270000,316999,False,148,scaffold_7
30,7271001,7502216,231215,True,148,scaffold_7
0,1,6000,5999,True,148,scaffold_8
1,67001,85000,17999,False,148,scaffold_8
2,541001,549000,7999,False,148,scaffold_8
3,2358001,2396000,37999,False,148,scaffold_8
4,2424001,2530000,105999,False,148,scaffold_8
5,2536001,2552000,15999,False,148,scaffold_8
6,2649001,2683000,33999,False,148,scaffold_8
7,2684001,2844000,159999,False,148,scaffold_8
8,2847001,2911000,63999,False,148,scaffold_8
9,2949001,3554000,604999,False,148,scaffold_8
10,3578001,3612000,33999,False,148,scaffold_8
11,3615001,3938000,322999,False,148,scaffold_8
12,4014001,4143000,128999,False,148,scaffold_8
13,4732001,4777000,44999,False,148,scaffold_8
14,4810001,4848000,37999,False,148,scaffold_8
15,4893001,4916000,22999,False,148,scaffold_8
16,5083001,5137000,53999,False,148,scaffold_8
17,5163001,5243000,79999,False,148,scaffold_8
18,5579001,5596000,16999,False,148,scaffold_8
19,5650001,5723000,72999,False,148,scaffold_8
20,5727001,5775000,47999,False,148,scaffold_8
21,5776001,5803000,26999,False,148,scaffold_8
22,5837001,5879000,41999,False,148,scaffold_8
23,5881001,5907000,25999,False,148,scaffold_8
24,6321001,6334544,13543,True,148,scaffold_8
0,1001,17000,15999,False,148,scaffold_9
1,109001,117000,7999,False,148,scaffold_9
2,121001,137000,15999,False,148,scaffold_9
3,366001,411000,44999,False,148,scaffold_9
4,413001,434000,20999,False,148,scaffold_9
5,501001,531000,29999,False,148,scaffold_9
6,670001,696000,25999,False,148,scaffold_9
7,732001,741000,8999,False,148,scaffold_9
8,815001,842000,26999,False,148,scaffold_9
9,873001,986000,112999,False,148,scaffold_9
10,987001,995000,7999,False,148,scaffold_9
11,1001001,1007000,5999,False,148,scaffold_9
12,1009001,1085000,75999,False,148,scaffold_9
13,1087001,1150000,62999,False,148,scaffold_9
14,1151001,1177000,25999,False,148,scaffold_9
15,1202001,1257000,54999,False,148,scaffold_9
16,1313001,1383000,69999,False,148,scaffold_9
17,1428001,1441000,12999,False,148,scaffold_9
18,1457001,1464000,6999,False,148,scaffold_9
19,1487001,1499000,11999,False,148,scaffold_9
20,1502001,1614000,111999,False,148,scaffold_9
21,1652001,1692000,39999,False,148,scaffold_9
22,1749001,1791000,41999,False,148,scaffold_9
23,1823001,1853000,29999,False,148,scaffold_9
24,1893001,1957000,63999,False,148,scaffold_9
25,1987001,2058000,70999,False,148,scaffold_9
26,2076001,2171000,94999,False,148,scaffold_9
27,2174001,2231000,56999,False,148,scaffold_9
28,2232001,2239000,6999,False,148,scaffold_9
29,2390001,2445000,54999,False,148,scaffold_9
30,2510001,2545000,34999,False,148,scaffold_9
31,2587001,2671000,83999,False,148,scaffold_9
32,2735001,3381000,645999,False,148,scaffold_9
33,3383001,5107000,1723999,False,148,scaffold_9
34,5112001,5114000,1999,False,148,scaffold_9
35,5116001,5238000,121999,False,148,scaffold_9
36,5239001,5298000,58999,False,148,scaffold_9
37,5299001,6331288,1032287,True,148,scaffold_9
0,1,136000,135999,True,148,scaffold_10
1,137001,414000,276999,False,148,scaffold_10
2,415001,482000,66999,False,148,scaffold_10
3,483001,582000,98999,False,148,scaffold_10
4,597001,797000,199999,False,148,scaffold_10
5,888001,921000,32999,False,148,scaffold_10
6,923001,1069000,145999,False,148,scaffold_10
7,1073001,1154000,80999,False,148,scaffold_10
8,1313001,1337000,23999,False,148,scaffold_10
9,1381001,1471000,89999,False,148,scaffold_10
10,1499001,1568000,68999,False,148,scaffold_10
11,1635001,1662000,26999,False,148,scaffold_10
12,1806001,1817000,10999,False,148,scaffold_10
13,2012001,2072000,59999,False,148,scaffold_10
14,2075001,2114000,38999,False,148,scaffold_10
15,2131001,2178000,46999,False,148,scaffold_10
16,2197001,2238000,40999,False,148,scaffold_10
17,2268001,2333000,64999,False,148,scaffold_10
18,2334001,2425000,90999,False,148,scaffold_10
19,2433001,2476000,42999,False,148,scaffold_10
20,2514001,2520000,5999,False,148,scaffold_10
21,2521001,2653000,131999,False,148,scaffold_10
22,2673001,2708000,34999,False,148,scaffold_10
23,2735001,2813000,77999,False,148,scaffold_10
24,2936001,2955000,18999,False,148,scaffold_10
25,3154001,3185000,30999,False,148,scaffold_10
26,3394001,3423000,28999,False,148,scaffold_10
27,3778001,3795000,16999,False,148,scaffold_10
28,4053001,4091000,37999,False,148,scaffold_10
29,4154001,4181000,26999,False,148,scaffold_10
30,4338001,4358000,19999,False,148,scaffold_10
31,4443001,4462000,18999,False,148,scaffold_10
32,4467001,4476000,8999,False,148,scaffold_10
33,4503001,4513000,9999,False,148,scaffold_10
34,4515001,4523000,7999,False,148,scaffold_10
35,4526001,4548000,21999,False,148,scaffold_10
36,4577001,4595000,17999,False,148,scaffold_10
37,4681001,4688000,6999,False,148,scaffold_10
38,4734001,4776000,41999,False,148,scaffold_10
39,4798001,4824000,25999,False,148,scaffold_10
40,4828001,4843000,14999,False,148,scaffold_10
41,4848001,4861000,12999,False,148,scaffold_10
42,4865001,4866973,1972,True,148,scaffold_10
0,11001,99000,87999,False,148,scaffold_11
1,149001,167000,17999,False,148,scaffold_11
2,169001,212000,42999,False,148,scaffold_11
3,214001,235000,20999,False,148,scaffold_11
4,240001,248000,7999,False,148,scaffold_11
5,419001,431000,11999,False,148,scaffold_11
6,648001,656000,7999,False,148,scaffold_11
7,781001,785000,3999,False,148,scaffold_11
8,1025001,1034000,8999,False,148,scaffold_11
9,1325001,1339000,13999,False,148,scaffold_11
10,1403001,1409000,5999,False,148,scaffold_11
11,1423001,1426000,2999,False,148,scaffold_11
12,1431001,1449000,17999,False,148,scaffold_11
13,1474001,1478000,3999,False,148,scaffold_11
14,1572001,1599000,26999,False,148,scaffold_11
15,1969001,1982000,12999,False,148,scaffold_11
16,2674001,2909000,234999,False,148,scaffold_11
17,2950001,3019000,68999,False,148,scaffold_11
18,3083001,3297000,213999,False,148,scaffold_11
19,3299001,3383000,83999,False,148,scaffold_11
20,3423001,3479000,55999,False,148,scaffold_11
21,3520001,3695000,174999,False,148,scaffold_11
22,3700001,3972000,271999,False,148,scaffold_11
23,3982001,4159000,176999,False,148,scaffold_11
24,4179001,4710000,530999,False,148,scaffold_11
25,4713001,4766820,53819,True,148,scaffold_11
0,1,1498000,1497999,True,148,scaffold_12
1,1720001,1735000,14999,False,148,scaffold_12
2,1784001,1807000,22999,False,148,scaffold_12
3,1926001,1962000,35999,False,148,scaffold_12
4,2048001,2103000,54999,False,148,scaffold_12
5,2136001,2181000,44999,False,148,scaffold_12
6,2336001,2378000,41999,False,148,scaffold_12
7,2571001,2610000,38999,False,148,scaffold_12
8,2685001,2699000,13999,False,148,scaffold_12
9,2747001,2747968,967,True,148,scaffold_12
0,1,342000,341999,True,149,scaffold_1
1,482001,498000,15999,False,149,scaffold_1
2,570001,643000,72999,False,149,scaffold_1
3,686001,758000,71999,False,149,scaffold_1
4,1281001,1292000,10999,False,149,scaffold_1
5,1615001,1660000,44999,False,149,scaffold_1
6,1812001,1934000,121999,False,149,scaffold_1
7,1950001,1984000,33999,False,149,scaffold_1
8,1986001,2015000,28999,False,149,scaffold_1
9,2347001,2387000,39999,False,149,scaffold_1
10,2449001,2519000,69999,False,149,scaffold_1
11,2568001,2579000,10999,False,149,scaffold_1
12,2729001,2746000,16999,False,149,scaffold_1
13,3173001,3209000,35999,False,149,scaffold_1
14,3446001,3499000,52999,False,149,scaffold_1
15,3703001,3879000,175999,False,149,scaffold_1
16,3901001,3941000,39999,False,149,scaffold_1
17,3956001,4030000,73999,False,149,scaffold_1
18,4062001,4117000,54999,False,149,scaffold_1
19,4304001,4400000,95999,False,149,scaffold_1
20,4462001,4549000,86999,False,149,scaffold_1
21,4717001,4788000,70999,False,149,scaffold_1
22,4796001,4814000,17999,False,149,scaffold_1
23,4927001,5025000,97999,False,149,scaffold_1
24,5087001,5114000,26999,False,149,scaffold_1
25,5481001,5512000,30999,False,149,scaffold_1
26,5534001,5579000,44999,False,149,scaffold_1
27,5858001,5870000,11999,False,149,scaffold_1
28,6108001,6153000,44999,False,149,scaffold_1
29,6154001,6177000,22999,False,149,scaffold_1
30,6202001,6512000,309999,False,149,scaffold_1
31,6542001,6555000,12999,False,149,scaffold_1
32,7038001,7247000,208999,False,149,scaffold_1
33,7248001,8477000,1228999,False,149,scaffold_1
34,8478001,8656000,177999,False,149,scaffold_1
35,8658001,9584000,925999,False,149,scaffold_1
36,9586001,10368000,781999,False,149,scaffold_1
37,10461001,10636000,174999,False,149,scaffold_1
38,10737001,10755000,17999,False,149,scaffold_1
39,10808001,10811000,2999,False,149,scaffold_1
40,10840001,10855000,14999,False,149,scaffold_1
41,10918001,10966000,47999,False,149,scaffold_1
42,11014001,11031000,16999,False,149,scaffold_1
43,11278001,11509000,230999,False,149,scaffold_1
44,11550001,11957000,406999,False,149,scaffold_1
45,12183001,12204000,20999,False,149,scaffold_1
46,12425001,12448000,22999,False,149,scaffold_1
47,12522001,12581000,58999,False,149,scaffold_1
48,12652001,12722000,69999,False,149,scaffold_1
49,12776001,12888000,111999,False,149,scaffold_1
50,12899001,12950000,50999,False,149,scaffold_1
51,12974001,13002000,27999,False,149,scaffold_1
52,13113001,13211000,97999,False,149,scaffold_1
53,13346001,13448000,101999,False,149,scaffold_1
54,13559001,13590000,30999,False,149,scaffold_1
55,13663001,13709000,45999,False,149,scaffold_1
56,13787001,13845000,57999,False,149,scaffold_1
57,13847001,13875000,27999,False,149,scaffold_1
58,13928001,13954000,25999,False,149,scaffold_1
59,13959001,13994000,34999,False,149,scaffold_1
60,14285001,14310000,24999,False,149,scaffold_1
61,14541001,14566000,24999,False,149,scaffold_1
62,14595001,14601000,5999,False,149,scaffold_1
63,14789001,14794116,5115,True,149,scaffold_1
0,21001,48000,26999,False,149,scaffold_2
1,93001,159000,65999,False,149,scaffold_2
2,168001,177000,8999,False,149,scaffold_2
3,303001,318000,14999,False,149,scaffold_2
4,330001,374000,43999,False,149,scaffold_2
5,1351001,1408000,56999,False,149,scaffold_2
6,2085001,2133000,47999,False,149,scaffold_2
7,2336001,2424000,87999,False,149,scaffold_2
8,2440001,2609000,168999,False,149,scaffold_2
9,2660001,2689000,28999,False,149,scaffold_2
10,2693001,2746000,52999,False,149,scaffold_2
11,2805001,2855000,49999,False,149,scaffold_2
12,2868001,2906000,37999,False,149,scaffold_2
13,2975001,3012000,36999,False,149,scaffold_2
14,3174001,3186000,11999,False,149,scaffold_2
15,3333001,3344000,10999,False,149,scaffold_2
16,3449001,3480000,30999,False,149,scaffold_2
17,3659001,3691000,31999,False,149,scaffold_2
18,3754001,3784000,29999,False,149,scaffold_2
19,4243001,4278000,34999,False,149,scaffold_2
20,4338001,4409000,70999,False,149,scaffold_2
21,4425001,4460000,34999,False,149,scaffold_2
22,4515001,4657000,141999,False,149,scaffold_2
23,4699001,4790000,90999,False,149,scaffold_2
24,4793001,4810000,16999,False,149,scaffold_2
25,4917001,4962000,44999,False,149,scaffold_2
26,5021001,5104000,82999,False,149,scaffold_2
27,5351001,5393000,41999,False,149,scaffold_2
28,5413001,5481000,67999,False,149,scaffold_2
29,5490001,5518000,27999,False,149,scaffold_2
30,5658001,5758000,99999,False,149,scaffold_2
31,5840001,5891000,50999,False,149,scaffold_2
32,5908001,5996000,87999,False,149,scaffold_2
33,6005001,6021000,15999,False,149,scaffold_2
34,6122001,6138000,15999,False,149,scaffold_2
35,6261001,6351000,89999,False,149,scaffold_2
36,6375001,6450000,74999,False,149,scaffold_2
37,6590001,6628000,37999,False,149,scaffold_2
38,6941001,6978000,36999,False,149,scaffold_2
39,7006001,7038000,31999,False,149,scaffold_2
40,7049001,7097000,47999,False,149,scaffold_2
41,7439001,7473000,33999,False,149,scaffold_2
42,7493001,7500000,6999,False,149,scaffold_2
43,7549001,7561000,11999,False,149,scaffold_2
44,7563001,7706000,142999,False,149,scaffold_2
45,7780001,7891000,110999,False,149,scaffold_2
46,7934001,8161000,226999,False,149,scaffold_2
47,8261001,8313000,51999,False,149,scaffold_2
48,8346001,8455000,108999,False,149,scaffold_2
49,8507001,8564000,56999,False,149,scaffold_2
50,9033001,9046000,12999,False,149,scaffold_2
51,9140001,9175000,34999,False,149,scaffold_2
52,9610001,9623000,12999,False,149,scaffold_2
53,9673001,9706000,32999,False,149,scaffold_2
54,9868001,9904000,35999,False,149,scaffold_2
55,10995001,10998000,2999,False,149,scaffold_2
56,11366001,11383000,16999,False,149,scaffold_2
57,11395001,11421000,25999,False,149,scaffold_2
58,11520001,11786000,265999,False,149,scaffold_2
59,11797001,11802476,5475,True,149,scaffold_2
0,218001,232000,13999,False,149,scaffold_3
1,796001,900000,103999,False,149,scaffold_3
2,1584001,1618000,33999,False,149,scaffold_3
3,1937001,1967000,29999,False,149,scaffold_3
4,2007001,2108000,100999,False,149,scaffold_3
5,2109001,2116000,6999,False,149,scaffold_3
6,2287001,2336000,48999,False,149,scaffold_3
7,2395001,2428000,32999,False,149,scaffold_3
8,2485001,2531000,45999,False,149,scaffold_3
9,2648001,2759000,110999,False,149,scaffold_3
10,3066001,3144000,77999,False,149,scaffold_3
11,3229001,3245000,15999,False,149,scaffold_3
12,3602001,3643000,40999,False,149,scaffold_3
13,3772001,3820000,47999,False,149,scaffold_3
14,3822001,3892000,69999,False,149,scaffold_3
15,3927001,3947000,19999,False,149,scaffold_3
16,4007001,4038000,30999,False,149,scaffold_3
17,4066001,4403000,336999,False,149,scaffold_3
18,4416001,4518000,101999,False,149,scaffold_3
19,4546001,4564000,17999,False,149,scaffold_3
20,4567001,4575000,7999,False,149,scaffold_3
21,4652001,4680000,27999,False,149,scaffold_3
22,4999001,5033000,33999,False,149,scaffold_3
23,5164001,5208000,43999,False,149,scaffold_3
24,5491001,5509000,17999,False,149,scaffold_3
25,5623001,5676000,52999,False,149,scaffold_3
26,5807001,5947000,139999,False,149,scaffold_3
27,5957001,6025000,67999,False,149,scaffold_3
28,6744001,6784000,39999,False,149,scaffold_3
29,6887001,7097000,209999,False,149,scaffold_3
30,7110001,7157000,46999,False,149,scaffold_3
31,7280001,7315000,34999,False,149,scaffold_3
32,7335001,7402000,66999,False,149,scaffold_3
33,7449001,7460000,10999,False,149,scaffold_3
34,7508001,7556000,47999,False,149,scaffold_3
35,7676001,7857000,180999,False,149,scaffold_3
36,8028001,8106000,77999,False,149,scaffold_3
37,8175001,8253000,77999,False,149,scaffold_3
38,8401001,8527000,125999,False,149,scaffold_3
39,8575001,8594000,18999,False,149,scaffold_3
40,8957001,8980000,22999,False,149,scaffold_3
41,9005001,9080000,74999,False,149,scaffold_3
42,9106001,9151000,44999,False,149,scaffold_3
43,9220001,9240000,19999,False,149,scaffold_3
44,9654001,9672000,17999,False,149,scaffold_3
45,9968001,9996000,27999,False,149,scaffold_3
46,10058001,10089000,30999,False,149,scaffold_3
47,10461001,10485000,23999,False,149,scaffold_3
48,10575001,11182071,607070,True,149,scaffold_3
0,1,7000,6999,True,149,scaffold_4
1,17001,32000,14999,False,149,scaffold_4
2,49001,88000,38999,False,149,scaffold_4
3,120001,146000,25999,False,149,scaffold_4
4,147001,151000,3999,False,149,scaffold_4
5,155001,215000,59999,False,149,scaffold_4
6,217001,226000,8999,False,149,scaffold_4
7,227001,266000,38999,False,149,scaffold_4
8,290001,342000,51999,False,149,scaffold_4
9,355001,374000,18999,False,149,scaffold_4
10,390001,410000,19999,False,149,scaffold_4
11,412001,425000,12999,False,149,scaffold_4
12,429001,500000,70999,False,149,scaffold_4
13,542001,606000,63999,False,149,scaffold_4
14,608001,691000,82999,False,149,scaffold_4
15,1043001,1047000,3999,False,149,scaffold_4
16,1121001,1136000,14999,False,149,scaffold_4
17,1137001,1198000,60999,False,149,scaffold_4
18,1199001,1226000,26999,False,149,scaffold_4
19,1229001,1261000,31999,False,149,scaffold_4
20,1268001,1279000,10999,False,149,scaffold_4
21,1283001,1604000,320999,False,149,scaffold_4
22,1609001,1611000,1999,False,149,scaffold_4
23,1613001,2206000,592999,False,149,scaffold_4
24,2210001,2218000,7999,False,149,scaffold_4
25,2219001,2281000,61999,False,149,scaffold_4
26,2282001,2310000,27999,False,149,scaffold_4
27,2312001,2462000,149999,False,149,scaffold_4
28,2480001,2635000,154999,False,149,scaffold_4
29,2676001,2795000,118999,False,149,scaffold_4
30,2896001,2966000,69999,False,149,scaffold_4
31,3030001,3130000,99999,False,149,scaffold_4
32,3205001,3263000,57999,False,149,scaffold_4
33,3295001,3769000,473999,False,149,scaffold_4
34,4057001,4108000,50999,False,149,scaffold_4
35,4910001,5089000,178999,False,149,scaffold_4
36,5173001,5224000,50999,False,149,scaffold_4
37,5340001,5374000,33999,False,149,scaffold_4
38,5475001,5506000,30999,False,149,scaffold_4
39,5514001,5620000,105999,False,149,scaffold_4
40,5659001,5784000,124999,False,149,scaffold_4
41,5786001,5819000,32999,False,149,scaffold_4
42,5952001,5970000,17999,False,149,scaffold_4
43,6146001,6196000,49999,False,149,scaffold_4
44,6214001,6244000,29999,False,149,scaffold_4
45,6765001,6817000,51999,False,149,scaffold_4
46,6893001,6924000,30999,False,149,scaffold_4
47,6950001,6995000,44999,False,149,scaffold_4
48,7036001,7124000,87999,False,149,scaffold_4
49,7193001,7290000,96999,False,149,scaffold_4
50,7347001,7392000,44999,False,149,scaffold_4
51,7641001,7665000,23999,False,149,scaffold_4
52,8846001,9699000,852999,False,149,scaffold_4
53,9700001,9845951,145950,True,149,scaffold_4
0,1,4000,3999,True,149,scaffold_5
1,152001,165000,12999,False,149,scaffold_5
2,319001,420000,100999,False,149,scaffold_5
3,463001,526000,62999,False,149,scaffold_5
4,668001,697000,28999,False,149,scaffold_5
5,802001,832000,29999,False,149,scaffold_5
6,931001,947000,15999,False,149,scaffold_5
7,1062001,1080000,17999,False,149,scaffold_5
8,1081001,1104000,22999,False,149,scaffold_5
9,1368001,1394000,25999,False,149,scaffold_5
10,2083001,2104000,20999,False,149,scaffold_5
11,2475001,2494000,18999,False,149,scaffold_5
12,2516001,2606000,89999,False,149,scaffold_5
13,2614001,2874000,259999,False,149,scaffold_5
14,3132001,3189000,56999,False,149,scaffold_5
15,3216001,3510000,293999,False,149,scaffold_5
16,3616001,3658000,41999,False,149,scaffold_5
17,3962001,4101000,138999,False,149,scaffold_5
18,4119001,4221000,101999,False,149,scaffold_5
19,4227001,4273000,45999,False,149,scaffold_5
20,4444001,4552000,107999,False,149,scaffold_5
21,4591001,4925000,333999,False,149,scaffold_5
22,5059001,5093000,33999,False,149,scaffold_5
23,5217001,5312000,94999,False,149,scaffold_5
24,5314001,5345000,30999,False,149,scaffold_5
25,5515001,5528000,12999,False,149,scaffold_5
26,5722001,5738000,15999,False,149,scaffold_5
27,5815001,5845000,29999,False,149,scaffold_5
28,6407001,6424000,16999,False,149,scaffold_5
29,6478001,6654000,175999,False,149,scaffold_5
30,6891001,6903000,11999,False,149,scaffold_5
31,7454001,7514000,59999,False,149,scaffold_5
32,7558001,7619000,60999,False,149,scaffold_5
33,7621001,7668000,46999,False,149,scaffold_5
34,7673001,7745000,71999,False,149,scaffold_5
35,8549001,8616000,66999,False,149,scaffold_5
36,8640001,8689000,48999,False,149,scaffold_5
37,8712001,9364176,652175,True,149,scaffold_5
0,65001,75000,9999,False,149,scaffold_6
1,79001,84000,4999,False,149,scaffold_6
2,86001,116000,29999,False,149,scaffold_6
3,166001,208000,41999,False,149,scaffold_6
4,239001,316000,76999,False,149,scaffold_6
5,468001,486000,17999,False,149,scaffold_6
6,732001,758000,25999,False,149,scaffold_6
7,990001,1038000,47999,False,149,scaffold_6
8,1122001,1227000,104999,False,149,scaffold_6
9,1228001,1264000,35999,False,149,scaffold_6
10,1284001,1311000,26999,False,149,scaffold_6
11,1478001,1548000,69999,False,149,scaffold_6
12,1562001,1597000,34999,False,149,scaffold_6
13,1656001,1737000,80999,False,149,scaffold_6
14,1868001,1906000,37999,False,149,scaffold_6
15,2026001,2104000,77999,False,149,scaffold_6
16,2130001,2214000,83999,False,149,scaffold_6
17,2237001,2265000,27999,False,149,scaffold_6
18,2336001,2872000,535999,False,149,scaffold_6
19,2933001,3024000,90999,False,149,scaffold_6
20,3111001,3209000,97999,False,149,scaffold_6
21,3223001,3350000,126999,False,149,scaffold_6
22,3351001,3793000,441999,False,149,scaffold_6
23,3898001,3913000,14999,False,149,scaffold_6
24,4018001,4195000,176999,False,149,scaffold_6
25,4836001,4872000,35999,False,149,scaffold_6
26,4910001,4916000,5999,False,149,scaffold_6
27,4954001,4997000,42999,False,149,scaffold_6
28,5862001,5956000,93999,False,149,scaffold_6
29,6003001,6082000,78999,False,149,scaffold_6
30,6123001,6190000,66999,False,149,scaffold_6
31,6776001,6804000,27999,False,149,scaffold_6
32,7221001,7337000,115999,False,149,scaffold_6
33,7387001,7436000,48999,False,149,scaffold_6
34,7553001,8268281,715280,True,149,scaffold_6
0,13001,31000,17999,False,149,scaffold_7
1,323001,341000,17999,False,149,scaffold_7
2,342001,508000,165999,False,149,scaffold_7
3,622001,641000,18999,False,149,scaffold_7
4,654001,675000,20999,False,149,scaffold_7
5,706001,736000,29999,False,149,scaffold_7
6,740001,753000,12999,False,149,scaffold_7
7,764001,843000,78999,False,149,scaffold_7
8,859001,864000,4999,False,149,scaffold_7
9,868001,945000,76999,False,149,scaffold_7
10,964001,966000,1999,False,149,scaffold_7
11,968001,980000,11999,False,149,scaffold_7
12,982001,1044000,61999,False,149,scaffold_7
13,1048001,1104000,55999,False,149,scaffold_7
14,1160001,1187000,26999,False,149,scaffold_7
15,1191001,1459000,267999,False,149,scaffold_7
16,1461001,1513000,51999,False,149,scaffold_7
17,1588001,1696000,107999,False,149,scaffold_7
18,1740001,1782000,41999,False,149,scaffold_7
19,1848001,1893000,44999,False,149,scaffold_7
20,1972001,2003000,30999,False,149,scaffold_7
21,2851001,2869000,17999,False,149,scaffold_7
22,3198001,3229000,30999,False,149,scaffold_7
23,3252001,3270000,17999,False,149,scaffold_7
24,3299001,3315000,15999,False,149,scaffold_7
25,3319001,3320000,999,False,149,scaffold_7
26,3321001,3370000,48999,False,149,scaffold_7
27,3523001,3768000,244999,False,149,scaffold_7
28,3950001,3967000,16999,False,149,scaffold_7
29,4027001,4047000,19999,False,149,scaffold_7
30,4322001,4361000,38999,False,149,scaffold_7
31,4415001,4503000,87999,False,149,scaffold_7
32,4522001,4578000,55999,False,149,scaffold_7
33,4642001,4745000,102999,False,149,scaffold_7
34,4978001,5168000,189999,False,149,scaffold_7
35,5482001,5537000,54999,False,149,scaffold_7
36,6693001,6720000,26999,False,149,scaffold_7
37,6766001,6783000,16999,False,149,scaffold_7
38,6954001,7270000,315999,False,149,scaffold_7
39,7271001,7502216,231215,True,149,scaffold_7
0,1,6000,5999,True,149,scaffold_8
1,66001,85000,18999,False,149,scaffold_8
2,541001,549000,7999,False,149,scaffold_8
3,2420001,2471000,50999,False,149,scaffold_8
4,2491001,2530000,38999,False,149,scaffold_8
5,2537001,2551000,13999,False,149,scaffold_8
6,2650001,2844000,193999,False,149,scaffold_8
7,2846001,2888000,41999,False,149,scaffold_8
8,3000001,3125000,124999,False,149,scaffold_8
9,3126001,3525000,398999,False,149,scaffold_8
10,3581001,3612000,30999,False,149,scaffold_8
11,3615001,3938000,322999,False,149,scaffold_8
12,4034001,4111000,76999,False,149,scaffold_8
13,4206001,4219000,12999,False,149,scaffold_8
14,4397001,4434000,36999,False,149,scaffold_8
15,4748001,4771000,22999,False,149,scaffold_8
16,5083001,5244000,160999,False,149,scaffold_8
17,5578001,5596000,17999,False,149,scaffold_8
18,5661001,5695000,33999,False,149,scaffold_8
19,5750001,5775000,24999,False,149,scaffold_8
20,5776001,5806000,29999,False,149,scaffold_8
21,5807001,5903000,95999,False,149,scaffold_8
22,6036001,6079000,42999,False,149,scaffold_8
23,6321001,6334544,13543,True,149,scaffold_8
0,1,21000,20999,True,149,scaffold_9
1,109001,111000,1999,False,149,scaffold_9
2,366001,411000,44999,False,149,scaffold_9
3,413001,434000,20999,False,149,scaffold_9
4,502001,531000,28999,False,149,scaffold_9
5,547001,564000,16999,False,149,scaffold_9
6,660001,665000,4999,False,149,scaffold_9
7,671001,697000,25999,False,149,scaffold_9
8,814001,842000,27999,False,149,scaffold_9
9,873001,986000,112999,False,149,scaffold_9
10,988001,995000,6999,False,149,scaffold_9
11,1008001,1150000,141999,False,149,scaffold_9
12,1151001,1160000,8999,False,149,scaffold_9
13,1203001,1257000,53999,False,149,scaffold_9
14,1313001,1390000,76999,False,149,scaffold_9
15,1404001,1423000,18999,False,149,scaffold_9
16,1428001,1441000,12999,False,149,scaffold_9
17,1520001,1586000,65999,False,149,scaffold_9
18,1599001,1625000,25999,False,149,scaffold_9
19,1637001,1682000,44999,False,149,scaffold_9
20,1749001,1807000,57999,False,149,scaffold_9
21,1840001,1848000,7999,False,149,scaffold_9
22,1886001,1957000,70999,False,149,scaffold_9
23,1987001,2135000,147999,False,149,scaffold_9
24,2137001,2239000,101999,False,149,scaffold_9
25,2410001,2442000,31999,False,149,scaffold_9
26,2594001,2632000,37999,False,149,scaffold_9
27,2735001,3381000,645999,False,149,scaffold_9
28,3383001,5107000,1723999,False,149,scaffold_9
29,5112001,5238000,125999,False,149,scaffold_9
30,5239001,5298000,58999,False,149,scaffold_9
31,5299001,6331288,1032287,True,149,scaffold_9
0,1,414000,413999,True,149,scaffold_10
1,415001,482000,66999,False,149,scaffold_10
2,483001,576000,92999,False,149,scaffold_10
3,596001,796000,199999,False,149,scaffold_10
4,813001,833000,19999,False,149,scaffold_10
5,888001,1069000,180999,False,149,scaffold_10
6,1090001,1148000,57999,False,149,scaffold_10
7,1387001,1473000,85999,False,149,scaffold_10
8,1806001,1817000,10999,False,149,scaffold_10
9,2041001,2060000,18999,False,149,scaffold_10
10,2078001,2103000,24999,False,149,scaffold_10
11,2140001,2170000,29999,False,149,scaffold_10
12,2197001,2459000,261999,False,149,scaffold_10
13,2513001,2520000,6999,False,149,scaffold_10
14,2551001,2575000,23999,False,149,scaffold_10
15,2600001,2653000,52999,False,149,scaffold_10
16,2670001,2748000,77999,False,149,scaffold_10
17,2942001,2953000,10999,False,149,scaffold_10
18,3110001,3130000,19999,False,149,scaffold_10
19,3154001,3177000,22999,False,149,scaffold_10
20,3395001,3424000,28999,False,149,scaffold_10
21,3469001,3476000,6999,False,149,scaffold_10
22,4051001,4090000,38999,False,149,scaffold_10
23,4154001,4174000,19999,False,149,scaffold_10
24,4335001,4362000,26999,False,149,scaffold_10
25,4443001,4462000,18999,False,149,scaffold_10
26,4467001,4477000,9999,False,149,scaffold_10
27,4497001,4513000,15999,False,149,scaffold_10
28,4515001,4523000,7999,False,149,scaffold_10
29,4526001,4548000,21999,False,149,scaffold_10
30,4554001,4562000,7999,False,149,scaffold_10
31,4574001,4596000,21999,False,149,scaffold_10
32,4679001,4688000,8999,False,149,scaffold_10
33,4735001,4776000,40999,False,149,scaffold_10
34,4798001,4824000,25999,False,149,scaffold_10
35,4828001,4843000,14999,False,149,scaffold_10
36,4848001,4861000,12999,False,149,scaffold_10
37,4865001,4866973,1972,True,149,scaffold_10
0,10001,93000,82999,False,149,scaffold_11
1,147001,167000,19999,False,149,scaffold_11
2,169001,212000,42999,False,149,scaffold_11
3,214001,236000,21999,False,149,scaffold_11
4,240001,248000,7999,False,149,scaffold_11
5,296001,317000,20999,False,149,scaffold_11
6,419001,431000,11999,False,149,scaffold_11
7,637001,656000,18999,False,149,scaffold_11
8,1025001,1034000,8999,False,149,scaffold_11
9,1403001,1409000,5999,False,149,scaffold_11
10,1423001,1426000,2999,False,149,scaffold_11
11,1474001,1478000,3999,False,149,scaffold_11
12,1527001,1534000,6999,False,149,scaffold_11
13,1856001,1870000,13999,False,149,scaffold_11
14,1871001,1884000,12999,False,149,scaffold_11
15,1950001,2060000,109999,False,149,scaffold_11
16,2124001,2130000,5999,False,149,scaffold_11
17,2131001,2148000,16999,False,149,scaffold_11
18,2701001,2878000,176999,False,149,scaffold_11
19,3083001,3183000,99999,False,149,scaffold_11
20,3184001,3295000,110999,False,149,scaffold_11
21,3313001,3383000,69999,False,149,scaffold_11
22,3429001,3479000,49999,False,149,scaffold_11
23,3521001,3933000,411999,False,149,scaffold_11
24,3982001,4161000,178999,False,149,scaffold_11
25,4179001,4710000,530999,False,149,scaffold_11
26,4713001,4766820,53819,True,149,scaffold_11
0,1,1500000,1499999,True,149,scaffold_12
1,1717001,1747000,29999,False,149,scaffold_12
2,1786001,1812000,25999,False,149,scaffold_12
3,1882001,1962000,79999,False,149,scaffold_12
4,1964001,2005000,40999,False,149,scaffold_12
5,2043001,2087000,43999,False,149,scaffold_12
6,2088001,2103000,14999,False,149,scaffold_12
7,2137001,2180000,42999,False,149,scaffold_12
8,2336001,2377000,40999,False,149,scaffold_12
9,2458001,2470000,11999,False,149,scaffold_12
10,2571001,2619000,47999,False,149,scaffold_12
11,2672001,2682000,9999,False,149,scaffold_12
0,1,342000,341999,True,150,scaffold_1
1,482001,498000,15999,False,150,scaffold_1
2,574001,643000,68999,False,150,scaffold_1
3,686001,743000,56999,False,150,scaffold_1
4,1281001,1292000,10999,False,150,scaffold_1
5,1617001,1660000,42999,False,150,scaffold_1
6,1817001,1898000,80999,False,150,scaffold_1
7,1954001,1964000,9999,False,150,scaffold_1
8,1965001,1984000,18999,False,150,scaffold_1
9,1988001,1991000,2999,False,150,scaffold_1
10,2450001,2517000,66999,False,150,scaffold_1
11,2727001,2746000,18999,False,150,scaffold_1
12,3179001,3208000,28999,False,150,scaffold_1
13,3445001,3480000,34999,False,150,scaffold_1
14,3715001,3736000,20999,False,150,scaffold_1
15,3909001,3941000,31999,False,150,scaffold_1
16,4061001,4112000,50999,False,150,scaffold_1
17,4314001,4354000,39999,False,150,scaffold_1
18,4927001,5022000,94999,False,150,scaffold_1
19,5089001,5110000,20999,False,150,scaffold_1
20,5481001,5512000,30999,False,150,scaffold_1
21,5535001,5573000,37999,False,150,scaffold_1
22,6108001,6153000,44999,False,150,scaffold_1
23,6154001,6176000,21999,False,150,scaffold_1
24,6201001,6507000,305999,False,150,scaffold_1
25,6542001,6569000,26999,False,150,scaffold_1
26,7037001,7247000,209999,False,150,scaffold_1
27,7248001,7588000,339999,False,150,scaffold_1
28,7590001,8656000,1065999,False,150,scaffold_1
29,8658001,9584000,925999,False,150,scaffold_1
30,9586001,10355000,768999,False,150,scaffold_1
31,10461001,10636000,174999,False,150,scaffold_1
32,10840001,10857000,16999,False,150,scaffold_1
33,11015001,11029000,13999,False,150,scaffold_1
34,11344001,11503000,158999,False,150,scaffold_1
35,11560001,11960000,399999,False,150,scaffold_1
36,12184001,12204000,19999,False,150,scaffold_1
37,12652001,12721000,68999,False,150,scaffold_1
38,12776001,12888000,111999,False,150,scaffold_1
39,13181001,13211000,29999,False,150,scaffold_1
40,13347001,13407000,59999,False,150,scaffold_1
41,13562001,13583000,20999,False,150,scaffold_1
42,14093001,14095000,1999,False,150,scaffold_1
43,14285001,14308000,22999,False,150,scaffold_1
44,14605001,14611000,5999,False,150,scaffold_1
0,22001,48000,25999,False,150,scaffold_2
1,93001,159000,65999,False,150,scaffold_2
2,168001,177000,8999,False,150,scaffold_2
3,332001,374000,41999,False,150,scaffold_2
4,2336001,2363000,26999,False,150,scaffold_2
5,2404001,2424000,19999,False,150,scaffold_2
6,2441001,2553000,111999,False,150,scaffold_2
7,2658001,2689000,30999,False,150,scaffold_2
8,2693001,2742000,48999,False,150,scaffold_2
9,3332001,3344000,11999,False,150,scaffold_2
10,3754001,3783000,28999,False,150,scaffold_2
11,4243001,4275000,31999,False,150,scaffold_2
12,4385001,4409000,23999,False,150,scaffold_2
13,4427001,4457000,29999,False,150,scaffold_2
14,4521001,4654000,132999,False,150,scaffold_2
15,4782001,4790000,7999,False,150,scaffold_2
16,4918001,4956000,37999,False,150,scaffold_2
17,5021001,5031000,9999,False,150,scaffold_2
18,5033001,5104000,70999,False,150,scaffold_2
19,5361001,5393000,31999,False,150,scaffold_2
20,5413001,5481000,67999,False,150,scaffold_2
21,5490001,5515000,24999,False,150,scaffold_2
22,5667001,5707000,39999,False,150,scaffold_2
23,5717001,5756000,38999,False,150,scaffold_2
24,5916001,5949000,32999,False,150,scaffold_2
25,6244001,6350000,105999,False,150,scaffold_2
26,6428001,6449000,20999,False,150,scaffold_2
27,6592001,6628000,35999,False,150,scaffold_2
28,7006001,7037000,30999,False,150,scaffold_2
29,7439001,7472000,32999,False,150,scaffold_2
30,7563001,7698000,134999,False,150,scaffold_2
31,7786001,7891000,104999,False,150,scaffold_2
32,7933001,8161000,227999,False,150,scaffold_2
33,8261001,8312000,50999,False,150,scaffold_2
34,8346001,8398000,51999,False,150,scaffold_2
35,8414001,8449000,34999,False,150,scaffold_2
36,8509001,8563000,53999,False,150,scaffold_2
37,9149001,9169000,19999,False,150,scaffold_2
38,11520001,11786000,265999,False,150,scaffold_2
0,1,2000,1999,True,150,scaffold_3
1,264001,267000,2999,False,150,scaffold_3
2,799001,901000,101999,False,150,scaffold_3
3,2078001,2108000,29999,False,150,scaffold_3
4,2291001,2336000,44999,False,150,scaffold_3
5,2487001,2533000,45999,False,150,scaffold_3
6,3769001,3820000,50999,False,150,scaffold_3
7,4108001,4385000,276999,False,150,scaffold_3
8,4418001,4519000,100999,False,150,scaffold_3
9,4547001,4558000,10999,False,150,scaffold_3
10,4653001,4678000,24999,False,150,scaffold_3
11,5493001,5509000,15999,False,150,scaffold_3
12,6741001,6783000,41999,False,150,scaffold_3
13,6910001,6962000,51999,False,150,scaffold_3
14,6963001,7096000,132999,False,150,scaffold_3
15,7286001,7302000,15999,False,150,scaffold_3
16,7333001,7363000,29999,False,150,scaffold_3
17,7365001,7395000,29999,False,150,scaffold_3
18,7540001,7556000,15999,False,150,scaffold_3
19,7692001,7799000,106999,False,150,scaffold_3
20,7818001,7845000,26999,False,150,scaffold_3
21,7910001,7932000,21999,False,150,scaffold_3
22,8176001,8253000,76999,False,150,scaffold_3
23,8462001,8527000,64999,False,150,scaffold_3
24,8575001,8594000,18999,False,150,scaffold_3
25,9968001,9995000,26999,False,150,scaffold_3
26,10461001,10484000,22999,False,150,scaffold_3
27,10587001,11163000,575999,False,150,scaffold_3
0,17001,32000,14999,False,150,scaffold_4
1,49001,88000,38999,False,150,scaffold_4
2,133001,146000,12999,False,150,scaffold_4
3,147001,151000,3999,False,150,scaffold_4
4,155001,160000,4999,False,150,scaffold_4
5,161001,215000,53999,False,150,scaffold_4
6,218001,226000,7999,False,150,scaffold_4
7,227001,241000,13999,False,150,scaffold_4
8,242001,266000,23999,False,150,scaffold_4
9,355001,374000,18999,False,150,scaffold_4
10,375001,380000,4999,False,150,scaffold_4
11,392001,410000,17999,False,150,scaffold_4
12,412001,425000,12999,False,150,scaffold_4
13,429001,498000,68999,False,150,scaffold_4
14,542001,661000,118999,False,150,scaffold_4
15,670001,691000,20999,False,150,scaffold_4
16,701001,727000,25999,False,150,scaffold_4
17,1121001,1136000,14999,False,150,scaffold_4
18,1137001,1198000,60999,False,150,scaffold_4
19,1199001,1208000,8999,False,150,scaffold_4
20,1210001,1226000,15999,False,150,scaffold_4
21,1235001,1253000,17999,False,150,scaffold_4
22,1254001,1261000,6999,False,150,scaffold_4
23,1265001,1279000,13999,False,150,scaffold_4
24,1283001,1337000,53999,False,150,scaffold_4
25,1358001,1392000,33999,False,150,scaffold_4
26,1393001,1598000,204999,False,150,scaffold_4
27,1613001,1999000,385999,False,150,scaffold_4
28,2023001,2065000,41999,False,150,scaffold_4
29,2251001,2268000,16999,False,150,scaffold_4
30,2269001,2279000,9999,False,150,scaffold_4
31,2284001,2352000,67999,False,150,scaffold_4
32,2392001,2460000,67999,False,150,scaffold_4
33,2476001,2583000,106999,False,150,scaffold_4
34,2597001,2635000,37999,False,150,scaffold_4
35,3091001,3127000,35999,False,150,scaffold_4
36,3335001,3760000,424999,False,150,scaffold_4
37,4941001,4985000,43999,False,150,scaffold_4
38,4988001,4999000,10999,False,150,scaffold_4
39,5008001,5048000,39999,False,150,scaffold_4
40,5173001,5210000,36999,False,150,scaffold_4
41,5302001,5403000,100999,False,150,scaffold_4
42,5476001,5506000,29999,False,150,scaffold_4
43,5514001,5620000,105999,False,150,scaffold_4
44,5670001,5784000,113999,False,150,scaffold_4
45,5786001,5817000,30999,False,150,scaffold_4
46,6149001,6193000,43999,False,150,scaffold_4
47,6768001,6817000,48999,False,150,scaffold_4
48,6902001,6924000,21999,False,150,scaffold_4
49,7036001,7062000,25999,False,150,scaffold_4
50,7240001,7265000,24999,False,150,scaffold_4
51,7641001,7665000,23999,False,150,scaffold_4
52,8849001,9699000,849999,False,150,scaffold_4
53,9700001,9845951,145950,True,150,scaffold_4
0,1,5000,4999,True,150,scaffold_5
1,318001,386000,67999,False,150,scaffold_5
2,463001,524000,60999,False,150,scaffold_5
3,933001,947000,13999,False,150,scaffold_5
4,2475001,2493000,17999,False,150,scaffold_5
5,2514001,2515000,999,False,150,scaffold_5
6,2563001,2738000,174999,False,150,scaffold_5
7,2813001,2871000,57999,False,150,scaffold_5
8,3137001,3186000,48999,False,150,scaffold_5
9,3218001,3253000,34999,False,150,scaffold_5
10,3278001,3512000,233999,False,150,scaffold_5
11,3962001,4101000,138999,False,150,scaffold_5
12,4121001,4221000,99999,False,150,scaffold_5
13,4246001,4274000,27999,False,150,scaffold_5
14,4446001,4505000,58999,False,150,scaffold_5
15,4601001,4680000,78999,False,150,scaffold_5
16,4691001,4861000,169999,False,150,scaffold_5
17,4904001,4917000,12999,False,150,scaffold_5
18,5301001,5306000,4999,False,150,scaffold_5
19,5315001,5346000,30999,False,150,scaffold_5
20,6411001,6418000,6999,False,150,scaffold_5
21,6504001,6566000,61999,False,150,scaffold_5
22,6608001,6653000,44999,False,150,scaffold_5
23,7559001,7610000,50999,False,150,scaffold_5
24,7621001,7655000,33999,False,150,scaffold_5
25,8258001,8263000,4999,False,150,scaffold_5
26,8668001,8688000,19999,False,150,scaffold_5
27,8713001,9364176,651175,True,150,scaffold_5
0,79001,85000,5999,False,150,scaffold_6
1,86001,113000,26999,False,150,scaffold_6
2,240001,253000,12999,False,150,scaffold_6
3,256001,262000,5999,False,150,scaffold_6
4,267001,283000,15999,False,150,scaffold_6
5,1236001,1258000,21999,False,150,scaffold_6
6,1478001,1546000,67999,False,150,scaffold_6
7,1837001,1906000,68999,False,150,scaffold_6
8,2023001,2087000,63999,False,150,scaffold_6
9,2128001,2211000,82999,False,150,scaffold_6
10,2336001,2595000,258999,False,150,scaffold_6
11,2596001,2653000,56999,False,150,scaffold_6
12,2660001,2695000,34999,False,150,scaffold_6
13,2711001,2851000,139999,False,150,scaffold_6
14,2934001,3016000,81999,False,150,scaffold_6
15,3112001,3176000,63999,False,150,scaffold_6
16,3223001,3274000,50999,False,150,scaffold_6
17,3283001,3328000,44999,False,150,scaffold_6
18,3406001,3430000,23999,False,150,scaffold_6
19,3457001,3806000,348999,False,150,scaffold_6
20,3900001,3913000,12999,False,150,scaffold_6
21,4018001,4072000,53999,False,150,scaffold_6
22,4080001,4192000,111999,False,150,scaffold_6
23,6011001,6078000,66999,False,150,scaffold_6
24,7272001,7337000,64999,False,150,scaffold_6
25,7389001,7435000,45999,False,150,scaffold_6
26,7553001,8268281,715280,True,150,scaffold_6
0,1,8000,7999,True,150,scaffold_7
1,13001,34000,20999,False,150,scaffold_7
2,323001,340000,16999,False,150,scaffold_7
3,342001,508000,165999,False,150,scaffold_7
4,554001,563000,8999,False,150,scaffold_7
5,706001,724000,17999,False,150,scaffold_7
6,725001,736000,10999,False,150,scaffold_7
7,740001,753000,12999,False,150,scaffold_7
8,764001,809000,44999,False,150,scaffold_7
9,859001,864000,4999,False,150,scaffold_7
10,955001,963000,7999,False,150,scaffold_7
11,964001,980000,15999,False,150,scaffold_7
12,982001,1044000,61999,False,150,scaffold_7
13,1191001,1512000,320999,False,150,scaffold_7
14,1588001,1688000,99999,False,150,scaffold_7
15,3326001,3369000,42999,False,150,scaffold_7
16,3524001,3775000,250999,False,150,scaffold_7
17,4414001,4514000,99999,False,150,scaffold_7
18,4551001,4596000,44999,False,150,scaffold_7
19,4635001,4742000,106999,False,150,scaffold_7
20,4979001,5114000,134999,False,150,scaffold_7
21,5483001,5516000,32999,False,150,scaffold_7
22,6955001,7270000,314999,False,150,scaffold_7
23,7271001,7502216,231215,True,150,scaffold_7
0,2001,6000,3999,False,150,scaffold_8
1,66001,85000,18999,False,150,scaffold_8
2,1859001,1926000,66999,False,150,scaffold_8
3,2091001,2114000,22999,False,150,scaffold_8
4,2444001,2470000,25999,False,150,scaffold_8
5,2492001,2525000,32999,False,150,scaffold_8
6,2539001,2548000,8999,False,150,scaffold_8
7,2664001,2672000,7999,False,150,scaffold_8
8,2741001,2789000,47999,False,150,scaffold_8
9,3059001,3125000,65999,False,150,scaffold_8
10,3126001,3525000,398999,False,150,scaffold_8
11,3581001,3614000,32999,False,150,scaffold_8
12,3615001,3938000,322999,False,150,scaffold_8
13,4038001,4099000,60999,False,150,scaffold_8
14,4202001,4221000,18999,False,150,scaffold_8
15,5095001,5136000,40999,False,150,scaffold_8
16,5187001,5241000,53999,False,150,scaffold_8
17,5669001,5691000,21999,False,150,scaffold_8
18,6329001,6334544,5543,True,150,scaffold_8
0,109001,117000,7999,False,150,scaffold_9
1,121001,134000,12999,False,150,scaffold_9
2,372001,411000,38999,False,150,scaffold_9
3,413001,423000,9999,False,150,scaffold_9
4,510001,531000,20999,False,150,scaffold_9
5,652001,665000,12999,False,150,scaffold_9
6,671001,696000,24999,False,150,scaffold_9
7,731001,742000,10999,False,150,scaffold_9
8,815001,842000,26999,False,150,scaffold_9
9,874001,882000,7999,False,150,scaffold_9
10,883001,986000,102999,False,150,scaffold_9
11,987001,995000,7999,False,150,scaffold_9
12,1001001,1007000,5999,False,150,scaffold_9
13,1010001,1085000,74999,False,150,scaffold_9
14,1087001,1162000,74999,False,150,scaffold_9
15,1313001,1377000,63999,False,150,scaffold_9
16,1766001,1791000,24999,False,150,scaffold_9
17,2599001,2616000,16999,False,150,scaffold_9
18,2744001,2758000,13999,False,150,scaffold_9
19,2768001,2811000,42999,False,150,scaffold_9
20,2870001,3381000,510999,False,150,scaffold_9
21,3383001,5107000,1723999,False,150,scaffold_9
22,5112001,5115000,2999,False,150,scaffold_9
23,5116001,5298000,181999,False,150,scaffold_9
24,5300001,5490000,189999,False,150,scaffold_9
25,5493001,6331288,838287,True,150,scaffold_9
0,1,199000,198999,True,150,scaffold_10
1,279001,405000,125999,False,150,scaffold_10
2,453001,482000,28999,False,150,scaffold_10
3,483001,585000,101999,False,150,scaffold_10
4,602001,795000,192999,False,150,scaffold_10
5,888001,916000,27999,False,150,scaffold_10
6,924001,963000,38999,False,150,scaffold_10
7,1073001,1112000,38999,False,150,scaffold_10
8,2142001,2167000,24999,False,150,scaffold_10
9,4050001,4091000,40999,False,150,scaffold_10
10,4154001,4174000,19999,False,150,scaffold_10
11,4443001,4462000,18999,False,150,scaffold_10
12,4467001,4476000,8999,False,150,scaffold_10
13,4503001,4513000,9999,False,150,scaffold_10
14,4527001,4548000,20999,False,150,scaffold_10
15,4554001,4562000,7999,False,150,scaffold_10
16,4574001,4596000,21999,False,150,scaffold_10
17,4734001,4772000,37999,False,150,scaffold_10
18,4773001,4776000,2999,False,150,scaffold_10
19,4798001,4824000,25999,False,150,scaffold_10
20,4827001,4843000,15999,False,150,scaffold_10
21,4848001,4861000,12999,False,150,scaffold_10
22,4865001,4866973,1972,True,150,scaffold_10
0,10001,99000,88999,False,150,scaffold_11
1,148001,167000,18999,False,150,scaffold_11
2,169001,186000,16999,False,150,scaffold_11
3,213001,235000,21999,False,150,scaffold_11
4,240001,248000,7999,False,150,scaffold_11
5,419001,431000,11999,False,150,scaffold_11
6,649001,656000,6999,False,150,scaffold_11
7,1025001,1034000,8999,False,150,scaffold_11
8,1423001,1426000,2999,False,150,scaffold_11
9,2701001,2867000,165999,False,150,scaffold_11
10,2979001,3011000,31999,False,150,scaffold_11
11,3205001,3260000,54999,False,150,scaffold_11
12,3328001,3383000,54999,False,150,scaffold_11
13,3556001,3651000,94999,False,150,scaffold_11
14,3702001,3929000,226999,False,150,scaffold_11
15,4004001,4073000,68999,False,150,scaffold_11
16,4097001,4159000,61999,False,150,scaffold_11
17,4317001,4710000,392999,False,150,scaffold_11
18,4713001,4766820,53819,True,150,scaffold_11
0,1,857000,856999,True,150,scaffold_12
1,865001,1448000,582999,False,150,scaffold_12
2,1719001,1733000,13999,False,150,scaffold_12
3,2571001,2617000,45999,False,150,scaffold_12
0,1,397000,396999,True,151,scaffold_1
1,482001,498000,15999,False,151,scaffold_1
2,555001,643000,87999,False,151,scaffold_1
3,686001,770000,83999,False,151,scaffold_1
4,793001,918000,124999,False,151,scaffold_1
5,1168001,1292000,123999,False,151,scaffold_1
6,1615001,1660000,44999,False,151,scaffold_1
7,1661001,1699000,37999,False,151,scaffold_1
8,1725001,1753000,27999,False,151,scaffold_1
9,1810001,1901000,90999,False,151,scaffold_1
10,1902001,1936000,33999,False,151,scaffold_1
11,1950001,1964000,13999,False,151,scaffold_1
12,1965001,1984000,18999,False,151,scaffold_1
13,1988001,2017000,28999,False,151,scaffold_1
14,2345001,2415000,69999,False,151,scaffold_1
15,2449001,2520000,70999,False,151,scaffold_1
16,2558001,2608000,49999,False,151,scaffold_1
17,2729001,2746000,16999,False,151,scaffold_1
18,2903001,2925000,21999,False,151,scaffold_1
19,2961001,3089000,127999,False,151,scaffold_1
20,3161001,3209000,47999,False,151,scaffold_1
21,3442001,3640000,197999,False,151,scaffold_1
22,3717001,4151000,433999,False,151,scaffold_1
23,4259001,4295000,35999,False,151,scaffold_1
24,4311001,4558000,246999,False,151,scaffold_1
25,4652001,4787000,134999,False,151,scaffold_1
26,4800001,5065000,264999,False,151,scaffold_1
27,5086001,5189000,102999,False,151,scaffold_1
28,5348001,5377000,28999,False,151,scaffold_1
29,5431001,5456000,24999,False,151,scaffold_1
30,5480001,5514000,33999,False,151,scaffold_1
31,5533001,5587000,53999,False,151,scaffold_1
32,5851001,5933000,81999,False,151,scaffold_1
33,6108001,6153000,44999,False,151,scaffold_1
34,6201001,6592000,390999,False,151,scaffold_1
35,6600001,6615000,14999,False,151,scaffold_1
36,6640001,6761000,120999,False,151,scaffold_1
37,6780001,6878000,97999,False,151,scaffold_1
38,6999001,7029000,29999,False,151,scaffold_1
39,7037001,7589000,551999,False,151,scaffold_1
40,7590001,8656000,1065999,False,151,scaffold_1
41,8658001,8893000,234999,False,151,scaffold_1
42,8894001,9584000,689999,False,151,scaffold_1
43,9586001,10369000,782999,False,151,scaffold_1
44,10454001,10650000,195999,False,151,scaffold_1
45,10663001,10769000,105999,False,151,scaffold_1
46,10917001,10990000,72999,False,151,scaffold_1
47,11013001,11030000,16999,False,151,scaffold_1
48,11112001,11169000,56999,False,151,scaffold_1
49,11213001,11964000,750999,False,151,scaffold_1
50,12146001,12205000,58999,False,151,scaffold_1
51,12221001,12238000,16999,False,151,scaffold_1
52,12331001,12373000,41999,False,151,scaffold_1
53,12382001,12396000,13999,False,151,scaffold_1
54,12397001,13077000,679999,False,151,scaffold_1
55,13117001,13216000,98999,False,151,scaffold_1
56,13346001,13438000,91999,False,151,scaffold_1
57,13558001,13593000,34999,False,151,scaffold_1
58,13797001,13845000,47999,False,151,scaffold_1
59,13911001,13927000,15999,False,151,scaffold_1
60,13958001,13975000,16999,False,151,scaffold_1
61,14285001,14309000,23999,False,151,scaffold_1
0,1,48000,47999,True,151,scaffold_2
1,93001,159000,65999,False,151,scaffold_2
2,165001,177000,11999,False,151,scaffold_2
3,178001,186000,7999,False,151,scaffold_2
4,332001,374000,41999,False,151,scaffold_2
5,459001,545000,85999,False,151,scaffold_2
6,732001,739000,6999,False,151,scaffold_2
7,1367001,1400000,32999,False,151,scaffold_2
8,1505001,1531000,25999,False,151,scaffold_2
9,1619001,1675000,55999,False,151,scaffold_2
10,1836001,1862000,25999,False,151,scaffold_2
11,1875001,1897000,21999,False,151,scaffold_2
12,1924001,1960000,35999,False,151,scaffold_2
13,2086001,2111000,24999,False,151,scaffold_2
14,2303001,2334000,30999,False,151,scaffold_2
15,2336001,2639000,302999,False,151,scaffold_2
16,2645001,2689000,43999,False,151,scaffold_2
17,2694001,2745000,50999,False,151,scaffold_2
18,2766001,2788000,21999,False,151,scaffold_2
19,2796001,2856000,59999,False,151,scaffold_2
20,2868001,2935000,66999,False,151,scaffold_2
21,2974001,3021000,46999,False,151,scaffold_2
22,3022001,3059000,36999,False,151,scaffold_2
23,3173001,3187000,13999,False,151,scaffold_2
24,3270001,3284000,13999,False,151,scaffold_2
25,3330001,3398000,67999,False,151,scaffold_2
26,3450001,3712000,261999,False,151,scaffold_2
27,3754001,3832000,77999,False,151,scaffold_2
28,4094001,4152000,57999,False,151,scaffold_2
29,4242001,4279000,36999,False,151,scaffold_2
30,4296001,4790000,493999,False,151,scaffold_2
31,4793001,4811000,17999,False,151,scaffold_2
32,4854001,4985000,130999,False,151,scaffold_2
33,5007001,5104000,96999,False,151,scaffold_2
34,5176001,5277000,100999,False,151,scaffold_2
35,5286001,5751000,464999,False,151,scaffold_2
36,5838001,5889000,50999,False,151,scaffold_2
37,5907001,6079000,171999,False,151,scaffold_2
38,6122001,6351000,228999,False,151,scaffold_2
39,6366001,6487000,120999,False,151,scaffold_2
40,6503001,6524000,20999,False,151,scaffold_2
41,6576001,6636000,59999,False,151,scaffold_2
42,6700001,6707000,6999,False,151,scaffold_2
43,6801001,6898000,96999,False,151,scaffold_2
44,6940001,7047000,106999,False,151,scaffold_2
45,7049001,7097000,47999,False,151,scaffold_2
46,7162001,7231000,68999,False,151,scaffold_2
47,7341001,7478000,136999,False,151,scaffold_2
48,7491001,7518000,26999,False,151,scaffold_2
49,7549001,7561000,11999,False,151,scaffold_2
50,7563001,7887000,323999,False,151,scaffold_2
51,7933001,8328000,394999,False,151,scaffold_2
52,8346001,8425000,78999,False,151,scaffold_2
53,8427001,8565000,137999,False,151,scaffold_2
54,8961001,9188000,226999,False,151,scaffold_2
55,9214001,9482000,267999,False,151,scaffold_2
56,9559001,9624000,64999,False,151,scaffold_2
57,9674001,9712000,37999,False,151,scaffold_2
58,9752001,9903000,150999,False,151,scaffold_2
59,10331001,10349000,17999,False,151,scaffold_2
60,10396001,10467000,70999,False,151,scaffold_2
61,11029001,11126000,96999,False,151,scaffold_2
62,11313001,11425000,111999,False,151,scaffold_2
63,11453001,11633000,179999,False,151,scaffold_2
64,11634001,11787000,152999,False,151,scaffold_2
0,372001,381000,8999,False,151,scaffold_3
1,618001,647000,28999,False,151,scaffold_3
2,684001,729000,44999,False,151,scaffold_3
3,798001,929000,130999,False,151,scaffold_3
4,1165001,1228000,62999,False,151,scaffold_3
5,1904001,1980000,75999,False,151,scaffold_3
6,1998001,2108000,109999,False,151,scaffold_3
7,2122001,2142000,19999,False,151,scaffold_3
8,2152001,2178000,25999,False,151,scaffold_3
9,2249001,2344000,94999,False,151,scaffold_3
10,2349001,2427000,77999,False,151,scaffold_3
11,2432001,2533000,100999,False,151,scaffold_3
12,2650001,2778000,127999,False,151,scaffold_3
13,3066001,3153000,86999,False,151,scaffold_3
14,3211001,3287000,75999,False,151,scaffold_3
15,3379001,3427000,47999,False,151,scaffold_3
16,3476001,3508000,31999,False,151,scaffold_3
17,3602001,3700000,97999,False,151,scaffold_3
18,3701001,3891000,189999,False,151,scaffold_3
19,3926001,3946000,19999,False,151,scaffold_3
20,3971001,4403000,431999,False,151,scaffold_3
21,4410001,4514000,103999,False,151,scaffold_3
22,4546001,4558000,11999,False,151,scaffold_3
23,4652001,4680000,27999,False,151,scaffold_3
24,4986001,5211000,224999,False,151,scaffold_3
25,5239001,5272000,32999,False,151,scaffold_3
26,5350001,5444000,93999,False,151,scaffold_3
27,5489001,5507000,17999,False,151,scaffold_3
28,5564001,5664000,99999,False,151,scaffold_3
29,5772001,5831000,58999,False,151,scaffold_3
30,5880001,6024000,143999,False,151,scaffold_3
31,6218001,6244000,25999,False,151,scaffold_3
32,6542001,6581000,38999,False,151,scaffold_3
33,6661001,6814000,152999,False,151,scaffold_3
34,6886001,7157000,270999,False,151,scaffold_3
35,7222001,7322000,99999,False,151,scaffold_3
36,7333001,7405000,71999,False,151,scaffold_3
37,7449001,7460000,10999,False,151,scaffold_3
38,7483001,7563000,79999,False,151,scaffold_3
39,7589001,7944000,354999,False,151,scaffold_3
40,8028001,8114000,85999,False,151,scaffold_3
41,8120001,8156000,35999,False,151,scaffold_3
42,8183001,8277000,93999,False,151,scaffold_3
43,8331001,8362000,30999,False,151,scaffold_3
44,8398001,8449000,50999,False,151,scaffold_3
45,8462001,8505000,42999,False,151,scaffold_3
46,8506001,8527000,20999,False,151,scaffold_3
47,8542001,8563000,20999,False,151,scaffold_3
48,8564001,8594000,29999,False,151,scaffold_3
49,8654001,8682000,27999,False,151,scaffold_3
50,8757001,8806000,48999,False,151,scaffold_3
51,8855001,8888000,32999,False,151,scaffold_3
52,8956001,9143000,186999,False,151,scaffold_3
53,9199001,9256000,56999,False,151,scaffold_3
54,9553001,9613000,59999,False,151,scaffold_3
55,9825001,9906000,80999,False,151,scaffold_3
56,9965001,9996000,30999,False,151,scaffold_3
57,10040001,10090000,49999,False,151,scaffold_3
58,10282001,10294000,11999,False,151,scaffold_3
59,10574001,11182071,608070,True,151,scaffold_3
0,11001,13000,1999,False,151,scaffold_4
1,17001,32000,14999,False,151,scaffold_4
2,48001,88000,39999,False,151,scaffold_4
3,90001,115000,24999,False,151,scaffold_4
4,120001,146000,25999,False,151,scaffold_4
5,147001,151000,3999,False,151,scaffold_4
6,155001,172000,16999,False,151,scaffold_4
7,175001,215000,39999,False,151,scaffold_4
8,217001,226000,8999,False,151,scaffold_4
9,227001,266000,38999,False,151,scaffold_4
10,294001,300000,5999,False,151,scaffold_4
11,355001,370000,14999,False,151,scaffold_4
12,393001,425000,31999,False,151,scaffold_4
13,429001,498000,68999,False,151,scaffold_4
14,541001,599000,57999,False,151,scaffold_4
15,600001,691000,90999,False,151,scaffold_4
16,1043001,1047000,3999,False,151,scaffold_4
17,1053001,1064000,10999,False,151,scaffold_4
18,1120001,1226000,105999,False,151,scaffold_4
19,1229001,1234000,4999,False,151,scaffold_4
20,1235001,1279000,43999,False,151,scaffold_4
21,1283001,1601000,317999,False,151,scaffold_4
22,1613001,1957000,343999,False,151,scaffold_4
23,1958001,2186000,227999,False,151,scaffold_4
24,2190001,2205000,14999,False,151,scaffold_4
25,2210001,2268000,57999,False,151,scaffold_4
26,2269001,2462000,192999,False,151,scaffold_4
27,2477001,2818000,340999,False,151,scaffold_4
28,2851001,3132000,280999,False,151,scaffold_4
29,3158001,3766000,607999,False,151,scaffold_4
30,3881001,4046000,164999,False,151,scaffold_4
31,4058001,4144000,85999,False,151,scaffold_4
32,4242001,4310000,67999,False,151,scaffold_4
33,4707001,4738000,30999,False,151,scaffold_4
34,4810001,5105000,294999,False,151,scaffold_4
35,5153001,5225000,71999,False,151,scaffold_4
36,5268001,5504000,235999,False,151,scaffold_4
37,5515001,5784000,268999,False,151,scaffold_4
38,5786001,5856000,69999,False,151,scaffold_4
39,5885001,6144000,258999,False,151,scaffold_4
40,6145001,6435000,289999,False,151,scaffold_4
41,6615001,6617000,1999,False,151,scaffold_4
42,6619001,6817000,197999,False,151,scaffold_4
43,6902001,6995000,92999,False,151,scaffold_4
44,7036001,7174000,137999,False,151,scaffold_4
45,7192001,7429000,236999,False,151,scaffold_4
46,7502001,7571000,68999,False,151,scaffold_4
47,7629001,7665000,35999,False,151,scaffold_4
48,7834001,7917000,82999,False,151,scaffold_4
49,7985001,8019000,33999,False,151,scaffold_4
50,8049001,8084000,34999,False,151,scaffold_4
51,8447001,8475000,27999,False,151,scaffold_4
52,8624001,8679000,54999,False,151,scaffold_4
53,8844001,9699000,854999,False,151,scaffold_4
54,9703001,9845951,142950,True,151,scaffold_4
0,140001,168000,27999,False,151,scaffold_5
1,318001,419000,100999,False,151,scaffold_5
2,453001,524000,70999,False,151,scaffold_5
3,676001,697000,20999,False,151,scaffold_5
4,925001,947000,21999,False,151,scaffold_5
5,1062001,1068000,5999,False,151,scaffold_5
6,1666001,1685000,18999,False,151,scaffold_5
7,2255001,2300000,44999,False,151,scaffold_5
8,2381001,2412000,30999,False,151,scaffold_5
9,2467001,2493000,25999,False,151,scaffold_5
10,2509001,2515000,5999,False,151,scaffold_5
11,2516001,2904000,387999,False,151,scaffold_5
12,3091001,3518000,426999,False,151,scaffold_5
13,3532001,3553000,20999,False,151,scaffold_5
14,3616001,3679000,62999,False,151,scaffold_5
15,3765001,3874000,108999,False,151,scaffold_5
16,3963001,4182000,218999,False,151,scaffold_5
17,4183001,4411000,227999,False,151,scaffold_5
18,4445001,5162000,716999,False,151,scaffold_5
19,5196001,5346000,149999,False,151,scaffold_5
20,5405001,5460000,54999,False,151,scaffold_5
21,5497001,5560000,62999,False,151,scaffold_5
22,5696001,5737000,40999,False,151,scaffold_5
23,6393001,6722000,328999,False,151,scaffold_5
24,6762001,6851000,88999,False,151,scaffold_5
25,6881001,6967000,85999,False,151,scaffold_5
26,7035001,7086000,50999,False,151,scaffold_5
27,7172001,7249000,76999,False,151,scaffold_5
28,7253001,7329000,75999,False,151,scaffold_5
29,7335001,7365000,29999,False,151,scaffold_5
30,7420001,7484000,63999,False,151,scaffold_5
31,7485001,7805000,319999,False,151,scaffold_5
32,8258001,8280000,21999,False,151,scaffold_5
33,8294001,8313000,18999,False,151,scaffold_5
34,8402001,8469000,66999,False,151,scaffold_5
35,8549001,8615000,65999,False,151,scaffold_5
36,8658001,9364176,706175,True,151,scaffold_5
0,78001,114000,35999,False,151,scaffold_6
1,161001,209000,47999,False,151,scaffold_6
2,239001,254000,14999,False,151,scaffold_6
3,265001,371000,105999,False,151,scaffold_6
4,467001,486000,18999,False,151,scaffold_6
5,625001,674000,48999,False,151,scaffold_6
6,966001,1037000,70999,False,151,scaffold_6
7,1142001,1226000,83999,False,151,scaffold_6
8,1229001,1309000,79999,False,151,scaffold_6
9,1427001,1542000,114999,False,151,scaffold_6
10,1562001,1777000,214999,False,151,scaffold_6
11,1793001,1957000,163999,False,151,scaffold_6
12,1977001,2105000,127999,False,151,scaffold_6
13,2124001,2224000,99999,False,151,scaffold_6
14,2235001,2286000,50999,False,151,scaffold_6
15,2329001,2595000,265999,False,151,scaffold_6
16,2596001,2865000,268999,False,151,scaffold_6
17,2932001,3208000,275999,False,151,scaffold_6
18,3228001,3350000,121999,False,151,scaffold_6
19,3351001,3795000,443999,False,151,scaffold_6
20,3810001,3933000,122999,False,151,scaffold_6
21,3943001,4195000,251999,False,151,scaffold_6
22,4838001,4916000,77999,False,151,scaffold_6
23,4954001,4996000,41999,False,151,scaffold_6
24,5122001,5169000,46999,False,151,scaffold_6
25,5208001,5267000,58999,False,151,scaffold_6
26,5277001,5320000,42999,False,151,scaffold_6
27,5321001,5326000,4999,False,151,scaffold_6
28,5557001,5771000,213999,False,151,scaffold_6
29,5774001,5794000,19999,False,151,scaffold_6
30,5861001,6089000,227999,False,151,scaffold_6
31,6123001,6192000,68999,False,151,scaffold_6
32,6476001,6505000,28999,False,151,scaffold_6
33,6560001,6593000,32999,False,151,scaffold_6
34,6685001,6715000,29999,False,151,scaffold_6
35,6760001,6805000,44999,False,151,scaffold_6
36,6836001,6857000,20999,False,151,scaffold_6
37,6897001,6993000,95999,False,151,scaffold_6
38,7184001,7339000,154999,False,151,scaffold_6
39,7388001,8268281,880280,True,151,scaffold_6
0,321001,508000,186999,False,151,scaffold_7
1,572001,579000,6999,False,151,scaffold_7
2,580001,591000,10999,False,151,scaffold_7
3,622001,641000,18999,False,151,scaffold_7
4,706001,753000,46999,False,151,scaffold_7
5,764001,809000,44999,False,151,scaffold_7
6,811001,829000,17999,False,151,scaffold_7
7,830001,843000,12999,False,151,scaffold_7
8,859001,864000,4999,False,151,scaffold_7
9,867001,872000,4999,False,151,scaffold_7
10,876001,944000,67999,False,151,scaffold_7
11,983001,1039000,55999,False,151,scaffold_7
12,1048001,1100000,51999,False,151,scaffold_7
13,1169001,1261000,91999,False,151,scaffold_7
14,1262001,1520000,257999,False,151,scaffold_7
15,1588001,1706000,117999,False,151,scaffold_7
16,1737001,1782000,44999,False,151,scaffold_7
17,1972001,2013000,40999,False,151,scaffold_7
18,2366001,2394000,27999,False,151,scaffold_7
19,2610001,2743000,132999,False,151,scaffold_7
20,2931001,2942000,10999,False,151,scaffold_7
21,3005001,3023000,17999,False,151,scaffold_7
22,3098001,3150000,51999,False,151,scaffold_7
23,3296001,3408000,111999,False,151,scaffold_7
24,3441001,3978000,536999,False,151,scaffold_7
25,4029001,4067000,37999,False,151,scaffold_7
26,4321001,4512000,190999,False,151,scaffold_7
27,4529001,4596000,66999,False,151,scaffold_7
28,4622001,5197000,574999,False,151,scaffold_7
29,5370001,5433000,62999,False,151,scaffold_7
30,5468001,5538000,69999,False,151,scaffold_7
31,5730001,5759000,28999,False,151,scaffold_7
32,6016001,6391000,374999,False,151,scaffold_7
33,6557001,6676000,118999,False,151,scaffold_7
34,6694001,6801000,106999,False,151,scaffold_7
35,6953001,7270000,316999,False,151,scaffold_7
36,7273001,7502216,229215,True,151,scaffold_7
0,58001,87000,28999,False,151,scaffold_8
1,91001,98000,6999,False,151,scaffold_8
2,1362001,1425000,62999,False,151,scaffold_8
3,1561001,1657000,95999,False,151,scaffold_8
4,1858001,1933000,74999,False,151,scaffold_8
5,2077001,2185000,107999,False,151,scaffold_8
6,2249001,2533000,283999,False,151,scaffold_8
7,2536001,2553000,16999,False,151,scaffold_8
8,2573001,2589000,15999,False,151,scaffold_8
9,2648001,2683000,34999,False,151,scaffold_8
10,2684001,2844000,159999,False,151,scaffold_8
11,2847001,2898000,50999,False,151,scaffold_8
12,2950001,3614000,663999,False,151,scaffold_8
13,3615001,4122000,506999,False,151,scaffold_8
14,4171001,4221000,49999,False,151,scaffold_8
15,4330001,4431000,100999,False,151,scaffold_8
16,4607001,4645000,37999,False,151,scaffold_8
17,4799001,4848000,48999,False,151,scaffold_8
18,4987001,5025000,37999,False,151,scaffold_8
19,5026001,5241000,214999,False,151,scaffold_8
20,5524001,5597000,72999,False,151,scaffold_8
21,5649001,5715000,65999,False,151,scaffold_8
22,5838001,6132000,293999,False,151,scaffold_8
23,6231001,6334544,103543,True,151,scaffold_8
0,1,20000,19999,True,151,scaffold_9
1,109001,118000,8999,False,151,scaffold_9
2,121001,148000,26999,False,151,scaffold_9
3,150001,179000,28999,False,151,scaffold_9
4,366001,411000,44999,False,151,scaffold_9
5,413001,441000,27999,False,151,scaffold_9
6,484001,531000,46999,False,151,scaffold_9
7,647001,665000,17999,False,151,scaffold_9
8,671001,697000,25999,False,151,scaffold_9
9,718001,741000,22999,False,151,scaffold_9
10,814001,842000,27999,False,151,scaffold_9
11,872001,986000,113999,False,151,scaffold_9
12,988001,995000,6999,False,151,scaffold_9
13,1001001,1007000,5999,False,151,scaffold_9
14,1009001,1198000,188999,False,151,scaffold_9
15,1202001,1231000,28999,False,151,scaffold_9
16,1313001,1387000,73999,False,151,scaffold_9
17,1507001,1670000,162999,False,151,scaffold_9
18,1731001,1812000,80999,False,151,scaffold_9
19,1814001,1850000,35999,False,151,scaffold_9
20,1891001,1951000,59999,False,151,scaffold_9
21,1986001,2227000,240999,False,151,scaffold_9
22,2257001,2430000,172999,False,151,scaffold_9
23,2516001,2548000,31999,False,151,scaffold_9
24,2595001,2683000,87999,False,151,scaffold_9
25,2735001,2921000,185999,False,151,scaffold_9
26,2922001,3381000,458999,False,151,scaffold_9
27,3383001,5100000,1716999,False,151,scaffold_9
28,5101001,5107000,5999,False,151,scaffold_9
29,5112001,6331288,1219287,True,151,scaffold_9
0,1,136000,135999,True,151,scaffold_10
1,137001,414000,276999,False,151,scaffold_10
2,415001,482000,66999,False,151,scaffold_10
3,483001,756000,272999,False,151,scaffold_10
4,783001,878000,94999,False,151,scaffold_10
5,888001,1069000,180999,False,151,scaffold_10
6,1072001,1210000,137999,False,151,scaffold_10
7,1308001,1363000,54999,False,151,scaffold_10
8,1369001,1476000,106999,False,151,scaffold_10
9,1500001,1524000,23999,False,151,scaffold_10
10,1587001,1756000,168999,False,151,scaffold_10
11,1803001,1821000,17999,False,151,scaffold_10
12,2047001,2108000,60999,False,151,scaffold_10
13,2131001,2177000,45999,False,151,scaffold_10
14,2234001,2460000,225999,False,151,scaffold_10
15,2510001,2520000,9999,False,151,scaffold_10
16,2551001,2652000,100999,False,151,scaffold_10
17,2671001,2705000,33999,False,151,scaffold_10
18,2722001,2748000,25999,False,151,scaffold_10
19,2759001,2782000,22999,False,151,scaffold_10
20,2789001,2809000,19999,False,151,scaffold_10
21,3114001,3132000,17999,False,151,scaffold_10
22,3155001,3177000,21999,False,151,scaffold_10
23,3469001,3476000,6999,False,151,scaffold_10
24,3575001,3582000,6999,False,151,scaffold_10
25,4000001,4016000,15999,False,151,scaffold_10
26,4052001,4085000,32999,False,151,scaffold_10
27,4154001,4174000,19999,False,151,scaffold_10
28,4335001,4365000,29999,False,151,scaffold_10
29,4527001,4548000,20999,False,151,scaffold_10
30,4565001,4597000,31999,False,151,scaffold_10
31,4716001,4732000,15999,False,151,scaffold_10
32,4734001,4776000,41999,False,151,scaffold_10
33,4798001,4824000,25999,False,151,scaffold_10
34,4828001,4843000,14999,False,151,scaffold_10
35,4848001,4861000,12999,False,151,scaffold_10
36,4865001,4866973,1972,True,151,scaffold_10
0,9001,91000,81999,False,151,scaffold_11
1,132001,167000,34999,False,151,scaffold_11
2,169001,191000,21999,False,151,scaffold_11
3,213001,236000,22999,False,151,scaffold_11
4,240001,248000,7999,False,151,scaffold_11
5,295001,324000,28999,False,151,scaffold_11
6,419001,431000,11999,False,151,scaffold_11
7,637001,656000,18999,False,151,scaffold_11
8,1025001,1034000,8999,False,151,scaffold_11
9,1195001,1215000,19999,False,151,scaffold_11
10,1219001,1241000,21999,False,151,scaffold_11
11,1573001,1596000,22999,False,151,scaffold_11
12,1853001,2007000,153999,False,151,scaffold_11
13,2008001,2025000,16999,False,151,scaffold_11
14,2109001,2172000,62999,False,151,scaffold_11
15,2201001,2225000,23999,False,151,scaffold_11
16,2333001,2388000,54999,False,151,scaffold_11
17,2658001,2718000,59999,False,151,scaffold_11
18,2744001,2920000,175999,False,151,scaffold_11
19,2941001,3034000,92999,False,151,scaffold_11
20,3059001,3386000,326999,False,151,scaffold_11
21,3399001,3479000,79999,False,151,scaffold_11
22,3518001,3683000,164999,False,151,scaffold_11
23,3704001,3722000,17999,False,151,scaffold_11
24,3743001,4161000,417999,False,151,scaffold_11
25,4189001,4710000,520999,False,151,scaffold_11
26,4712001,4766820,54819,True,151,scaffold_11
0,1,36000,35999,True,151,scaffold_12
1,37001,1078000,1040999,False,151,scaffold_12
2,1079001,1498000,418999,False,151,scaffold_12
3,1717001,1733000,15999,False,151,scaffold_12
4,1786001,1808000,21999,False,151,scaffold_12
5,1886001,1995000,108999,False,151,scaffold_12
6,2066001,2102000,35999,False,151,scaffold_12
7,2130001,2169000,38999,False,151,scaffold_12
8,2341001,2380000,38999,False,151,scaffold_12
9,2384001,2392000,7999,False,151,scaffold_12
10,2571001,2617000,45999,False,151,scaffold_12
11,2685001,2708000,22999,False,151,scaffold_12
0,1,357000,356999,True,152,scaffold_1
1,482001,498000,15999,False,152,scaffold_1
2,571001,643000,71999,False,152,scaffold_1
3,686001,774000,87999,False,152,scaffold_1
4,1059001,1088000,28999,False,152,scaffold_1
5,1168001,1193000,24999,False,152,scaffold_1
6,1271001,1292000,20999,False,152,scaffold_1
7,1616001,1660000,43999,False,152,scaffold_1
8,1776001,1779000,2999,False,152,scaffold_1
9,1807001,1934000,126999,False,152,scaffold_1
10,1950001,1964000,13999,False,152,scaffold_1
11,1965001,1984000,18999,False,152,scaffold_1
12,1986001,2037000,50999,False,152,scaffold_1
13,2268001,2312000,43999,False,152,scaffold_1
14,2363001,2422000,58999,False,152,scaffold_1
15,2449001,2518000,68999,False,152,scaffold_1
16,2546001,2620000,73999,False,152,scaffold_1
17,2725001,2746000,20999,False,152,scaffold_1
18,2894001,2925000,30999,False,152,scaffold_1
19,2960001,3061000,100999,False,152,scaffold_1
20,3170001,3209000,38999,False,152,scaffold_1
21,3444001,3499000,54999,False,152,scaffold_1
22,3575001,3652000,76999,False,152,scaffold_1
23,3704001,3880000,175999,False,152,scaffold_1
24,3901001,4029000,127999,False,152,scaffold_1
25,4060001,4157000,96999,False,152,scaffold_1
26,4301001,4375000,73999,False,152,scaffold_1
27,4409001,4543000,133999,False,152,scaffold_1
28,4715001,4789000,73999,False,152,scaffold_1
29,4796001,4852000,55999,False,152,scaffold_1
30,4927001,5066000,138999,False,152,scaffold_1
31,5084001,5199000,114999,False,152,scaffold_1
32,5436001,5514000,77999,False,152,scaffold_1
33,5535001,5594000,58999,False,152,scaffold_1
34,5826001,5917000,90999,False,152,scaffold_1
35,6108001,6153000,44999,False,152,scaffold_1
36,6154001,6616000,461999,False,152,scaffold_1
37,6640001,6672000,31999,False,152,scaffold_1
38,6812001,6862000,49999,False,152,scaffold_1
39,6912001,6944000,31999,False,152,scaffold_1
40,7038001,7247000,208999,False,152,scaffold_1
41,7248001,7589000,340999,False,152,scaffold_1
42,7590001,8300000,709999,False,152,scaffold_1
43,8301001,8656000,354999,False,152,scaffold_1
44,8657001,8902000,244999,False,152,scaffold_1
45,8903001,9584000,680999,False,152,scaffold_1
46,9586001,10363000,776999,False,152,scaffold_1
47,10460001,10788000,327999,False,152,scaffold_1
48,10835001,10857000,21999,False,152,scaffold_1
49,10917001,10940000,22999,False,152,scaffold_1
50,10947001,10958000,10999,False,152,scaffold_1
51,11014001,11059000,44999,False,152,scaffold_1
52,11268001,11975000,706999,False,152,scaffold_1
53,12147001,12243000,95999,False,152,scaffold_1
54,12492001,12530000,37999,False,152,scaffold_1
55,12636001,13216000,579999,False,152,scaffold_1
56,13321001,13437000,115999,False,152,scaffold_1
57,13554001,13584000,29999,False,152,scaffold_1
58,13959001,13971000,11999,False,152,scaffold_1
59,14290001,14310000,19999,False,152,scaffold_1
0,21001,48000,26999,False,152,scaffold_2
1,95001,159000,63999,False,152,scaffold_2
2,168001,177000,8999,False,152,scaffold_2
3,178001,186000,7999,False,152,scaffold_2
4,302001,318000,15999,False,152,scaffold_2
5,333001,374000,40999,False,152,scaffold_2
6,734001,739000,4999,False,152,scaffold_2
7,1537001,1556000,18999,False,152,scaffold_2
8,1883001,1900000,16999,False,152,scaffold_2
9,2085001,2111000,25999,False,152,scaffold_2
10,2303001,2334000,30999,False,152,scaffold_2
11,2336001,2609000,272999,False,152,scaffold_2
12,2648001,2689000,40999,False,152,scaffold_2
13,2695001,2746000,50999,False,152,scaffold_2
14,2766001,2788000,21999,False,152,scaffold_2
15,2816001,2856000,39999,False,152,scaffold_2
16,2868001,2912000,43999,False,152,scaffold_2
17,2964001,3021000,56999,False,152,scaffold_2
18,3022001,3106000,83999,False,152,scaffold_2
19,3271001,3284000,12999,False,152,scaffold_2
20,3331001,3345000,13999,False,152,scaffold_2
21,3360001,3390000,29999,False,152,scaffold_2
22,3450001,3477000,26999,False,152,scaffold_2
23,3659001,3692000,32999,False,152,scaffold_2
24,3754001,3784000,29999,False,152,scaffold_2
25,4243001,4277000,33999,False,152,scaffold_2
26,4297001,4409000,111999,False,152,scaffold_2
27,4426001,4790000,363999,False,152,scaffold_2
28,4891001,4975000,83999,False,152,scaffold_2
29,5011001,5104000,92999,False,152,scaffold_2
30,5189001,5268000,78999,False,152,scaffold_2
31,5286001,5314000,27999,False,152,scaffold_2
32,5335001,5564000,228999,False,152,scaffold_2
33,5605001,5779000,173999,False,152,scaffold_2
34,5837001,6079000,241999,False,152,scaffold_2
35,6094001,6330000,235999,False,152,scaffold_2
36,6331001,6349000,17999,False,152,scaffold_2
37,6366001,6477000,110999,False,152,scaffold_2
38,6501001,6529000,27999,False,152,scaffold_2
39,6545001,6633000,87999,False,152,scaffold_2
40,6831001,6930000,98999,False,152,scaffold_2
41,6938001,7038000,99999,False,152,scaffold_2
42,7063001,7097000,33999,False,152,scaffold_2
43,7130001,7232000,101999,False,152,scaffold_2
44,7339001,7473000,133999,False,152,scaffold_2
45,7548001,7561000,12999,False,152,scaffold_2
46,7563001,7891000,327999,False,152,scaffold_2
47,7933001,8235000,301999,False,152,scaffold_2
48,8259001,8316000,56999,False,152,scaffold_2
49,8340001,8345000,4999,False,152,scaffold_2
50,8346001,8454000,107999,False,152,scaffold_2
51,8464001,8493000,28999,False,152,scaffold_2
52,8495001,8591000,95999,False,152,scaffold_2
53,8932001,9098000,165999,False,152,scaffold_2
54,9118001,9279000,160999,False,152,scaffold_2
55,9318001,9470000,151999,False,152,scaffold_2
56,9554001,9639000,84999,False,152,scaffold_2
57,9670001,9696000,25999,False,152,scaffold_2
58,9792001,9814000,21999,False,152,scaffold_2
59,9840001,9900000,59999,False,152,scaffold_2
60,10404001,10467000,62999,False,152,scaffold_2
61,10675001,10730000,54999,False,152,scaffold_2
62,11046001,11065000,18999,False,152,scaffold_2
63,11368001,11381000,12999,False,152,scaffold_2
64,11394001,11502000,107999,False,152,scaffold_2
65,11518001,11802476,284475,True,152,scaffold_2
0,1,2000,1999,True,152,scaffold_3
1,528001,538000,9999,False,152,scaffold_3
2,618001,646000,27999,False,152,scaffold_3
3,796001,901000,104999,False,152,scaffold_3
4,1179001,1225000,45999,False,152,scaffold_3
5,1999001,2147000,147999,False,152,scaffold_3
6,2287001,2336000,48999,False,152,scaffold_3
7,2393001,2428000,34999,False,152,scaffold_3
8,2433001,2533000,99999,False,152,scaffold_3
9,2656001,2760000,103999,False,152,scaffold_3
10,3066001,3181000,114999,False,152,scaffold_3
11,3261001,3343000,81999,False,152,scaffold_3
12,3604001,3891000,286999,False,152,scaffold_3
13,3998001,4034000,35999,False,152,scaffold_3
14,4092001,4398000,305999,False,152,scaffold_3
15,4415001,4521000,105999,False,152,scaffold_3
16,4651001,4686000,34999,False,152,scaffold_3
17,4698001,4718000,19999,False,152,scaffold_3
18,4857001,4893000,35999,False,152,scaffold_3
19,4995001,5216000,220999,False,152,scaffold_3
20,5239001,5274000,34999,False,152,scaffold_3
21,5355001,5508000,152999,False,152,scaffold_3
22,5577001,5673000,95999,False,152,scaffold_3
23,5807001,6023000,215999,False,152,scaffold_3
24,6517001,6599000,81999,False,152,scaffold_3
25,6673001,6806000,132999,False,152,scaffold_3
26,6892001,6962000,69999,False,152,scaffold_3
27,6963001,7098000,134999,False,152,scaffold_3
28,7113001,7157000,43999,False,152,scaffold_3
29,7234001,7242000,7999,False,152,scaffold_3
30,7253001,7328000,74999,False,152,scaffold_3
31,7332001,7437000,104999,False,152,scaffold_3
32,7462001,7480000,17999,False,152,scaffold_3
33,7482001,7557000,74999,False,152,scaffold_3
34,7574001,7629000,54999,False,152,scaffold_3
35,7692001,7954000,261999,False,152,scaffold_3
36,8029001,8114000,84999,False,152,scaffold_3
37,8186001,8253000,66999,False,152,scaffold_3
38,8334001,8359000,24999,False,152,scaffold_3
39,8377001,8449000,71999,False,152,scaffold_3
40,8462001,8598000,135999,False,152,scaffold_3
41,8653001,8682000,28999,False,152,scaffold_3
42,8782001,8805000,22999,False,152,scaffold_3
43,8962001,9079000,116999,False,152,scaffold_3
44,9099001,9156000,56999,False,152,scaffold_3
45,9967001,10001000,33999,False,152,scaffold_3
46,10040001,10099000,58999,False,152,scaffold_3
47,10234001,10302000,67999,False,152,scaffold_3
48,10446001,10458000,11999,False,152,scaffold_3
49,10461001,10486000,24999,False,152,scaffold_3
50,10550001,10572000,21999,False,152,scaffold_3
51,10574001,11182071,608070,True,152,scaffold_3
0,17001,32000,14999,False,152,scaffold_4
1,48001,88000,39999,False,152,scaffold_4
2,106001,115000,8999,False,152,scaffold_4
3,120001,151000,30999,False,152,scaffold_4
4,155001,186000,30999,False,152,scaffold_4
5,187001,215000,27999,False,152,scaffold_4
6,217001,226000,8999,False,152,scaffold_4
7,227001,241000,13999,False,152,scaffold_4
8,242001,266000,23999,False,152,scaffold_4
9,283001,306000,22999,False,152,scaffold_4
10,355001,370000,14999,False,152,scaffold_4
11,390001,410000,19999,False,152,scaffold_4
12,412001,425000,12999,False,152,scaffold_4
13,429001,504000,74999,False,152,scaffold_4
14,510001,592000,81999,False,152,scaffold_4
15,593001,599000,5999,False,152,scaffold_4
16,600001,606000,5999,False,152,scaffold_4
17,608001,691000,82999,False,152,scaffold_4
18,701001,726000,24999,False,152,scaffold_4
19,1121001,1136000,14999,False,152,scaffold_4
20,1137001,1208000,70999,False,152,scaffold_4
21,1210001,1226000,15999,False,152,scaffold_4
22,1236001,1279000,42999,False,152,scaffold_4
23,1283001,1605000,321999,False,152,scaffold_4
24,1613001,1957000,343999,False,152,scaffold_4
25,1958001,2281000,322999,False,152,scaffold_4
26,2284001,2462000,177999,False,152,scaffold_4
27,2475001,2635000,159999,False,152,scaffold_4
28,2648001,2675000,26999,False,152,scaffold_4
29,2676001,2812000,135999,False,152,scaffold_4
30,2891001,3127000,235999,False,152,scaffold_4
31,3201001,3822000,620999,False,152,scaffold_4
32,3919001,3952000,32999,False,152,scaffold_4
33,4019001,4038000,18999,False,152,scaffold_4
34,4058001,4146000,87999,False,152,scaffold_4
35,4242001,4309000,66999,False,152,scaffold_4
36,4703001,4737000,33999,False,152,scaffold_4
37,4803001,4840000,36999,False,152,scaffold_4
38,4900001,5104000,203999,False,152,scaffold_4
39,5169001,5246000,76999,False,152,scaffold_4
40,5261001,5506000,244999,False,152,scaffold_4
41,5515001,5784000,268999,False,152,scaffold_4
42,5786001,5856000,69999,False,152,scaffold_4
43,5868001,5970000,101999,False,152,scaffold_4
44,6011001,6197000,185999,False,152,scaffold_4
45,6213001,6277000,63999,False,152,scaffold_4
46,6404001,6432000,27999,False,152,scaffold_4
47,6615001,6617000,1999,False,152,scaffold_4
48,6707001,6817000,109999,False,152,scaffold_4
49,6837001,6924000,86999,False,152,scaffold_4
50,6926001,6995000,68999,False,152,scaffold_4
51,7036001,7429000,392999,False,152,scaffold_4
52,7628001,7665000,36999,False,152,scaffold_4
53,7859001,7918000,58999,False,152,scaffold_4
54,8052001,8139000,86999,False,152,scaffold_4
55,8844001,9699000,854999,False,152,scaffold_4
56,9700001,9845951,145950,True,152,scaffold_4
0,27001,32000,4999,False,152,scaffold_5
1,141001,174000,32999,False,152,scaffold_5
2,319001,400000,80999,False,152,scaffold_5
3,442001,526000,83999,False,152,scaffold_5
4,668001,697000,28999,False,152,scaffold_5
5,927001,947000,19999,False,152,scaffold_5
6,2105001,2125000,19999,False,152,scaffold_5
7,2255001,2302000,46999,False,152,scaffold_5
8,2474001,2496000,21999,False,152,scaffold_5
9,2509001,2515000,5999,False,152,scaffold_5
10,2516001,2529000,12999,False,152,scaffold_5
11,2552001,2910000,357999,False,152,scaffold_5
12,3091001,3514000,422999,False,152,scaffold_5
13,3532001,3549000,16999,False,152,scaffold_5
14,3615001,3661000,45999,False,152,scaffold_5
15,3712001,3750000,37999,False,152,scaffold_5
16,3825001,3876000,50999,False,152,scaffold_5
17,3915001,3946000,30999,False,152,scaffold_5
18,3961001,4410000,448999,False,152,scaffold_5
19,4444001,4926000,481999,False,152,scaffold_5
20,4946001,5097000,150999,False,152,scaffold_5
21,5217001,5346000,128999,False,152,scaffold_5
22,5510001,5536000,25999,False,152,scaffold_5
23,5720001,5738000,17999,False,152,scaffold_5
24,6393001,6725000,331999,False,152,scaffold_5
25,6779001,6850000,70999,False,152,scaffold_5
26,6878001,6906000,27999,False,152,scaffold_5
27,7047001,7083000,35999,False,152,scaffold_5
28,7169001,7249000,79999,False,152,scaffold_5
29,7251001,7329000,77999,False,152,scaffold_5
30,7338001,7364000,25999,False,152,scaffold_5
31,7454001,7512000,57999,False,152,scaffold_5
32,7523001,7758000,234999,False,152,scaffold_5
33,8380001,8469000,88999,False,152,scaffold_5
34,8552001,8616000,63999,False,152,scaffold_5
35,8638001,8689000,50999,False,152,scaffold_5
36,8713001,9364176,651175,True,152,scaffold_5
0,78001,84000,5999,False,152,scaffold_6
1,86001,115000,28999,False,152,scaffold_6
2,140001,209000,68999,False,152,scaffold_6
3,239001,255000,15999,False,152,scaffold_6
4,256001,319000,62999,False,152,scaffold_6
5,1146001,1226000,79999,False,152,scaffold_6
6,1229001,1265000,35999,False,152,scaffold_6
7,1288001,1297000,8999,False,152,scaffold_6
8,1435001,1615000,179999,False,152,scaffold_6
9,1658001,1750000,91999,False,152,scaffold_6
10,1806001,1933000,126999,False,152,scaffold_6
11,2025001,2105000,79999,False,152,scaffold_6
12,2124001,2215000,90999,False,152,scaffold_6
13,2236001,2284000,47999,False,152,scaffold_6
14,2318001,2595000,276999,False,152,scaffold_6
15,2596001,2654000,57999,False,152,scaffold_6
16,2655001,2872000,216999,False,152,scaffold_6
17,2928001,3211000,282999,False,152,scaffold_6
18,3220001,3806000,585999,False,152,scaffold_6
19,3810001,3933000,122999,False,152,scaffold_6
20,3942001,4193000,250999,False,152,scaffold_6
21,4839001,4869000,29999,False,152,scaffold_6
22,4956001,4993000,36999,False,152,scaffold_6
23,5559001,5668000,108999,False,152,scaffold_6
24,5719001,5752000,32999,False,152,scaffold_6
25,5861001,5972000,110999,False,152,scaffold_6
26,6010001,6089000,78999,False,152,scaffold_6
27,6122001,6191000,68999,False,152,scaffold_6
28,6487001,6504000,16999,False,152,scaffold_6
29,6672001,6716000,43999,False,152,scaffold_6
30,6766001,6804000,37999,False,152,scaffold_6
31,6834001,6856000,21999,False,152,scaffold_6
32,6911001,6942000,30999,False,152,scaffold_6
33,7183001,7249000,65999,False,152,scaffold_6
34,7254001,7338000,83999,False,152,scaffold_6
35,7362001,7483000,120999,False,152,scaffold_6
36,7537001,7716000,178999,False,152,scaffold_6
37,7733001,8268281,535280,True,152,scaffold_6
0,1,34000,33999,True,152,scaffold_7
1,309001,340000,30999,False,152,scaffold_7
2,342001,508000,165999,False,152,scaffold_7
3,571001,579000,7999,False,152,scaffold_7
4,580001,590000,9999,False,152,scaffold_7
5,623001,641000,17999,False,152,scaffold_7
6,654001,676000,21999,False,152,scaffold_7
7,687001,736000,48999,False,152,scaffold_7
8,764001,829000,64999,False,152,scaffold_7
9,830001,843000,12999,False,152,scaffold_7
10,858001,864000,5999,False,152,scaffold_7
11,868001,963000,94999,False,152,scaffold_7
12,982001,1044000,61999,False,152,scaffold_7
13,1048001,1122000,73999,False,152,scaffold_7
14,1191001,1512000,320999,False,152,scaffold_7
15,1588001,1689000,100999,False,152,scaffold_7
16,1982001,2016000,33999,False,152,scaffold_7
17,2579001,2658000,78999,False,152,scaffold_7
18,2851001,2953000,101999,False,152,scaffold_7
19,3094001,3138000,43999,False,152,scaffold_7
20,3296001,3422000,125999,False,152,scaffold_7
21,3487001,3886000,398999,False,152,scaffold_7
22,3917001,3969000,51999,False,152,scaffold_7
23,4021001,4066000,44999,False,152,scaffold_7
24,4322001,4378000,55999,False,152,scaffold_7
25,4415001,4512000,96999,False,152,scaffold_7
26,4547001,4919000,371999,False,152,scaffold_7
27,4953001,4964000,10999,False,152,scaffold_7
28,4978001,5204000,225999,False,152,scaffold_7
29,5374001,5434000,59999,False,152,scaffold_7
30,5470001,5538000,67999,False,152,scaffold_7
31,6312001,6369000,56999,False,152,scaffold_7
32,6568001,6662000,93999,False,152,scaffold_7
33,6696001,6722000,25999,False,152,scaffold_7
34,6744001,6799000,54999,False,152,scaffold_7
35,6949001,7270000,320999,False,152,scaffold_7
36,7271001,7502216,231215,True,152,scaffold_7
0,66001,87000,20999,False,152,scaffold_8
1,1365001,1405000,39999,False,152,scaffold_8
2,1561001,1610000,48999,False,152,scaffold_8
3,1858001,1978000,119999,False,152,scaffold_8
4,2080001,2153000,72999,False,152,scaffold_8
5,2231001,2239000,7999,False,152,scaffold_8
6,2252001,2284000,31999,False,152,scaffold_8
7,2333001,2531000,197999,False,152,scaffold_8
8,2534001,2586000,51999,False,152,scaffold_8
9,2650001,2844000,193999,False,152,scaffold_8
10,2847001,2890000,42999,False,152,scaffold_8
11,2951001,2987000,35999,False,152,scaffold_8
12,3032001,3612000,579999,False,152,scaffold_8
13,3615001,4267000,651999,False,152,scaffold_8
14,4297001,4369000,71999,False,152,scaffold_8
15,4400001,4432000,31999,False,152,scaffold_8
16,4566001,4648000,81999,False,152,scaffold_8
17,4891001,4928000,36999,False,152,scaffold_8
18,4996001,5014000,17999,False,152,scaffold_8
19,5028001,5241000,212999,False,152,scaffold_8
20,5510001,5602000,91999,False,152,scaffold_8
21,5649001,5694000,44999,False,152,scaffold_8
22,5817001,5904000,86999,False,152,scaffold_8
23,5961001,5995000,33999,False,152,scaffold_8
24,6024001,6117000,92999,False,152,scaffold_8
25,6238001,6300000,61999,False,152,scaffold_8
26,6323001,6334544,11543,True,152,scaffold_8
0,109001,118000,8999,False,152,scaffold_9
1,121001,138000,16999,False,152,scaffold_9
2,366001,411000,44999,False,152,scaffold_9
3,413001,434000,20999,False,152,scaffold_9
4,483001,531000,47999,False,152,scaffold_9
5,660001,665000,4999,False,152,scaffold_9
6,671001,697000,25999,False,152,scaffold_9
7,731001,741000,9999,False,152,scaffold_9
8,814001,842000,27999,False,152,scaffold_9
9,873001,986000,112999,False,152,scaffold_9
10,988001,995000,6999,False,152,scaffold_9
11,1001001,1007000,5999,False,152,scaffold_9
12,1008001,1085000,76999,False,152,scaffold_9
13,1087001,1165000,77999,False,152,scaffold_9
14,1312001,1378000,65999,False,152,scaffold_9
15,1428001,1440000,11999,False,152,scaffold_9
16,1456001,1464000,7999,False,152,scaffold_9
17,1560001,1622000,61999,False,152,scaffold_9
18,1634001,1670000,35999,False,152,scaffold_9
19,1731001,1811000,79999,False,152,scaffold_9
20,1814001,1857000,42999,False,152,scaffold_9
21,1990001,2131000,140999,False,152,scaffold_9
22,2139001,2172000,32999,False,152,scaffold_9
23,2174001,2221000,46999,False,152,scaffold_9
24,2314001,2354000,39999,False,152,scaffold_9
25,2515001,2575000,59999,False,152,scaffold_9
26,2595001,2683000,87999,False,152,scaffold_9
27,2737001,3381000,643999,False,152,scaffold_9
28,3383001,5107000,1723999,False,152,scaffold_9
29,5112001,5115000,2999,False,152,scaffold_9
30,5116001,5298000,181999,False,152,scaffold_9
31,5300001,6331288,1031287,True,152,scaffold_9
0,1,406000,405999,True,152,scaffold_10
1,419001,877000,457999,False,152,scaffold_10
2,888001,1069000,180999,False,152,scaffold_10
3,1073001,1180000,106999,False,152,scaffold_10
4,1313001,1346000,32999,False,152,scaffold_10
5,1368001,1462000,93999,False,152,scaffold_10
6,1590001,1680000,89999,False,152,scaffold_10
7,1696001,1724000,27999,False,152,scaffold_10
8,1861001,1916000,54999,False,152,scaffold_10
9,2012001,2108000,95999,False,152,scaffold_10
10,2130001,2171000,40999,False,152,scaffold_10
11,2268001,2324000,55999,False,152,scaffold_10
12,2346001,2425000,78999,False,152,scaffold_10
13,2552001,2649000,96999,False,152,scaffold_10
14,2673001,2697000,23999,False,152,scaffold_10
15,2819001,2861000,41999,False,152,scaffold_10
16,3115001,3142000,26999,False,152,scaffold_10
17,3644001,3675000,30999,False,152,scaffold_10
18,4038001,4091000,52999,False,152,scaffold_10
19,4154001,4175000,20999,False,152,scaffold_10
20,4335001,4367000,31999,False,152,scaffold_10
21,4445001,4462000,16999,False,152,scaffold_10
22,4467001,4513000,45999,False,152,scaffold_10
23,4527001,4548000,20999,False,152,scaffold_10
24,4554001,4562000,7999,False,152,scaffold_10
25,4565001,4597000,31999,False,152,scaffold_10
26,4716001,4732000,15999,False,152,scaffold_10
27,4734001,4776000,41999,False,152,scaffold_10
28,4798001,4824000,25999,False,152,scaffold_10
29,4828001,4843000,14999,False,152,scaffold_10
30,4848001,4861000,12999,False,152,scaffold_10
31,4865001,4866973,1972,True,152,scaffold_10
0,10001,93000,82999,False,152,scaffold_11
1,132001,167000,34999,False,152,scaffold_11
2,169001,212000,42999,False,152,scaffold_11
3,213001,235000,21999,False,152,scaffold_11
4,240001,246000,5999,False,152,scaffold_11
5,297001,312000,14999,False,152,scaffold_11
6,419001,431000,11999,False,152,scaffold_11
7,433001,442000,8999,False,152,scaffold_11
8,648001,656000,7999,False,152,scaffold_11
9,1028001,1034000,5999,False,152,scaffold_11
10,1403001,1409000,5999,False,152,scaffold_11
11,1853001,1883000,29999,False,152,scaffold_11
12,2115001,2170000,54999,False,152,scaffold_11
13,2193001,2225000,31999,False,152,scaffold_11
14,2675001,2919000,243999,False,152,scaffold_11
15,2952001,3034000,81999,False,152,scaffold_11
16,3060001,3383000,322999,False,152,scaffold_11
17,3420001,3481000,60999,False,152,scaffold_11
18,3519001,4161000,641999,False,152,scaffold_11
19,4182001,4710000,527999,False,152,scaffold_11
20,4713001,4766820,53819,True,152,scaffold_11
0,1,1498000,1497999,True,152,scaffold_12
1,1718001,1751000,32999,False,152,scaffold_12
2,1906001,1951000,44999,False,152,scaffold_12
3,1976001,2041000,64999,False,152,scaffold_12
4,2043001,2101000,57999,False,152,scaffold_12
5,2130001,2164000,33999,False,152,scaffold_12
6,2341001,2378000,36999,False,152,scaffold_12
7,2571001,2609000,37999,False,152,scaffold_12
0,1,499000,498999,True,153,scaffold_1
1,570001,1108000,537999,False,153,scaffold_1
2,1168001,1292000,123999,False,153,scaffold_1
3,1297001,1369000,71999,False,153,scaffold_1
4,1464001,1509000,44999,False,153,scaffold_1
5,1630001,1698000,67999,False,153,scaffold_1
6,1704001,1964000,259999,False,153,scaffold_1
7,1965001,2221000,255999,False,153,scaffold_1
8,2228001,2809000,580999,False,153,scaffold_1
9,2879001,3232000,352999,False,153,scaffold_1
10,3250001,3372000,121999,False,153,scaffold_1
11,3443001,3711000,267999,False,153,scaffold_1
12,3712001,4059000,346999,False,153,scaffold_1
13,4061001,4464000,402999,False,153,scaffold_1
14,4465001,4794000,328999,False,153,scaffold_1
15,4796001,5070000,273999,False,153,scaffold_1
16,5087001,5335000,247999,False,153,scaffold_1
17,5343001,5521000,177999,False,153,scaffold_1
18,5534001,5621000,86999,False,153,scaffold_1
19,5635001,5688000,52999,False,153,scaffold_1
20,5704001,5758000,53999,False,153,scaffold_1
21,5783001,6101000,317999,False,153,scaffold_1
22,6109001,6863000,753999,False,153,scaffold_1
23,6864001,7247000,382999,False,153,scaffold_1
24,7248001,7589000,340999,False,153,scaffold_1
25,7590001,8470000,879999,False,153,scaffold_1
26,8472001,8488000,15999,False,153,scaffold_1
27,8489001,8656000,166999,False,153,scaffold_1
28,8658001,9489000,830999,False,153,scaffold_1
29,9490001,9584000,93999,False,153,scaffold_1
30,9586001,10792000,1205999,False,153,scaffold_1
31,10832001,10858000,25999,False,153,scaffold_1
32,10870001,10989000,118999,False,153,scaffold_1
33,11013001,11401000,387999,False,153,scaffold_1
34,11402001,12396000,993999,False,153,scaffold_1
35,12397001,13217000,819999,False,153,scaffold_1
36,13311001,13516000,204999,False,153,scaffold_1
37,13517001,13739000,221999,False,153,scaffold_1
38,13748001,13927000,178999,False,153,scaffold_1
39,13928001,13955000,26999,False,153,scaffold_1
40,13958001,14079000,120999,False,153,scaffold_1
41,14112001,14275000,162999,False,153,scaffold_1
42,14287001,14310000,22999,False,153,scaffold_1
43,14318001,14353000,34999,False,153,scaffold_1
44,14377001,14426000,48999,False,153,scaffold_1
45,14438001,14461000,22999,False,153,scaffold_1
46,14524001,14529000,4999,False,153,scaffold_1
47,14530001,14612000,81999,False,153,scaffold_1
48,14742001,14794116,52115,True,153,scaffold_1
0,1,48000,47999,True,153,scaffold_2
1,93001,158000,64999,False,153,scaffold_2
2,250001,286000,35999,False,153,scaffold_2
3,296001,318000,21999,False,153,scaffold_2
4,331001,381000,49999,False,153,scaffold_2
5,387001,445000,57999,False,153,scaffold_2
6,459001,587000,127999,False,153,scaffold_2
7,720001,739000,18999,False,153,scaffold_2
8,759001,822000,62999,False,153,scaffold_2
9,889001,1016000,126999,False,153,scaffold_2
10,1018001,1111000,92999,False,153,scaffold_2
11,1112001,1258000,145999,False,153,scaffold_2
12,1286001,1678000,391999,False,153,scaffold_2
13,1686001,1890000,203999,False,153,scaffold_2
14,1891001,1961000,69999,False,153,scaffold_2
15,1963001,2013000,49999,False,153,scaffold_2
16,2028001,2334000,305999,False,153,scaffold_2
17,2347001,2636000,288999,False,153,scaffold_2
18,2650001,2688000,37999,False,153,scaffold_2
19,2693001,2747000,53999,False,153,scaffold_2
20,2766001,2776000,9999,False,153,scaffold_2
21,2777001,2857000,79999,False,153,scaffold_2
22,2876001,3160000,283999,False,153,scaffold_2
23,3161001,3187000,25999,False,153,scaffold_2
24,3219001,3284000,64999,False,153,scaffold_2
25,3285001,3438000,152999,False,153,scaffold_2
26,3441001,4194000,752999,False,153,scaffold_2
27,4195001,4502000,306999,False,153,scaffold_2
28,4503001,4818000,314999,False,153,scaffold_2
29,4833001,4986000,152999,False,153,scaffold_2
30,5016001,5632000,615999,False,153,scaffold_2
31,5633001,5780000,146999,False,153,scaffold_2
32,5807001,6352000,544999,False,153,scaffold_2
33,6365001,7047000,681999,False,153,scaffold_2
34,7049001,7274000,224999,False,153,scaffold_2
35,7288001,7518000,229999,False,153,scaffold_2
36,7547001,7561000,13999,False,153,scaffold_2
37,7562001,8101000,538999,False,153,scaffold_2
38,8102001,8345000,242999,False,153,scaffold_2
39,8346001,8391000,44999,False,153,scaffold_2
40,8392001,8850000,457999,False,153,scaffold_2
41,8882001,9652000,769999,False,153,scaffold_2
42,9661001,9905000,243999,False,153,scaffold_2
43,9926001,9944000,17999,False,153,scaffold_2
44,10188001,10766000,577999,False,153,scaffold_2
45,10774001,10969000,194999,False,153,scaffold_2
46,10999001,11802476,803475,True,153,scaffold_2
0,63001,96000,32999,False,153,scaffold_3
1,140001,182000,41999,False,153,scaffold_3
2,203001,215000,11999,False,153,scaffold_3
3,217001,258000,40999,False,153,scaffold_3
4,270001,282000,11999,False,153,scaffold_3
5,352001,362000,9999,False,153,scaffold_3
6,406001,454000,47999,False,153,scaffold_3
7,575001,608000,32999,False,153,scaffold_3
8,618001,646000,27999,False,153,scaffold_3
9,685001,936000,250999,False,153,scaffold_3
10,938001,1024000,85999,False,153,scaffold_3
11,1063001,1135000,71999,False,153,scaffold_3
12,1163001,1256000,92999,False,153,scaffold_3
13,1357001,1372000,14999,False,153,scaffold_3
14,1527001,1582000,54999,False,153,scaffold_3
15,1584001,1811000,226999,False,153,scaffold_3
16,1813001,1890000,76999,False,153,scaffold_3
17,1891001,1990000,98999,False,153,scaffold_3
18,1991001,2428000,436999,False,153,scaffold_3
19,2433001,2533000,99999,False,153,scaffold_3
20,2534001,2559000,24999,False,153,scaffold_3
21,2561001,2612000,50999,False,153,scaffold_3
22,2621001,3062000,440999,False,153,scaffold_3
23,3064001,4398000,1333999,False,153,scaffold_3
24,4414001,4522000,107999,False,153,scaffold_3
25,4546001,4558000,11999,False,153,scaffold_3
26,4639001,4720000,80999,False,153,scaffold_3
27,4744001,6609000,1864999,False,153,scaffold_3
28,6659001,6794000,134999,False,153,scaffold_3
29,6795001,7447000,651999,False,153,scaffold_3
30,7449001,7909000,459999,False,153,scaffold_3
31,7910001,8167000,256999,False,153,scaffold_3
32,8175001,8807000,631999,False,153,scaffold_3
33,8814001,8826000,11999,False,153,scaffold_3
34,8833001,9257000,423999,False,153,scaffold_3
35,9270001,9721000,450999,False,153,scaffold_3
36,9724001,9812000,87999,False,153,scaffold_3
37,9814001,10149000,334999,False,153,scaffold_3
38,10152001,10305000,152999,False,153,scaffold_3
39,10316001,10458000,141999,False,153,scaffold_3
40,10461001,10547000,85999,False,153,scaffold_3
41,10548001,10572000,23999,False,153,scaffold_3
42,10578001,10600000,21999,False,153,scaffold_3
43,10601001,11182071,581070,True,153,scaffold_3
0,1,7000,6999,True,153,scaffold_4
1,10001,13000,2999,False,153,scaffold_4
2,17001,32000,14999,False,153,scaffold_4
3,46001,88000,41999,False,153,scaffold_4
4,110001,115000,4999,False,153,scaffold_4
5,154001,215000,60999,False,153,scaffold_4
6,217001,273000,55999,False,153,scaffold_4
7,283001,343000,59999,False,153,scaffold_4
8,355001,425000,69999,False,153,scaffold_4
9,429001,505000,75999,False,153,scaffold_4
10,507001,592000,84999,False,153,scaffold_4
11,593001,691000,97999,False,153,scaffold_4
12,706001,727000,20999,False,153,scaffold_4
13,1053001,1065000,11999,False,153,scaffold_4
14,1082001,1110000,27999,False,153,scaffold_4
15,1113001,1136000,22999,False,153,scaffold_4
16,1137001,1226000,88999,False,153,scaffold_4
17,1229001,1279000,49999,False,153,scaffold_4
18,1282001,1605000,322999,False,153,scaffold_4
19,1609001,1612000,2999,False,153,scaffold_4
20,1613001,2268000,654999,False,153,scaffold_4
21,2269001,2390000,120999,False,153,scaffold_4
22,2391001,3127000,735999,False,153,scaffold_4
23,3157001,4382000,1224999,False,153,scaffold_4
24,4394001,4547000,152999,False,153,scaffold_4
25,4608001,5511000,902999,False,153,scaffold_4
26,5515001,5784000,268999,False,153,scaffold_4
27,5786001,6612000,825999,False,153,scaffold_4
28,6619001,6826000,206999,False,153,scaffold_4
29,6828001,6924000,95999,False,153,scaffold_4
30,6926001,7666000,739999,False,153,scaffold_4
31,7681001,7953000,271999,False,153,scaffold_4
32,7963001,8139000,175999,False,153,scaffold_4
33,8186001,8224000,37999,False,153,scaffold_4
34,8264001,8376000,111999,False,153,scaffold_4
35,8382001,8678000,295999,False,153,scaffold_4
36,8703001,8830000,126999,False,153,scaffold_4
37,8837001,8930000,92999,False,153,scaffold_4
38,8932001,9699000,766999,False,153,scaffold_4
39,9700001,9845951,145950,True,153,scaffold_4
0,90001,121000,30999,False,153,scaffold_5
1,139001,174000,34999,False,153,scaffold_5
2,189001,205000,15999,False,153,scaffold_5
3,228001,418000,189999,False,153,scaffold_5
4,443001,536000,92999,False,153,scaffold_5
5,563001,720000,156999,False,153,scaffold_5
6,783001,789000,5999,False,153,scaffold_5
7,795001,832000,36999,False,153,scaffold_5
8,922001,955000,32999,False,153,scaffold_5
9,1062001,1516000,453999,False,153,scaffold_5
10,1626001,1685000,58999,False,153,scaffold_5
11,1750001,1818000,67999,False,153,scaffold_5
12,1838001,1867000,28999,False,153,scaffold_5
13,1877001,1895000,17999,False,153,scaffold_5
14,1898001,1986000,87999,False,153,scaffold_5
15,2080001,2104000,23999,False,153,scaffold_5
16,2105001,2139000,33999,False,153,scaffold_5
17,2255001,2365000,109999,False,153,scaffold_5
18,2381001,2841000,459999,False,153,scaffold_5
19,2842001,3458000,615999,False,153,scaffold_5
20,3459001,3523000,63999,False,153,scaffold_5
21,3524001,4805000,1280999,False,153,scaffold_5
22,4806001,4861000,54999,False,153,scaffold_5
23,4862001,5345000,482999,False,153,scaffold_5
24,5381001,5582000,200999,False,153,scaffold_5
25,5593001,5888000,294999,False,153,scaffold_5
26,6098001,6262000,163999,False,153,scaffold_5
27,6263001,6295000,31999,False,153,scaffold_5
28,6316001,6476000,159999,False,153,scaffold_5
29,6478001,7100000,621999,False,153,scaffold_5
30,7118001,7522000,403999,False,153,scaffold_5
31,7523001,7809000,285999,False,153,scaffold_5
32,7811001,8047000,235999,False,153,scaffold_5
33,8078001,8105000,26999,False,153,scaffold_5
34,8143001,8171000,27999,False,153,scaffold_5
35,8180001,8194000,13999,False,153,scaffold_5
36,8258001,8470000,211999,False,153,scaffold_5
37,8493001,9364176,871175,True,153,scaffold_5
0,21001,39000,17999,False,153,scaffold_6
1,42001,74000,31999,False,153,scaffold_6
2,78001,121000,42999,False,153,scaffold_6
3,122001,235000,112999,False,153,scaffold_6
4,236001,420000,183999,False,153,scaffold_6
5,436001,541000,104999,False,153,scaffold_6
6,543001,579000,35999,False,153,scaffold_6
7,617001,664000,46999,False,153,scaffold_6
8,688001,810000,121999,False,153,scaffold_6
9,814001,830000,15999,False,153,scaffold_6
10,833001,950000,116999,False,153,scaffold_6
11,951001,1243000,291999,False,153,scaffold_6
12,1244001,1405000,160999,False,153,scaffold_6
13,1427001,2022000,594999,False,153,scaffold_6
14,2023001,2358000,334999,False,153,scaffold_6
15,2359001,2872000,512999,False,153,scaffold_6
16,2885001,2925000,39999,False,153,scaffold_6
17,2926001,3806000,879999,False,153,scaffold_6
18,3810001,4207000,396999,False,153,scaffold_6
19,4208001,4558000,349999,False,153,scaffold_6
20,4561001,4757000,195999,False,153,scaffold_6
21,4764001,4921000,156999,False,153,scaffold_6
22,4924001,5006000,81999,False,153,scaffold_6
23,5056001,6333000,1276999,False,153,scaffold_6
24,6423001,7343000,919999,False,153,scaffold_6
25,7382001,8268281,886280,True,153,scaffold_6
0,1,35000,34999,True,153,scaffold_7
1,50001,51000,999,False,153,scaffold_7
2,80001,205000,124999,False,153,scaffold_7
3,306001,510000,203999,False,153,scaffold_7
4,570001,612000,41999,False,153,scaffold_7
5,614001,676000,61999,False,153,scaffold_7
6,695001,753000,57999,False,153,scaffold_7
7,760001,827000,66999,False,153,scaffold_7
8,867001,872000,4999,False,153,scaffold_7
9,875001,943000,67999,False,153,scaffold_7
10,952001,963000,10999,False,153,scaffold_7
11,964001,967000,2999,False,153,scaffold_7
12,968001,1044000,75999,False,153,scaffold_7
13,1048001,1123000,74999,False,153,scaffold_7
14,1160001,2120000,959999,False,153,scaffold_7
15,2184001,2407000,222999,False,153,scaffold_7
16,2438001,2747000,308999,False,153,scaffold_7
17,2788001,2982000,193999,False,153,scaffold_7
18,3005001,4133000,1127999,False,153,scaffold_7
19,4191001,5251000,1059999,False,153,scaffold_7
20,5261001,5469000,207999,False,153,scaffold_7
21,5473001,5676000,202999,False,153,scaffold_7
22,5677001,6094000,416999,False,153,scaffold_7
23,6095001,6430000,334999,False,153,scaffold_7
24,6466001,6935000,468999,False,153,scaffold_7
25,6938001,7502216,564215,True,153,scaffold_7
0,1,10000,9999,True,153,scaffold_8
1,30001,64000,33999,False,153,scaffold_8
2,66001,87000,20999,False,153,scaffold_8
3,335001,353000,17999,False,153,scaffold_8
4,592001,606000,13999,False,153,scaffold_8
5,820001,822000,1999,False,153,scaffold_8
6,982001,1062000,79999,False,153,scaffold_8
7,1113001,1256000,142999,False,153,scaffold_8
8,1270001,1424000,153999,False,153,scaffold_8
9,1514001,1759000,244999,False,153,scaffold_8
10,1798001,2295000,496999,False,153,scaffold_8
11,2296001,2683000,386999,False,153,scaffold_8
12,2684001,2845000,160999,False,153,scaffold_8
13,2847001,3614000,766999,False,153,scaffold_8
14,3615001,4646000,1030999,False,153,scaffold_8
15,4717001,4964000,246999,False,153,scaffold_8
16,4982001,5636000,653999,False,153,scaffold_8
17,5648001,5723000,74999,False,153,scaffold_8
18,5724001,6334544,610543,True,153,scaffold_8
0,1,22000,21999,True,153,scaffold_9
1,109001,184000,74999,False,153,scaffold_9
2,236001,243000,6999,False,153,scaffold_9
3,253001,259000,5999,False,153,scaffold_9
4,282001,411000,128999,False,153,scaffold_9
5,413001,435000,21999,False,153,scaffold_9
6,436001,531000,94999,False,153,scaffold_9
7,549001,564000,14999,False,153,scaffold_9
8,591001,632000,40999,False,153,scaffold_9
9,634001,664000,29999,False,153,scaffold_9
10,671001,697000,25999,False,153,scaffold_9
11,719001,775000,55999,False,153,scaffold_9
12,794001,805000,10999,False,153,scaffold_9
13,807001,844000,36999,False,153,scaffold_9
14,876001,986000,109999,False,153,scaffold_9
15,988001,996000,7999,False,153,scaffold_9
16,997001,1196000,198999,False,153,scaffold_9
17,1202001,1277000,74999,False,153,scaffold_9
18,1311001,1394000,82999,False,153,scaffold_9
19,1427001,1441000,13999,False,153,scaffold_9
20,1457001,1471000,13999,False,153,scaffold_9
21,1482001,1857000,374999,False,153,scaffold_9
22,1877001,2171000,293999,False,153,scaffold_9
23,2173001,3381000,1207999,False,153,scaffold_9
24,3383001,4861000,1477999,False,153,scaffold_9
25,4863001,5099000,235999,False,153,scaffold_9
26,5116001,6331288,1215287,True,153,scaffold_9
0,1,1069000,1068999,True,153,scaffold_10
1,1073001,2520000,1446999,False,153,scaffold_10
2,2521001,3022000,500999,False,153,scaffold_10
3,3062001,3127000,64999,False,153,scaffold_10
4,3128001,3204000,75999,False,153,scaffold_10
5,3253001,3301000,47999,False,153,scaffold_10
6,3304001,3477000,172999,False,153,scaffold_10
7,3481001,3505000,23999,False,153,scaffold_10
8,3552001,3582000,29999,False,153,scaffold_10
9,3620001,3671000,50999,False,153,scaffold_10
10,3706001,3795000,88999,False,153,scaffold_10
11,3802001,3836000,33999,False,153,scaffold_10
12,3871001,3903000,31999,False,153,scaffold_10
13,3936001,3993000,56999,False,153,scaffold_10
14,4001001,4094000,92999,False,153,scaffold_10
15,4155001,4261000,105999,False,153,scaffold_10
16,4295001,4314000,18999,False,153,scaffold_10
17,4316001,4427000,110999,False,153,scaffold_10
18,4443001,4513000,69999,False,153,scaffold_10
19,4515001,4523000,7999,False,153,scaffold_10
20,4525001,4548000,22999,False,153,scaffold_10
21,4554001,4562000,7999,False,153,scaffold_10
22,4565001,4635000,69999,False,153,scaffold_10
23,4716001,4772000,55999,False,153,scaffold_10
24,4773001,4776000,2999,False,153,scaffold_10
25,4791001,4797000,5999,False,153,scaffold_10
26,4798001,4824000,25999,False,153,scaffold_10
27,4827001,4843000,15999,False,153,scaffold_10
28,4848001,4861000,12999,False,153,scaffold_10
29,4865001,4866973,1972,True,153,scaffold_10
0,10001,111000,100999,False,153,scaffold_11
1,131001,167000,35999,False,153,scaffold_11
2,171001,212000,40999,False,153,scaffold_11
3,213001,236000,22999,False,153,scaffold_11
4,240001,253000,12999,False,153,scaffold_11
5,278001,327000,48999,False,153,scaffold_11
6,419001,431000,11999,False,153,scaffold_11
7,433001,455000,21999,False,153,scaffold_11
8,648001,656000,7999,False,153,scaffold_11
9,1025001,1034000,8999,False,153,scaffold_11
10,1070001,1110000,39999,False,153,scaffold_11
11,1171001,1215000,43999,False,153,scaffold_11
12,1219001,1249000,29999,False,153,scaffold_11
13,1304001,1398000,93999,False,153,scaffold_11
14,1423001,1470000,46999,False,153,scaffold_11
15,1525001,1696000,170999,False,153,scaffold_11
16,1721001,1729000,7999,False,153,scaffold_11
17,1759001,2291000,531999,False,153,scaffold_11
18,2331001,2430000,98999,False,153,scaffold_11
19,2432001,2920000,487999,False,153,scaffold_11
20,2946001,3183000,236999,False,153,scaffold_11
21,3184001,3733000,548999,False,153,scaffold_11
22,3742001,3832000,89999,False,153,scaffold_11
23,3833001,4710000,876999,False,153,scaffold_11
24,4712001,4766820,54819,True,153,scaffold_11
0,1,67000,66999,True,153,scaffold_12
1,68001,1763000,1694999,False,153,scaffold_12
2,1765001,1811000,45999,False,153,scaffold_12
3,1824001,2125000,300999,False,153,scaffold_12
4,2130001,2189000,58999,False,153,scaffold_12
5,2279001,2427000,147999,False,153,scaffold_12
6,2428001,2491000,62999,False,153,scaffold_12
7,2492001,2546000,53999,False,153,scaffold_12
8,2571001,2624000,52999,False,153,scaffold_12
9,2625001,2647000,21999,False,153,scaffold_12
10,2674001,2682000,7999,False,153,scaffold_12
11,2686001,2708000,21999,False,153,scaffold_12
0,1,1291000,1290999,True,154,scaffold_1
1,1295001,1938000,642999,False,154,scaffold_1
2,1945001,1964000,18999,False,154,scaffold_1
3,1965001,2183000,217999,False,154,scaffold_1
4,2206001,2630000,423999,False,154,scaffold_1
5,2641001,2804000,162999,False,154,scaffold_1
6,2873001,3240000,366999,False,154,scaffold_1
7,3244001,3381000,136999,False,154,scaffold_1
8,3417001,4794000,1376999,False,154,scaffold_1
9,4796001,5231000,434999,False,154,scaffold_1
10,5264001,5335000,70999,False,154,scaffold_1
11,5341001,5526000,184999,False,154,scaffold_1
12,5528001,5619000,90999,False,154,scaffold_1
13,5650001,5709000,58999,False,154,scaffold_1
14,5784001,5980000,195999,False,154,scaffold_1
15,6053001,6380000,326999,False,154,scaffold_1
16,6384001,6863000,478999,False,154,scaffold_1
17,6864001,7247000,382999,False,154,scaffold_1
18,7248001,7584000,335999,False,154,scaffold_1
19,7586001,8656000,1069999,False,154,scaffold_1
20,8657001,9584000,926999,False,154,scaffold_1
21,9586001,12084000,2497999,False,154,scaffold_1
22,12105001,12888000,782999,False,154,scaffold_1
23,12905001,13200000,294999,False,154,scaffold_1
24,13201001,13217000,15999,False,154,scaffold_1
25,13309001,13449000,139999,False,154,scaffold_1
26,13517001,13616000,98999,False,154,scaffold_1
27,13633001,13706000,72999,False,154,scaffold_1
28,13748001,13776000,27999,False,154,scaffold_1
29,13796001,13845000,48999,False,154,scaffold_1
30,13847001,13941000,93999,False,154,scaffold_1
31,13957001,13990000,32999,False,154,scaffold_1
32,14015001,14082000,66999,False,154,scaffold_1
33,14113001,14130000,16999,False,154,scaffold_1
34,14131001,14142000,10999,False,154,scaffold_1
35,14288001,14308000,19999,False,154,scaffold_1
36,14316001,14363000,46999,False,154,scaffold_1
37,14443001,14469000,25999,False,154,scaffold_1
38,14471001,14480000,8999,False,154,scaffold_1
39,14530001,14591000,60999,False,154,scaffold_1
40,14649001,14666000,16999,False,154,scaffold_1
0,1,48000,47999,True,154,scaffold_2
1,51001,91000,39999,False,154,scaffold_2
2,96001,159000,62999,False,154,scaffold_2
3,164001,177000,12999,False,154,scaffold_2
4,212001,288000,75999,False,154,scaffold_2
5,330001,374000,43999,False,154,scaffold_2
6,418001,443000,24999,False,154,scaffold_2
7,459001,581000,121999,False,154,scaffold_2
8,585001,625000,39999,False,154,scaffold_2
9,787001,851000,63999,False,154,scaffold_2
10,932001,1015000,82999,False,154,scaffold_2
11,1019001,1057000,37999,False,154,scaffold_2
12,1061001,1098000,36999,False,154,scaffold_2
13,1102001,1225000,122999,False,154,scaffold_2
14,1230001,1258000,27999,False,154,scaffold_2
15,1294001,1562000,267999,False,154,scaffold_2
16,1570001,1657000,86999,False,154,scaffold_2
17,1712001,1900000,187999,False,154,scaffold_2
18,1925001,2013000,87999,False,154,scaffold_2
19,2042001,2144000,101999,False,154,scaffold_2
20,2179001,2235000,55999,False,154,scaffold_2
21,2248001,2631000,382999,False,154,scaffold_2
22,2646001,2689000,42999,False,154,scaffold_2
23,2693001,3108000,414999,False,154,scaffold_2
24,3164001,3181000,16999,False,154,scaffold_2
25,3183001,3284000,100999,False,154,scaffold_2
26,3286001,3451000,164999,False,154,scaffold_2
27,3452001,3877000,424999,False,154,scaffold_2
28,3892001,3955000,62999,False,154,scaffold_2
29,3966001,4060000,93999,False,154,scaffold_2
30,4077001,4190000,112999,False,154,scaffold_2
31,4204001,4987000,782999,False,154,scaffold_2
32,5004001,5777000,772999,False,154,scaffold_2
33,5839001,7480000,1640999,False,154,scaffold_2
34,7545001,7561000,15999,False,154,scaffold_2
35,7563001,8330000,766999,False,154,scaffold_2
36,8331001,8344000,12999,False,154,scaffold_2
37,8346001,8493000,146999,False,154,scaffold_2
38,8495001,9175000,679999,False,154,scaffold_2
39,9182001,9738000,555999,False,154,scaffold_2
40,9754001,9828000,73999,False,154,scaffold_2
41,9850001,9900000,49999,False,154,scaffold_2
42,9965001,9981000,15999,False,154,scaffold_2
43,10096001,10120000,23999,False,154,scaffold_2
44,10159001,10762000,602999,False,154,scaffold_2
45,10768001,10970000,201999,False,154,scaffold_2
46,10991001,10994000,2999,False,154,scaffold_2
47,10995001,11365000,369999,False,154,scaffold_2
48,11368001,11801000,432999,False,154,scaffold_2
0,1,2000,1999,True,154,scaffold_3
1,10001,55000,44999,False,154,scaffold_3
2,100001,104000,3999,False,154,scaffold_3
3,105001,129000,23999,False,154,scaffold_3
4,151001,174000,22999,False,154,scaffold_3
5,237001,259000,21999,False,154,scaffold_3
6,575001,607000,31999,False,154,scaffold_3
7,618001,642000,23999,False,154,scaffold_3
8,649001,656000,6999,False,154,scaffold_3
9,662001,734000,71999,False,154,scaffold_3
10,772001,936000,163999,False,154,scaffold_3
11,1045001,1084000,38999,False,154,scaffold_3
12,1098001,1109000,10999,False,154,scaffold_3
13,1154001,1162000,7999,False,154,scaffold_3
14,1163001,1248000,84999,False,154,scaffold_3
15,1358001,1380000,21999,False,154,scaffold_3
16,1429001,1474000,44999,False,154,scaffold_3
17,1488001,1582000,93999,False,154,scaffold_3
18,1584001,1634000,49999,False,154,scaffold_3
19,1635001,1689000,53999,False,154,scaffold_3
20,1691001,1819000,127999,False,154,scaffold_3
21,1837001,1978000,140999,False,154,scaffold_3
22,1987001,2306000,318999,False,154,scaffold_3
23,2350001,2573000,222999,False,154,scaffold_3
24,2633001,3062000,428999,False,154,scaffold_3
25,3066001,3901000,834999,False,154,scaffold_3
26,3929001,4555000,625999,False,154,scaffold_3
27,4581001,4600000,18999,False,154,scaffold_3
28,4636001,4666000,29999,False,154,scaffold_3
29,4696001,4763000,66999,False,154,scaffold_3
30,4765001,6249000,1483999,False,154,scaffold_3
31,6419001,7156000,736999,False,154,scaffold_3
32,7165001,7445000,279999,False,154,scaffold_3
33,7449001,7563000,113999,False,154,scaffold_3
34,7572001,7908000,335999,False,154,scaffold_3
35,7910001,7960000,49999,False,154,scaffold_3
36,8028001,8450000,421999,False,154,scaffold_3
37,8457001,8730000,272999,False,154,scaffold_3
38,8761001,8804000,42999,False,154,scaffold_3
39,8843001,9264000,420999,False,154,scaffold_3
40,9297001,9803000,505999,False,154,scaffold_3
41,9806001,10147000,340999,False,154,scaffold_3
42,10172001,10458000,285999,False,154,scaffold_3
43,10461001,11182071,721070,True,154,scaffold_3
0,11001,13000,1999,False,154,scaffold_4
1,14001,16000,1999,False,154,scaffold_4
2,48001,122000,73999,False,154,scaffold_4
3,126001,146000,19999,False,154,scaffold_4
4,147001,151000,3999,False,154,scaffold_4
5,161001,215000,53999,False,154,scaffold_4
6,217001,226000,8999,False,154,scaffold_4
7,228001,241000,12999,False,154,scaffold_4
8,242001,259000,16999,False,154,scaffold_4
9,283001,344000,60999,False,154,scaffold_4
10,345001,353000,7999,False,154,scaffold_4
11,355001,410000,54999,False,154,scaffold_4
12,412001,425000,12999,False,154,scaffold_4
13,426001,428000,1999,False,154,scaffold_4
14,429001,494000,64999,False,154,scaffold_4
15,498001,505000,6999,False,154,scaffold_4
16,506001,592000,85999,False,154,scaffold_4
17,608001,691000,82999,False,154,scaffold_4
18,1053001,1081000,27999,False,154,scaffold_4
19,1098001,1136000,37999,False,154,scaffold_4
20,1138001,1226000,87999,False,154,scaffold_4
21,1229001,1605000,375999,False,154,scaffold_4
22,1607001,1610000,2999,False,154,scaffold_4
23,1613001,2205000,591999,False,154,scaffold_4
24,2210001,2218000,7999,False,154,scaffold_4
25,2219001,2402000,182999,False,154,scaffold_4
26,2404001,2460000,55999,False,154,scaffold_4
27,2475001,3045000,569999,False,154,scaffold_4
28,3046001,4197000,1150999,False,154,scaffold_4
29,4198001,4352000,153999,False,154,scaffold_4
30,4398001,5225000,826999,False,154,scaffold_4
31,5261001,5506000,244999,False,154,scaffold_4
32,5514001,5784000,269999,False,154,scaffold_4
33,5786001,6128000,341999,False,154,scaffold_4
34,6145001,6438000,292999,False,154,scaffold_4
35,6452001,6510000,57999,False,154,scaffold_4
36,6531001,6537000,5999,False,154,scaffold_4
37,6542001,6612000,69999,False,154,scaffold_4
38,6620001,6640000,19999,False,154,scaffold_4
39,6706001,6817000,110999,False,154,scaffold_4
40,6829001,6924000,94999,False,154,scaffold_4
41,6926001,7482000,555999,False,154,scaffold_4
42,7498001,7571000,72999,False,154,scaffold_4
43,7628001,7666000,37999,False,154,scaffold_4
44,7692001,7716000,23999,False,154,scaffold_4
45,7773001,7925000,151999,False,154,scaffold_4
46,7967001,8015000,47999,False,154,scaffold_4
47,8049001,8104000,54999,False,154,scaffold_4
48,8389001,8429000,39999,False,154,scaffold_4
49,8555001,8597000,41999,False,154,scaffold_4
50,8624001,8679000,54999,False,154,scaffold_4
51,8710001,8829000,118999,False,154,scaffold_4
52,8844001,9699000,854999,False,154,scaffold_4
53,9700001,9845951,145950,True,154,scaffold_4
0,48001,57000,8999,False,154,scaffold_5
1,114001,121000,6999,False,154,scaffold_5
2,127001,202000,74999,False,154,scaffold_5
3,323001,419000,95999,False,154,scaffold_5
4,442001,526000,83999,False,154,scaffold_5
5,610001,658000,47999,False,154,scaffold_5
6,668001,720000,51999,False,154,scaffold_5
7,803001,832000,28999,False,154,scaffold_5
8,933001,947000,13999,False,154,scaffold_5
9,1097001,1182000,84999,False,154,scaffold_5
10,1183001,1461000,277999,False,154,scaffold_5
11,1476001,1502000,25999,False,154,scaffold_5
12,1614001,1690000,75999,False,154,scaffold_5
13,1769001,1822000,52999,False,154,scaffold_5
14,1876001,1895000,18999,False,154,scaffold_5
15,1947001,1971000,23999,False,154,scaffold_5
16,2078001,2104000,25999,False,154,scaffold_5
17,2106001,2138000,31999,False,154,scaffold_5
18,2256001,2515000,258999,False,154,scaffold_5
19,2516001,3242000,725999,False,154,scaffold_5
20,3243001,4101000,857999,False,154,scaffold_5
21,4114001,5346000,1231999,False,154,scaffold_5
22,5348001,5469000,120999,False,154,scaffold_5
23,5495001,5848000,352999,False,154,scaffold_5
24,5864001,5891000,26999,False,154,scaffold_5
25,5922001,5979000,56999,False,154,scaffold_5
26,6116001,6262000,145999,False,154,scaffold_5
27,6263001,6297000,33999,False,154,scaffold_5
28,6377001,7088000,710999,False,154,scaffold_5
29,7102001,7386000,283999,False,154,scaffold_5
30,7406001,7514000,107999,False,154,scaffold_5
31,7523001,7800000,276999,False,154,scaffold_5
32,7817001,7911000,93999,False,154,scaffold_5
33,7912001,8049000,136999,False,154,scaffold_5
34,8123001,8161000,37999,False,154,scaffold_5
35,8230001,8257000,26999,False,154,scaffold_5
36,8261001,8464000,202999,False,154,scaffold_5
37,8509001,8539000,29999,False,154,scaffold_5
38,8540001,9364176,824175,True,154,scaffold_5
0,21001,38000,16999,False,154,scaffold_6
1,70001,74000,3999,False,154,scaffold_6
2,78001,84000,5999,False,154,scaffold_6
3,86001,121000,34999,False,154,scaffold_6
4,136001,411000,274999,False,154,scaffold_6
5,455001,499000,43999,False,154,scaffold_6
6,589001,595000,5999,False,154,scaffold_6
7,642001,677000,34999,False,154,scaffold_6
8,730001,806000,75999,False,154,scaffold_6
9,833001,851000,17999,False,154,scaffold_6
10,863001,890000,26999,False,154,scaffold_6
11,900001,1226000,325999,False,154,scaffold_6
12,1228001,1306000,77999,False,154,scaffold_6
13,1378001,1604000,225999,False,154,scaffold_6
14,1657001,2105000,447999,False,154,scaffold_6
15,2126001,2219000,92999,False,154,scaffold_6
16,2236001,2285000,48999,False,154,scaffold_6
17,2320001,2595000,274999,False,154,scaffold_6
18,2596001,2867000,270999,False,154,scaffold_6
19,2879001,3211000,331999,False,154,scaffold_6
20,3218001,3801000,582999,False,154,scaffold_6
21,3810001,3935000,124999,False,154,scaffold_6
22,3968001,4207000,238999,False,154,scaffold_6
23,4216001,4335000,118999,False,154,scaffold_6
24,4385001,4541000,155999,False,154,scaffold_6
25,4560001,4716000,155999,False,154,scaffold_6
26,4814001,4918000,103999,False,154,scaffold_6
27,4923001,4997000,73999,False,154,scaffold_6
28,5055001,5184000,128999,False,154,scaffold_6
29,5199001,5641000,441999,False,154,scaffold_6
30,5642001,5845000,202999,False,154,scaffold_6
31,5849001,6333000,483999,False,154,scaffold_6
32,6335001,6359000,23999,False,154,scaffold_6
33,6440001,7338000,897999,False,154,scaffold_6
34,7372001,8268281,896280,True,154,scaffold_6
0,22001,46000,23999,False,154,scaffold_7
1,309001,341000,31999,False,154,scaffold_7
2,342001,505000,162999,False,154,scaffold_7
3,615001,642000,26999,False,154,scaffold_7
4,646001,736000,89999,False,154,scaffold_7
5,739001,753000,13999,False,154,scaffold_7
6,762001,829000,66999,False,154,scaffold_7
7,868001,872000,3999,False,154,scaffold_7
8,875001,910000,34999,False,154,scaffold_7
9,914001,963000,48999,False,154,scaffold_7
10,982001,1044000,61999,False,154,scaffold_7
11,1071001,1151000,79999,False,154,scaffold_7
12,1191001,1846000,654999,False,154,scaffold_7
13,1847001,2125000,277999,False,154,scaffold_7
14,2187001,2204000,16999,False,154,scaffold_7
15,2222001,2286000,63999,False,154,scaffold_7
16,2355001,2401000,45999,False,154,scaffold_7
17,2443001,2745000,301999,False,154,scaffold_7
18,2788001,4346000,1557999,False,154,scaffold_7
19,4347001,5466000,1118999,False,154,scaffold_7
20,5491001,5645000,153999,False,154,scaffold_7
21,5677001,6522000,844999,False,154,scaffold_7
22,6525001,7502216,977215,True,154,scaffold_7
0,1,6000,5999,True,154,scaffold_8
1,13001,23000,9999,False,154,scaffold_8
2,37001,85000,47999,False,154,scaffold_8
3,332001,355000,22999,False,154,scaffold_8
4,373001,394000,20999,False,154,scaffold_8
5,434001,447000,12999,False,154,scaffold_8
6,982001,1047000,64999,False,154,scaffold_8
7,1080001,1098000,17999,False,154,scaffold_8
8,1115001,1136000,20999,False,154,scaffold_8
9,1138001,1157000,18999,False,154,scaffold_8
10,1170001,1231000,60999,False,154,scaffold_8
11,1270001,1331000,60999,False,154,scaffold_8
12,1359001,1428000,68999,False,154,scaffold_8
13,1498001,1547000,48999,False,154,scaffold_8
14,1554001,1658000,103999,False,154,scaffold_8
15,1697001,1748000,50999,False,154,scaffold_8
16,1799001,2683000,883999,False,154,scaffold_8
17,2684001,2844000,159999,False,154,scaffold_8
18,2847001,3125000,277999,False,154,scaffold_8
19,3126001,3614000,487999,False,154,scaffold_8
20,3615001,4687000,1071999,False,154,scaffold_8
21,4718001,4788000,69999,False,154,scaffold_8
22,4799001,4964000,164999,False,154,scaffold_8
23,4969001,6334544,1365543,True,154,scaffold_8
0,79001,106000,26999,False,154,scaffold_9
1,109001,111000,1999,False,154,scaffold_9
2,119001,182000,62999,False,154,scaffold_9
3,190001,216000,25999,False,154,scaffold_9
4,287001,411000,123999,False,154,scaffold_9
5,413001,440000,26999,False,154,scaffold_9
6,442001,464000,21999,False,154,scaffold_9
7,477001,531000,53999,False,154,scaffold_9
8,532001,579000,46999,False,154,scaffold_9
9,634001,665000,30999,False,154,scaffold_9
10,670001,754000,83999,False,154,scaffold_9
11,948001,986000,37999,False,154,scaffold_9
12,1127001,1150000,22999,False,154,scaffold_9
13,1151001,1191000,39999,False,154,scaffold_9
14,1203001,1237000,33999,False,154,scaffold_9
15,1342001,1387000,44999,False,154,scaffold_9
16,1407001,1424000,16999,False,154,scaffold_9
17,1426001,1453000,26999,False,154,scaffold_9
18,1457001,1481000,23999,False,154,scaffold_9
19,1483001,1592000,108999,False,154,scaffold_9
20,1593001,1728000,134999,False,154,scaffold_9
21,1730001,2171000,440999,False,154,scaffold_9
22,2176001,2227000,50999,False,154,scaffold_9
23,2230001,3381000,1150999,False,154,scaffold_9
24,3383001,3781000,397999,False,154,scaffold_9
25,3782001,3822000,39999,False,154,scaffold_9
26,3866001,4520000,653999,False,154,scaffold_9
27,4526001,5083000,556999,False,154,scaffold_9
28,5112001,5115000,2999,False,154,scaffold_9
29,5116001,5298000,181999,False,154,scaffold_9
30,5300001,6331288,1031287,True,154,scaffold_9
0,1,482000,481999,True,154,scaffold_10
1,483001,1068000,584999,False,154,scaffold_10
2,1072001,1211000,138999,False,154,scaffold_10
3,1223001,2100000,876999,False,154,scaffold_10
4,2120001,2520000,399999,False,154,scaffold_10
5,2521001,2812000,290999,False,154,scaffold_10
6,2820001,3127000,306999,False,154,scaffold_10
7,3264001,3274000,9999,False,154,scaffold_10
8,3308001,3346000,37999,False,154,scaffold_10
9,3377001,3458000,80999,False,154,scaffold_10
10,3631001,3675000,43999,False,154,scaffold_10
11,3703001,3795000,91999,False,154,scaffold_10
12,3802001,3814000,11999,False,154,scaffold_10
13,4000001,4137000,136999,False,154,scaffold_10
14,4165001,4184000,18999,False,154,scaffold_10
15,4316001,4411000,94999,False,154,scaffold_10
16,4413001,4466000,52999,False,154,scaffold_10
17,4491001,4513000,21999,False,154,scaffold_10
18,4554001,4562000,7999,False,154,scaffold_10
19,4573001,4615000,41999,False,154,scaffold_10
20,4681001,4685000,3999,False,154,scaffold_10
21,4686001,4699000,12999,False,154,scaffold_10
22,4700001,4715000,14999,False,154,scaffold_10
23,4716001,4723000,6999,False,154,scaffold_10
24,4753001,4776000,22999,False,154,scaffold_10
25,4791001,4797000,5999,False,154,scaffold_10
26,4798001,4824000,25999,False,154,scaffold_10
27,4828001,4861000,32999,False,154,scaffold_10
28,4865001,4866973,1972,True,154,scaffold_10
0,9001,110000,100999,False,154,scaffold_11
1,118001,129000,10999,False,154,scaffold_11
2,132001,167000,34999,False,154,scaffold_11
3,169001,212000,42999,False,154,scaffold_11
4,213001,238000,24999,False,154,scaffold_11
5,261001,276000,14999,False,154,scaffold_11
6,402001,417000,14999,False,154,scaffold_11
7,433001,449000,15999,False,154,scaffold_11
8,649001,656000,6999,False,154,scaffold_11
9,790001,822000,31999,False,154,scaffold_11
10,909001,939000,29999,False,154,scaffold_11
11,1029001,1034000,4999,False,154,scaffold_11
12,1101001,1120000,18999,False,154,scaffold_11
13,1219001,1249000,29999,False,154,scaffold_11
14,1325001,1370000,44999,False,154,scaffold_11
15,1526001,1544000,17999,False,154,scaffold_11
16,1578001,1805000,226999,False,154,scaffold_11
17,1854001,2058000,203999,False,154,scaffold_11
18,2065001,2169000,103999,False,154,scaffold_11
19,2192001,2224000,31999,False,154,scaffold_11
20,2340001,2407000,66999,False,154,scaffold_11
21,2408001,3006000,597999,False,154,scaffold_11
22,3007001,3040000,32999,False,154,scaffold_11
23,3059001,3514000,454999,False,154,scaffold_11
24,3516001,3695000,178999,False,154,scaffold_11
25,3723001,4710000,986999,False,154,scaffold_11
26,4713001,4766820,53819,True,154,scaffold_11
0,1,787000,786999,True,154,scaffold_12
1,788001,1620000,831999,False,154,scaffold_12
2,1638001,1693000,54999,False,154,scaffold_12
3,1700001,1763000,62999,False,154,scaffold_12
4,1764001,2125000,360999,False,154,scaffold_12
5,2129001,2192000,62999,False,154,scaffold_12
6,2219001,2317000,97999,False,154,scaffold_12
7,2318001,2479000,160999,False,154,scaffold_12
8,2571001,2622000,50999,False,154,scaffold_12
9,2625001,2682000,56999,False,154,scaffold_12
10,2685001,2699000,13999,False,154,scaffold_12
11,2703001,2708000,4999,False,154,scaffold_12
12,2709001,2722000,12999,False,154,scaffold_12
13,2724001,2747968,23967,True,154,scaffold_12
0,1,500000,499999,True,155,scaffold_1
1,509001,545000,35999,False,155,scaffold_1
2,568001,1087000,518999,False,155,scaffold_1
3,1168001,1292000,123999,False,155,scaffold_1
4,1311001,1347000,35999,False,155,scaffold_1
5,1540001,1587000,46999,False,155,scaffold_1
6,1604001,1699000,94999,False,155,scaffold_1
7,1725001,1964000,238999,False,155,scaffold_1
8,1965001,2010000,44999,False,155,scaffold_1
9,2052001,2101000,48999,False,155,scaffold_1
10,2135001,2184000,48999,False,155,scaffold_1
11,2341001,2438000,96999,False,155,scaffold_1
12,2449001,2621000,171999,False,155,scaffold_1
13,2658001,2771000,112999,False,155,scaffold_1
14,2891001,2928000,36999,False,155,scaffold_1
15,2948001,3037000,88999,False,155,scaffold_1
16,3100001,3133000,32999,False,155,scaffold_1
17,3169001,3240000,70999,False,155,scaffold_1
18,3277001,3357000,79999,False,155,scaffold_1
19,3437001,3621000,183999,False,155,scaffold_1
20,3685001,3709000,23999,False,155,scaffold_1
21,3712001,4417000,704999,False,155,scaffold_1
22,4418001,4794000,375999,False,155,scaffold_1
23,4796001,4904000,107999,False,155,scaffold_1
24,4906001,5070000,163999,False,155,scaffold_1
25,5087001,5200000,112999,False,155,scaffold_1
26,5265001,5310000,44999,False,155,scaffold_1
27,5347001,5473000,125999,False,155,scaffold_1
28,5479001,5512000,32999,False,155,scaffold_1
29,5540001,5620000,79999,False,155,scaffold_1
30,5818001,5952000,133999,False,155,scaffold_1
31,6019001,6069000,49999,False,155,scaffold_1
32,6108001,6178000,69999,False,155,scaffold_1
33,6204001,6322000,117999,False,155,scaffold_1
34,6323001,6461000,137999,False,155,scaffold_1
35,6462001,6575000,112999,False,155,scaffold_1
36,6633001,6760000,126999,False,155,scaffold_1
37,6791001,6918000,126999,False,155,scaffold_1
38,6921001,7247000,325999,False,155,scaffold_1
39,7248001,8656000,1407999,False,155,scaffold_1
40,8658001,8899000,240999,False,155,scaffold_1
41,8902001,9539000,636999,False,155,scaffold_1
42,9540001,9584000,43999,False,155,scaffold_1
43,9586001,10640000,1053999,False,155,scaffold_1
44,10664001,10792000,127999,False,155,scaffold_1
45,10827001,10854000,26999,False,155,scaffold_1
46,10894001,12270000,1375999,False,155,scaffold_1
47,12302001,12396000,93999,False,155,scaffold_1
48,12398001,12559000,160999,False,155,scaffold_1
49,12560001,13077000,516999,False,155,scaffold_1
50,13098001,13189000,90999,False,155,scaffold_1
51,13191001,13213000,21999,False,155,scaffold_1
52,13341001,13455000,113999,False,155,scaffold_1
53,13462001,13496000,33999,False,155,scaffold_1
54,13517001,13534000,16999,False,155,scaffold_1
55,13548001,13619000,70999,False,155,scaffold_1
56,13635001,13709000,73999,False,155,scaffold_1
57,13792001,13845000,52999,False,155,scaffold_1
58,13846001,13927000,80999,False,155,scaffold_1
59,13928001,13955000,26999,False,155,scaffold_1
60,13959001,14004000,44999,False,155,scaffold_1
61,14053001,14062000,8999,False,155,scaffold_1
62,14287001,14313000,25999,False,155,scaffold_1
63,14530001,14621000,90999,False,155,scaffold_1
64,14653001,14662000,8999,False,155,scaffold_1
65,14740001,14794116,54115,True,155,scaffold_1
0,20001,48000,27999,False,155,scaffold_2
1,101001,159000,57999,False,155,scaffold_2
2,165001,177000,11999,False,155,scaffold_2
3,302001,318000,15999,False,155,scaffold_2
4,332001,381000,48999,False,155,scaffold_2
5,418001,442000,23999,False,155,scaffold_2
6,458001,545000,86999,False,155,scaffold_2
7,731001,739000,7999,False,155,scaffold_2
8,1019001,1069000,49999,False,155,scaffold_2
9,1112001,1162000,49999,False,155,scaffold_2
10,1164001,1188000,23999,False,155,scaffold_2
11,1233001,1253000,19999,False,155,scaffold_2
12,1346001,1584000,237999,False,155,scaffold_2
13,1595001,1786000,190999,False,155,scaffold_2
14,1804001,1862000,57999,False,155,scaffold_2
15,1864001,1983000,118999,False,155,scaffold_2
16,2042001,2259000,216999,False,155,scaffold_2
17,2301001,2334000,32999,False,155,scaffold_2
18,2336001,2448000,111999,False,155,scaffold_2
19,2453001,2635000,181999,False,155,scaffold_2
20,2647001,2689000,41999,False,155,scaffold_2
21,2697001,2746000,48999,False,155,scaffold_2
22,2766001,2856000,89999,False,155,scaffold_2
23,2869001,3107000,237999,False,155,scaffold_2
24,3157001,3160000,2999,False,155,scaffold_2
25,3174001,3186000,11999,False,155,scaffold_2
26,3223001,3284000,60999,False,155,scaffold_2
27,3286001,3414000,127999,False,155,scaffold_2
28,3448001,3713000,264999,False,155,scaffold_2
29,3748001,3957000,208999,False,155,scaffold_2
30,3982001,4194000,211999,False,155,scaffold_2
31,4199001,4375000,175999,False,155,scaffold_2
32,4381001,4790000,408999,False,155,scaffold_2
33,4891001,4986000,94999,False,155,scaffold_2
34,5008001,5104000,95999,False,155,scaffold_2
35,5151001,5779000,627999,False,155,scaffold_2
36,5830001,6351000,520999,False,155,scaffold_2
37,6366001,6483000,116999,False,155,scaffold_2
38,6503001,7095000,591999,False,155,scaffold_2
39,7163001,7242000,78999,False,155,scaffold_2
40,7340001,7475000,134999,False,155,scaffold_2
41,7491001,7518000,26999,False,155,scaffold_2
42,7548001,7562000,13999,False,155,scaffold_2
43,7563001,7920000,356999,False,155,scaffold_2
44,7933001,7944000,10999,False,155,scaffold_2
45,7946001,8329000,382999,False,155,scaffold_2
46,8346001,8494000,147999,False,155,scaffold_2
47,8495001,8587000,91999,False,155,scaffold_2
48,8622001,8652000,29999,False,155,scaffold_2
49,8771001,8792000,20999,False,155,scaffold_2
50,8799001,8825000,25999,False,155,scaffold_2
51,8919001,9136000,216999,False,155,scaffold_2
52,9137001,9468000,330999,False,155,scaffold_2
53,9532001,9545000,12999,False,155,scaffold_2
54,9559001,9741000,181999,False,155,scaffold_2
55,9752001,9828000,75999,False,155,scaffold_2
56,9829001,9919000,89999,False,155,scaffold_2
57,9926001,9940000,13999,False,155,scaffold_2
58,10001001,10104000,102999,False,155,scaffold_2
59,10214001,10252000,37999,False,155,scaffold_2
60,10263001,10354000,90999,False,155,scaffold_2
61,10392001,10506000,113999,False,155,scaffold_2
62,10516001,10585000,68999,False,155,scaffold_2
63,10625001,10736000,110999,False,155,scaffold_2
64,10859001,10975000,115999,False,155,scaffold_2
65,10995001,10998000,2999,False,155,scaffold_2
66,11000001,11076000,75999,False,155,scaffold_2
67,11119001,11203000,83999,False,155,scaffold_2
68,11243001,11422000,178999,False,155,scaffold_2
69,11452001,11597000,144999,False,155,scaffold_2
70,11598001,11802476,204475,True,155,scaffold_2
0,1,2000,1999,True,155,scaffold_3
1,3001,8000,4999,False,155,scaffold_3
2,43001,55000,11999,False,155,scaffold_3
3,155001,174000,18999,False,155,scaffold_3
4,634001,646000,11999,False,155,scaffold_3
5,795001,936000,140999,False,155,scaffold_3
6,1163001,1234000,70999,False,155,scaffold_3
7,1357001,1383000,25999,False,155,scaffold_3
8,1531001,1553000,21999,False,155,scaffold_3
9,1573001,1581000,7999,False,155,scaffold_3
10,1609001,1790000,180999,False,155,scaffold_3
11,1826001,1886000,59999,False,155,scaffold_3
12,1902001,1980000,77999,False,155,scaffold_3
13,1999001,2108000,108999,False,155,scaffold_3
14,2109001,2203000,93999,False,155,scaffold_3
15,2204001,2344000,139999,False,155,scaffold_3
16,2349001,2428000,78999,False,155,scaffold_3
17,2432001,2533000,100999,False,155,scaffold_3
18,2534001,2558000,23999,False,155,scaffold_3
19,2561001,2609000,47999,False,155,scaffold_3
20,2621001,2937000,315999,False,155,scaffold_3
21,2968001,3032000,63999,False,155,scaffold_3
22,3066001,3457000,390999,False,155,scaffold_3
23,3469001,3892000,422999,False,155,scaffold_3
24,3927001,4164000,236999,False,155,scaffold_3
25,4165001,4237000,71999,False,155,scaffold_3
26,4243001,4404000,160999,False,155,scaffold_3
27,4410001,4520000,109999,False,155,scaffold_3
28,4540001,4559000,18999,False,155,scaffold_3
29,4705001,4717000,11999,False,155,scaffold_3
30,4744001,4775000,30999,False,155,scaffold_3
31,4776001,4816000,39999,False,155,scaffold_3
32,4839001,4917000,77999,False,155,scaffold_3
33,4967001,5325000,357999,False,155,scaffold_3
34,5342001,5697000,354999,False,155,scaffold_3
35,5701001,6088000,386999,False,155,scaffold_3
36,6098001,6184000,85999,False,155,scaffold_3
37,6221001,6255000,33999,False,155,scaffold_3
38,6260001,6304000,43999,False,155,scaffold_3
39,6453001,6494000,40999,False,155,scaffold_3
40,6538001,6583000,44999,False,155,scaffold_3
41,6682001,7099000,416999,False,155,scaffold_3
42,7109001,7157000,47999,False,155,scaffold_3
43,7230001,7447000,216999,False,155,scaffold_3
44,7450001,7460000,9999,False,155,scaffold_3
45,7462001,7563000,100999,False,155,scaffold_3
46,7573001,7989000,415999,False,155,scaffold_3
47,8029001,8109000,79999,False,155,scaffold_3
48,8122001,8167000,44999,False,155,scaffold_3
49,8174001,8726000,551999,False,155,scaffold_3
50,8756001,8806000,49999,False,155,scaffold_3
51,8815001,8916000,100999,False,155,scaffold_3
52,8952001,9242000,289999,False,155,scaffold_3
53,9323001,9580000,256999,False,155,scaffold_3
54,9645001,9693000,47999,False,155,scaffold_3
55,9732001,9812000,79999,False,155,scaffold_3
56,9814001,9906000,91999,False,155,scaffold_3
57,9968001,9994000,25999,False,155,scaffold_3
58,10040001,10102000,61999,False,155,scaffold_3
59,10244001,10302000,57999,False,155,scaffold_3
60,10377001,10457000,79999,False,155,scaffold_3
61,10585001,11182071,597070,True,155,scaffold_3
0,11001,13000,1999,False,155,scaffold_4
1,17001,32000,14999,False,155,scaffold_4
2,48001,88000,39999,False,155,scaffold_4
3,120001,146000,25999,False,155,scaffold_4
4,147001,151000,3999,False,155,scaffold_4
5,155001,160000,4999,False,155,scaffold_4
6,161001,216000,54999,False,155,scaffold_4
7,217001,226000,8999,False,155,scaffold_4
8,242001,267000,24999,False,155,scaffold_4
9,283001,310000,26999,False,155,scaffold_4
10,313001,353000,39999,False,155,scaffold_4
11,355001,374000,18999,False,155,scaffold_4
12,412001,425000,12999,False,155,scaffold_4
13,429001,505000,75999,False,155,scaffold_4
14,516001,536000,19999,False,155,scaffold_4
15,539001,563000,23999,False,155,scaffold_4
16,564001,592000,27999,False,155,scaffold_4
17,593001,607000,13999,False,155,scaffold_4
18,608001,691000,82999,False,155,scaffold_4
19,700001,727000,26999,False,155,scaffold_4
20,1113001,1136000,22999,False,155,scaffold_4
21,1137001,1226000,88999,False,155,scaffold_4
22,1229001,1253000,23999,False,155,scaffold_4
23,1254001,1279000,24999,False,155,scaffold_4
24,1283001,1392000,108999,False,155,scaffold_4
25,1393001,1605000,211999,False,155,scaffold_4
26,1613001,2206000,592999,False,155,scaffold_4
27,2207001,2268000,60999,False,155,scaffold_4
28,2269001,2471000,201999,False,155,scaffold_4
29,2475001,2632000,156999,False,155,scaffold_4
30,2648001,2675000,26999,False,155,scaffold_4
31,2676001,3252000,575999,False,155,scaffold_4
32,3253001,3605000,351999,False,155,scaffold_4
33,3606001,3766000,159999,False,155,scaffold_4
34,3794001,4045000,250999,False,155,scaffold_4
35,4048001,4196000,147999,False,155,scaffold_4
36,4212001,4297000,84999,False,155,scaffold_4
37,4698001,5506000,807999,False,155,scaffold_4
38,5514001,5629000,114999,False,155,scaffold_4
39,5637001,5784000,146999,False,155,scaffold_4
40,5786001,6197000,410999,False,155,scaffold_4
41,6210001,6278000,67999,False,155,scaffold_4
42,6286001,6538000,251999,False,155,scaffold_4
43,6548001,6612000,63999,False,155,scaffold_4
44,6614001,6617000,2999,False,155,scaffold_4
45,6620001,6826000,205999,False,155,scaffold_4
46,6828001,6995000,166999,False,155,scaffold_4
47,7008001,7180000,171999,False,155,scaffold_4
48,7189001,7403000,213999,False,155,scaffold_4
49,7461001,7567000,105999,False,155,scaffold_4
50,7628001,7667000,38999,False,155,scaffold_4
51,7752001,7928000,175999,False,155,scaffold_4
52,7975001,8016000,40999,False,155,scaffold_4
53,8051001,8100000,48999,False,155,scaffold_4
54,8258001,8364000,105999,False,155,scaffold_4
55,8637001,8680000,42999,False,155,scaffold_4
56,8703001,8829000,125999,False,155,scaffold_4
57,8843001,9178000,334999,False,155,scaffold_4
58,9179001,9699000,519999,False,155,scaffold_4
59,9703001,9845951,142950,True,155,scaffold_4
0,139001,168000,28999,False,155,scaffold_5
1,319001,420000,100999,False,155,scaffold_5
2,442001,526000,83999,False,155,scaffold_5
3,593001,661000,67999,False,155,scaffold_5
4,669001,720000,50999,False,155,scaffold_5
5,729001,746000,16999,False,155,scaffold_5
6,804001,832000,27999,False,155,scaffold_5
7,910001,947000,36999,False,155,scaffold_5
8,1062001,1105000,42999,False,155,scaffold_5
9,1120001,1136000,15999,False,155,scaffold_5
10,1195001,1221000,25999,False,155,scaffold_5
11,1253001,1405000,151999,False,155,scaffold_5
12,1583001,1592000,8999,False,155,scaffold_5
13,1627001,1656000,28999,False,155,scaffold_5
14,1657001,1661000,3999,False,155,scaffold_5
15,1759001,1792000,32999,False,155,scaffold_5
16,1943001,1968000,24999,False,155,scaffold_5
17,2082001,2104000,21999,False,155,scaffold_5
18,2185001,2210000,24999,False,155,scaffold_5
19,2255001,2300000,44999,False,155,scaffold_5
20,2381001,2515000,133999,False,155,scaffold_5
21,2516001,2981000,464999,False,155,scaffold_5
22,3029001,3043000,13999,False,155,scaffold_5
23,3045001,3068000,22999,False,155,scaffold_5
24,3096001,3565000,468999,False,155,scaffold_5
25,3614001,3681000,66999,False,155,scaffold_5
26,3710001,3907000,196999,False,155,scaffold_5
27,3915001,3945000,29999,False,155,scaffold_5
28,3963001,4063000,99999,False,155,scaffold_5
29,4065001,4121000,55999,False,155,scaffold_5
30,4122001,4431000,308999,False,155,scaffold_5
31,4445001,4503000,57999,False,155,scaffold_5
32,4504001,4810000,305999,False,155,scaffold_5
33,4811001,4925000,113999,False,155,scaffold_5
34,4938001,4992000,53999,False,155,scaffold_5
35,5017001,5110000,92999,False,155,scaffold_5
36,5153001,5346000,192999,False,155,scaffold_5
37,5404001,5471000,66999,False,155,scaffold_5
38,5490001,5577000,86999,False,155,scaffold_5
39,5689001,5739000,49999,False,155,scaffold_5
40,5740001,5768000,27999,False,155,scaffold_5
41,5809001,5888000,78999,False,155,scaffold_5
42,6204001,6262000,57999,False,155,scaffold_5
43,6263001,6274000,10999,False,155,scaffold_5
44,6391001,6737000,345999,False,155,scaffold_5
45,6762001,6968000,205999,False,155,scaffold_5
46,7034001,7085000,50999,False,155,scaffold_5
47,7172001,7385000,212999,False,155,scaffold_5
48,7407001,7442000,34999,False,155,scaffold_5
49,7454001,8051000,596999,False,155,scaffold_5
50,8124001,8161000,36999,False,155,scaffold_5
51,8258001,8310000,51999,False,155,scaffold_5
52,8322001,8344000,21999,False,155,scaffold_5
53,8376001,8469000,92999,False,155,scaffold_5
54,8552001,8616000,63999,False,155,scaffold_5
55,8632001,9362000,729999,False,155,scaffold_5
0,43001,47000,3999,False,155,scaffold_6
1,79001,84000,4999,False,155,scaffold_6
2,86001,121000,34999,False,155,scaffold_6
3,122001,208000,85999,False,155,scaffold_6
4,239001,253000,13999,False,155,scaffold_6
5,267001,376000,108999,False,155,scaffold_6
6,377001,431000,53999,False,155,scaffold_6
7,467001,495000,27999,False,155,scaffold_6
8,555001,580000,24999,False,155,scaffold_6
9,605001,614000,8999,False,155,scaffold_6
10,618001,663000,44999,False,155,scaffold_6
11,692001,808000,115999,False,155,scaffold_6
12,833001,857000,23999,False,155,scaffold_6
13,884001,1052000,167999,False,155,scaffold_6
14,1120001,1226000,105999,False,155,scaffold_6
15,1229001,1309000,79999,False,155,scaffold_6
16,1390001,1552000,161999,False,155,scaffold_6
17,1559001,1643000,83999,False,155,scaffold_6
18,1656001,2021000,364999,False,155,scaffold_6
19,2023001,2213000,189999,False,155,scaffold_6
20,2229001,2595000,365999,False,155,scaffold_6
21,2596001,2872000,275999,False,155,scaffold_6
22,2911001,3210000,298999,False,155,scaffold_6
23,3218001,3806000,587999,False,155,scaffold_6
24,3810001,3933000,122999,False,155,scaffold_6
25,3940001,4200000,259999,False,155,scaffold_6
26,4229001,4341000,111999,False,155,scaffold_6
27,4402001,4426000,23999,False,155,scaffold_6
28,4450001,4488000,37999,False,155,scaffold_6
29,4580001,4725000,144999,False,155,scaffold_6
30,4774001,4918000,143999,False,155,scaffold_6
31,4944001,4993000,48999,False,155,scaffold_6
32,5067001,5183000,115999,False,155,scaffold_6
33,5201001,5411000,209999,False,155,scaffold_6
34,5443001,5471000,27999,False,155,scaffold_6
35,5619001,5827000,207999,False,155,scaffold_6
36,5859001,6278000,418999,False,155,scaffold_6
37,6455001,6506000,50999,False,155,scaffold_6
38,6574001,6614000,39999,False,155,scaffold_6
39,6647001,6804000,156999,False,155,scaffold_6
40,6836001,6864000,27999,False,155,scaffold_6
41,6898001,7042000,143999,False,155,scaffold_6
42,7109001,7140000,30999,False,155,scaffold_6
43,7182001,7337000,154999,False,155,scaffold_6
44,7362001,8268281,906280,True,155,scaffold_6
0,2001,34000,31999,False,155,scaffold_7
1,111001,118000,6999,False,155,scaffold_7
2,131001,151000,19999,False,155,scaffold_7
3,273001,340000,66999,False,155,scaffold_7
4,342001,478000,135999,False,155,scaffold_7
5,479001,510000,30999,False,155,scaffold_7
6,571001,579000,7999,False,155,scaffold_7
7,707001,735000,27999,False,155,scaffold_7
8,764001,827000,62999,False,155,scaffold_7
9,859001,864000,4999,False,155,scaffold_7
10,867001,919000,51999,False,155,scaffold_7
11,920001,943000,22999,False,155,scaffold_7
12,982001,1026000,43999,False,155,scaffold_7
13,1028001,1044000,15999,False,155,scaffold_7
14,1048001,1123000,74999,False,155,scaffold_7
15,1160001,1240000,79999,False,155,scaffold_7
16,1241001,1261000,19999,False,155,scaffold_7
17,1262001,1438000,175999,False,155,scaffold_7
18,1439001,1460000,20999,False,155,scaffold_7
19,1461001,1528000,66999,False,155,scaffold_7
20,1588001,1721000,132999,False,155,scaffold_7
21,1722001,1782000,59999,False,155,scaffold_7
22,1815001,1845000,29999,False,155,scaffold_7
23,1847001,1882000,34999,False,155,scaffold_7
24,1910001,2029000,118999,False,155,scaffold_7
25,2034001,2114000,79999,False,155,scaffold_7
26,2186001,2208000,21999,False,155,scaffold_7
27,2224001,2317000,92999,False,155,scaffold_7
28,2367001,2410000,42999,False,155,scaffold_7
29,2442001,2594000,151999,False,155,scaffold_7
30,2613001,2712000,98999,False,155,scaffold_7
31,2714001,2759000,44999,False,155,scaffold_7
32,2784001,2869000,84999,False,155,scaffold_7
33,2931001,2958000,26999,False,155,scaffold_7
34,3005001,3059000,53999,False,155,scaffold_7
35,3096001,3271000,174999,False,155,scaffold_7
36,3292001,3422000,129999,False,155,scaffold_7
37,3487001,3614000,126999,False,155,scaffold_7
38,3615001,3703000,87999,False,155,scaffold_7
39,3717001,3932000,214999,False,155,scaffold_7
40,3949001,3978000,28999,False,155,scaffold_7
41,4022001,4152000,129999,False,155,scaffold_7
42,4167001,4188000,20999,False,155,scaffold_7
43,4245001,4279000,33999,False,155,scaffold_7
44,4281001,4581000,299999,False,155,scaffold_7
45,4629001,5209000,579999,False,155,scaffold_7
46,5261001,5344000,82999,False,155,scaffold_7
47,5395001,5434000,38999,False,155,scaffold_7
48,5470001,5645000,174999,False,155,scaffold_7
49,5719001,5858000,138999,False,155,scaffold_7
50,5901001,5995000,93999,False,155,scaffold_7
51,6014001,6248000,233999,False,155,scaffold_7
52,6293001,6437000,143999,False,155,scaffold_7
53,6467001,6504000,36999,False,155,scaffold_7
54,6541001,6687000,145999,False,155,scaffold_7
55,6688001,6929000,240999,False,155,scaffold_7
56,6945001,7502216,557215,True,155,scaffold_7
0,1,6000,5999,True,155,scaffold_8
1,31001,64000,32999,False,155,scaffold_8
2,66001,85000,18999,False,155,scaffold_8
3,1013001,1051000,37999,False,155,scaffold_8
4,1362001,1441000,78999,False,155,scaffold_8
5,1562001,1582000,19999,False,155,scaffold_8
6,1596001,1660000,63999,False,155,scaffold_8
7,1827001,1963000,135999,False,155,scaffold_8
8,2016001,2041000,24999,False,155,scaffold_8
9,2060001,2191000,130999,False,155,scaffold_8
10,2198001,2399000,200999,False,155,scaffold_8
11,2418001,2554000,135999,False,155,scaffold_8
12,2555001,2844000,288999,False,155,scaffold_8
13,2846001,3125000,278999,False,155,scaffold_8
14,3126001,3614000,487999,False,155,scaffold_8
15,3615001,3810000,194999,False,155,scaffold_8
16,3811001,4275000,463999,False,155,scaffold_8
17,4327001,4432000,104999,False,155,scaffold_8
18,4557001,4713000,155999,False,155,scaffold_8
19,4717001,4772000,54999,False,155,scaffold_8
20,4773001,4872000,98999,False,155,scaffold_8
21,4887001,4963000,75999,False,155,scaffold_8
22,4982001,5271000,288999,False,155,scaffold_8
23,5399001,5486000,86999,False,155,scaffold_8
24,5501001,5600000,98999,False,155,scaffold_8
25,5649001,5710000,60999,False,155,scaffold_8
26,5728001,6070000,341999,False,155,scaffold_8
27,6071001,6334544,263543,True,155,scaffold_8
0,109001,118000,8999,False,155,scaffold_9
1,121001,137000,15999,False,155,scaffold_9
2,150001,182000,31999,False,155,scaffold_9
3,271001,276000,4999,False,155,scaffold_9
4,366001,404000,37999,False,155,scaffold_9
5,413001,434000,20999,False,155,scaffold_9
6,483001,531000,47999,False,155,scaffold_9
7,547001,564000,16999,False,155,scaffold_9
8,649001,665000,15999,False,155,scaffold_9
9,669001,696000,26999,False,155,scaffold_9
10,814001,842000,27999,False,155,scaffold_9
11,878001,986000,107999,False,155,scaffold_9
12,988001,995000,6999,False,155,scaffold_9
13,997001,1000000,2999,False,155,scaffold_9
14,1001001,1085000,83999,False,155,scaffold_9
15,1087001,1198000,110999,False,155,scaffold_9
16,1202001,1257000,54999,False,155,scaffold_9
17,1311001,1402000,90999,False,155,scaffold_9
18,1406001,1423000,16999,False,155,scaffold_9
19,1483001,1728000,244999,False,155,scaffold_9
20,1730001,1739000,8999,False,155,scaffold_9
21,1740001,1860000,119999,False,155,scaffold_9
22,1885001,1957000,71999,False,155,scaffold_9
23,1971001,2171000,199999,False,155,scaffold_9
24,2174001,2289000,114999,False,155,scaffold_9
25,2290001,3381000,1090999,False,155,scaffold_9
26,3383001,4016000,632999,False,155,scaffold_9
27,4017001,4393000,375999,False,155,scaffold_9
28,4394001,5100000,705999,False,155,scaffold_9
29,5101001,5107000,5999,False,155,scaffold_9
30,5112001,5115000,2999,False,155,scaffold_9
31,5116001,5238000,121999,False,155,scaffold_9
32,5239001,5298000,58999,False,155,scaffold_9
33,5299001,5490000,190999,False,155,scaffold_9
34,5493001,6331288,838287,True,155,scaffold_9
0,1,369000,368999,True,155,scaffold_10
1,370001,482000,111999,False,155,scaffold_10
2,483001,592000,108999,False,155,scaffold_10
3,596001,797000,200999,False,155,scaffold_10
4,809001,1069000,259999,False,155,scaffold_10
5,1073001,1114000,40999,False,155,scaffold_10
6,1128001,1210000,81999,False,155,scaffold_10
7,1243001,1844000,600999,False,155,scaffold_10
8,1861001,1916000,54999,False,155,scaffold_10
9,1989001,2113000,123999,False,155,scaffold_10
10,2130001,2476000,345999,False,155,scaffold_10
11,2485001,2520000,34999,False,155,scaffold_10
12,2521001,2816000,294999,False,155,scaffold_10
13,2817001,2956000,138999,False,155,scaffold_10
14,3099001,3136000,36999,False,155,scaffold_10
15,3154001,3183000,28999,False,155,scaffold_10
16,3270001,3296000,25999,False,155,scaffold_10
17,3360001,3459000,98999,False,155,scaffold_10
18,3481001,3504000,22999,False,155,scaffold_10
19,3552001,3582000,29999,False,155,scaffold_10
20,3589001,3600000,10999,False,155,scaffold_10
21,3734001,3746000,11999,False,155,scaffold_10
22,3769001,3795000,25999,False,155,scaffold_10
23,4006001,4026000,19999,False,155,scaffold_10
24,4049001,4093000,43999,False,155,scaffold_10
25,4154001,4173000,18999,False,155,scaffold_10
26,4233001,4259000,25999,False,155,scaffold_10
27,4334001,4349000,14999,False,155,scaffold_10
28,4390001,4422000,31999,False,155,scaffold_10
29,4442001,4463000,20999,False,155,scaffold_10
30,4467001,4513000,45999,False,155,scaffold_10
31,4515001,4523000,7999,False,155,scaffold_10
32,4526001,4548000,21999,False,155,scaffold_10
33,4554001,4562000,7999,False,155,scaffold_10
34,4565001,4598000,32999,False,155,scaffold_10
35,4716001,4732000,15999,False,155,scaffold_10
36,4733001,4751000,17999,False,155,scaffold_10
37,4752001,4776000,23999,False,155,scaffold_10
38,4798001,4824000,25999,False,155,scaffold_10
39,4828001,4843000,14999,False,155,scaffold_10
40,4848001,4861000,12999,False,155,scaffold_10
41,4865001,4866973,1972,True,155,scaffold_10
0,10001,93000,82999,False,155,scaffold_11
1,149001,167000,17999,False,155,scaffold_11
2,169001,212000,42999,False,155,scaffold_11
3,214001,236000,21999,False,155,scaffold_11
4,240001,253000,12999,False,155,scaffold_11
5,289001,320000,30999,False,155,scaffold_11
6,419001,431000,11999,False,155,scaffold_11
7,637001,656000,18999,False,155,scaffold_11
8,1219001,1249000,29999,False,155,scaffold_11
9,1310001,1381000,70999,False,155,scaffold_11
10,1382001,1398000,15999,False,155,scaffold_11
11,1435001,1470000,34999,False,155,scaffold_11
12,1518001,1607000,88999,False,155,scaffold_11
13,1667001,1693000,25999,False,155,scaffold_11
14,1768001,1804000,35999,False,155,scaffold_11
15,1853001,2007000,153999,False,155,scaffold_11
16,2008001,2058000,49999,False,155,scaffold_11
17,2063001,2233000,169999,False,155,scaffold_11
18,2572001,2920000,347999,False,155,scaffold_11
19,2947001,3056000,108999,False,155,scaffold_11
20,3058001,3407000,348999,False,155,scaffold_11
21,3423001,3479000,55999,False,155,scaffold_11
22,3520001,3695000,174999,False,155,scaffold_11
23,3706001,4710000,1003999,False,155,scaffold_11
24,4713001,4766820,53819,True,155,scaffold_11
0,1,1598000,1597999,True,155,scaffold_12
1,1637001,1683000,45999,False,155,scaffold_12
2,1713001,1812000,98999,False,155,scaffold_12
3,1824001,2015000,190999,False,155,scaffold_12
4,2016001,2042000,25999,False,155,scaffold_12
5,2043001,2104000,60999,False,155,scaffold_12
6,2105001,2124000,18999,False,155,scaffold_12
7,2130001,2192000,61999,False,155,scaffold_12
8,2291001,2445000,153999,False,155,scaffold_12
9,2459001,2479000,19999,False,155,scaffold_12
10,2571001,2618000,46999,False,155,scaffold_12
11,2685001,2699000,13999,False,155,scaffold_12
0,1,1292000,1291999,True,156,scaffold_1
1,1294001,1937000,642999,False,156,scaffold_1
2,1945001,1964000,18999,False,156,scaffold_1
3,1965001,2018000,52999,False,156,scaffold_1
4,2253001,2304000,50999,False,156,scaffold_1
5,2347001,3033000,685999,False,156,scaffold_1
6,3038001,3125000,86999,False,156,scaffold_1
7,3188001,3240000,51999,False,156,scaffold_1
8,3244001,3273000,28999,False,156,scaffold_1
9,3412001,3433000,20999,False,156,scaffold_1
10,3438001,3633000,194999,False,156,scaffold_1
11,3671001,3881000,209999,False,156,scaffold_1
12,3891001,4041000,149999,False,156,scaffold_1
13,4042001,4184000,141999,False,156,scaffold_1
14,4270001,4284000,13999,False,156,scaffold_1
15,4314001,4355000,40999,False,156,scaffold_1
16,4709001,4770000,60999,False,156,scaffold_1
17,4796001,4826000,29999,False,156,scaffold_1
18,4861001,4880000,18999,False,156,scaffold_1
19,4924001,5048000,123999,False,156,scaffold_1
20,5080001,5190000,109999,False,156,scaffold_1
21,5353001,5379000,25999,False,156,scaffold_1
22,5419001,5471000,51999,False,156,scaffold_1
23,5535001,5614000,78999,False,156,scaffold_1
24,5683001,5712000,28999,False,156,scaffold_1
25,5794001,5831000,36999,False,156,scaffold_1
26,5835001,5928000,92999,False,156,scaffold_1
27,6055001,6381000,325999,False,156,scaffold_1
28,6382001,6863000,480999,False,156,scaffold_1
29,6864001,7247000,382999,False,156,scaffold_1
30,7248001,7584000,335999,False,156,scaffold_1
31,7590001,8656000,1065999,False,156,scaffold_1
32,8658001,9584000,925999,False,156,scaffold_1
33,9586001,11139000,1552999,False,156,scaffold_1
34,11283001,11304000,20999,False,156,scaffold_1
35,11326001,11537000,210999,False,156,scaffold_1
36,11560001,11918000,357999,False,156,scaffold_1
37,11919001,11987000,67999,False,156,scaffold_1
38,11993001,12007000,13999,False,156,scaffold_1
39,12109001,12151000,41999,False,156,scaffold_1
40,12195001,12294000,98999,False,156,scaffold_1
41,12438001,12519000,80999,False,156,scaffold_1
42,12646001,12998000,351999,False,156,scaffold_1
43,13019001,13216000,196999,False,156,scaffold_1
44,13264001,13418000,153999,False,156,scaffold_1
45,13517001,13541000,23999,False,156,scaffold_1
46,13557001,13589000,31999,False,156,scaffold_1
47,13594001,13615000,20999,False,156,scaffold_1
48,13928001,13937000,8999,False,156,scaffold_1
49,14283001,14306000,22999,False,156,scaffold_1
50,14450001,14469000,18999,False,156,scaffold_1
51,14738001,14752000,13999,False,156,scaffold_1
0,1,48000,47999,True,156,scaffold_2
1,51001,91000,39999,False,156,scaffold_2
2,93001,159000,65999,False,156,scaffold_2
3,164001,176000,11999,False,156,scaffold_2
4,214001,266000,51999,False,156,scaffold_2
5,297001,317000,19999,False,156,scaffold_2
6,330001,374000,43999,False,156,scaffold_2
7,460001,475000,14999,False,156,scaffold_2
8,511001,583000,71999,False,156,scaffold_2
9,585001,625000,39999,False,156,scaffold_2
10,679001,729000,49999,False,156,scaffold_2
11,785001,814000,28999,False,156,scaffold_2
12,948001,1011000,62999,False,156,scaffold_2
13,1018001,1024000,5999,False,156,scaffold_2
14,1754001,1767000,12999,False,156,scaffold_2
15,1792001,1831000,38999,False,156,scaffold_2
16,1928001,1960000,31999,False,156,scaffold_2
17,2311001,2560000,248999,False,156,scaffold_2
18,2561001,2689000,127999,False,156,scaffold_2
19,2694001,2775000,80999,False,156,scaffold_2
20,2777001,3081000,303999,False,156,scaffold_2
21,3171001,3181000,9999,False,156,scaffold_2
22,3183001,3219000,35999,False,156,scaffold_2
23,3256001,3284000,27999,False,156,scaffold_2
24,3361001,3490000,128999,False,156,scaffold_2
25,3592001,3619000,26999,False,156,scaffold_2
26,3688001,3692000,3999,False,156,scaffold_2
27,3746001,3794000,47999,False,156,scaffold_2
28,3829001,3864000,34999,False,156,scaffold_2
29,4204001,4325000,120999,False,156,scaffold_2
30,4340001,4759000,418999,False,156,scaffold_2
31,4793001,4863000,69999,False,156,scaffold_2
32,4865001,4954000,88999,False,156,scaffold_2
33,4974001,5284000,309999,False,156,scaffold_2
34,5285001,5340000,54999,False,156,scaffold_2
35,5361001,5441000,79999,False,156,scaffold_2
36,5442001,5600000,157999,False,156,scaffold_2
37,5610001,5776000,165999,False,156,scaffold_2
38,5841001,6053000,211999,False,156,scaffold_2
39,6054001,6149000,94999,False,156,scaffold_2
40,6150001,6173000,22999,False,156,scaffold_2
41,6197001,6214000,16999,False,156,scaffold_2
42,6232001,7561000,1328999,False,156,scaffold_2
43,7563001,8318000,754999,False,156,scaffold_2
44,8335001,8345000,9999,False,156,scaffold_2
45,8346001,8493000,146999,False,156,scaffold_2
46,8495001,9175000,679999,False,156,scaffold_2
47,9182001,9310000,127999,False,156,scaffold_2
48,9312001,9545000,232999,False,156,scaffold_2
49,9555001,9739000,183999,False,156,scaffold_2
50,9810001,9900000,89999,False,156,scaffold_2
51,10082001,10121000,38999,False,156,scaffold_2
52,10144001,10157000,12999,False,156,scaffold_2
53,10158001,10190000,31999,False,156,scaffold_2
54,10191001,10250000,58999,False,156,scaffold_2
55,10460001,10561000,100999,False,156,scaffold_2
56,10599001,10699000,99999,False,156,scaffold_2
57,10713001,10762000,48999,False,156,scaffold_2
58,10768001,10821000,52999,False,156,scaffold_2
59,10991001,11365000,373999,False,156,scaffold_2
60,11369001,11801000,431999,False,156,scaffold_2
0,152001,173000,20999,False,156,scaffold_3
1,528001,539000,10999,False,156,scaffold_3
2,575001,616000,40999,False,156,scaffold_3
3,618001,643000,24999,False,156,scaffold_3
4,649001,737000,87999,False,156,scaffold_3
5,772001,847000,74999,False,156,scaffold_3
6,848001,901000,52999,False,156,scaffold_3
7,1152001,1162000,9999,False,156,scaffold_3
8,1163001,1191000,27999,False,156,scaffold_3
9,1584001,1599000,14999,False,156,scaffold_3
10,1694001,1706000,11999,False,156,scaffold_3
11,1941001,1960000,18999,False,156,scaffold_3
12,1985001,2101000,115999,False,156,scaffold_3
13,2227001,2307000,79999,False,156,scaffold_3
14,2348001,2368000,19999,False,156,scaffold_3
15,2410001,2533000,122999,False,156,scaffold_3
16,2534001,2552000,17999,False,156,scaffold_3
17,2605001,2666000,60999,False,156,scaffold_3
18,2723001,2756000,32999,False,156,scaffold_3
19,3262001,3340000,77999,False,156,scaffold_3
20,3662001,3901000,238999,False,156,scaffold_3
21,3906001,3921000,14999,False,156,scaffold_3
22,3922001,3939000,16999,False,156,scaffold_3
23,3974001,4046000,71999,False,156,scaffold_3
24,4108001,4404000,295999,False,156,scaffold_3
25,4406001,4555000,148999,False,156,scaffold_3
26,4571001,4677000,105999,False,156,scaffold_3
27,4698001,4763000,64999,False,156,scaffold_3
28,4765001,4845000,79999,False,156,scaffold_3
29,4966001,5005000,38999,False,156,scaffold_3
30,5061001,5087000,25999,False,156,scaffold_3
31,5250001,5293000,42999,False,156,scaffold_3
32,5409001,5446000,36999,False,156,scaffold_3
33,5861001,5906000,44999,False,156,scaffold_3
34,5907001,6010000,102999,False,156,scaffold_3
35,6052001,6084000,31999,False,156,scaffold_3
36,6148001,6205000,56999,False,156,scaffold_3
37,6422001,7127000,704999,False,156,scaffold_3
38,7165001,7445000,279999,False,156,scaffold_3
39,7449001,7479000,29999,False,156,scaffold_3
40,7482001,7650000,167999,False,156,scaffold_3
41,7664001,7909000,244999,False,156,scaffold_3
42,7910001,7950000,39999,False,156,scaffold_3
43,8040001,8143000,102999,False,156,scaffold_3
44,8171001,8193000,21999,False,156,scaffold_3
45,8206001,8255000,48999,False,156,scaffold_3
46,8323001,8526000,202999,False,156,scaffold_3
47,8577001,8597000,19999,False,156,scaffold_3
48,8608001,8631000,22999,False,156,scaffold_3
49,8655001,8748000,92999,False,156,scaffold_3
50,8842001,8950000,107999,False,156,scaffold_3
51,9015001,9075000,59999,False,156,scaffold_3
52,9302001,9352000,49999,False,156,scaffold_3
53,9513001,9566000,52999,False,156,scaffold_3
54,9705001,9782000,76999,False,156,scaffold_3
55,9847001,10148000,300999,False,156,scaffold_3
56,10152001,10242000,89999,False,156,scaffold_3
57,10248001,10459000,210999,False,156,scaffold_3
58,10461001,11182071,721070,True,156,scaffold_3
0,1,7000,6999,True,156,scaffold_4
1,11001,13000,1999,False,156,scaffold_4
2,14001,16000,1999,False,156,scaffold_4
3,17001,32000,14999,False,156,scaffold_4
4,49001,86000,36999,False,156,scaffold_4
5,87001,151000,63999,False,156,scaffold_4
6,161001,215000,53999,False,156,scaffold_4
7,217001,226000,8999,False,156,scaffold_4
8,227001,277000,49999,False,156,scaffold_4
9,283001,307000,23999,False,156,scaffold_4
10,318001,353000,34999,False,156,scaffold_4
11,355001,381000,25999,False,156,scaffold_4
12,383001,410000,26999,False,156,scaffold_4
13,412001,425000,12999,False,156,scaffold_4
14,426001,428000,1999,False,156,scaffold_4
15,429001,494000,64999,False,156,scaffold_4
16,499001,592000,92999,False,156,scaffold_4
17,600001,607000,6999,False,156,scaffold_4
18,608001,691000,82999,False,156,scaffold_4
19,1030001,1048000,17999,False,156,scaffold_4
20,1053001,1086000,32999,False,156,scaffold_4
21,1087001,1208000,120999,False,156,scaffold_4
22,1210001,1225000,14999,False,156,scaffold_4
23,1228001,1253000,24999,False,156,scaffold_4
24,1294001,1337000,42999,False,156,scaffold_4
25,1354001,1597000,242999,False,156,scaffold_4
26,1608001,1610000,1999,False,156,scaffold_4
27,1613001,1715000,101999,False,156,scaffold_4
28,1758001,1860000,101999,False,156,scaffold_4
29,1905001,1991000,85999,False,156,scaffold_4
30,1993001,2020000,26999,False,156,scaffold_4
31,2038001,2086000,47999,False,156,scaffold_4
32,2215001,2246000,30999,False,156,scaffold_4
33,2247001,2251000,3999,False,156,scaffold_4
34,2252001,2268000,15999,False,156,scaffold_4
35,2285001,2356000,70999,False,156,scaffold_4
36,2371001,2395000,23999,False,156,scaffold_4
37,2406001,2470000,63999,False,156,scaffold_4
38,2484001,2639000,154999,False,156,scaffold_4
39,2690001,2752000,61999,False,156,scaffold_4
40,2934001,2964000,29999,False,156,scaffold_4
41,2977001,3067000,89999,False,156,scaffold_4
42,3089001,3128000,38999,False,156,scaffold_4
43,3196001,3317000,120999,False,156,scaffold_4
44,3334001,3835000,500999,False,156,scaffold_4
45,3937001,3964000,26999,False,156,scaffold_4
46,4054001,4128000,73999,False,156,scaffold_4
47,4240001,4377000,136999,False,156,scaffold_4
48,4398001,4885000,486999,False,156,scaffold_4
49,4900001,5097000,196999,False,156,scaffold_4
50,5171001,5243000,71999,False,156,scaffold_4
51,5266001,5437000,170999,False,156,scaffold_4
52,5471001,5506000,34999,False,156,scaffold_4
53,5514001,5784000,269999,False,156,scaffold_4
54,5786001,5824000,37999,False,156,scaffold_4
55,5926001,5957000,30999,False,156,scaffold_4
56,5996001,6099000,102999,False,156,scaffold_4
57,6152001,6301000,148999,False,156,scaffold_4
58,6406001,6438000,31999,False,156,scaffold_4
59,6615001,6617000,1999,False,156,scaffold_4
60,6723001,6817000,93999,False,156,scaffold_4
61,6859001,6921000,61999,False,156,scaffold_4
62,6974001,7124000,149999,False,156,scaffold_4
63,7159001,7321000,161999,False,156,scaffold_4
64,7537001,7572000,34999,False,156,scaffold_4
65,7636001,7664000,27999,False,156,scaffold_4
66,7985001,8019000,33999,False,156,scaffold_4
67,8556001,8584000,27999,False,156,scaffold_4
68,8712001,8809000,96999,False,156,scaffold_4
69,8844001,9699000,854999,False,156,scaffold_4
70,9700001,9845951,145950,True,156,scaffold_4
0,141001,174000,32999,False,156,scaffold_5
1,189001,204000,14999,False,156,scaffold_5
2,318001,401000,82999,False,156,scaffold_5
3,402001,432000,29999,False,156,scaffold_5
4,445001,523000,77999,False,156,scaffold_5
5,933001,947000,13999,False,156,scaffold_5
6,2106001,2146000,39999,False,156,scaffold_5
7,2258001,2304000,45999,False,156,scaffold_5
8,2340001,2402000,61999,False,156,scaffold_5
9,2474001,2515000,40999,False,156,scaffold_5
10,2516001,3655000,1138999,False,156,scaffold_5
11,3666001,4440000,773999,False,156,scaffold_5
12,4446001,4929000,482999,False,156,scaffold_5
13,4948001,5346000,397999,False,156,scaffold_5
14,5348001,5395000,46999,False,156,scaffold_5
15,5431001,5466000,34999,False,156,scaffold_5
16,5547001,5672000,124999,False,156,scaffold_5
17,5685001,5842000,156999,False,156,scaffold_5
18,5858001,5888000,29999,False,156,scaffold_5
19,5922001,5934000,11999,False,156,scaffold_5
20,6231001,6262000,30999,False,156,scaffold_5
21,6336001,6796000,459999,False,156,scaffold_5
22,6827001,6945000,117999,False,156,scaffold_5
23,7026001,7089000,62999,False,156,scaffold_5
24,7116001,7148000,31999,False,156,scaffold_5
25,7159001,7268000,108999,False,156,scaffold_5
26,7297001,7386000,88999,False,156,scaffold_5
27,7406001,7451000,44999,False,156,scaffold_5
28,7454001,7514000,59999,False,156,scaffold_5
29,7516001,7606000,89999,False,156,scaffold_5
30,7622001,7805000,182999,False,156,scaffold_5
31,7813001,7910000,96999,False,156,scaffold_5
32,7922001,7998000,75999,False,156,scaffold_5
33,8025001,8049000,23999,False,156,scaffold_5
34,8079001,8103000,23999,False,156,scaffold_5
35,8238001,8257000,18999,False,156,scaffold_5
36,8258001,8458000,199999,False,156,scaffold_5
37,8502001,8539000,36999,False,156,scaffold_5
38,8540001,9364176,824175,True,156,scaffold_5
0,41001,66000,24999,False,156,scaffold_6
1,69001,75000,5999,False,156,scaffold_6
2,78001,84000,5999,False,156,scaffold_6
3,86001,252000,165999,False,156,scaffold_6
4,267001,343000,75999,False,156,scaffold_6
5,1041001,1060000,18999,False,156,scaffold_6
6,1233001,1264000,30999,False,156,scaffold_6
7,1435001,1462000,26999,False,156,scaffold_6
8,1476001,1582000,105999,False,156,scaffold_6
9,1657001,1712000,54999,False,156,scaffold_6
10,1825001,1906000,80999,False,156,scaffold_6
11,2025001,2088000,62999,False,156,scaffold_6
12,2126001,2211000,84999,False,156,scaffold_6
13,2236001,2285000,48999,False,156,scaffold_6
14,2315001,2653000,337999,False,156,scaffold_6
15,2655001,2903000,247999,False,156,scaffold_6
16,2933001,3031000,97999,False,156,scaffold_6
17,3072001,3210000,137999,False,156,scaffold_6
18,3218001,3768000,549999,False,156,scaffold_6
19,3770001,3801000,30999,False,156,scaffold_6
20,3852001,3932000,79999,False,156,scaffold_6
21,3966001,4206000,239999,False,156,scaffold_6
22,4315001,4328000,12999,False,156,scaffold_6
23,4462001,4493000,30999,False,156,scaffold_6
24,4924001,4942000,17999,False,156,scaffold_6
25,4946001,5001000,54999,False,156,scaffold_6
26,5131001,5178000,46999,False,156,scaffold_6
27,5248001,5642000,393999,False,156,scaffold_6
28,5656001,5743000,86999,False,156,scaffold_6
29,5755001,5771000,15999,False,156,scaffold_6
30,5775001,5824000,48999,False,156,scaffold_6
31,5849001,6118000,268999,False,156,scaffold_6
32,6138001,6182000,43999,False,156,scaffold_6
33,6234001,6317000,82999,False,156,scaffold_6
34,6336001,6392000,55999,False,156,scaffold_6
35,6702001,6851000,148999,False,156,scaffold_6
36,6864001,7001000,136999,False,156,scaffold_6
37,7047001,7341000,293999,False,156,scaffold_6
38,7371001,7423000,51999,False,156,scaffold_6
39,7424001,7490000,65999,False,156,scaffold_6
40,7508001,7709000,200999,False,156,scaffold_6
41,7710001,8268281,558280,True,156,scaffold_6
0,13001,47000,33999,False,156,scaffold_7
1,309001,340000,30999,False,156,scaffold_7
2,342001,504000,161999,False,156,scaffold_7
3,622001,645000,22999,False,156,scaffold_7
4,646001,754000,107999,False,156,scaffold_7
5,763001,829000,65999,False,156,scaffold_7
6,830001,840000,9999,False,156,scaffold_7
7,876001,910000,33999,False,156,scaffold_7
8,914001,948000,33999,False,156,scaffold_7
9,949001,963000,13999,False,156,scaffold_7
10,964001,966000,1999,False,156,scaffold_7
11,968001,980000,11999,False,156,scaffold_7
12,982001,1046000,63999,False,156,scaffold_7
13,1048001,1104000,55999,False,156,scaffold_7
14,1105001,1159000,53999,False,156,scaffold_7
15,1192001,2125000,932999,False,156,scaffold_7
16,2222001,2259000,36999,False,156,scaffold_7
17,2714001,2759000,44999,False,156,scaffold_7
18,2791001,5327000,2535999,False,156,scaffold_7
19,5349001,5395000,45999,False,156,scaffold_7
20,5420001,5561000,140999,False,156,scaffold_7
21,6033001,6068000,34999,False,156,scaffold_7
22,6095001,6522000,426999,False,156,scaffold_7
23,6524001,7270000,745999,False,156,scaffold_7
24,7271001,7502216,231215,True,156,scaffold_7
0,1,6000,5999,True,156,scaffold_8
1,12001,24000,11999,False,156,scaffold_8
2,37001,85000,47999,False,156,scaffold_8
3,91001,101000,9999,False,156,scaffold_8
4,373001,386000,12999,False,156,scaffold_8
5,434001,470000,35999,False,156,scaffold_8
6,1022001,1095000,72999,False,156,scaffold_8
7,1360001,1431000,70999,False,156,scaffold_8
8,1599001,1650000,50999,False,156,scaffold_8
9,1669001,1748000,78999,False,156,scaffold_8
10,1796001,2135000,338999,False,156,scaffold_8
11,2147001,2584000,436999,False,156,scaffold_8
12,2642001,2683000,40999,False,156,scaffold_8
13,2684001,2755000,70999,False,156,scaffold_8
14,2767001,2844000,76999,False,156,scaffold_8
15,2864001,2899000,34999,False,156,scaffold_8
16,3035001,3614000,578999,False,156,scaffold_8
17,3615001,4111000,495999,False,156,scaffold_8
18,4168001,4419000,250999,False,156,scaffold_8
19,4421001,4504000,82999,False,156,scaffold_8
20,4566001,4688000,121999,False,156,scaffold_8
21,4822001,4936000,113999,False,156,scaffold_8
22,4969001,4995000,25999,False,156,scaffold_8
23,5009001,5244000,234999,False,156,scaffold_8
24,5303001,5365000,61999,False,156,scaffold_8
25,5488001,5702000,213999,False,156,scaffold_8
26,6210001,6237000,26999,False,156,scaffold_8
27,6328001,6334544,6543,True,156,scaffold_8
0,1,41000,40999,True,156,scaffold_9
1,55001,105000,49999,False,156,scaffold_9
2,121001,148000,26999,False,156,scaffold_9
3,150001,170000,19999,False,156,scaffold_9
4,189001,216000,26999,False,156,scaffold_9
5,284001,317000,32999,False,156,scaffold_9
6,319001,411000,91999,False,156,scaffold_9
7,413001,435000,21999,False,156,scaffold_9
8,436001,440000,3999,False,156,scaffold_9
9,442001,531000,88999,False,156,scaffold_9
10,532001,579000,46999,False,156,scaffold_9
11,583001,631000,47999,False,156,scaffold_9
12,633001,659000,25999,False,156,scaffold_9
13,660001,665000,4999,False,156,scaffold_9
14,670001,742000,71999,False,156,scaffold_9
15,1131001,1149000,17999,False,156,scaffold_9
16,1766001,1807000,40999,False,156,scaffold_9
17,2000001,2031000,30999,False,156,scaffold_9
18,2448001,2480000,31999,False,156,scaffold_9
19,2596001,3637000,1040999,False,156,scaffold_9
20,3638001,3779000,140999,False,156,scaffold_9
21,3931001,4229000,297999,False,156,scaffold_9
22,4252001,4487000,234999,False,156,scaffold_9
23,4529001,4847000,317999,False,156,scaffold_9
24,4959001,5089000,129999,False,156,scaffold_9
25,5116001,5238000,121999,False,156,scaffold_9
26,5239001,5298000,58999,False,156,scaffold_9
27,5300001,5490000,189999,False,156,scaffold_9
28,5491001,5745000,253999,False,156,scaffold_9
29,5773001,6011000,237999,False,156,scaffold_9
30,6016001,6087000,70999,False,156,scaffold_9
31,6088001,6331288,243287,True,156,scaffold_9
0,1,414000,413999,True,156,scaffold_10
1,415001,482000,66999,False,156,scaffold_10
2,483001,881000,397999,False,156,scaffold_10
3,883001,1069000,185999,False,156,scaffold_10
4,1073001,1240000,166999,False,156,scaffold_10
5,1549001,1676000,126999,False,156,scaffold_10
6,1807001,1820000,12999,False,156,scaffold_10
7,1976001,2097000,120999,False,156,scaffold_10
8,2354001,2406000,51999,False,156,scaffold_10
9,2521001,2524000,2999,False,156,scaffold_10
10,2569001,2583000,13999,False,156,scaffold_10
11,2837001,2871000,33999,False,156,scaffold_10
12,3394001,3406000,11999,False,156,scaffold_10
13,3660001,3676000,15999,False,156,scaffold_10
14,4000001,4015000,14999,False,156,scaffold_10
15,4048001,4137000,88999,False,156,scaffold_10
16,4164001,4188000,23999,False,156,scaffold_10
17,4316001,4325000,8999,False,156,scaffold_10
18,4332001,4369000,36999,False,156,scaffold_10
19,4385001,4514000,128999,False,156,scaffold_10
20,4515001,4535000,19999,False,156,scaffold_10
21,4554001,4562000,7999,False,156,scaffold_10
22,4565001,4598000,32999,False,156,scaffold_10
23,4599001,4639000,39999,False,156,scaffold_10
24,4645001,4685000,39999,False,156,scaffold_10
25,4686001,4715000,28999,False,156,scaffold_10
26,4734001,4766000,31999,False,156,scaffold_10
27,4780001,4790000,9999,False,156,scaffold_10
28,4791001,4797000,5999,False,156,scaffold_10
29,4798001,4824000,25999,False,156,scaffold_10
30,4828001,4866973,38972,True,156,scaffold_10
0,9001,108000,98999,False,156,scaffold_11
1,132001,259000,126999,False,156,scaffold_11
2,260001,276000,15999,False,156,scaffold_11
3,359001,403000,43999,False,156,scaffold_11
4,404001,416000,11999,False,156,scaffold_11
5,419001,431000,11999,False,156,scaffold_11
6,433001,461000,27999,False,156,scaffold_11
7,649001,656000,6999,False,156,scaffold_11
8,734001,761000,26999,False,156,scaffold_11
9,791001,818000,26999,False,156,scaffold_11
10,1423001,1427000,3999,False,156,scaffold_11
11,1587001,1636000,48999,False,156,scaffold_11
12,1646001,1806000,159999,False,156,scaffold_11
13,2323001,2389000,65999,False,156,scaffold_11
14,2414001,2627000,212999,False,156,scaffold_11
15,2688001,2939000,250999,False,156,scaffold_11
16,2946001,3039000,92999,False,156,scaffold_11
17,3058001,3406000,347999,False,156,scaffold_11
18,3408001,3476000,67999,False,156,scaffold_11
19,3566001,4710000,1143999,False,156,scaffold_11
20,4712001,4766820,54819,True,156,scaffold_11
0,1,1513000,1512999,True,156,scaffold_12
1,1542001,1620000,77999,False,156,scaffold_12
2,1721001,1763000,41999,False,156,scaffold_12
3,1814001,1830000,15999,False,156,scaffold_12
4,2463001,2479000,15999,False,156,scaffold_12
5,2487001,2503000,15999,False,156,scaffold_12
6,2571001,2623000,51999,False,156,scaffold_12
7,2625001,2657000,31999,False,156,scaffold_12
8,2658001,2698000,39999,False,156,scaffold_12
9,2710001,2722000,11999,False,156,scaffold_12
0,1,442000,441999,True,157,scaffold_1
1,481001,500000,18999,False,157,scaffold_1
2,570001,654000,83999,False,157,scaffold_1
3,686001,757000,70999,False,157,scaffold_1
4,1008001,1108000,99999,False,157,scaffold_1
5,1168001,1294000,125999,False,157,scaffold_1
6,1612001,1660000,47999,False,157,scaffold_1
7,1757001,1901000,143999,False,157,scaffold_1
8,1909001,1959000,49999,False,157,scaffold_1
9,1960001,1984000,23999,False,157,scaffold_1
10,1986001,2001000,14999,False,157,scaffold_1
11,2005001,2020000,14999,False,157,scaffold_1
12,2144001,2692000,547999,False,157,scaffold_1
13,2715001,3240000,524999,False,157,scaffold_1
14,3443001,3624000,180999,False,157,scaffold_1
15,3682001,3880000,197999,False,157,scaffold_1
16,3901001,3941000,39999,False,157,scaffold_1
17,3956001,4112000,155999,False,157,scaffold_1
18,4114001,4158000,43999,False,157,scaffold_1
19,4262001,4300000,37999,False,157,scaffold_1
20,4304001,4356000,51999,False,157,scaffold_1
21,4400001,4459000,58999,False,157,scaffold_1
22,4495001,4545000,49999,False,157,scaffold_1
23,4654001,4812000,157999,False,157,scaffold_1
24,4919001,5060000,140999,False,157,scaffold_1
25,5078001,5199000,120999,False,157,scaffold_1
26,5292001,5334000,41999,False,157,scaffold_1
27,5350001,5521000,170999,False,157,scaffold_1
28,5535001,5596000,60999,False,157,scaffold_1
29,5826001,5945000,118999,False,157,scaffold_1
30,6108001,6381000,272999,False,157,scaffold_1
31,6384001,6673000,288999,False,157,scaffold_1
32,6723001,6761000,37999,False,157,scaffold_1
33,6835001,6918000,82999,False,157,scaffold_1
34,7001001,7228000,226999,False,157,scaffold_1
35,7229001,7247000,17999,False,157,scaffold_1
36,7248001,7588000,339999,False,157,scaffold_1
37,7590001,8656000,1065999,False,157,scaffold_1
38,8658001,9584000,925999,False,157,scaffold_1
39,9586001,10369000,782999,False,157,scaffold_1
40,10449001,10805000,355999,False,157,scaffold_1
41,10834001,10857000,22999,False,157,scaffold_1
42,10885001,10907000,21999,False,157,scaffold_1
43,10920001,10990000,69999,False,157,scaffold_1
44,11009001,11101000,91999,False,157,scaffold_1
45,11180001,11251000,70999,False,157,scaffold_1
46,11264001,11536000,271999,False,157,scaffold_1
47,11550001,12022000,471999,False,157,scaffold_1
48,12060001,12099000,38999,False,157,scaffold_1
49,12106001,12247000,140999,False,157,scaffold_1
50,12288001,12396000,107999,False,157,scaffold_1
51,12397001,12520000,122999,False,157,scaffold_1
52,12651001,12758000,106999,False,157,scaffold_1
53,12771001,13215000,443999,False,157,scaffold_1
54,13324001,13430000,105999,False,157,scaffold_1
55,13473001,13496000,22999,False,157,scaffold_1
56,13500001,13516000,15999,False,157,scaffold_1
57,13517001,13589000,71999,False,157,scaffold_1
58,13591001,13614000,22999,False,157,scaffold_1
59,14286001,14308000,21999,False,157,scaffold_1
60,14465001,14479000,13999,False,157,scaffold_1
0,10001,48000,37999,False,157,scaffold_2
1,51001,159000,107999,False,157,scaffold_2
2,165001,176000,10999,False,157,scaffold_2
3,240001,288000,47999,False,157,scaffold_2
4,296001,318000,21999,False,157,scaffold_2
5,332001,379000,46999,False,157,scaffold_2
6,460001,550000,89999,False,157,scaffold_2
7,591001,631000,39999,False,157,scaffold_2
8,706001,739000,32999,False,157,scaffold_2
9,944001,1016000,71999,False,157,scaffold_2
10,1018001,1029000,10999,False,157,scaffold_2
11,1802001,1831000,28999,False,157,scaffold_2
12,1930001,1944000,13999,False,157,scaffold_2
13,2085001,2108000,22999,False,157,scaffold_2
14,2323001,2689000,365999,False,157,scaffold_2
15,2693001,2751000,57999,False,157,scaffold_2
16,2766001,2788000,21999,False,157,scaffold_2
17,2823001,2857000,33999,False,157,scaffold_2
18,2868001,3059000,190999,False,157,scaffold_2
19,3153001,3160000,6999,False,157,scaffold_2
20,3161001,3188000,26999,False,157,scaffold_2
21,3252001,3284000,31999,False,157,scaffold_2
22,3332001,3343000,10999,False,157,scaffold_2
23,3355001,3425000,69999,False,157,scaffold_2
24,3449001,3468000,18999,False,157,scaffold_2
25,3529001,3619000,89999,False,157,scaffold_2
26,3671001,3696000,24999,False,157,scaffold_2
27,3741001,3821000,79999,False,157,scaffold_2
28,4044001,4160000,115999,False,157,scaffold_2
29,4206001,4324000,117999,False,157,scaffold_2
30,4334001,4790000,455999,False,157,scaffold_2
31,4793001,4814000,20999,False,157,scaffold_2
32,4848001,4995000,146999,False,157,scaffold_2
33,5004001,5224000,219999,False,157,scaffold_2
34,5250001,5779000,528999,False,157,scaffold_2
35,5840001,6142000,301999,False,157,scaffold_2
36,6226001,6674000,447999,False,157,scaffold_2
37,6689001,6996000,306999,False,157,scaffold_2
38,7005001,7039000,33999,False,157,scaffold_2
39,7049001,7561000,511999,False,157,scaffold_2
40,7563001,7864000,300999,False,157,scaffold_2
41,7865001,8333000,467999,False,157,scaffold_2
42,8335001,8345000,9999,False,157,scaffold_2
43,8346001,8591000,244999,False,157,scaffold_2
44,8592001,8604000,11999,False,157,scaffold_2
45,8687001,8851000,163999,False,157,scaffold_2
46,8873001,9512000,638999,False,157,scaffold_2
47,9523001,9775000,251999,False,157,scaffold_2
48,9811001,9905000,93999,False,157,scaffold_2
49,10193001,10256000,62999,False,157,scaffold_2
50,10404001,10434000,29999,False,157,scaffold_2
51,10435001,10467000,31999,False,157,scaffold_2
52,10469001,10581000,111999,False,157,scaffold_2
53,10674001,10708000,33999,False,157,scaffold_2
54,10720001,10735000,14999,False,157,scaffold_2
55,10776001,10814000,37999,False,157,scaffold_2
56,11013001,11279000,265999,False,157,scaffold_2
57,11326001,11787000,460999,False,157,scaffold_2
0,518001,526000,7999,False,157,scaffold_3
1,528001,539000,10999,False,157,scaffold_3
2,575001,594000,18999,False,157,scaffold_3
3,618001,647000,28999,False,157,scaffold_3
4,684001,765000,80999,False,157,scaffold_3
5,798001,920000,121999,False,157,scaffold_3
6,1163001,1191000,27999,False,157,scaffold_3
7,1583001,1599000,15999,False,157,scaffold_3
8,1755001,1776000,20999,False,157,scaffold_3
9,1925001,1994000,68999,False,157,scaffold_3
10,1995001,2212000,216999,False,157,scaffold_3
11,2265001,2361000,95999,False,157,scaffold_3
12,2414001,2429000,14999,False,157,scaffold_3
13,2432001,2558000,125999,False,157,scaffold_3
14,2595001,2665000,69999,False,157,scaffold_3
15,2716001,2738000,21999,False,157,scaffold_3
16,3111001,3144000,32999,False,157,scaffold_3
17,3306001,3347000,40999,False,157,scaffold_3
18,3604001,3634000,29999,False,157,scaffold_3
19,3656001,4399000,742999,False,157,scaffold_3
20,4414001,4521000,106999,False,157,scaffold_3
21,4532001,4579000,46999,False,157,scaffold_3
22,4580001,4689000,108999,False,157,scaffold_3
23,4698001,4908000,209999,False,157,scaffold_3
24,4954001,5089000,134999,False,157,scaffold_3
25,5108001,5124000,15999,False,157,scaffold_3
26,5156001,5210000,53999,False,157,scaffold_3
27,5237001,5279000,41999,False,157,scaffold_3
28,5385001,5449000,63999,False,157,scaffold_3
29,5806001,5954000,147999,False,157,scaffold_3
30,5976001,6024000,47999,False,157,scaffold_3
31,6054001,6322000,267999,False,157,scaffold_3
32,6342001,6392000,49999,False,157,scaffold_3
33,6420001,6962000,541999,False,157,scaffold_3
34,6978001,7157000,178999,False,157,scaffold_3
35,7210001,7447000,236999,False,157,scaffold_3
36,7449001,7454000,4999,False,157,scaffold_3
37,7482001,7649000,166999,False,157,scaffold_3
38,7675001,8004000,328999,False,157,scaffold_3
39,8027001,8156000,128999,False,157,scaffold_3
40,8175001,8255000,79999,False,157,scaffold_3
41,8257001,8594000,336999,False,157,scaffold_3
42,8604001,8637000,32999,False,157,scaffold_3
43,8667001,8719000,51999,False,157,scaffold_3
44,8754001,8934000,179999,False,157,scaffold_3
45,9000001,9087000,86999,False,157,scaffold_3
46,9302001,9366000,63999,False,157,scaffold_3
47,9434001,9458000,23999,False,157,scaffold_3
48,9498001,9535000,36999,False,157,scaffold_3
49,9709001,9787000,77999,False,157,scaffold_3
50,9846001,10148000,301999,False,157,scaffold_3
51,10152001,10194000,41999,False,157,scaffold_3
52,10219001,11182071,963070,True,157,scaffold_3
0,17001,33000,15999,False,157,scaffold_4
1,46001,146000,99999,False,157,scaffold_4
2,162001,226000,63999,False,157,scaffold_4
3,227001,277000,49999,False,157,scaffold_4
4,283001,310000,26999,False,157,scaffold_4
5,312001,353000,40999,False,157,scaffold_4
6,355001,380000,24999,False,157,scaffold_4
7,383001,410000,26999,False,157,scaffold_4
8,412001,425000,12999,False,157,scaffold_4
9,426001,599000,172999,False,157,scaffold_4
10,600001,607000,6999,False,157,scaffold_4
11,608001,692000,83999,False,157,scaffold_4
12,701001,727000,25999,False,157,scaffold_4
13,1087001,1208000,120999,False,157,scaffold_4
14,1210001,1226000,15999,False,157,scaffold_4
15,1235001,1253000,17999,False,157,scaffold_4
16,1254001,1279000,24999,False,157,scaffold_4
17,1283001,1604000,320999,False,157,scaffold_4
18,1613001,1849000,235999,False,157,scaffold_4
19,1850001,2117000,266999,False,157,scaffold_4
20,2145001,2172000,26999,False,157,scaffold_4
21,2219001,2246000,26999,False,157,scaffold_4
22,2247001,2310000,62999,False,157,scaffold_4
23,2311001,2471000,159999,False,157,scaffold_4
24,2476001,2639000,162999,False,157,scaffold_4
25,2683001,2767000,83999,False,157,scaffold_4
26,2915001,3329000,413999,False,157,scaffold_4
27,3338001,3788000,449999,False,157,scaffold_4
28,3850001,3980000,129999,False,157,scaffold_4
29,4058001,4106000,47999,False,157,scaffold_4
30,4221001,4487000,265999,False,157,scaffold_4
31,4519001,4889000,369999,False,157,scaffold_4
32,4891001,5244000,352999,False,157,scaffold_4
33,5277001,5506000,228999,False,157,scaffold_4
34,5515001,5957000,441999,False,157,scaffold_4
35,6005001,6429000,423999,False,157,scaffold_4
36,6471001,6514000,42999,False,157,scaffold_4
37,6615001,6617000,1999,False,157,scaffold_4
38,6619001,6690000,70999,False,157,scaffold_4
39,6706001,6834000,127999,False,157,scaffold_4
40,6858001,6924000,65999,False,157,scaffold_4
41,6926001,7124000,197999,False,157,scaffold_4
42,7128001,7323000,194999,False,157,scaffold_4
43,7352001,7452000,99999,False,157,scaffold_4
44,7492001,7573000,80999,False,157,scaffold_4
45,7632001,7665000,32999,False,157,scaffold_4
46,7862001,7922000,59999,False,157,scaffold_4
47,7985001,8078000,92999,False,157,scaffold_4
48,8150001,8168000,17999,False,157,scaffold_4
49,8456001,8590000,133999,False,157,scaffold_4
50,8635001,8685000,49999,False,157,scaffold_4
51,8707001,8826000,118999,False,157,scaffold_4
52,8844001,9845951,1001950,True,157,scaffold_4
0,1,15000,14999,True,157,scaffold_5
1,129001,163000,33999,False,157,scaffold_5
2,316001,428000,111999,False,157,scaffold_5
3,435001,524000,88999,False,157,scaffold_5
4,669001,702000,32999,False,157,scaffold_5
5,933001,971000,37999,False,157,scaffold_5
6,1062001,1068000,5999,False,157,scaffold_5
7,1069001,1108000,38999,False,157,scaffold_5
8,1539001,1557000,17999,False,157,scaffold_5
9,1657001,1662000,4999,False,157,scaffold_5
10,2106001,2119000,12999,False,157,scaffold_5
11,2254001,2307000,52999,False,157,scaffold_5
12,2380001,2401000,20999,False,157,scaffold_5
13,2472001,2500000,27999,False,157,scaffold_5
14,2502001,2515000,12999,False,157,scaffold_5
15,2516001,3598000,1081999,False,157,scaffold_5
16,3599001,4939000,1339999,False,157,scaffold_5
17,4967001,5208000,240999,False,157,scaffold_5
18,5217001,5451000,233999,False,157,scaffold_5
19,5497001,5528000,30999,False,157,scaffold_5
20,5547001,5569000,21999,False,157,scaffold_5
21,5696001,5739000,42999,False,157,scaffold_5
22,5740001,5826000,85999,False,157,scaffold_5
23,5871001,5889000,17999,False,157,scaffold_5
24,6176001,6262000,85999,False,157,scaffold_5
25,6324001,6957000,632999,False,157,scaffold_5
26,7011001,7086000,74999,False,157,scaffold_5
27,7151001,7363000,211999,False,157,scaffold_5
28,7406001,7845000,438999,False,157,scaffold_5
29,7881001,7900000,18999,False,157,scaffold_5
30,7934001,8048000,113999,False,157,scaffold_5
31,8258001,8539000,280999,False,157,scaffold_5
32,8540001,9364176,824175,True,157,scaffold_5
0,2001,39000,36999,False,157,scaffold_6
1,42001,254000,211999,False,157,scaffold_6
2,263001,376000,112999,False,157,scaffold_6
3,377001,395000,17999,False,157,scaffold_6
4,621001,666000,44999,False,157,scaffold_6
5,787001,797000,9999,False,157,scaffold_6
6,965001,992000,26999,False,157,scaffold_6
7,993001,1015000,21999,False,157,scaffold_6
8,1154001,1310000,155999,False,157,scaffold_6
9,1383001,1595000,211999,False,157,scaffold_6
10,1657001,1716000,58999,False,157,scaffold_6
11,1764001,1935000,170999,False,157,scaffold_6
12,1980001,2020000,39999,False,157,scaffold_6
13,2023001,2114000,90999,False,157,scaffold_6
14,2116001,2285000,168999,False,157,scaffold_6
15,2314001,2874000,559999,False,157,scaffold_6
16,2927001,3236000,308999,False,157,scaffold_6
17,3237001,4016000,778999,False,157,scaffold_6
18,4017001,4072000,54999,False,157,scaffold_6
19,4081001,4187000,105999,False,157,scaffold_6
20,4188001,4204000,15999,False,157,scaffold_6
21,4272001,4306000,33999,False,157,scaffold_6
22,4836001,4869000,32999,False,157,scaffold_6
23,4951001,4992000,40999,False,157,scaffold_6
24,5131001,5179000,47999,False,157,scaffold_6
25,5264001,5972000,707999,False,157,scaffold_6
26,6007001,6183000,175999,False,157,scaffold_6
27,6257001,6314000,56999,False,157,scaffold_6
28,6447001,6515000,67999,False,157,scaffold_6
29,6686001,6859000,172999,False,157,scaffold_6
30,6911001,7349000,437999,False,157,scaffold_6
31,7374001,7529000,154999,False,157,scaffold_6
32,7541001,8268281,727280,True,157,scaffold_6
0,1,33000,32999,True,157,scaffold_7
1,50001,58000,7999,False,157,scaffold_7
2,309001,508000,198999,False,157,scaffold_7
3,622001,754000,131999,False,157,scaffold_7
4,764001,844000,79999,False,157,scaffold_7
5,876001,948000,71999,False,157,scaffold_7
6,950001,966000,15999,False,157,scaffold_7
7,968001,981000,12999,False,157,scaffold_7
8,982001,1044000,61999,False,157,scaffold_7
9,1048001,1136000,87999,False,157,scaffold_7
10,1138001,1149000,10999,False,157,scaffold_7
11,1174001,1512000,337999,False,157,scaffold_7
12,1514001,1693000,178999,False,157,scaffold_7
13,1821001,1894000,72999,False,157,scaffold_7
14,2128001,2213000,84999,False,157,scaffold_7
15,2642001,2657000,14999,False,157,scaffold_7
16,2722001,2759000,36999,False,157,scaffold_7
17,2828001,3072000,243999,False,157,scaffold_7
18,3296001,3422000,125999,False,157,scaffold_7
19,3430001,3986000,555999,False,157,scaffold_7
20,4012001,4156000,143999,False,157,scaffold_7
21,4190001,4295000,104999,False,157,scaffold_7
22,4323001,4515000,191999,False,157,scaffold_7
23,4546001,5561000,1014999,False,157,scaffold_7
24,6090001,6235000,144999,False,157,scaffold_7
25,6298001,6414000,115999,False,157,scaffold_7
26,6462001,6489000,26999,False,157,scaffold_7
27,6497001,6519000,21999,False,157,scaffold_7
28,6558001,6797000,238999,False,157,scaffold_7
29,6818001,6872000,53999,False,157,scaffold_7
30,6944001,7502216,558215,True,157,scaffold_7
0,1,7000,6999,True,157,scaffold_8
1,29001,85000,55999,False,157,scaffold_8
2,335001,363000,27999,False,157,scaffold_8
3,434001,461000,26999,False,157,scaffold_8
4,999001,1064000,64999,False,157,scaffold_8
5,1365001,1426000,60999,False,157,scaffold_8
6,1487001,1548000,60999,False,157,scaffold_8
7,1614001,1650000,35999,False,157,scaffold_8
8,1670001,1719000,48999,False,157,scaffold_8
9,1720001,1759000,38999,False,157,scaffold_8
10,1801001,2590000,788999,False,157,scaffold_8
11,2615001,2683000,67999,False,157,scaffold_8
12,2684001,2840000,155999,False,157,scaffold_8
13,3029001,4289000,1259999,False,157,scaffold_8
14,4299001,4419000,119999,False,157,scaffold_8
15,4460001,4489000,28999,False,157,scaffold_8
16,4564001,4648000,83999,False,157,scaffold_8
17,4815001,4964000,148999,False,157,scaffold_8
18,5010001,5241000,230999,False,157,scaffold_8
19,5306001,5375000,68999,False,157,scaffold_8
20,5393001,5695000,301999,False,157,scaffold_8
21,6229001,6250000,20999,False,157,scaffold_8
22,6324001,6334544,10543,True,157,scaffold_8
0,1,37000,36999,True,157,scaffold_9
1,67001,108000,40999,False,157,scaffold_9
2,109001,148000,38999,False,157,scaffold_9
3,150001,174000,23999,False,157,scaffold_9
4,205001,224000,18999,False,157,scaffold_9
5,289001,317000,27999,False,157,scaffold_9
6,319001,411000,91999,False,157,scaffold_9
7,413001,531000,117999,False,157,scaffold_9
8,548001,579000,30999,False,157,scaffold_9
9,633001,659000,25999,False,157,scaffold_9
10,660001,666000,5999,False,157,scaffold_9
11,671001,697000,25999,False,157,scaffold_9
12,730001,742000,11999,False,157,scaffold_9
13,812001,860000,47999,False,157,scaffold_9
14,873001,986000,112999,False,157,scaffold_9
15,987001,995000,7999,False,157,scaffold_9
16,998001,1191000,192999,False,157,scaffold_9
17,1245001,1379000,133999,False,157,scaffold_9
18,1456001,1481000,24999,False,157,scaffold_9
19,1660001,1681000,20999,False,157,scaffold_9
20,1760001,1806000,45999,False,157,scaffold_9
21,1986001,2032000,45999,False,157,scaffold_9
22,2601001,2700000,98999,False,157,scaffold_9
23,2728001,3381000,652999,False,157,scaffold_9
24,3383001,5115000,1731999,False,157,scaffold_9
25,5116001,5298000,181999,False,157,scaffold_9
26,5299001,6331288,1032287,True,157,scaffold_9
0,1,482000,481999,True,157,scaffold_10
1,483001,1069000,585999,False,157,scaffold_10
2,1073001,1212000,138999,False,157,scaffold_10
3,1367001,1713000,345999,False,157,scaffold_10
4,1774001,1817000,42999,False,157,scaffold_10
5,1910001,1917000,6999,False,157,scaffold_10
6,2086001,2108000,21999,False,157,scaffold_10
7,2129001,2170000,40999,False,157,scaffold_10
8,2267001,2327000,59999,False,157,scaffold_10
9,2346001,2447000,100999,False,157,scaffold_10
10,2825001,2875000,49999,False,157,scaffold_10
11,3076001,3084000,7999,False,157,scaffold_10
12,3109001,3134000,24999,False,157,scaffold_10
13,3649001,3673000,23999,False,157,scaffold_10
14,3879001,3900000,20999,False,157,scaffold_10
15,4000001,4096000,95999,False,157,scaffold_10
16,4097001,4184000,86999,False,157,scaffold_10
17,4232001,4257000,24999,False,157,scaffold_10
18,4316001,4502000,185999,False,157,scaffold_10
19,4503001,4514000,10999,False,157,scaffold_10
20,4515001,4548000,32999,False,157,scaffold_10
21,4554001,4562000,7999,False,157,scaffold_10
22,4563001,4597000,33999,False,157,scaffold_10
23,4644001,4686000,41999,False,157,scaffold_10
24,4700001,4715000,14999,False,157,scaffold_10
25,4716001,4732000,15999,False,157,scaffold_10
26,4734001,4766000,31999,False,157,scaffold_10
27,4791001,4861000,69999,False,157,scaffold_10
28,4862001,4866973,4972,True,157,scaffold_10
0,11001,109000,97999,False,157,scaffold_11
1,131001,168000,36999,False,157,scaffold_11
2,169001,212000,42999,False,157,scaffold_11
3,213001,235000,21999,False,157,scaffold_11
4,277001,321000,43999,False,157,scaffold_11
5,366001,393000,26999,False,157,scaffold_11
6,419001,431000,11999,False,157,scaffold_11
7,433001,458000,24999,False,157,scaffold_11
8,648001,657000,8999,False,157,scaffold_11
9,733001,754000,20999,False,157,scaffold_11
10,1710001,1732000,21999,False,157,scaffold_11
11,1772001,1802000,29999,False,157,scaffold_11
12,2192001,2215000,22999,False,157,scaffold_11
13,2258001,2300000,41999,False,157,scaffold_11
14,2321001,2649000,327999,False,157,scaffold_11
15,2699001,3020000,320999,False,157,scaffold_11
16,3050001,3383000,332999,False,157,scaffold_11
17,3411001,4162000,750999,False,157,scaffold_11
18,4181001,4710000,528999,False,157,scaffold_11
19,4713001,4766820,53819,True,157,scaffold_11
0,1,1501000,1500999,True,157,scaffold_12
1,1543001,1595000,51999,False,157,scaffold_12
2,1712001,1749000,36999,False,157,scaffold_12
3,1788001,1805000,16999,False,157,scaffold_12
4,2384001,2411000,26999,False,157,scaffold_12
5,2559001,2570000,10999,False,157,scaffold_12
6,2571001,2619000,47999,False,157,scaffold_12
7,2625001,2657000,31999,False,157,scaffold_12
8,2659001,2708000,48999,False,157,scaffold_12
9,2710001,2722000,11999,False,157,scaffold_12
0,1,442000,441999,True,158,scaffold_1
1,464001,500000,35999,False,158,scaffold_1
2,570001,651000,80999,False,158,scaffold_1
3,686001,778000,91999,False,158,scaffold_1
4,805001,899000,93999,False,158,scaffold_1
5,953001,1292000,338999,False,158,scaffold_1
6,1306001,1346000,39999,False,158,scaffold_1
7,1617001,1984000,366999,False,158,scaffold_1
8,1986001,2032000,45999,False,158,scaffold_1
9,2124001,3241000,1116999,False,158,scaffold_1
10,3244001,3289000,44999,False,158,scaffold_1
11,3320001,3378000,57999,False,158,scaffold_1
12,3440001,3881000,440999,False,158,scaffold_1
13,3901001,4168000,266999,False,158,scaffold_1
14,4258001,4460000,201999,False,158,scaffold_1
15,4506001,4556000,49999,False,158,scaffold_1
16,4566001,4585000,18999,False,158,scaffold_1
17,4642001,4786000,143999,False,158,scaffold_1
18,4796001,5156000,359999,False,158,scaffold_1
19,5162001,5201000,38999,False,158,scaffold_1
20,5243001,5334000,90999,False,158,scaffold_1
21,5354001,5521000,166999,False,158,scaffold_1
22,5533001,5673000,139999,False,158,scaffold_1
23,5824001,5933000,108999,False,158,scaffold_1
24,6048001,6101000,52999,False,158,scaffold_1
25,6108001,6381000,272999,False,158,scaffold_1
26,6383001,6863000,479999,False,158,scaffold_1
27,6864001,7589000,724999,False,158,scaffold_1
28,7590001,8656000,1065999,False,158,scaffold_1
29,8658001,9584000,925999,False,158,scaffold_1
30,9586001,10369000,782999,False,158,scaffold_1
31,10377001,10795000,417999,False,158,scaffold_1
32,10816001,10857000,40999,False,158,scaffold_1
33,10898001,11079000,180999,False,158,scaffold_1
34,11080001,12592000,1511999,False,158,scaffold_1
35,12604001,13215000,610999,False,158,scaffold_1
36,13245001,13437000,191999,False,158,scaffold_1
37,13478001,13496000,17999,False,158,scaffold_1
38,13517001,13587000,69999,False,158,scaffold_1
39,13600001,13613000,12999,False,158,scaffold_1
40,13637001,13713000,75999,False,158,scaffold_1
41,13928001,13954000,25999,False,158,scaffold_1
42,13978001,14005000,26999,False,158,scaffold_1
43,14284001,14314000,29999,False,158,scaffold_1
44,14316001,14354000,37999,False,158,scaffold_1
45,14471001,14491000,19999,False,158,scaffold_1
0,1,48000,47999,True,158,scaffold_2
1,51001,91000,39999,False,158,scaffold_2
2,92001,159000,66999,False,158,scaffold_2
3,165001,177000,11999,False,158,scaffold_2
4,178001,281000,102999,False,158,scaffold_2
5,296001,318000,21999,False,158,scaffold_2
6,319001,375000,55999,False,158,scaffold_2
7,391001,439000,47999,False,158,scaffold_2
8,459001,635000,175999,False,158,scaffold_2
9,678001,739000,60999,False,158,scaffold_2
10,766001,854000,87999,False,158,scaffold_2
11,861001,874000,12999,False,158,scaffold_2
12,884001,1015000,130999,False,158,scaffold_2
13,1017001,1081000,63999,False,158,scaffold_2
14,1113001,1184000,70999,False,158,scaffold_2
15,1421001,1557000,135999,False,158,scaffold_2
16,1636001,1831000,194999,False,158,scaffold_2
17,1914001,1926000,11999,False,158,scaffold_2
18,1927001,1969000,41999,False,158,scaffold_2
19,1995001,2108000,112999,False,158,scaffold_2
20,2203001,2242000,38999,False,158,scaffold_2
21,2302001,2560000,257999,False,158,scaffold_2
22,2561001,2636000,74999,False,158,scaffold_2
23,2645001,2689000,43999,False,158,scaffold_2
24,2693001,3021000,327999,False,158,scaffold_2
25,3022001,3110000,87999,False,158,scaffold_2
26,3161001,3284000,122999,False,158,scaffold_2
27,3286001,3299000,12999,False,158,scaffold_2
28,3327001,3616000,288999,False,158,scaffold_2
29,3623001,3691000,67999,False,158,scaffold_2
30,3743001,3877000,133999,False,158,scaffold_2
31,4034001,4790000,755999,False,158,scaffold_2
32,4793001,5230000,436999,False,158,scaffold_2
33,5250001,5789000,538999,False,158,scaffold_2
34,5820001,5892000,71999,False,158,scaffold_2
35,5912001,6178000,265999,False,158,scaffold_2
36,6198001,6694000,495999,False,158,scaffold_2
37,6695001,7561000,865999,False,158,scaffold_2
38,7563001,7610000,46999,False,158,scaffold_2
39,7611001,7988000,376999,False,158,scaffold_2
40,7989001,8313000,323999,False,158,scaffold_2
41,8346001,8494000,147999,False,158,scaffold_2
42,8496001,9796000,1299999,False,158,scaffold_2
43,9840001,9905000,64999,False,158,scaffold_2
44,10089001,10112000,22999,False,158,scaffold_2
45,10167001,10186000,18999,False,158,scaffold_2
46,10187001,10247000,59999,False,158,scaffold_2
47,10308001,10354000,45999,False,158,scaffold_2
48,10402001,10577000,174999,False,158,scaffold_2
49,10593001,10755000,161999,False,158,scaffold_2
50,10757001,10766000,8999,False,158,scaffold_2
51,10774001,10821000,46999,False,158,scaffold_2
52,10822001,10874000,51999,False,158,scaffold_2
53,10877001,10962000,84999,False,158,scaffold_2
54,11000001,11365000,364999,False,158,scaffold_2
55,11367001,11802476,435475,True,158,scaffold_2
0,50001,98000,47999,False,158,scaffold_3
1,100001,108000,7999,False,158,scaffold_3
2,144001,170000,25999,False,158,scaffold_3
3,236001,267000,30999,False,158,scaffold_3
4,602001,617000,14999,False,158,scaffold_3
5,618001,646000,27999,False,158,scaffold_3
6,649001,704000,54999,False,158,scaffold_3
7,705001,928000,222999,False,158,scaffold_3
8,1067001,1096000,28999,False,158,scaffold_3
9,1143001,1272000,128999,False,158,scaffold_3
10,1417001,1467000,49999,False,158,scaffold_3
11,1501001,1545000,43999,False,158,scaffold_3
12,1584001,1616000,31999,False,158,scaffold_3
13,1717001,1853000,135999,False,158,scaffold_3
14,1923001,2108000,184999,False,158,scaffold_3
15,2110001,2143000,32999,False,158,scaffold_3
16,2164001,2226000,61999,False,158,scaffold_3
17,2227001,2388000,160999,False,158,scaffold_3
18,2417001,2430000,12999,False,158,scaffold_3
19,2432001,2560000,127999,False,158,scaffold_3
20,2561001,2573000,11999,False,158,scaffold_3
21,2576001,2754000,177999,False,158,scaffold_3
22,3261001,3359000,97999,False,158,scaffold_3
23,3602001,3921000,318999,False,158,scaffold_3
24,3922001,4925000,1002999,False,158,scaffold_3
25,4949001,5225000,275999,False,158,scaffold_3
26,5236001,5318000,81999,False,158,scaffold_3
27,5385001,5531000,145999,False,158,scaffold_3
28,5584001,5676000,91999,False,158,scaffold_3
29,5743001,5766000,22999,False,158,scaffold_3
30,5803001,6025000,221999,False,158,scaffold_3
31,6026001,6198000,171999,False,158,scaffold_3
32,6219001,6246000,26999,False,158,scaffold_3
33,6247001,7157000,909999,False,158,scaffold_3
34,7180001,7447000,266999,False,158,scaffold_3
35,7449001,7460000,10999,False,158,scaffold_3
36,7462001,7646000,183999,False,158,scaffold_3
37,7671001,7909000,237999,False,158,scaffold_3
38,7910001,7980000,69999,False,158,scaffold_3
39,7981001,8006000,24999,False,158,scaffold_3
40,8028001,8118000,89999,False,158,scaffold_3
41,8120001,8156000,35999,False,158,scaffold_3
42,8177001,8264000,86999,False,158,scaffold_3
43,8265001,8640000,374999,False,158,scaffold_3
44,8655001,8918000,262999,False,158,scaffold_3
45,9003001,9080000,76999,False,158,scaffold_3
46,9185001,9265000,79999,False,158,scaffold_3
47,9303001,9585000,281999,False,158,scaffold_3
48,9644001,9687000,42999,False,158,scaffold_3
49,9704001,9797000,92999,False,158,scaffold_3
50,9846001,10149000,302999,False,158,scaffold_3
51,10151001,11182071,1031070,True,158,scaffold_3
0,1,7000,6999,True,158,scaffold_4
1,11001,13000,1999,False,158,scaffold_4
2,14001,16000,1999,False,158,scaffold_4
3,17001,36000,18999,False,158,scaffold_4
4,46001,146000,99999,False,158,scaffold_4
5,147001,226000,78999,False,158,scaffold_4
6,227001,280000,52999,False,158,scaffold_4
7,283001,307000,23999,False,158,scaffold_4
8,312001,353000,40999,False,158,scaffold_4
9,355001,410000,54999,False,158,scaffold_4
10,412001,425000,12999,False,158,scaffold_4
11,426001,592000,165999,False,158,scaffold_4
12,593001,606000,12999,False,158,scaffold_4
13,608001,682000,73999,False,158,scaffold_4
14,683001,691000,7999,False,158,scaffold_4
15,695001,726000,30999,False,158,scaffold_4
16,1008001,1048000,39999,False,158,scaffold_4
17,1052001,1086000,33999,False,158,scaffold_4
18,1087001,1209000,121999,False,158,scaffold_4
19,1210001,1262000,51999,False,158,scaffold_4
20,1265001,1279000,13999,False,158,scaffold_4
21,1283001,1605000,321999,False,158,scaffold_4
22,1613001,1638000,24999,False,158,scaffold_4
23,1639001,1957000,317999,False,158,scaffold_4
24,1958001,2117000,158999,False,158,scaffold_4
25,2119001,2340000,220999,False,158,scaffold_4
26,2342001,2461000,118999,False,158,scaffold_4
27,2476001,2675000,198999,False,158,scaffold_4
28,2676001,2696000,19999,False,158,scaffold_4
29,2698001,2812000,113999,False,158,scaffold_4
30,2829001,3173000,343999,False,158,scaffold_4
31,3188001,4201000,1012999,False,158,scaffold_4
32,4221001,4886000,664999,False,158,scaffold_4
33,4898001,5506000,607999,False,158,scaffold_4
34,5516001,5784000,267999,False,158,scaffold_4
35,5786001,6611000,824999,False,158,scaffold_4
36,6619001,6643000,23999,False,158,scaffold_4
37,6658001,7124000,465999,False,158,scaffold_4
38,7126001,7667000,540999,False,158,scaffold_4
39,7859001,8160000,300999,False,158,scaffold_4
40,8269001,8331000,61999,False,158,scaffold_4
41,8350001,8495000,144999,False,158,scaffold_4
42,8520001,8599000,78999,False,158,scaffold_4
43,8638001,8832000,193999,False,158,scaffold_4
44,8836001,9699000,862999,False,158,scaffold_4
45,9700001,9845951,145950,True,158,scaffold_4
0,1,16000,15999,True,158,scaffold_5
1,43001,57000,13999,False,158,scaffold_5
2,106001,175000,68999,False,158,scaffold_5
3,185001,203000,17999,False,158,scaffold_5
4,318001,427000,108999,False,158,scaffold_5
5,435001,531000,95999,False,158,scaffold_5
6,563001,572000,8999,False,158,scaffold_5
7,668001,722000,53999,False,158,scaffold_5
8,836001,867000,30999,False,158,scaffold_5
9,882001,976000,93999,False,158,scaffold_5
10,1006001,1032000,25999,False,158,scaffold_5
11,1062001,1068000,5999,False,158,scaffold_5
12,1069001,1124000,54999,False,158,scaffold_5
13,1522001,1565000,42999,False,158,scaffold_5
14,1611001,1639000,27999,False,158,scaffold_5
15,1912001,1956000,43999,False,158,scaffold_5
16,2105001,2140000,34999,False,158,scaffold_5
17,2256001,2440000,183999,False,158,scaffold_5
18,2472001,5462000,2989999,False,158,scaffold_5
19,5498001,5848000,349999,False,158,scaffold_5
20,5861001,5888000,26999,False,158,scaffold_5
21,6161001,6262000,100999,False,158,scaffold_5
22,6263001,7086000,822999,False,158,scaffold_5
23,7103001,7441000,337999,False,158,scaffold_5
24,7454001,7909000,454999,False,158,scaffold_5
25,7941001,8045000,103999,False,158,scaffold_5
26,8149001,8200000,50999,False,158,scaffold_5
27,8258001,8538000,279999,False,158,scaffold_5
28,8540001,9364176,824175,True,158,scaffold_5
0,1,40000,39999,True,158,scaffold_6
1,43001,75000,31999,False,158,scaffold_6
2,76001,121000,44999,False,158,scaffold_6
3,122001,376000,253999,False,158,scaffold_6
4,378001,396000,17999,False,158,scaffold_6
5,618001,660000,41999,False,158,scaffold_6
6,785001,800000,14999,False,158,scaffold_6
7,948001,1083000,134999,False,158,scaffold_6
8,1146001,1600000,453999,False,158,scaffold_6
9,1657001,1737000,79999,False,158,scaffold_6
10,1739001,1935000,195999,False,158,scaffold_6
11,1937001,1950000,12999,False,158,scaffold_6
12,1963001,2285000,321999,False,158,scaffold_6
13,2314001,2653000,338999,False,158,scaffold_6
14,2659001,2907000,247999,False,158,scaffold_6
15,2929001,3768000,838999,False,158,scaffold_6
16,3770001,4207000,436999,False,158,scaffold_6
17,4209001,4397000,187999,False,158,scaffold_6
18,4416001,4553000,136999,False,158,scaffold_6
19,4703001,4868000,164999,False,158,scaffold_6
20,4924001,5006000,81999,False,158,scaffold_6
21,5087001,6097000,1009999,False,158,scaffold_6
22,6124001,6321000,196999,False,158,scaffold_6
23,6423001,6509000,85999,False,158,scaffold_6
24,6531001,7349000,817999,False,158,scaffold_6
25,7359001,7540000,180999,False,158,scaffold_6
26,7541001,8268281,727280,True,158,scaffold_6
0,1,49000,48999,True,158,scaffold_7
1,50001,69000,18999,False,158,scaffold_7
2,89001,124000,34999,False,158,scaffold_7
3,299001,508000,208999,False,158,scaffold_7
4,571001,579000,7999,False,158,scaffold_7
5,580001,754000,173999,False,158,scaffold_7
6,756001,864000,107999,False,158,scaffold_7
7,868001,884000,15999,False,158,scaffold_7
8,887001,948000,60999,False,158,scaffold_7
9,949001,1159000,209999,False,158,scaffold_7
10,1167001,1512000,344999,False,158,scaffold_7
11,1544001,1693000,148999,False,158,scaffold_7
12,1748001,1782000,33999,False,158,scaffold_7
13,1783001,1892000,108999,False,158,scaffold_7
14,2017001,2221000,203999,False,158,scaffold_7
15,2222001,2280000,57999,False,158,scaffold_7
16,2338001,2380000,41999,False,158,scaffold_7
17,2437001,2491000,53999,False,158,scaffold_7
18,2576001,2606000,29999,False,158,scaffold_7
19,2610001,2659000,48999,False,158,scaffold_7
20,2722001,2760000,37999,False,158,scaffold_7
21,2833001,3156000,322999,False,158,scaffold_7
22,3292001,3987000,694999,False,158,scaffold_7
23,4018001,4154000,135999,False,158,scaffold_7
24,4190001,4312000,121999,False,158,scaffold_7
25,4313001,4516000,202999,False,158,scaffold_7
26,4527001,5572000,1044999,False,158,scaffold_7
27,6016001,6435000,418999,False,158,scaffold_7
28,6454001,6522000,67999,False,158,scaffold_7
29,6524001,6686000,161999,False,158,scaffold_7
30,6692001,6875000,182999,False,158,scaffold_7
31,6901001,6925000,23999,False,158,scaffold_7
32,6948001,7270000,321999,False,158,scaffold_7
33,7271001,7502216,231215,True,158,scaffold_7
0,1,6000,5999,True,158,scaffold_8
1,31001,64000,32999,False,158,scaffold_8
2,66001,87000,20999,False,158,scaffold_8
3,93001,101000,7999,False,158,scaffold_8
4,335001,366000,30999,False,158,scaffold_8
5,433001,468000,34999,False,158,scaffold_8
6,471001,485000,13999,False,158,scaffold_8
7,646001,688000,41999,False,158,scaffold_8
8,889001,898000,8999,False,158,scaffold_8
9,974001,994000,19999,False,158,scaffold_8
10,999001,1132000,132999,False,158,scaffold_8
11,1147001,1210000,62999,False,158,scaffold_8
12,1301001,1429000,127999,False,158,scaffold_8
13,1468001,1658000,189999,False,158,scaffold_8
14,1673001,2683000,1009999,False,158,scaffold_8
15,2684001,2971000,286999,False,158,scaffold_8
16,2998001,3125000,126999,False,158,scaffold_8
17,3126001,4784000,1657999,False,158,scaffold_8
18,4799001,4964000,164999,False,158,scaffold_8
19,4982001,5716000,733999,False,158,scaffold_8
20,5796001,5956000,159999,False,158,scaffold_8
21,5984001,6078000,93999,False,158,scaffold_8
22,6201001,6286000,84999,False,158,scaffold_8
23,6320001,6334544,14543,True,158,scaffold_8
0,1,41000,40999,True,158,scaffold_9
1,43001,107000,63999,False,158,scaffold_9
2,109001,119000,9999,False,158,scaffold_9
3,121001,180000,58999,False,158,scaffold_9
4,285001,411000,125999,False,158,scaffold_9
5,413001,434000,20999,False,158,scaffold_9
6,436001,531000,94999,False,158,scaffold_9
7,532001,564000,31999,False,158,scaffold_9
8,592001,659000,66999,False,158,scaffold_9
9,660001,665000,4999,False,158,scaffold_9
10,669001,775000,105999,False,158,scaffold_9
11,814001,844000,29999,False,158,scaffold_9
12,886001,986000,99999,False,158,scaffold_9
13,988001,995000,6999,False,158,scaffold_9
14,998001,1007000,8999,False,158,scaffold_9
15,1008001,1196000,187999,False,158,scaffold_9
16,1232001,1380000,147999,False,158,scaffold_9
17,1525001,1529000,3999,False,158,scaffold_9
18,1599001,1807000,207999,False,158,scaffold_9
19,1872001,1931000,58999,False,158,scaffold_9
20,1984001,2054000,69999,False,158,scaffold_9
21,2075001,2355000,279999,False,158,scaffold_9
22,2536001,2673000,136999,False,158,scaffold_9
23,2735001,4964000,2228999,False,158,scaffold_9
24,4965001,5298000,332999,False,158,scaffold_9
25,5299001,6331288,1032287,True,158,scaffold_9
0,1,414000,413999,True,158,scaffold_10
1,415001,1069000,653999,False,158,scaffold_10
2,1072001,1300000,227999,False,158,scaffold_10
3,1301001,1429000,127999,False,158,scaffold_10
4,1442001,2189000,746999,False,158,scaffold_10
5,2262001,2476000,213999,False,158,scaffold_10
6,2558001,2654000,95999,False,158,scaffold_10
7,2672001,2694000,21999,False,158,scaffold_10
8,2758001,2924000,165999,False,158,scaffold_10
9,2963001,3014000,50999,False,158,scaffold_10
10,3062001,3217000,154999,False,158,scaffold_10
11,3455001,3477000,21999,False,158,scaffold_10
12,3481001,3493000,11999,False,158,scaffold_10
13,3633001,3676000,42999,False,158,scaffold_10
14,3704001,3797000,92999,False,158,scaffold_10
15,3880001,3902000,21999,False,158,scaffold_10
16,4000001,4140000,139999,False,158,scaffold_10
17,4155001,4260000,104999,False,158,scaffold_10
18,4303001,4315000,11999,False,158,scaffold_10
19,4316001,4502000,185999,False,158,scaffold_10
20,4503001,4514000,10999,False,158,scaffold_10
21,4515001,4549000,33999,False,158,scaffold_10
22,4574001,4688000,113999,False,158,scaffold_10
23,4690001,4699000,8999,False,158,scaffold_10
24,4700001,4715000,14999,False,158,scaffold_10
25,4716001,4776000,59999,False,158,scaffold_10
26,4798001,4861000,62999,False,158,scaffold_10
27,4862001,4866973,4972,True,158,scaffold_10
0,9001,98000,88999,False,158,scaffold_11
1,131001,253000,121999,False,158,scaffold_11
2,276001,322000,45999,False,158,scaffold_11
3,359001,417000,57999,False,158,scaffold_11
4,419001,431000,11999,False,158,scaffold_11
5,433001,463000,29999,False,158,scaffold_11
6,561001,574000,12999,False,158,scaffold_11
7,634001,656000,21999,False,158,scaffold_11
8,722001,759000,36999,False,158,scaffold_11
9,1188001,1215000,26999,False,158,scaffold_11
10,1219001,1249000,29999,False,158,scaffold_11
11,1363001,1372000,8999,False,158,scaffold_11
12,1423001,1436000,12999,False,158,scaffold_11
13,1474001,1477000,2999,False,158,scaffold_11
14,1527001,1535000,7999,False,158,scaffold_11
15,1703001,1734000,30999,False,158,scaffold_11
16,1775001,1796000,20999,False,158,scaffold_11
17,1956001,2049000,92999,False,158,scaffold_11
18,2149001,2164000,14999,False,158,scaffold_11
19,2179001,2210000,30999,False,158,scaffold_11
20,2233001,2630000,396999,False,158,scaffold_11
21,2631001,2921000,289999,False,158,scaffold_11
22,2922001,3034000,111999,False,158,scaffold_11
23,3043001,3406000,362999,False,158,scaffold_11
24,3408001,4710000,1301999,False,158,scaffold_11
25,4712001,4766820,54819,True,158,scaffold_11
0,1,1830000,1829999,True,158,scaffold_12
1,1831001,1935000,103999,False,158,scaffold_12
2,2045001,2086000,40999,False,158,scaffold_12
3,2353001,2375000,21999,False,158,scaffold_12
4,2387001,2485000,97999,False,158,scaffold_12
5,2492001,2565000,72999,False,158,scaffold_12
6,2571001,2655000,83999,False,158,scaffold_12
7,2660001,2678000,17999,False,158,scaffold_12
8,2686001,2708000,21999,False,158,scaffold_12
9,2709001,2723000,13999,False,158,scaffold_12
0,1,499000,498999,True,159,scaffold_1
1,552001,754000,201999,False,159,scaffold_1
2,964001,1108000,143999,False,159,scaffold_1
3,1137001,1294000,156999,False,159,scaffold_1
4,1606001,1731000,124999,False,159,scaffold_1
5,1757001,2000000,242999,False,159,scaffold_1
6,2205001,2237000,31999,False,159,scaffold_1
7,2256001,2687000,430999,False,159,scaffold_1
8,2688001,3284000,595999,False,159,scaffold_1
9,3443001,3633000,189999,False,159,scaffold_1
10,3661001,4158000,496999,False,159,scaffold_1
11,4269001,4373000,103999,False,159,scaffold_1
12,4527001,4552000,24999,False,159,scaffold_1
13,4653001,4786000,132999,False,159,scaffold_1
14,4796001,4813000,16999,False,159,scaffold_1
15,4856001,4874000,17999,False,159,scaffold_1
16,4925001,5060000,134999,False,159,scaffold_1
17,5082001,5200000,117999,False,159,scaffold_1
18,5291001,5333000,41999,False,159,scaffold_1
19,5359001,5595000,235999,False,159,scaffold_1
20,5798001,5950000,151999,False,159,scaffold_1
21,6108001,6760000,651999,False,159,scaffold_1
22,6835001,6916000,80999,False,159,scaffold_1
23,6938001,6957000,18999,False,159,scaffold_1
24,7005001,7029000,23999,False,159,scaffold_1
25,7030001,7247000,216999,False,159,scaffold_1
26,7248001,7588000,339999,False,159,scaffold_1
27,7590001,8656000,1065999,False,159,scaffold_1
28,8658001,9584000,925999,False,159,scaffold_1
29,9586001,10372000,785999,False,159,scaffold_1
30,10377001,10805000,427999,False,159,scaffold_1
31,10832001,10858000,25999,False,159,scaffold_1
32,10919001,10990000,70999,False,159,scaffold_1
33,11013001,11078000,64999,False,159,scaffold_1
34,11279001,12275000,995999,False,159,scaffold_1
35,12351001,12396000,44999,False,159,scaffold_1
36,12425001,12460000,34999,False,159,scaffold_1
37,12479001,12520000,40999,False,159,scaffold_1
38,12623001,13214000,590999,False,159,scaffold_1
39,13262001,13277000,14999,False,159,scaffold_1
40,13340001,13420000,79999,False,159,scaffold_1
41,13474001,13496000,21999,False,159,scaffold_1
42,13559001,13590000,30999,False,159,scaffold_1
43,13901001,13907000,5999,False,159,scaffold_1
44,14290001,14314000,23999,False,159,scaffold_1
45,14743001,14752000,8999,False,159,scaffold_1
0,1,48000,47999,True,159,scaffold_2
1,51001,91000,39999,False,159,scaffold_2
2,93001,160000,66999,False,159,scaffold_2
3,164001,177000,12999,False,159,scaffold_2
4,239001,287000,47999,False,159,scaffold_2
5,300001,318000,17999,False,159,scaffold_2
6,332001,378000,45999,False,159,scaffold_2
7,456001,636000,179999,False,159,scaffold_2
8,704001,739000,34999,False,159,scaffold_2
9,793001,835000,41999,False,159,scaffold_2
10,941001,1016000,74999,False,159,scaffold_2
11,1017001,1044000,26999,False,159,scaffold_2
12,1685001,1723000,37999,False,159,scaffold_2
13,1812001,1830000,17999,False,159,scaffold_2
14,1914001,2005000,90999,False,159,scaffold_2
15,2086001,2093000,6999,False,159,scaffold_2
16,2312001,2560000,247999,False,159,scaffold_2
17,2561001,2638000,76999,False,159,scaffold_2
18,2645001,2689000,43999,False,159,scaffold_2
19,2693001,3127000,433999,False,159,scaffold_2
20,3174001,3212000,37999,False,159,scaffold_2
21,3251001,3284000,32999,False,159,scaffold_2
22,3331001,3342000,10999,False,159,scaffold_2
23,3355001,3488000,132999,False,159,scaffold_2
24,3540001,3595000,54999,False,159,scaffold_2
25,3627001,3692000,64999,False,159,scaffold_2
26,3751001,3866000,114999,False,159,scaffold_2
27,4205001,4322000,116999,False,159,scaffold_2
28,4334001,4790000,455999,False,159,scaffold_2
29,4793001,4960000,166999,False,159,scaffold_2
30,4978001,5148000,169999,False,159,scaffold_2
31,5150001,5231000,80999,False,159,scaffold_2
32,5248001,5780000,531999,False,159,scaffold_2
33,5813001,6563000,749999,False,159,scaffold_2
34,6576001,6638000,61999,False,159,scaffold_2
35,6695001,7478000,782999,False,159,scaffold_2
36,7491001,7561000,69999,False,159,scaffold_2
37,7563001,8329000,765999,False,159,scaffold_2
38,8331001,8333000,1999,False,159,scaffold_2
39,8335001,8345000,9999,False,159,scaffold_2
40,8346001,8494000,147999,False,159,scaffold_2
41,8495001,8604000,108999,False,159,scaffold_2
42,8611001,8865000,253999,False,159,scaffold_2
43,8876001,9513000,636999,False,159,scaffold_2
44,9521001,9552000,30999,False,159,scaffold_2
45,9555001,9627000,71999,False,159,scaffold_2
46,9628001,9861000,232999,False,159,scaffold_2
47,9862001,9940000,77999,False,159,scaffold_2
48,10061001,10112000,50999,False,159,scaffold_2
49,10137001,10354000,216999,False,159,scaffold_2
50,10402001,10434000,31999,False,159,scaffold_2
51,10436001,10583000,146999,False,159,scaffold_2
52,10662001,10696000,33999,False,159,scaffold_2
53,10776001,10819000,42999,False,159,scaffold_2
54,10864001,10965000,100999,False,159,scaffold_2
55,10991001,10993000,1999,False,159,scaffold_2
56,10995001,10998000,2999,False,159,scaffold_2
57,10999001,11096000,96999,False,159,scaffold_2
58,11098001,11276000,177999,False,159,scaffold_2
59,11311001,11365000,53999,False,159,scaffold_2
60,11366001,11802476,436475,True,159,scaffold_2
0,51001,55000,3999,False,159,scaffold_3
1,528001,539000,10999,False,159,scaffold_3
2,575001,594000,18999,False,159,scaffold_3
3,618001,647000,28999,False,159,scaffold_3
4,660001,766000,105999,False,159,scaffold_3
5,767001,935000,167999,False,159,scaffold_3
6,1163001,1193000,29999,False,159,scaffold_3
7,1722001,1795000,72999,False,159,scaffold_3
8,1796001,1818000,21999,False,159,scaffold_3
9,1939001,1980000,40999,False,159,scaffold_3
10,2006001,2108000,101999,False,159,scaffold_3
11,2110001,2194000,83999,False,159,scaffold_3
12,2264001,2344000,79999,False,159,scaffold_3
13,2433001,2558000,124999,False,159,scaffold_3
14,2593001,2669000,75999,False,159,scaffold_3
15,3260001,3278000,17999,False,159,scaffold_3
16,3330001,3345000,14999,False,159,scaffold_3
17,3605001,3643000,37999,False,159,scaffold_3
18,3658001,4053000,394999,False,159,scaffold_3
19,4067001,4404000,336999,False,159,scaffold_3
20,4405001,4824000,418999,False,159,scaffold_3
21,4853001,4910000,56999,False,159,scaffold_3
22,4954001,5087000,132999,False,159,scaffold_3
23,5161001,5194000,32999,False,159,scaffold_3
24,5238001,5274000,35999,False,159,scaffold_3
25,5397001,5451000,53999,False,159,scaffold_3
26,5737001,6024000,286999,False,159,scaffold_3
27,6055001,6202000,146999,False,159,scaffold_3
28,6274001,6322000,47999,False,159,scaffold_3
29,6424001,7157000,732999,False,159,scaffold_3
30,7180001,7445000,264999,False,159,scaffold_3
31,7449001,7460000,10999,False,159,scaffold_3
32,7462001,7656000,193999,False,159,scaffold_3
33,7671001,7980000,308999,False,159,scaffold_3
34,7981001,8156000,174999,False,159,scaffold_3
35,8177001,8255000,77999,False,159,scaffold_3
36,8329001,8354000,24999,False,159,scaffold_3
37,8378001,8640000,261999,False,159,scaffold_3
38,8757001,8917000,159999,False,159,scaffold_3
39,9005001,9084000,78999,False,159,scaffold_3
40,9186001,9255000,68999,False,159,scaffold_3
41,9300001,9316000,15999,False,159,scaffold_3
42,9326001,9352000,25999,False,159,scaffold_3
43,9509001,9564000,54999,False,159,scaffold_3
44,9773001,9822000,48999,False,159,scaffold_3
45,9872001,10110000,237999,False,159,scaffold_3
46,10111001,10148000,36999,False,159,scaffold_3
47,10186001,10214000,27999,False,159,scaffold_3
48,10216001,10458000,241999,False,159,scaffold_3
49,10461001,11182071,721070,True,159,scaffold_3
0,1,7000,6999,True,159,scaffold_4
1,17001,33000,15999,False,159,scaffold_4
2,48001,116000,67999,False,159,scaffold_4
3,117001,136000,18999,False,159,scaffold_4
4,137001,152000,14999,False,159,scaffold_4
5,155001,215000,59999,False,159,scaffold_4
6,218001,226000,7999,False,159,scaffold_4
7,227001,267000,39999,False,159,scaffold_4
8,283001,306000,22999,False,159,scaffold_4
9,318001,353000,34999,False,159,scaffold_4
10,355001,410000,54999,False,159,scaffold_4
11,412001,425000,12999,False,159,scaffold_4
12,426001,592000,165999,False,159,scaffold_4
13,593001,607000,13999,False,159,scaffold_4
14,608001,691000,82999,False,159,scaffold_4
15,694001,727000,32999,False,159,scaffold_4
16,744001,809000,64999,False,159,scaffold_4
17,1028001,1049000,20999,False,159,scaffold_4
18,1075001,1198000,122999,False,159,scaffold_4
19,1199001,1208000,8999,False,159,scaffold_4
20,1210001,1264000,53999,False,159,scaffold_4
21,1265001,1279000,13999,False,159,scaffold_4
22,1283001,1345000,61999,False,159,scaffold_4
23,1354001,1605000,250999,False,159,scaffold_4
24,1613001,1711000,97999,False,159,scaffold_4
25,1749001,1866000,116999,False,159,scaffold_4
26,1869001,1957000,87999,False,159,scaffold_4
27,1958001,1992000,33999,False,159,scaffold_4
28,2056001,2117000,60999,False,159,scaffold_4
29,2158001,2170000,11999,False,159,scaffold_4
30,2201001,2208000,6999,False,159,scaffold_4
31,2210001,2280000,69999,False,159,scaffold_4
32,2284001,2310000,25999,False,159,scaffold_4
33,2312001,2466000,153999,False,159,scaffold_4
34,2480001,2636000,155999,False,159,scaffold_4
35,2682001,2758000,75999,False,159,scaffold_4
36,2923001,3069000,145999,False,159,scaffold_4
37,3086001,3835000,748999,False,159,scaffold_4
38,3850001,3991000,140999,False,159,scaffold_4
39,4009001,4105000,95999,False,159,scaffold_4
40,4220001,4890000,669999,False,159,scaffold_4
41,4891001,5444000,552999,False,159,scaffold_4
42,5462001,5466000,3999,False,159,scaffold_4
43,5467001,5506000,38999,False,159,scaffold_4
44,5515001,5959000,443999,False,159,scaffold_4
45,5996001,6118000,121999,False,159,scaffold_4
46,6146001,6430000,283999,False,159,scaffold_4
47,6474001,6515000,40999,False,159,scaffold_4
48,6559001,6578000,18999,False,159,scaffold_4
49,6614001,6617000,2999,False,159,scaffold_4
50,6619001,6672000,52999,False,159,scaffold_4
51,6723001,6788000,64999,False,159,scaffold_4
52,6789001,6834000,44999,False,159,scaffold_4
53,6875001,6924000,48999,False,159,scaffold_4
54,6926001,7124000,197999,False,159,scaffold_4
55,7126001,7324000,197999,False,159,scaffold_4
56,7353001,7572000,218999,False,159,scaffold_4
57,7596001,7665000,68999,False,159,scaffold_4
58,7862001,7922000,59999,False,159,scaffold_4
59,7985001,8112000,126999,False,159,scaffold_4
60,8278001,8328000,49999,False,159,scaffold_4
61,8353001,8482000,128999,False,159,scaffold_4
62,8519001,8601000,81999,False,159,scaffold_4
63,8708001,9845951,1137950,True,159,scaffold_4
0,1,16000,15999,True,159,scaffold_5
1,136001,172000,35999,False,159,scaffold_5
2,189001,204000,14999,False,159,scaffold_5
3,319001,430000,110999,False,159,scaffold_5
4,450001,528000,77999,False,159,scaffold_5
5,540001,562000,21999,False,159,scaffold_5
6,563001,577000,13999,False,159,scaffold_5
7,669001,698000,28999,False,159,scaffold_5
8,783001,789000,5999,False,159,scaffold_5
9,933001,977000,43999,False,159,scaffold_5
10,1542001,1559000,16999,False,159,scaffold_5
11,1560001,1577000,16999,False,159,scaffold_5
12,2038001,2058000,19999,False,159,scaffold_5
13,2105001,2148000,42999,False,159,scaffold_5
14,2255001,2439000,183999,False,159,scaffold_5
15,2463001,2515000,51999,False,159,scaffold_5
16,2516001,4431000,1914999,False,159,scaffold_5
17,4444001,4810000,365999,False,159,scaffold_5
18,4811001,5458000,646999,False,159,scaffold_5
19,5485001,5528000,42999,False,159,scaffold_5
20,5557001,5565000,7999,False,159,scaffold_5
21,5626001,6006000,379999,False,159,scaffold_5
22,6130001,6274000,143999,False,159,scaffold_5
23,6325001,6972000,646999,False,159,scaffold_5
24,7015001,7091000,75999,False,159,scaffold_5
25,7151001,7249000,97999,False,159,scaffold_5
26,7279001,7405000,125999,False,159,scaffold_5
27,7406001,7451000,44999,False,159,scaffold_5
28,7454001,7897000,442999,False,159,scaffold_5
29,7941001,8001000,59999,False,159,scaffold_5
30,8019001,8047000,27999,False,159,scaffold_5
31,8077001,8206000,128999,False,159,scaffold_5
32,8214001,8250000,35999,False,159,scaffold_5
33,8258001,8539000,280999,False,159,scaffold_5
34,8540001,9364176,824175,True,159,scaffold_5
0,14001,38000,23999,False,159,scaffold_6
1,41001,251000,209999,False,159,scaffold_6
2,267001,376000,108999,False,159,scaffold_6
3,378001,419000,40999,False,159,scaffold_6
4,977001,1034000,56999,False,159,scaffold_6
5,1157001,1310000,152999,False,159,scaffold_6
6,1435001,1603000,167999,False,159,scaffold_6
7,1657001,1752000,94999,False,159,scaffold_6
8,1763001,1906000,142999,False,159,scaffold_6
9,1907001,1933000,25999,False,159,scaffold_6
10,1997001,2286000,288999,False,159,scaffold_6
11,2310001,2864000,553999,False,159,scaffold_6
12,2928001,3350000,421999,False,159,scaffold_6
13,3351001,3806000,454999,False,159,scaffold_6
14,3809001,4072000,262999,False,159,scaffold_6
15,4073001,4207000,133999,False,159,scaffold_6
16,4249001,4282000,32999,False,159,scaffold_6
17,4289001,4298000,8999,False,159,scaffold_6
18,4835001,4876000,40999,False,159,scaffold_6
19,4946001,5006000,59999,False,159,scaffold_6
20,5017001,5048000,30999,False,159,scaffold_6
21,5067001,6212000,1144999,False,159,scaffold_6
22,6253001,6303000,49999,False,159,scaffold_6
23,6335001,6394000,58999,False,159,scaffold_6
24,6452001,6511000,58999,False,159,scaffold_6
25,6531001,6581000,49999,False,159,scaffold_6
26,6616001,6745000,128999,False,159,scaffold_6
27,6762001,6859000,96999,False,159,scaffold_6
28,6898001,7342000,443999,False,159,scaffold_6
29,7361001,7540000,178999,False,159,scaffold_6
30,7541001,8268281,727280,True,159,scaffold_6
0,1,34000,33999,True,159,scaffold_7
1,50001,60000,9999,False,159,scaffold_7
2,294001,305000,10999,False,159,scaffold_7
3,306001,508000,201999,False,159,scaffold_7
4,622001,754000,131999,False,159,scaffold_7
5,763001,844000,80999,False,159,scaffold_7
6,874001,963000,88999,False,159,scaffold_7
7,964001,1044000,79999,False,159,scaffold_7
8,1047001,1157000,109999,False,159,scaffold_7
9,1189001,1512000,322999,False,159,scaffold_7
10,1567001,1693000,125999,False,159,scaffold_7
11,1776001,1893000,116999,False,159,scaffold_7
12,1991001,2020000,28999,False,159,scaffold_7
13,2096001,2210000,113999,False,159,scaffold_7
14,2211001,2252000,40999,False,159,scaffold_7
15,2429001,2462000,32999,False,159,scaffold_7
16,2577001,2602000,24999,False,159,scaffold_7
17,2642001,2656000,13999,False,159,scaffold_7
18,2851001,3076000,224999,False,159,scaffold_7
19,3296001,3986000,689999,False,159,scaffold_7
20,4012001,4154000,141999,False,159,scaffold_7
21,4177001,4188000,10999,False,159,scaffold_7
22,4190001,5297000,1106999,False,159,scaffold_7
23,5341001,5563000,221999,False,159,scaffold_7
24,5726001,5759000,32999,False,159,scaffold_7
25,6069001,6435000,365999,False,159,scaffold_7
26,6455001,6521000,65999,False,159,scaffold_7
27,6565001,6884000,318999,False,159,scaffold_7
28,6902001,6952000,49999,False,159,scaffold_7
29,6953001,7502216,549215,True,159,scaffold_7
0,1,7000,6999,True,159,scaffold_8
1,29001,85000,55999,False,159,scaffold_8
2,262001,271000,8999,False,159,scaffold_8
3,433001,458000,24999,False,159,scaffold_8
4,1003001,1132000,128999,False,159,scaffold_8
5,1146001,1188000,41999,False,159,scaffold_8
6,1311001,1429000,117999,False,159,scaffold_8
7,1497001,1545000,47999,False,159,scaffold_8
8,1566001,1658000,91999,False,159,scaffold_8
9,1669001,2186000,516999,False,159,scaffold_8
10,2204001,2591000,386999,False,159,scaffold_8
11,2614001,2683000,68999,False,159,scaffold_8
12,2685001,2844000,158999,False,159,scaffold_8
13,2925001,2946000,20999,False,159,scaffold_8
14,2949001,2959000,9999,False,159,scaffold_8
15,2976001,3614000,637999,False,159,scaffold_8
16,3615001,4281000,665999,False,159,scaffold_8
17,4309001,4432000,122999,False,159,scaffold_8
18,4459001,4503000,43999,False,159,scaffold_8
19,4564001,4676000,111999,False,159,scaffold_8
20,4816001,4963000,146999,False,159,scaffold_8
21,5029001,5247000,217999,False,159,scaffold_8
22,5307001,5368000,60999,False,159,scaffold_8
23,5390001,5695000,304999,False,159,scaffold_8
24,6318001,6334544,16543,True,159,scaffold_8
0,1,41000,40999,True,159,scaffold_9
1,64001,108000,43999,False,159,scaffold_9
2,109001,148000,38999,False,159,scaffold_9
3,150001,180000,29999,False,159,scaffold_9
4,298001,435000,136999,False,159,scaffold_9
5,436001,531000,94999,False,159,scaffold_9
6,532001,545000,12999,False,159,scaffold_9
7,547001,577000,29999,False,159,scaffold_9
8,596001,665000,68999,False,159,scaffold_9
9,672001,711000,38999,False,159,scaffold_9
10,731001,742000,10999,False,159,scaffold_9
11,808001,843000,34999,False,159,scaffold_9
12,886001,986000,99999,False,159,scaffold_9
13,988001,1031000,42999,False,159,scaffold_9
14,1035001,1172000,136999,False,159,scaffold_9
15,1174001,1191000,16999,False,159,scaffold_9
16,1249001,1380000,130999,False,159,scaffold_9
17,1718001,1807000,88999,False,159,scaffold_9
18,2174001,2201000,26999,False,159,scaffold_9
19,2219001,2291000,71999,False,159,scaffold_9
20,2484001,2524000,39999,False,159,scaffold_9
21,2596001,2673000,76999,False,159,scaffold_9
22,2731001,5111000,2379999,False,159,scaffold_9
23,5112001,5298000,185999,False,159,scaffold_9
24,5299001,6331288,1032287,True,159,scaffold_9
0,1,1068000,1067999,True,159,scaffold_10
1,1072001,1148000,75999,False,159,scaffold_10
2,1167001,1336000,168999,False,159,scaffold_10
3,1367001,1419000,51999,False,159,scaffold_10
4,1534001,1714000,179999,False,159,scaffold_10
5,1751001,1822000,70999,False,159,scaffold_10
6,1939001,2005000,65999,False,159,scaffold_10
7,2064001,2110000,45999,False,159,scaffold_10
8,2125001,2188000,62999,False,159,scaffold_10
9,2283001,2326000,42999,False,159,scaffold_10
10,2346001,2414000,67999,False,159,scaffold_10
11,2599001,2650000,50999,False,159,scaffold_10
12,2826001,2897000,70999,False,159,scaffold_10
13,3065001,3133000,67999,False,159,scaffold_10
14,3481001,3493000,11999,False,159,scaffold_10
15,3874001,3903000,28999,False,159,scaffold_10
16,4000001,4027000,26999,False,159,scaffold_10
17,4049001,4136000,86999,False,159,scaffold_10
18,4155001,4211000,55999,False,159,scaffold_10
19,4214001,4257000,42999,False,159,scaffold_10
20,4316001,4322000,5999,False,159,scaffold_10
21,4332001,4367000,34999,False,159,scaffold_10
22,4383001,4514000,130999,False,159,scaffold_10
23,4515001,4549000,33999,False,159,scaffold_10
24,4554001,4562000,7999,False,159,scaffold_10
25,4563001,4615000,51999,False,159,scaffold_10
26,4727001,4766000,38999,False,159,scaffold_10
27,4798001,4824000,25999,False,159,scaffold_10
28,4828001,4866973,38972,True,159,scaffold_10
0,1,108000,107999,True,159,scaffold_11
1,131001,273000,141999,False,159,scaffold_11
2,275001,349000,73999,False,159,scaffold_11
3,377001,417000,39999,False,159,scaffold_11
4,419001,431000,11999,False,159,scaffold_11
5,433001,457000,23999,False,159,scaffold_11
6,648001,657000,8999,False,159,scaffold_11
7,1724001,1728000,3999,False,159,scaffold_11
8,1775001,1802000,26999,False,159,scaffold_11
9,2242001,2283000,40999,False,159,scaffold_11
10,2312001,2698000,385999,False,159,scaffold_11
11,2700001,3028000,327999,False,159,scaffold_11
12,3041001,3390000,348999,False,159,scaffold_11
13,3409001,4766820,1357819,True,159,scaffold_11
0,1,1591000,1590999,True,159,scaffold_12
1,1688001,1762000,73999,False,159,scaffold_12
2,1788001,1811000,22999,False,159,scaffold_12
3,2035001,2042000,6999,False,159,scaffold_12
4,2292001,2303000,10999,False,159,scaffold_12
5,2463001,2485000,21999,False,159,scaffold_12
6,2492001,2505000,12999,False,159,scaffold_12
7,2559001,2570000,10999,False,159,scaffold_12
8,2571001,2657000,85999,False,159,scaffold_12
9,2659001,2708000,48999,False,159,scaffold_12
10,2709001,2720000,10999,False,159,scaffold_12
11,2724001,2747968,23967,True,159,scaffold_12
0,1,499000,498999,True,160,scaffold_1
1,549001,643000,93999,False,160,scaffold_1
2,686001,760000,73999,False,160,scaffold_1
3,913001,926000,12999,False,160,scaffold_1
4,1044001,1117000,72999,False,160,scaffold_1
5,1231001,1292000,60999,False,160,scaffold_1
6,1606001,1698000,91999,False,160,scaffold_1
7,1770001,1784000,13999,False,160,scaffold_1
8,1809001,1901000,91999,False,160,scaffold_1
9,1916001,1984000,67999,False,160,scaffold_1
10,1986001,1997000,10999,False,160,scaffold_1
11,2363001,2414000,50999,False,160,scaffold_1
12,2448001,2621000,172999,False,160,scaffold_1
13,2718001,2853000,134999,False,160,scaffold_1
14,2893001,3068000,174999,False,160,scaffold_1
15,3100001,3111000,10999,False,160,scaffold_1
16,3179001,3192000,12999,False,160,scaffold_1
17,3193001,3240000,46999,False,160,scaffold_1
18,3453001,3631000,177999,False,160,scaffold_1
19,3684001,3877000,192999,False,160,scaffold_1
20,3901001,4156000,254999,False,160,scaffold_1
21,4311001,4354000,42999,False,160,scaffold_1
22,4707001,4749000,41999,False,160,scaffold_1
23,4920001,5023000,102999,False,160,scaffold_1
24,5083001,5110000,26999,False,160,scaffold_1
25,5355001,5373000,17999,False,160,scaffold_1
26,5483001,5577000,93999,False,160,scaffold_1
27,5795001,5918000,122999,False,160,scaffold_1
28,6108001,6185000,76999,False,160,scaffold_1
29,6209001,6322000,112999,False,160,scaffold_1
30,6323001,6511000,187999,False,160,scaffold_1
31,6541001,6579000,37999,False,160,scaffold_1
32,6631001,6669000,37999,False,160,scaffold_1
33,6834001,6855000,20999,False,160,scaffold_1
34,7013001,7583000,569999,False,160,scaffold_1
35,7590001,8656000,1065999,False,160,scaffold_1
36,8658001,9584000,925999,False,160,scaffold_1
37,9586001,10017000,430999,False,160,scaffold_1
38,10018001,10364000,345999,False,160,scaffold_1
39,10450001,10792000,341999,False,160,scaffold_1
40,10837001,10855000,17999,False,160,scaffold_1
41,11011001,11037000,25999,False,160,scaffold_1
42,11318001,11536000,217999,False,160,scaffold_1
43,11550001,11979000,428999,False,160,scaffold_1
44,12184001,12243000,58999,False,160,scaffold_1
45,12652001,12757000,104999,False,160,scaffold_1
46,12775001,12890000,114999,False,160,scaffold_1
47,12904001,13008000,103999,False,160,scaffold_1
48,13022001,13213000,190999,False,160,scaffold_1
49,13347001,13404000,56999,False,160,scaffold_1
50,14290001,14313000,22999,False,160,scaffold_1
0,1,41000,40999,True,160,scaffold_2
1,42001,48000,5999,False,160,scaffold_2
2,74001,159000,84999,False,160,scaffold_2
3,165001,177000,11999,False,160,scaffold_2
4,178001,186000,7999,False,160,scaffold_2
5,189001,203000,13999,False,160,scaffold_2
6,239001,266000,26999,False,160,scaffold_2
7,296001,318000,21999,False,160,scaffold_2
8,331001,381000,49999,False,160,scaffold_2
9,569001,613000,43999,False,160,scaffold_2
10,720001,739000,18999,False,160,scaffold_2
11,1001001,1013000,11999,False,160,scaffold_2
12,2085001,2106000,20999,False,160,scaffold_2
13,2330001,2638000,307999,False,160,scaffold_2
14,2668001,2689000,20999,False,160,scaffold_2
15,2693001,2746000,52999,False,160,scaffold_2
16,2805001,2855000,49999,False,160,scaffold_2
17,2876001,2899000,22999,False,160,scaffold_2
18,2946001,3021000,74999,False,160,scaffold_2
19,3022001,3057000,34999,False,160,scaffold_2
20,3174001,3196000,21999,False,160,scaffold_2
21,3260001,3284000,23999,False,160,scaffold_2
22,3364001,3413000,48999,False,160,scaffold_2
23,3450001,3486000,35999,False,160,scaffold_2
24,3748001,3783000,34999,False,160,scaffold_2
25,4238001,4409000,170999,False,160,scaffold_2
26,4426001,4496000,69999,False,160,scaffold_2
27,4519001,4679000,159999,False,160,scaffold_2
28,4705001,4765000,59999,False,160,scaffold_2
29,4847001,4959000,111999,False,160,scaffold_2
30,5010001,5104000,93999,False,160,scaffold_2
31,5124001,5222000,97999,False,160,scaffold_2
32,5285001,5313000,27999,False,160,scaffold_2
33,5360001,5390000,29999,False,160,scaffold_2
34,5414001,5564000,149999,False,160,scaffold_2
35,5618001,5764000,145999,False,160,scaffold_2
36,5837001,6080000,242999,False,160,scaffold_2
37,6244001,6352000,107999,False,160,scaffold_2
38,6365001,6449000,83999,False,160,scaffold_2
39,6507001,6544000,36999,False,160,scaffold_2
40,6576001,6629000,52999,False,160,scaffold_2
41,6695001,6740000,44999,False,160,scaffold_2
42,6822001,6978000,155999,False,160,scaffold_2
43,7004001,7247000,242999,False,160,scaffold_2
44,7259001,7518000,258999,False,160,scaffold_2
45,7563001,8285000,721999,False,160,scaffold_2
46,8286001,8313000,26999,False,160,scaffold_2
47,8346001,8563000,216999,False,160,scaffold_2
48,8800001,8865000,64999,False,160,scaffold_2
49,8986001,9077000,90999,False,160,scaffold_2
50,9079001,9098000,18999,False,160,scaffold_2
51,9115001,9168000,52999,False,160,scaffold_2
52,9213001,9275000,61999,False,160,scaffold_2
53,9281001,9297000,15999,False,160,scaffold_2
54,9317001,9512000,194999,False,160,scaffold_2
55,9532001,9697000,164999,False,160,scaffold_2
56,9840001,9904000,63999,False,160,scaffold_2
57,10165001,10186000,20999,False,160,scaffold_2
58,10187001,10245000,57999,False,160,scaffold_2
59,10471001,10562000,90999,False,160,scaffold_2
60,11023001,11085000,61999,False,160,scaffold_2
61,11316001,11388000,71999,False,160,scaffold_2
62,11392001,11483000,90999,False,160,scaffold_2
63,11484001,11802476,318475,True,160,scaffold_2
0,51001,55000,3999,False,160,scaffold_3
1,618001,646000,27999,False,160,scaffold_3
2,791001,900000,108999,False,160,scaffold_3
3,1174001,1191000,16999,False,160,scaffold_3
4,2047001,2108000,60999,False,160,scaffold_3
5,2264001,2341000,76999,False,160,scaffold_3
6,2433001,2532000,98999,False,160,scaffold_3
7,3678001,3891000,212999,False,160,scaffold_3
8,4006001,4034000,27999,False,160,scaffold_3
9,4071001,4398000,326999,False,160,scaffold_3
10,4415001,4523000,107999,False,160,scaffold_3
11,4532001,4604000,71999,False,160,scaffold_3
12,4637001,4725000,87999,False,160,scaffold_3
13,4762001,4799000,36999,False,160,scaffold_3
14,4852001,4906000,53999,False,160,scaffold_3
15,4966001,5023000,56999,False,160,scaffold_3
16,5241001,5279000,37999,False,160,scaffold_3
17,5411001,5440000,28999,False,160,scaffold_3
18,5805001,5954000,148999,False,160,scaffold_3
19,5987001,6022000,34999,False,160,scaffold_3
20,6514001,6584000,69999,False,160,scaffold_3
21,6655001,6807000,151999,False,160,scaffold_3
22,6838001,6878000,39999,False,160,scaffold_3
23,6910001,7157000,246999,False,160,scaffold_3
24,7231001,7327000,95999,False,160,scaffold_3
25,7333001,7402000,68999,False,160,scaffold_3
26,7483001,7556000,72999,False,160,scaffold_3
27,7578001,7629000,50999,False,160,scaffold_3
28,7683001,7856000,172999,False,160,scaffold_3
29,7910001,7943000,32999,False,160,scaffold_3
30,8090001,8112000,21999,False,160,scaffold_3
31,8177001,8253000,75999,False,160,scaffold_3
32,8398001,8448000,49999,False,160,scaffold_3
33,8462001,8528000,65999,False,160,scaffold_3
34,8573001,8594000,20999,False,160,scaffold_3
35,8757001,8770000,12999,False,160,scaffold_3
36,9006001,9075000,68999,False,160,scaffold_3
37,9965001,10091000,125999,False,160,scaffold_3
38,10234001,10367000,132999,False,160,scaffold_3
39,10378001,10388000,9999,False,160,scaffold_3
40,10418001,10458000,39999,False,160,scaffold_3
41,10462001,11182071,720070,True,160,scaffold_3
0,17001,35000,17999,False,160,scaffold_4
1,48001,112000,63999,False,160,scaffold_4
2,120001,152000,31999,False,160,scaffold_4
3,155001,226000,70999,False,160,scaffold_4
4,227001,278000,50999,False,160,scaffold_4
5,283001,307000,23999,False,160,scaffold_4
6,318001,353000,34999,False,160,scaffold_4
7,355001,374000,18999,False,160,scaffold_4
8,375001,425000,49999,False,160,scaffold_4
9,426001,428000,1999,False,160,scaffold_4
10,429001,592000,162999,False,160,scaffold_4
11,593001,607000,13999,False,160,scaffold_4
12,608001,691000,82999,False,160,scaffold_4
13,695001,726000,30999,False,160,scaffold_4
14,1050001,1081000,30999,False,160,scaffold_4
15,1082001,1086000,3999,False,160,scaffold_4
16,1087001,1209000,121999,False,160,scaffold_4
17,1210001,1219000,8999,False,160,scaffold_4
18,1269001,1279000,9999,False,160,scaffold_4
19,1283001,1336000,52999,False,160,scaffold_4
20,1358001,1597000,238999,False,160,scaffold_4
21,1613001,1671000,57999,False,160,scaffold_4
22,1749001,1864000,114999,False,160,scaffold_4
23,1904001,1989000,84999,False,160,scaffold_4
24,2222001,2246000,23999,False,160,scaffold_4
25,2247001,2280000,32999,False,160,scaffold_4
26,2284001,2340000,55999,False,160,scaffold_4
27,2342001,2389000,46999,False,160,scaffold_4
28,2391001,2426000,34999,False,160,scaffold_4
29,2476001,2635000,158999,False,160,scaffold_4
30,2700001,2747000,46999,False,160,scaffold_4
31,2943001,2955000,11999,False,160,scaffold_4
32,3034001,3068000,33999,False,160,scaffold_4
33,3090001,3127000,36999,False,160,scaffold_4
34,3203001,3267000,63999,False,160,scaffold_4
35,3334001,3764000,429999,False,160,scaffold_4
36,3933001,3956000,22999,False,160,scaffold_4
37,4058001,4104000,45999,False,160,scaffold_4
38,4282001,4447000,164999,False,160,scaffold_4
39,4702001,4772000,69999,False,160,scaffold_4
40,4900001,5102000,201999,False,160,scaffold_4
41,5169001,5211000,41999,False,160,scaffold_4
42,5213001,5242000,28999,False,160,scaffold_4
43,5300001,5438000,137999,False,160,scaffold_4
44,5472001,5506000,33999,False,160,scaffold_4
45,5515001,5784000,268999,False,160,scaffold_4
46,5786001,5824000,37999,False,160,scaffold_4
47,5927001,5945000,17999,False,160,scaffold_4
48,6049001,6094000,44999,False,160,scaffold_4
49,6147001,6197000,49999,False,160,scaffold_4
50,6229001,6306000,76999,False,160,scaffold_4
51,6472001,6491000,18999,False,160,scaffold_4
52,6615001,6617000,1999,False,160,scaffold_4
53,6712001,6788000,75999,False,160,scaffold_4
54,6871001,7124000,252999,False,160,scaffold_4
55,7152001,7321000,168999,False,160,scaffold_4
56,7499001,7554000,54999,False,160,scaffold_4
57,7627001,7665000,37999,False,160,scaffold_4
58,8403001,8412000,8999,False,160,scaffold_4
59,8755001,9699000,943999,False,160,scaffold_4
60,9700001,9845951,145950,True,160,scaffold_4
0,132001,174000,41999,False,160,scaffold_5
1,318001,416000,97999,False,160,scaffold_5
2,455001,523000,67999,False,160,scaffold_5
3,933001,947000,13999,False,160,scaffold_5
4,2108001,2147000,38999,False,160,scaffold_5
5,2257001,2302000,44999,False,160,scaffold_5
6,2381001,2405000,23999,False,160,scaffold_5
7,2476001,2494000,17999,False,160,scaffold_5
8,2508001,2515000,6999,False,160,scaffold_5
9,2516001,2530000,13999,False,160,scaffold_5
10,2552001,3658000,1105999,False,160,scaffold_5
11,3713001,3751000,37999,False,160,scaffold_5
12,3832001,4132000,299999,False,160,scaffold_5
13,4155001,4242000,86999,False,160,scaffold_5
14,4243001,4377000,133999,False,160,scaffold_5
15,4422001,4941000,518999,False,160,scaffold_5
16,4967001,5106000,138999,False,160,scaffold_5
17,5145001,5398000,252999,False,160,scaffold_5
18,5498001,5532000,33999,False,160,scaffold_5
19,5696001,5830000,133999,False,160,scaffold_5
20,5859001,5891000,31999,False,160,scaffold_5
21,6174001,6250000,75999,False,160,scaffold_5
22,6325001,6359000,33999,False,160,scaffold_5
23,6408001,6731000,322999,False,160,scaffold_5
24,6757001,6792000,34999,False,160,scaffold_5
25,7033001,7083000,49999,False,160,scaffold_5
26,7166001,7248000,81999,False,160,scaffold_5
27,7299001,7363000,63999,False,160,scaffold_5
28,7424001,7438000,13999,False,160,scaffold_5
29,7454001,7619000,164999,False,160,scaffold_5
30,7622001,7670000,47999,False,160,scaffold_5
31,7711001,7776000,64999,False,160,scaffold_5
32,7782001,7805000,22999,False,160,scaffold_5
33,7812001,7897000,84999,False,160,scaffold_5
34,7942001,8017000,74999,False,160,scaffold_5
35,8258001,8346000,87999,False,160,scaffold_5
36,8359001,8470000,110999,False,160,scaffold_5
37,8550001,8616000,65999,False,160,scaffold_5
38,8659001,8685000,25999,False,160,scaffold_5
39,8705001,9364176,659175,True,160,scaffold_5
0,43001,75000,31999,False,160,scaffold_6
1,77001,113000,35999,False,160,scaffold_6
2,162001,210000,47999,False,160,scaffold_6
3,239001,253000,13999,False,160,scaffold_6
4,267001,376000,108999,False,160,scaffold_6
5,402001,419000,16999,False,160,scaffold_6
6,1231001,1265000,33999,False,160,scaffold_6
7,1284001,1305000,20999,False,160,scaffold_6
8,1478001,1583000,104999,False,160,scaffold_6
9,1658001,1714000,55999,False,160,scaffold_6
10,1765001,1902000,136999,False,160,scaffold_6
11,2024001,2106000,81999,False,160,scaffold_6
12,2127001,2211000,83999,False,160,scaffold_6
13,2235001,2283000,47999,False,160,scaffold_6
14,2333001,2651000,317999,False,160,scaffold_6
15,2662001,2863000,200999,False,160,scaffold_6
16,2928001,3015000,86999,False,160,scaffold_6
17,3070001,3210000,139999,False,160,scaffold_6
18,3217001,3800000,582999,False,160,scaffold_6
19,3881001,4204000,322999,False,160,scaffold_6
20,5282001,5338000,55999,False,160,scaffold_6
21,5382001,5503000,120999,False,160,scaffold_6
22,5525001,5647000,121999,False,160,scaffold_6
23,5678001,5742000,63999,False,160,scaffold_6
24,5863001,5969000,105999,False,160,scaffold_6
25,6003001,6088000,84999,False,160,scaffold_6
26,6124001,6183000,58999,False,160,scaffold_6
27,6766001,6859000,92999,False,160,scaffold_6
28,6910001,6943000,32999,False,160,scaffold_6
29,6974001,7006000,31999,False,160,scaffold_6
30,7163001,7340000,176999,False,160,scaffold_6
31,7382001,7488000,105999,False,160,scaffold_6
32,7545001,8268281,723280,True,160,scaffold_6
0,298001,508000,209999,False,160,scaffold_7
1,622001,755000,132999,False,160,scaffold_7
2,765001,843000,77999,False,160,scaffold_7
3,876001,948000,71999,False,160,scaffold_7
4,949001,963000,13999,False,160,scaffold_7
5,964001,979000,14999,False,160,scaffold_7
6,982001,1044000,61999,False,160,scaffold_7
7,1048001,1149000,100999,False,160,scaffold_7
8,1202001,1512000,309999,False,160,scaffold_7
9,1565001,1693000,127999,False,160,scaffold_7
10,2180001,2212000,31999,False,160,scaffold_7
11,2851001,2979000,127999,False,160,scaffold_7
12,3293001,3422000,128999,False,160,scaffold_7
13,3460001,3809000,348999,False,160,scaffold_7
14,3902001,3985000,82999,False,160,scaffold_7
15,4026001,4081000,54999,False,160,scaffold_7
16,4321001,4382000,60999,False,160,scaffold_7
17,4403001,4514000,110999,False,160,scaffold_7
18,4530001,4913000,382999,False,160,scaffold_7
19,4978001,5149000,170999,False,160,scaffold_7
20,5400001,5444000,43999,False,160,scaffold_7
21,5467001,5537000,69999,False,160,scaffold_7
22,6096001,6181000,84999,False,160,scaffold_7
23,6261001,6432000,170999,False,160,scaffold_7
24,6501001,6510000,8999,False,160,scaffold_7
25,6561001,6593000,31999,False,160,scaffold_7
26,6601001,6637000,35999,False,160,scaffold_7
27,6752001,6797000,44999,False,160,scaffold_7
28,6817001,6875000,57999,False,160,scaffold_7
29,6944001,7186000,241999,False,160,scaffold_7
30,7187001,7270000,82999,False,160,scaffold_7
31,7271001,7502216,231215,True,160,scaffold_7
0,29001,85000,55999,False,160,scaffold_8
1,93001,101000,7999,False,160,scaffold_8
2,1021001,1053000,31999,False,160,scaffold_8
3,1362001,1422000,59999,False,160,scaffold_8
4,1502001,1551000,48999,False,160,scaffold_8
5,1672001,1762000,89999,False,160,scaffold_8
6,1856001,1978000,121999,False,160,scaffold_8
7,2086001,2184000,97999,False,160,scaffold_8
8,2252001,2291000,38999,False,160,scaffold_8
9,2355001,2531000,175999,False,160,scaffold_8
10,2536001,2590000,53999,False,160,scaffold_8
11,2641001,2683000,41999,False,160,scaffold_8
12,2741001,2842000,100999,False,160,scaffold_8
13,3058001,3612000,553999,False,160,scaffold_8
14,3615001,3768000,152999,False,160,scaffold_8
15,3769001,3975000,205999,False,160,scaffold_8
16,4011001,4112000,100999,False,160,scaffold_8
17,4171001,4268000,96999,False,160,scaffold_8
18,4329001,4440000,110999,False,160,scaffold_8
19,4467001,4481000,13999,False,160,scaffold_8
20,4608001,4648000,39999,False,160,scaffold_8
21,4820001,4916000,95999,False,160,scaffold_8
22,5028001,5244000,215999,False,160,scaffold_8
23,5449001,5467000,17999,False,160,scaffold_8
24,5521001,5598000,76999,False,160,scaffold_8
25,5649001,5692000,42999,False,160,scaffold_8
26,6329001,6334544,5543,True,160,scaffold_8
0,1,22000,21999,True,160,scaffold_9
1,80001,108000,27999,False,160,scaffold_9
2,299001,411000,111999,False,160,scaffold_9
3,413001,435000,21999,False,160,scaffold_9
4,483001,531000,47999,False,160,scaffold_9
5,547001,563000,15999,False,160,scaffold_9
6,656001,665000,8999,False,160,scaffold_9
7,671001,697000,25999,False,160,scaffold_9
8,815001,860000,44999,False,160,scaffold_9
9,873001,986000,112999,False,160,scaffold_9
10,987001,1085000,97999,False,160,scaffold_9
11,1087001,1166000,78999,False,160,scaffold_9
12,1312001,1377000,64999,False,160,scaffold_9
13,1758001,1800000,41999,False,160,scaffold_9
14,2601001,2617000,15999,False,160,scaffold_9
15,2731001,2985000,253999,False,160,scaffold_9
16,2986001,3381000,394999,False,160,scaffold_9
17,3383001,5115000,1731999,False,160,scaffold_9
18,5116001,5238000,121999,False,160,scaffold_9
19,5239001,5298000,58999,False,160,scaffold_9
20,5300001,6331288,1031287,True,160,scaffold_9
0,1,414000,413999,True,160,scaffold_10
1,415001,482000,66999,False,160,scaffold_10
2,483001,878000,394999,False,160,scaffold_10
3,888001,1069000,180999,False,160,scaffold_10
4,1073001,1154000,80999,False,160,scaffold_10
5,1313001,1335000,21999,False,160,scaffold_10
6,1604001,1674000,69999,False,160,scaffold_10
7,2087001,2102000,14999,False,160,scaffold_10
8,2141001,2167000,25999,False,160,scaffold_10
9,2346001,2392000,45999,False,160,scaffold_10
10,4000001,4011000,10999,False,160,scaffold_10
11,4049001,4137000,87999,False,160,scaffold_10
12,4155001,4182000,26999,False,160,scaffold_10
13,4334001,4366000,31999,False,160,scaffold_10
14,4389001,4429000,39999,False,160,scaffold_10
15,4443001,4502000,58999,False,160,scaffold_10
16,4503001,4513000,9999,False,160,scaffold_10
17,4515001,4523000,7999,False,160,scaffold_10
18,4526001,4548000,21999,False,160,scaffold_10
19,4554001,4562000,7999,False,160,scaffold_10
20,4565001,4597000,31999,False,160,scaffold_10
21,4734001,4776000,41999,False,160,scaffold_10
22,4781001,4784000,2999,False,160,scaffold_10
23,4785001,4824000,38999,False,160,scaffold_10
24,4827001,4861000,33999,False,160,scaffold_10
25,4862001,4866973,4972,True,160,scaffold_10
0,9001,95000,85999,False,160,scaffold_11
1,148001,212000,63999,False,160,scaffold_11
2,213001,236000,22999,False,160,scaffold_11
3,289001,320000,30999,False,160,scaffold_11
4,419001,431000,11999,False,160,scaffold_11
5,648001,656000,7999,False,160,scaffold_11
6,1474001,1477000,2999,False,160,scaffold_11
7,2339001,2498000,158999,False,160,scaffold_11
8,2689001,2874000,184999,False,160,scaffold_11
9,2981001,3023000,41999,False,160,scaffold_11
10,3058001,3384000,325999,False,160,scaffold_11
11,3565001,3719000,153999,False,160,scaffold_11
12,3722001,3933000,210999,False,160,scaffold_11
13,4009001,4072000,62999,False,160,scaffold_11
14,4118001,4186000,67999,False,160,scaffold_11
15,4267001,4766820,499819,True,160,scaffold_11
0,1,1504000,1503999,True,160,scaffold_12
1,1717001,1756000,38999,False,160,scaffold_12
2,2571001,2631000,59999,False,160,scaffold_12
0,1,397000,396999,True,161,scaffold_1
1,468001,498000,29999,False,161,scaffold_1
2,570001,650000,79999,False,161,scaffold_1
3,686001,759000,72999,False,161,scaffold_1
4,760001,770000,9999,False,161,scaffold_1
5,1054001,1100000,45999,False,161,scaffold_1
6,1147001,1292000,144999,False,161,scaffold_1
7,1297001,1334000,36999,False,161,scaffold_1
8,1616001,1648000,31999,False,161,scaffold_1
9,1649001,1660000,10999,False,161,scaffold_1
10,1661001,1696000,34999,False,161,scaffold_1
11,1765001,1799000,33999,False,161,scaffold_1
12,1819001,1984000,164999,False,161,scaffold_1
13,1986001,2021000,34999,False,161,scaffold_1
14,2141001,2150000,8999,False,161,scaffold_1
15,2212001,2241000,28999,False,161,scaffold_1
16,2256001,2396000,139999,False,161,scaffold_1
17,2397001,2629000,231999,False,161,scaffold_1
18,2651001,2686000,34999,False,161,scaffold_1
19,2715001,2793000,77999,False,161,scaffold_1
20,2826001,3127000,300999,False,161,scaffold_1
21,3174001,3209000,34999,False,161,scaffold_1
22,3244001,3265000,20999,False,161,scaffold_1
23,3436001,3634000,197999,False,161,scaffold_1
24,3682001,3878000,195999,False,161,scaffold_1
25,3902001,4166000,263999,False,161,scaffold_1
26,4270001,4355000,84999,False,161,scaffold_1
27,4493001,4552000,58999,False,161,scaffold_1
28,4613001,4626000,12999,False,161,scaffold_1
29,4705001,4793000,87999,False,161,scaffold_1
30,4862001,4894000,31999,False,161,scaffold_1
31,4916001,5059000,142999,False,161,scaffold_1
32,5082001,5194000,111999,False,161,scaffold_1
33,5357001,5410000,52999,False,161,scaffold_1
34,5481001,5521000,39999,False,161,scaffold_1
35,5532001,5594000,61999,False,161,scaffold_1
36,5835001,5928000,92999,False,161,scaffold_1
37,6020001,6070000,49999,False,161,scaffold_1
38,6112001,6179000,66999,False,161,scaffold_1
39,6180001,6186000,5999,False,161,scaffold_1
40,6188001,6579000,390999,False,161,scaffold_1
41,6601001,6615000,13999,False,161,scaffold_1
42,6639001,6663000,23999,False,161,scaffold_1
43,6790001,6862000,71999,False,161,scaffold_1
44,6864001,6950000,85999,False,161,scaffold_1
45,6969001,7247000,277999,False,161,scaffold_1
46,7248001,7584000,335999,False,161,scaffold_1
47,7590001,8641000,1050999,False,161,scaffold_1
48,8642001,8656000,13999,False,161,scaffold_1
49,8658001,9316000,657999,False,161,scaffold_1
50,9317001,9584000,266999,False,161,scaffold_1
51,9586001,10370000,783999,False,161,scaffold_1
52,10397001,10430000,32999,False,161,scaffold_1
53,10460001,10642000,181999,False,161,scaffold_1
54,10675001,10768000,92999,False,161,scaffold_1
55,10837001,10855000,17999,False,161,scaffold_1
56,10882001,10991000,108999,False,161,scaffold_1
57,11015001,11076000,60999,False,161,scaffold_1
58,11181001,11251000,69999,False,161,scaffold_1
59,11269001,11535000,265999,False,161,scaffold_1
60,11550001,11972000,421999,False,161,scaffold_1
61,12003001,12044000,40999,False,161,scaffold_1
62,12073001,12253000,179999,False,161,scaffold_1
63,12358001,12396000,37999,False,161,scaffold_1
64,12397001,12527000,129999,False,161,scaffold_1
65,12568001,12586000,17999,False,161,scaffold_1
66,12624001,12890000,265999,False,161,scaffold_1
67,12916001,13215000,298999,False,161,scaffold_1
68,13347001,13432000,84999,False,161,scaffold_1
69,13517001,13589000,71999,False,161,scaffold_1
70,13591001,13615000,23999,False,161,scaffold_1
71,13725001,13740000,14999,False,161,scaffold_1
72,13981001,14000000,18999,False,161,scaffold_1
73,14291001,14313000,21999,False,161,scaffold_1
74,14649001,14663000,13999,False,161,scaffold_1
0,21001,39000,17999,False,161,scaffold_2
1,51001,91000,39999,False,161,scaffold_2
2,92001,159000,66999,False,161,scaffold_2
3,165001,177000,11999,False,161,scaffold_2
4,179001,222000,42999,False,161,scaffold_2
5,240001,287000,46999,False,161,scaffold_2
6,296001,318000,21999,False,161,scaffold_2
7,335001,381000,45999,False,161,scaffold_2
8,390001,411000,20999,False,161,scaffold_2
9,559001,628000,68999,False,161,scaffold_2
10,706001,739000,32999,False,161,scaffold_2
11,882001,1016000,133999,False,161,scaffold_2
12,1019001,1036000,16999,False,161,scaffold_2
13,1776001,1822000,45999,False,161,scaffold_2
14,1915001,1953000,37999,False,161,scaffold_2
15,2042001,2048000,5999,False,161,scaffold_2
16,2077001,2112000,34999,False,161,scaffold_2
17,2314001,2335000,20999,False,161,scaffold_2
18,2336001,2609000,272999,False,161,scaffold_2
19,2653001,2689000,35999,False,161,scaffold_2
20,2693001,2740000,46999,False,161,scaffold_2
21,2766001,2788000,21999,False,161,scaffold_2
22,2797001,2855000,57999,False,161,scaffold_2
23,2868001,3099000,230999,False,161,scaffold_2
24,3225001,3284000,58999,False,161,scaffold_2
25,3359001,3426000,66999,False,161,scaffold_2
26,3447001,3487000,39999,False,161,scaffold_2
27,3577001,3655000,77999,False,161,scaffold_2
28,3734001,3784000,49999,False,161,scaffold_2
29,4206001,4790000,583999,False,161,scaffold_2
30,4793001,4969000,175999,False,161,scaffold_2
31,5008001,5105000,96999,False,161,scaffold_2
32,5140001,5794000,653999,False,161,scaffold_2
33,5820001,6141000,320999,False,161,scaffold_2
34,6230001,6330000,99999,False,161,scaffold_2
35,6331001,6462000,130999,False,161,scaffold_2
36,6504001,6638000,133999,False,161,scaffold_2
37,6699001,6979000,279999,False,161,scaffold_2
38,7007001,7244000,236999,False,161,scaffold_2
39,7335001,7526000,190999,False,161,scaffold_2
40,7549001,7561000,11999,False,161,scaffold_2
41,7563001,7891000,327999,False,161,scaffold_2
42,7893001,8316000,422999,False,161,scaffold_2
43,8331001,8333000,1999,False,161,scaffold_2
44,8335001,8344000,8999,False,161,scaffold_2
45,8346001,8455000,108999,False,161,scaffold_2
46,8466001,8493000,26999,False,161,scaffold_2
47,8505001,8564000,58999,False,161,scaffold_2
48,8799001,8851000,51999,False,161,scaffold_2
49,8932001,8952000,19999,False,161,scaffold_2
50,8989001,9098000,108999,False,161,scaffold_2
51,9115001,9471000,355999,False,161,scaffold_2
52,9472001,9742000,269999,False,161,scaffold_2
53,10215001,10252000,36999,False,161,scaffold_2
54,10403001,10434000,30999,False,161,scaffold_2
55,10436001,10576000,139999,False,161,scaffold_2
56,10648001,10719000,70999,False,161,scaffold_2
57,10720001,10756000,35999,False,161,scaffold_2
58,10935001,10971000,35999,False,161,scaffold_2
59,10995001,11136000,140999,False,161,scaffold_2
60,11230001,11232000,1999,False,161,scaffold_2
61,11238001,11274000,35999,False,161,scaffold_2
62,11310001,11345000,34999,False,161,scaffold_2
63,11393001,11786000,392999,False,161,scaffold_2
64,11797001,11802476,5475,True,161,scaffold_2
0,1,6000,5999,True,161,scaffold_3
1,66001,99000,32999,False,161,scaffold_3
2,130001,170000,39999,False,161,scaffold_3
3,575001,592000,16999,False,161,scaffold_3
4,618001,647000,28999,False,161,scaffold_3
5,648001,738000,89999,False,161,scaffold_3
6,795001,934000,138999,False,161,scaffold_3
7,971001,996000,24999,False,161,scaffold_3
8,1086001,1097000,10999,False,161,scaffold_3
9,1148001,1162000,13999,False,161,scaffold_3
10,1163001,1192000,28999,False,161,scaffold_3
11,1212001,1238000,25999,False,161,scaffold_3
12,1936001,1980000,43999,False,161,scaffold_3
13,1995001,2108000,112999,False,161,scaffold_3
14,2110001,2143000,32999,False,161,scaffold_3
15,2151001,2201000,49999,False,161,scaffold_3
16,2228001,2338000,109999,False,161,scaffold_3
17,2432001,2444000,11999,False,161,scaffold_3
18,2445001,2533000,87999,False,161,scaffold_3
19,2591001,2676000,84999,False,161,scaffold_3
20,2718001,2735000,16999,False,161,scaffold_3
21,3072001,3082000,9999,False,161,scaffold_3
22,3261001,3351000,89999,False,161,scaffold_3
23,3605001,3638000,32999,False,161,scaffold_3
24,3666001,3821000,154999,False,161,scaffold_3
25,3822001,3894000,71999,False,161,scaffold_3
26,3910001,3939000,28999,False,161,scaffold_3
27,3968001,4037000,68999,False,161,scaffold_3
28,4072001,4404000,331999,False,161,scaffold_3
29,4406001,4556000,149999,False,161,scaffold_3
30,4568001,4630000,61999,False,161,scaffold_3
31,4636001,4917000,280999,False,161,scaffold_3
32,4956001,5086000,129999,False,161,scaffold_3
33,5145001,5226000,80999,False,161,scaffold_3
34,5236001,5279000,42999,False,161,scaffold_3
35,5396001,5449000,52999,False,161,scaffold_3
36,5494001,5506000,11999,False,161,scaffold_3
37,5803001,5947000,143999,False,161,scaffold_3
38,5974001,6094000,119999,False,161,scaffold_3
39,6276001,6305000,28999,False,161,scaffold_3
40,6429001,6703000,273999,False,161,scaffold_3
41,6731001,7157000,425999,False,161,scaffold_3
42,7231001,7416000,184999,False,161,scaffold_3
43,7431001,7440000,8999,False,161,scaffold_3
44,7449001,7458000,8999,False,161,scaffold_3
45,7483001,7565000,81999,False,161,scaffold_3
46,7597001,7909000,311999,False,161,scaffold_3
47,7910001,7944000,33999,False,161,scaffold_3
48,8028001,8152000,123999,False,161,scaffold_3
49,8183001,8253000,69999,False,161,scaffold_3
50,8315001,8361000,45999,False,161,scaffold_3
51,8380001,8532000,151999,False,161,scaffold_3
52,8565001,8626000,60999,False,161,scaffold_3
53,8657001,8683000,25999,False,161,scaffold_3
54,8816001,8837000,20999,False,161,scaffold_3
55,8838001,8890000,51999,False,161,scaffold_3
56,8905001,8951000,45999,False,161,scaffold_3
57,8994001,9075000,80999,False,161,scaffold_3
58,9301001,9313000,11999,False,161,scaffold_3
59,9499001,9536000,36999,False,161,scaffold_3
60,9968001,10087000,118999,False,161,scaffold_3
61,10107001,10148000,40999,False,161,scaffold_3
62,10204001,10458000,253999,False,161,scaffold_3
63,10461001,10510000,48999,False,161,scaffold_3
64,10552001,11182071,630070,True,161,scaffold_3
0,17001,33000,15999,False,161,scaffold_4
1,48001,86000,37999,False,161,scaffold_4
2,120001,151000,30999,False,161,scaffold_4
3,155001,215000,59999,False,161,scaffold_4
4,217001,226000,8999,False,161,scaffold_4
5,227001,280000,52999,False,161,scaffold_4
6,283001,353000,69999,False,161,scaffold_4
7,355001,374000,18999,False,161,scaffold_4
8,375001,380000,4999,False,161,scaffold_4
9,393001,410000,16999,False,161,scaffold_4
10,412001,428000,15999,False,161,scaffold_4
11,429001,505000,75999,False,161,scaffold_4
12,507001,592000,84999,False,161,scaffold_4
13,593001,606000,12999,False,161,scaffold_4
14,608001,691000,82999,False,161,scaffold_4
15,694001,727000,32999,False,161,scaffold_4
16,1030001,1042000,11999,False,161,scaffold_4
17,1050001,1081000,30999,False,161,scaffold_4
18,1087001,1226000,138999,False,161,scaffold_4
19,1235001,1279000,43999,False,161,scaffold_4
20,1283001,1606000,322999,False,161,scaffold_4
21,1613001,1898000,284999,False,161,scaffold_4
22,1900001,2206000,305999,False,161,scaffold_4
23,2210001,2218000,7999,False,161,scaffold_4
24,2219001,2246000,26999,False,161,scaffold_4
25,2247001,2340000,92999,False,161,scaffold_4
26,2343001,2635000,291999,False,161,scaffold_4
27,2661001,2675000,13999,False,161,scaffold_4
28,2676001,2767000,90999,False,161,scaffold_4
29,2923001,3129000,205999,False,161,scaffold_4
30,3201001,3331000,129999,False,161,scaffold_4
31,3334001,4046000,711999,False,161,scaffold_4
32,4049001,4106000,56999,False,161,scaffold_4
33,4113001,4145000,31999,False,161,scaffold_4
34,4225001,4381000,155999,False,161,scaffold_4
35,4399001,4473000,73999,False,161,scaffold_4
36,4648001,4757000,108999,False,161,scaffold_4
37,4795001,5094000,298999,False,161,scaffold_4
38,5146001,5246000,99999,False,161,scaffold_4
39,5290001,5438000,147999,False,161,scaffold_4
40,5452001,5506000,53999,False,161,scaffold_4
41,5514001,5784000,269999,False,161,scaffold_4
42,5786001,5917000,130999,False,161,scaffold_4
43,5918001,6371000,452999,False,161,scaffold_4
44,6405001,6419000,13999,False,161,scaffold_4
45,6468001,6612000,143999,False,161,scaffold_4
46,6615001,6617000,1999,False,161,scaffold_4
47,6624001,6636000,11999,False,161,scaffold_4
48,6666001,6683000,16999,False,161,scaffold_4
49,6705001,6827000,121999,False,161,scaffold_4
50,6828001,6924000,95999,False,161,scaffold_4
51,6926001,7124000,197999,False,161,scaffold_4
52,7146001,7452000,305999,False,161,scaffold_4
53,7461001,7489000,27999,False,161,scaffold_4
54,7511001,7571000,59999,False,161,scaffold_4
55,7628001,7663000,34999,False,161,scaffold_4
56,7855001,7935000,79999,False,161,scaffold_4
57,7985001,8019000,33999,False,161,scaffold_4
58,8049001,8079000,29999,False,161,scaffold_4
59,8264001,8327000,62999,False,161,scaffold_4
60,8349001,8415000,65999,False,161,scaffold_4
61,8520001,8591000,70999,False,161,scaffold_4
62,8703001,8827000,123999,False,161,scaffold_4
63,8841001,9699000,857999,False,161,scaffold_4
64,9700001,9845951,145950,True,161,scaffold_4
0,1,11000,10999,True,161,scaffold_5
1,48001,87000,38999,False,161,scaffold_5
2,140001,174000,33999,False,161,scaffold_5
3,185001,204000,18999,False,161,scaffold_5
4,319001,421000,101999,False,161,scaffold_5
5,451001,523000,71999,False,161,scaffold_5
6,668001,699000,30999,False,161,scaffold_5
7,836001,866000,29999,False,161,scaffold_5
8,933001,947000,13999,False,161,scaffold_5
9,948001,969000,20999,False,161,scaffold_5
10,1255001,1284000,28999,False,161,scaffold_5
11,1543001,1557000,13999,False,161,scaffold_5
12,1912001,1954000,41999,False,161,scaffold_5
13,2106001,2126000,19999,False,161,scaffold_5
14,2260001,2400000,139999,False,161,scaffold_5
15,2476001,2501000,24999,False,161,scaffold_5
16,2516001,3007000,490999,False,161,scaffold_5
17,3050001,3684000,633999,False,161,scaffold_5
18,3719001,3822000,102999,False,161,scaffold_5
19,3824001,4376000,551999,False,161,scaffold_5
20,4415001,5115000,699999,False,161,scaffold_5
21,5134001,5389000,254999,False,161,scaffold_5
22,5414001,5540000,125999,False,161,scaffold_5
23,5689001,5739000,49999,False,161,scaffold_5
24,6190001,6262000,71999,False,161,scaffold_5
25,6324001,6968000,643999,False,161,scaffold_5
26,7054001,7086000,31999,False,161,scaffold_5
27,7118001,7146000,27999,False,161,scaffold_5
28,7168001,7249000,80999,False,161,scaffold_5
29,7253001,7322000,68999,False,161,scaffold_5
30,7406001,7447000,40999,False,161,scaffold_5
31,7454001,7512000,57999,False,161,scaffold_5
32,7523001,7910000,386999,False,161,scaffold_5
33,8258001,8473000,214999,False,161,scaffold_5
34,8505001,8527000,21999,False,161,scaffold_5
35,8551001,8686000,134999,False,161,scaffold_5
36,8704001,9364176,660175,True,161,scaffold_5
0,1,39000,38999,True,161,scaffold_6
1,42001,75000,32999,False,161,scaffold_6
2,77001,84000,6999,False,161,scaffold_6
3,86001,121000,34999,False,161,scaffold_6
4,122001,156000,33999,False,161,scaffold_6
5,162001,376000,213999,False,161,scaffold_6
6,378001,419000,40999,False,161,scaffold_6
7,428001,450000,21999,False,161,scaffold_6
8,466001,497000,30999,False,161,scaffold_6
9,625001,674000,48999,False,161,scaffold_6
10,783001,809000,25999,False,161,scaffold_6
11,948001,1086000,137999,False,161,scaffold_6
12,1145001,1193000,47999,False,161,scaffold_6
13,1206001,1374000,167999,False,161,scaffold_6
14,1420001,1583000,162999,False,161,scaffold_6
15,1656001,1717000,60999,False,161,scaffold_6
16,1764001,1813000,48999,False,161,scaffold_6
17,1837001,1902000,64999,False,161,scaffold_6
18,1909001,1935000,25999,False,161,scaffold_6
19,1997001,2108000,110999,False,161,scaffold_6
20,2129001,2212000,82999,False,161,scaffold_6
21,2236001,2282000,45999,False,161,scaffold_6
22,2315001,2373000,57999,False,161,scaffold_6
23,2374001,3050000,675999,False,161,scaffold_6
24,3065001,3608000,542999,False,161,scaffold_6
25,3609001,3806000,196999,False,161,scaffold_6
26,3807001,3847000,39999,False,161,scaffold_6
27,3879001,4206000,326999,False,161,scaffold_6
28,4287001,4363000,75999,False,161,scaffold_6
29,4414001,4485000,70999,False,161,scaffold_6
30,4597001,4621000,23999,False,161,scaffold_6
31,4747001,4754000,6999,False,161,scaffold_6
32,4759001,4826000,66999,False,161,scaffold_6
33,4847001,4875000,27999,False,161,scaffold_6
34,4954001,4992000,37999,False,161,scaffold_6
35,5276001,5342000,65999,False,161,scaffold_6
36,5356001,5410000,53999,False,161,scaffold_6
37,5453001,5492000,38999,False,161,scaffold_6
38,5551001,6096000,544999,False,161,scaffold_6
39,6123001,6186000,62999,False,161,scaffold_6
40,6248001,6278000,29999,False,161,scaffold_6
41,6448001,6512000,63999,False,161,scaffold_6
42,6596001,6645000,48999,False,161,scaffold_6
43,6673001,6728000,54999,False,161,scaffold_6
44,6765001,6947000,181999,False,161,scaffold_6
45,6948001,7031000,82999,False,161,scaffold_6
46,7159001,7349000,189999,False,161,scaffold_6
47,7367001,7520000,152999,False,161,scaffold_6
48,7549001,8268281,719280,True,161,scaffold_6
0,1,31000,30999,True,161,scaffold_7
1,35001,47000,11999,False,161,scaffold_7
2,295001,340000,44999,False,161,scaffold_7
3,342001,505000,162999,False,161,scaffold_7
4,580001,612000,31999,False,161,scaffold_7
5,614001,645000,30999,False,161,scaffold_7
6,646001,753000,106999,False,161,scaffold_7
7,760001,829000,68999,False,161,scaffold_7
8,830001,842000,11999,False,161,scaffold_7
9,868001,872000,3999,False,161,scaffold_7
10,875001,908000,32999,False,161,scaffold_7
11,909001,963000,53999,False,161,scaffold_7
12,964001,981000,16999,False,161,scaffold_7
13,982001,1044000,61999,False,161,scaffold_7
14,1047001,1149000,101999,False,161,scaffold_7
15,1168001,1692000,523999,False,161,scaffold_7
16,1737001,1774000,36999,False,161,scaffold_7
17,1792001,1885000,92999,False,161,scaffold_7
18,1986001,2029000,42999,False,161,scaffold_7
19,2047001,2064000,16999,False,161,scaffold_7
20,2128001,2158000,29999,False,161,scaffold_7
21,2187001,2221000,33999,False,161,scaffold_7
22,2728001,2759000,30999,False,161,scaffold_7
23,2851001,2986000,134999,False,161,scaffold_7
24,3012001,3072000,59999,False,161,scaffold_7
25,3292001,3614000,321999,False,161,scaffold_7
26,3615001,3976000,360999,False,161,scaffold_7
27,4025001,4102000,76999,False,161,scaffold_7
28,4324001,4514000,189999,False,161,scaffold_7
29,4550001,4768000,217999,False,161,scaffold_7
30,4770001,5250000,479999,False,161,scaffold_7
31,5278001,5467000,188999,False,161,scaffold_7
32,5473001,5566000,92999,False,161,scaffold_7
33,6069001,6094000,24999,False,161,scaffold_7
34,6096001,6435000,338999,False,161,scaffold_7
35,6466001,6492000,25999,False,161,scaffold_7
36,6559001,6592000,32999,False,161,scaffold_7
37,6602001,6663000,60999,False,161,scaffold_7
38,6751001,6866000,114999,False,161,scaffold_7
39,6901001,6925000,23999,False,161,scaffold_7
40,6945001,7154000,208999,False,161,scaffold_7
41,7155001,7270000,114999,False,161,scaffold_7
42,7271001,7347000,75999,False,161,scaffold_7
43,7348001,7502216,154215,True,161,scaffold_7
0,1,7000,6999,True,161,scaffold_8
1,32001,85000,52999,False,161,scaffold_8
2,93001,101000,7999,False,161,scaffold_8
3,335001,355000,19999,False,161,scaffold_8
4,922001,928000,5999,False,161,scaffold_8
5,1003001,1133000,129999,False,161,scaffold_8
6,1258001,1268000,9999,False,161,scaffold_8
7,1320001,1422000,101999,False,161,scaffold_8
8,1500001,1536000,35999,False,161,scaffold_8
9,1598001,1647000,48999,False,161,scaffold_8
10,1669001,1761000,91999,False,161,scaffold_8
11,1818001,2144000,325999,False,161,scaffold_8
12,2158001,2603000,444999,False,161,scaffold_8
13,2647001,2683000,35999,False,161,scaffold_8
14,2685001,2844000,158999,False,161,scaffold_8
15,2845001,2908000,62999,False,161,scaffold_8
16,2929001,2942000,12999,False,161,scaffold_8
17,2950001,2970000,19999,False,161,scaffold_8
18,2999001,3125000,125999,False,161,scaffold_8
19,3126001,3612000,485999,False,161,scaffold_8
20,3615001,4270000,654999,False,161,scaffold_8
21,4307001,4433000,125999,False,161,scaffold_8
22,4470001,4502000,31999,False,161,scaffold_8
23,4566001,4675000,108999,False,161,scaffold_8
24,4810001,4916000,105999,False,161,scaffold_8
25,5029001,5241000,211999,False,161,scaffold_8
26,5355001,5370000,14999,False,161,scaffold_8
27,5448001,5697000,248999,False,161,scaffold_8
28,5817001,5908000,90999,False,161,scaffold_8
29,5921001,5942000,20999,False,161,scaffold_8
30,6095001,6118000,22999,False,161,scaffold_8
31,6209001,6260000,50999,False,161,scaffold_8
32,6320001,6334544,14543,True,161,scaffold_8
0,1,22000,21999,True,161,scaffold_9
1,67001,106000,38999,False,161,scaffold_9
2,109001,119000,9999,False,161,scaffold_9
3,121001,135000,13999,False,161,scaffold_9
4,150001,158000,7999,False,161,scaffold_9
5,295001,411000,115999,False,161,scaffold_9
6,413001,434000,20999,False,161,scaffold_9
7,436001,439000,2999,False,161,scaffold_9
8,442001,531000,88999,False,161,scaffold_9
9,532001,545000,12999,False,161,scaffold_9
10,547001,565000,17999,False,161,scaffold_9
11,609001,659000,49999,False,161,scaffold_9
12,660001,665000,4999,False,161,scaffold_9
13,671001,708000,36999,False,161,scaffold_9
14,732001,741000,8999,False,161,scaffold_9
15,814001,842000,27999,False,161,scaffold_9
16,873001,986000,112999,False,161,scaffold_9
17,987001,995000,7999,False,161,scaffold_9
18,997001,1007000,9999,False,161,scaffold_9
19,1009001,1198000,188999,False,161,scaffold_9
20,1209001,1256000,46999,False,161,scaffold_9
21,1267001,1380000,112999,False,161,scaffold_9
22,1409001,1422000,12999,False,161,scaffold_9
23,1502001,1515000,12999,False,161,scaffold_9
24,1516001,1538000,21999,False,161,scaffold_9
25,1599001,1691000,91999,False,161,scaffold_9
26,1716001,1803000,86999,False,161,scaffold_9
27,1986001,2130000,143999,False,161,scaffold_9
28,2175001,2291000,115999,False,161,scaffold_9
29,2514001,2528000,13999,False,161,scaffold_9
30,2598001,2720000,121999,False,161,scaffold_9
31,2737001,3381000,643999,False,161,scaffold_9
32,3383001,5107000,1723999,False,161,scaffold_9
33,5112001,5238000,125999,False,161,scaffold_9
34,5239001,5298000,58999,False,161,scaffold_9
35,5300001,5490000,189999,False,161,scaffold_9
36,5493001,6331288,838287,True,161,scaffold_9
0,1,482000,481999,True,161,scaffold_10
1,483001,840000,356999,False,161,scaffold_10
2,841001,1069000,227999,False,161,scaffold_10
3,1073001,1209000,135999,False,161,scaffold_10
4,1314001,1724000,409999,False,161,scaffold_10
5,1772001,1817000,44999,False,161,scaffold_10
6,2063001,2169000,105999,False,161,scaffold_10
7,2234001,2327000,92999,False,161,scaffold_10
8,2346001,2471000,124999,False,161,scaffold_10
9,2521001,2533000,11999,False,161,scaffold_10
10,2560001,2654000,93999,False,161,scaffold_10
11,2787001,2897000,109999,False,161,scaffold_10
12,3064001,3217000,152999,False,161,scaffold_10
13,3481001,3528000,46999,False,161,scaffold_10
14,3633001,3675000,41999,False,161,scaffold_10
15,4000001,4029000,28999,False,161,scaffold_10
16,4046001,4137000,90999,False,161,scaffold_10
17,4155001,4211000,55999,False,161,scaffold_10
18,4214001,4255000,40999,False,161,scaffold_10
19,4305001,4313000,7999,False,161,scaffold_10
20,4334001,4368000,33999,False,161,scaffold_10
21,4389001,4502000,112999,False,161,scaffold_10
22,4503001,4514000,10999,False,161,scaffold_10
23,4515001,4549000,33999,False,161,scaffold_10
24,4554001,4562000,7999,False,161,scaffold_10
25,4565001,4596000,30999,False,161,scaffold_10
26,4700001,4767000,66999,False,161,scaffold_10
27,4798001,4826000,27999,False,161,scaffold_10
28,4828001,4847000,18999,False,161,scaffold_10
29,4848001,4861000,12999,False,161,scaffold_10
30,4862001,4866973,4972,True,161,scaffold_10
0,9001,106000,96999,False,161,scaffold_11
1,131001,167000,35999,False,161,scaffold_11
2,169001,236000,66999,False,161,scaffold_11
3,289001,320000,30999,False,161,scaffold_11
4,419001,431000,11999,False,161,scaffold_11
5,433001,452000,18999,False,161,scaffold_11
6,648001,657000,8999,False,161,scaffold_11
7,708001,710000,1999,False,161,scaffold_11
8,1090001,1110000,19999,False,161,scaffold_11
9,1519001,1537000,17999,False,161,scaffold_11
10,1704001,1737000,32999,False,161,scaffold_11
11,1784001,1802000,17999,False,161,scaffold_11
12,1943001,1981000,37999,False,161,scaffold_11
13,2009001,2038000,28999,False,161,scaffold_11
14,2267001,2296000,28999,False,161,scaffold_11
15,2348001,2578000,229999,False,161,scaffold_11
16,2604001,3005000,400999,False,161,scaffold_11
17,3082001,3177000,94999,False,161,scaffold_11
18,3188001,3972000,783999,False,161,scaffold_11
19,3985001,4710000,724999,False,161,scaffold_11
20,4713001,4766820,53819,True,161,scaffold_11
0,1,1591000,1590999,True,161,scaffold_12
1,1715001,1749000,33999,False,161,scaffold_12
2,1919001,1952000,32999,False,161,scaffold_12
3,2049001,2101000,51999,False,161,scaffold_12
4,2571001,2618000,46999,False,161,scaffold_12
5,2661001,2708000,46999,False,161,scaffold_12
6,2710001,2731000,20999,False,161,scaffold_12
0,1,397000,396999,True,162,scaffold_1
1,398001,442000,43999,False,162,scaffold_1
2,482001,499000,16999,False,162,scaffold_1
3,568001,640000,71999,False,162,scaffold_1
4,686001,753000,66999,False,162,scaffold_1
5,1268001,1292000,23999,False,162,scaffold_1
6,1617001,1660000,42999,False,162,scaffold_1
7,1811001,1900000,88999,False,162,scaffold_1
8,1923001,1984000,60999,False,162,scaffold_1
9,2353001,2626000,272999,False,162,scaffold_1
10,2663001,2697000,33999,False,162,scaffold_1
11,2724001,2746000,21999,False,162,scaffold_1
12,2881001,2920000,38999,False,162,scaffold_1
13,2950001,3000000,49999,False,162,scaffold_1
14,3002001,3031000,28999,False,162,scaffold_1
15,3048001,3071000,22999,False,162,scaffold_1
16,3102001,3151000,48999,False,162,scaffold_1
17,3185001,3241000,55999,False,162,scaffold_1
18,3244001,3258000,13999,False,162,scaffold_1
19,3419001,3425000,5999,False,162,scaffold_1
20,3441001,3567000,125999,False,162,scaffold_1
21,3582001,3622000,39999,False,162,scaffold_1
22,3687001,3878000,190999,False,162,scaffold_1
23,3901001,3941000,39999,False,162,scaffold_1
24,3959001,4157000,197999,False,162,scaffold_1
25,4270001,4356000,85999,False,162,scaffold_1
26,4641001,4673000,31999,False,162,scaffold_1
27,4709001,4814000,104999,False,162,scaffold_1
28,4920001,5027000,106999,False,162,scaffold_1
29,5087001,5196000,108999,False,162,scaffold_1
30,5482001,5521000,38999,False,162,scaffold_1
31,5535001,5577000,41999,False,162,scaffold_1
32,5852001,5915000,62999,False,162,scaffold_1
33,6108001,6153000,44999,False,162,scaffold_1
34,6154001,6185000,30999,False,162,scaffold_1
35,6201001,6379000,177999,False,162,scaffold_1
36,6383001,6509000,125999,False,162,scaffold_1
37,6543001,6578000,34999,False,162,scaffold_1
38,6633001,6660000,26999,False,162,scaffold_1
39,6831001,6851000,19999,False,162,scaffold_1
40,7015001,7029000,13999,False,162,scaffold_1
41,7036001,7247000,210999,False,162,scaffold_1
42,7248001,7584000,335999,False,162,scaffold_1
43,7590001,7923000,332999,False,162,scaffold_1
44,7924001,8656000,731999,False,162,scaffold_1
45,8658001,9564000,905999,False,162,scaffold_1
46,9565001,10363000,797999,False,162,scaffold_1
47,10450001,10643000,192999,False,162,scaffold_1
48,10664001,10766000,101999,False,162,scaffold_1
49,10835001,10857000,21999,False,162,scaffold_1
50,10918001,10990000,71999,False,162,scaffold_1
51,11015001,11030000,14999,False,162,scaffold_1
52,11283001,11402000,118999,False,162,scaffold_1
53,11403001,11538000,134999,False,162,scaffold_1
54,11565001,11951000,385999,False,162,scaffold_1
55,12174001,12243000,68999,False,162,scaffold_1
56,12624001,12722000,97999,False,162,scaffold_1
57,12735001,12754000,18999,False,162,scaffold_1
58,12775001,12890000,114999,False,162,scaffold_1
59,12906001,12944000,37999,False,162,scaffold_1
60,12961001,13211000,249999,False,162,scaffold_1
61,13343001,13428000,84999,False,162,scaffold_1
62,13554001,13581000,26999,False,162,scaffold_1
63,14287001,14309000,21999,False,162,scaffold_1
0,1,48000,47999,True,162,scaffold_2
1,95001,159000,63999,False,162,scaffold_2
2,178001,288000,109999,False,162,scaffold_2
3,296001,318000,21999,False,162,scaffold_2
4,332001,374000,41999,False,162,scaffold_2
5,387001,399000,11999,False,162,scaffold_2
6,716001,739000,22999,False,162,scaffold_2
7,1666001,1721000,54999,False,162,scaffold_2
8,2080001,2112000,31999,False,162,scaffold_2
9,2314001,2636000,321999,False,162,scaffold_2
10,2653001,2689000,35999,False,162,scaffold_2
11,2693001,2746000,52999,False,162,scaffold_2
12,2766001,2866000,99999,False,162,scaffold_2
13,2868001,3021000,152999,False,162,scaffold_2
14,3334001,3344000,9999,False,162,scaffold_2
15,3360001,3414000,53999,False,162,scaffold_2
16,3450001,3487000,36999,False,162,scaffold_2
17,3680001,3708000,27999,False,162,scaffold_2
18,3743001,3790000,46999,False,162,scaffold_2
19,4243001,4320000,76999,False,162,scaffold_2
20,4335001,4409000,73999,False,162,scaffold_2
21,4422001,4660000,237999,False,162,scaffold_2
22,4710001,4790000,79999,False,162,scaffold_2
23,4793001,4809000,15999,False,162,scaffold_2
24,4878001,4985000,106999,False,162,scaffold_2
25,5021001,5104000,82999,False,162,scaffold_2
26,5139001,5162000,22999,False,162,scaffold_2
27,5179001,5224000,44999,False,162,scaffold_2
28,5286001,5496000,209999,False,162,scaffold_2
29,5497001,5563000,65999,False,162,scaffold_2
30,5616001,5759000,142999,False,162,scaffold_2
31,5839001,5889000,49999,False,162,scaffold_2
32,5914001,6074000,159999,False,162,scaffold_2
33,6232001,6302000,69999,False,162,scaffold_2
34,6303001,6351000,47999,False,162,scaffold_2
35,6384001,6419000,34999,False,162,scaffold_2
36,6422001,6449000,26999,False,162,scaffold_2
37,6506001,6632000,125999,False,162,scaffold_2
38,6810001,6972000,161999,False,162,scaffold_2
39,7004001,7094000,89999,False,162,scaffold_2
40,7106001,7244000,137999,False,162,scaffold_2
41,7340001,7478000,137999,False,162,scaffold_2
42,7488001,7524000,35999,False,162,scaffold_2
43,7550001,7562000,11999,False,162,scaffold_2
44,7563001,7593000,29999,False,162,scaffold_2
45,7594001,7707000,112999,False,162,scaffold_2
46,7750001,7890000,139999,False,162,scaffold_2
47,7906001,8314000,407999,False,162,scaffold_2
48,8346001,8456000,109999,False,162,scaffold_2
49,8495001,8566000,70999,False,162,scaffold_2
50,8801001,8817000,15999,False,162,scaffold_2
51,8935001,8941000,5999,False,162,scaffold_2
52,9033001,9060000,26999,False,162,scaffold_2
53,9116001,9175000,58999,False,162,scaffold_2
54,9242001,9278000,35999,False,162,scaffold_2
55,9321001,9508000,186999,False,162,scaffold_2
56,9572001,9636000,63999,False,162,scaffold_2
57,9674001,9696000,21999,False,162,scaffold_2
58,10168001,10185000,16999,False,162,scaffold_2
59,10187001,10205000,17999,False,162,scaffold_2
60,10215001,10220000,4999,False,162,scaffold_2
61,10438001,10467000,28999,False,162,scaffold_2
62,10474001,10565000,90999,False,162,scaffold_2
63,10757001,10766000,8999,False,162,scaffold_2
64,10774001,10814000,39999,False,162,scaffold_2
65,10995001,10998000,2999,False,162,scaffold_2
66,11023001,11097000,73999,False,162,scaffold_2
67,11098001,11123000,24999,False,162,scaffold_2
68,11367001,11384000,16999,False,162,scaffold_2
69,11394001,11503000,108999,False,162,scaffold_2
70,11519001,11802476,283475,True,162,scaffold_2
0,43001,55000,11999,False,162,scaffold_3
1,618001,646000,27999,False,162,scaffold_3
2,692001,737000,44999,False,162,scaffold_3
3,791001,855000,63999,False,162,scaffold_3
4,856001,901000,44999,False,162,scaffold_3
5,1163001,1190000,26999,False,162,scaffold_3
6,1936001,1980000,43999,False,162,scaffold_3
7,2014001,2108000,93999,False,162,scaffold_3
8,2289001,2323000,33999,False,162,scaffold_3
9,2434001,2533000,98999,False,162,scaffold_3
10,2534001,2545000,10999,False,162,scaffold_3
11,2637001,2666000,28999,False,162,scaffold_3
12,3605001,3643000,37999,False,162,scaffold_3
13,3713001,3891000,177999,False,162,scaffold_3
14,3909001,3921000,11999,False,162,scaffold_3
15,3922001,3946000,23999,False,162,scaffold_3
16,4069001,4402000,332999,False,162,scaffold_3
17,4420001,4519000,98999,False,162,scaffold_3
18,4546001,4558000,11999,False,162,scaffold_3
19,4583001,4686000,102999,False,162,scaffold_3
20,4739001,4822000,82999,False,162,scaffold_3
21,4847001,4906000,58999,False,162,scaffold_3
22,5000001,5034000,33999,False,162,scaffold_3
23,5065001,5124000,58999,False,162,scaffold_3
24,5157001,5196000,38999,False,162,scaffold_3
25,5402001,5443000,40999,False,162,scaffold_3
26,5494001,5506000,11999,False,162,scaffold_3
27,5804001,6080000,275999,False,162,scaffold_3
28,6289001,6303000,13999,False,162,scaffold_3
29,6510001,6581000,70999,False,162,scaffold_3
30,6635001,6812000,176999,False,162,scaffold_3
31,6859001,6962000,102999,False,162,scaffold_3
32,6963001,7098000,134999,False,162,scaffold_3
33,7253001,7301000,47999,False,162,scaffold_3
34,7333001,7397000,63999,False,162,scaffold_3
35,7518001,7563000,44999,False,162,scaffold_3
36,7680001,7909000,228999,False,162,scaffold_3
37,7910001,7979000,68999,False,162,scaffold_3
38,8045001,8072000,26999,False,162,scaffold_3
39,8078001,8114000,35999,False,162,scaffold_3
40,8121001,8156000,34999,False,162,scaffold_3
41,8184001,8253000,68999,False,162,scaffold_3
42,8335001,8363000,27999,False,162,scaffold_3
43,8427001,8449000,21999,False,162,scaffold_3
44,8462001,8527000,64999,False,162,scaffold_3
45,8575001,8627000,51999,False,162,scaffold_3
46,8757001,8798000,40999,False,162,scaffold_3
47,8956001,8986000,29999,False,162,scaffold_3
48,9004001,9075000,70999,False,162,scaffold_3
49,9968001,9995000,26999,False,162,scaffold_3
50,10065001,10109000,43999,False,162,scaffold_3
51,10244001,10305000,60999,False,162,scaffold_3
52,10421001,10458000,36999,False,162,scaffold_3
53,10461001,10485000,23999,False,162,scaffold_3
54,10550001,11182071,632070,True,162,scaffold_3
0,11001,16000,4999,False,162,scaffold_4
1,48001,88000,39999,False,162,scaffold_4
2,120001,146000,25999,False,162,scaffold_4
3,147001,151000,3999,False,162,scaffold_4
4,155001,226000,70999,False,162,scaffold_4
5,227001,279000,51999,False,162,scaffold_4
6,291001,353000,61999,False,162,scaffold_4
7,355001,374000,18999,False,162,scaffold_4
8,375001,380000,4999,False,162,scaffold_4
9,389001,410000,20999,False,162,scaffold_4
10,412001,425000,12999,False,162,scaffold_4
11,429001,505000,75999,False,162,scaffold_4
12,510001,592000,81999,False,162,scaffold_4
13,593001,606000,12999,False,162,scaffold_4
14,608001,691000,82999,False,162,scaffold_4
15,695001,726000,30999,False,162,scaffold_4
16,1028001,1048000,19999,False,162,scaffold_4
17,1115001,1136000,20999,False,162,scaffold_4
18,1137001,1208000,70999,False,162,scaffold_4
19,1210001,1226000,15999,False,162,scaffold_4
20,1268001,1280000,11999,False,162,scaffold_4
21,1283001,1605000,321999,False,162,scaffold_4
22,1613001,2068000,454999,False,162,scaffold_4
23,2071001,2186000,114999,False,162,scaffold_4
24,2188001,2206000,17999,False,162,scaffold_4
25,2210001,2218000,7999,False,162,scaffold_4
26,2219001,2462000,242999,False,162,scaffold_4
27,2476001,2635000,158999,False,162,scaffold_4
28,2698001,2744000,45999,False,162,scaffold_4
29,2914001,2968000,53999,False,162,scaffold_4
30,3032001,3128000,95999,False,162,scaffold_4
31,3188001,3665000,476999,False,162,scaffold_4
32,3688001,3768000,79999,False,162,scaffold_4
33,4054001,4143000,88999,False,162,scaffold_4
34,4276001,4307000,30999,False,162,scaffold_4
35,4673001,4733000,59999,False,162,scaffold_4
36,4899001,5095000,195999,False,162,scaffold_4
37,5145001,5243000,97999,False,162,scaffold_4
38,5289001,5501000,211999,False,162,scaffold_4
39,5514001,5784000,269999,False,162,scaffold_4
40,5786001,5830000,43999,False,162,scaffold_4
41,5869001,5900000,30999,False,162,scaffold_4
42,5926001,5962000,35999,False,162,scaffold_4
43,6067001,6099000,31999,False,162,scaffold_4
44,6132001,6266000,133999,False,162,scaffold_4
45,6615001,6617000,1999,False,162,scaffold_4
46,6705001,6818000,112999,False,162,scaffold_4
47,6860001,6924000,63999,False,162,scaffold_4
48,6926001,7124000,197999,False,162,scaffold_4
49,7151001,7322000,170999,False,162,scaffold_4
50,7352001,7402000,49999,False,162,scaffold_4
51,7498001,7570000,71999,False,162,scaffold_4
52,7628001,7665000,36999,False,162,scaffold_4
53,8520001,8596000,75999,False,162,scaffold_4
54,8738001,8821000,82999,False,162,scaffold_4
55,8858001,9596000,737999,False,162,scaffold_4
56,9597001,9699000,101999,False,162,scaffold_4
57,9700001,9845951,145950,True,162,scaffold_4
0,1,6000,5999,True,162,scaffold_5
1,127001,173000,45999,False,162,scaffold_5
2,186001,204000,17999,False,162,scaffold_5
3,318001,390000,71999,False,162,scaffold_5
4,454001,523000,68999,False,162,scaffold_5
5,563001,566000,2999,False,162,scaffold_5
6,668001,699000,30999,False,162,scaffold_5
7,1878001,1896000,17999,False,162,scaffold_5
8,2264001,2314000,49999,False,162,scaffold_5
9,2382001,2391000,8999,False,162,scaffold_5
10,2479001,2493000,13999,False,162,scaffold_5
11,2506001,2515000,8999,False,162,scaffold_5
12,2552001,3025000,472999,False,162,scaffold_5
13,3091001,3438000,346999,False,162,scaffold_5
14,3449001,3564000,114999,False,162,scaffold_5
15,3606001,3663000,56999,False,162,scaffold_5
16,3719001,3751000,31999,False,162,scaffold_5
17,3768001,3806000,37999,False,162,scaffold_5
18,3956001,4433000,476999,False,162,scaffold_5
19,4446001,4926000,479999,False,162,scaffold_5
20,4968001,5121000,152999,False,162,scaffold_5
21,5133001,5309000,175999,False,162,scaffold_5
22,5318001,5345000,26999,False,162,scaffold_5
23,5719001,5739000,19999,False,162,scaffold_5
24,5862001,5889000,26999,False,162,scaffold_5
25,6408001,6856000,447999,False,162,scaffold_5
26,6876001,6941000,64999,False,162,scaffold_5
27,6950001,6969000,18999,False,162,scaffold_5
28,7166001,7243000,76999,False,162,scaffold_5
29,7292001,7332000,39999,False,162,scaffold_5
30,7334001,7363000,28999,False,162,scaffold_5
31,7406001,7512000,105999,False,162,scaffold_5
32,7523001,7619000,95999,False,162,scaffold_5
33,7620001,7664000,43999,False,162,scaffold_5
34,7709001,7750000,40999,False,162,scaffold_5
35,7760001,7805000,44999,False,162,scaffold_5
36,8258001,8309000,50999,False,162,scaffold_5
37,8412001,8470000,57999,False,162,scaffold_5
38,8544001,8617000,72999,False,162,scaffold_5
39,8659001,9364176,705175,True,162,scaffold_5
0,1,40000,39999,True,162,scaffold_6
1,41001,75000,33999,False,162,scaffold_6
2,76001,112000,35999,False,162,scaffold_6
3,147001,211000,63999,False,162,scaffold_6
4,238001,253000,14999,False,162,scaffold_6
5,267001,298000,30999,False,162,scaffold_6
6,299001,369000,69999,False,162,scaffold_6
7,378001,418000,39999,False,162,scaffold_6
8,1155001,1227000,71999,False,162,scaffold_6
9,1229001,1266000,36999,False,162,scaffold_6
10,1421001,1599000,177999,False,162,scaffold_6
11,1658001,1724000,65999,False,162,scaffold_6
12,1769001,1906000,136999,False,162,scaffold_6
13,2025001,2105000,79999,False,162,scaffold_6
14,2130001,2283000,152999,False,162,scaffold_6
15,2316001,2867000,550999,False,162,scaffold_6
16,2928001,3604000,675999,False,162,scaffold_6
17,3605001,3806000,200999,False,162,scaffold_6
18,3881001,3921000,39999,False,162,scaffold_6
19,3965001,4195000,229999,False,162,scaffold_6
20,4835001,4868000,32999,False,162,scaffold_6
21,4967001,5005000,37999,False,162,scaffold_6
22,5267001,5416000,148999,False,162,scaffold_6
23,5559001,5647000,87999,False,162,scaffold_6
24,5679001,5771000,91999,False,162,scaffold_6
25,5774001,5791000,16999,False,162,scaffold_6
26,5862001,5980000,117999,False,162,scaffold_6
27,6004001,6204000,199999,False,162,scaffold_6
28,6248001,6277000,28999,False,162,scaffold_6
29,6349001,6366000,16999,False,162,scaffold_6
30,6762001,6859000,96999,False,162,scaffold_6
31,6911001,7138000,226999,False,162,scaffold_6
32,7166001,7341000,174999,False,162,scaffold_6
33,7362001,7485000,122999,False,162,scaffold_6
34,7541001,7809000,267999,False,162,scaffold_6
35,7811001,7842000,30999,False,162,scaffold_6
36,7849001,8268281,419280,True,162,scaffold_6
0,1,9000,8999,True,162,scaffold_7
1,11001,31000,19999,False,162,scaffold_7
2,50001,70000,19999,False,162,scaffold_7
3,293001,340000,46999,False,162,scaffold_7
4,342001,504000,161999,False,162,scaffold_7
5,570001,577000,6999,False,162,scaffold_7
6,580001,591000,10999,False,162,scaffold_7
7,622001,753000,130999,False,162,scaffold_7
8,765001,842000,76999,False,162,scaffold_7
9,875001,963000,87999,False,162,scaffold_7
10,964001,980000,15999,False,162,scaffold_7
11,982001,1044000,61999,False,162,scaffold_7
12,1048001,1152000,103999,False,162,scaffold_7
13,1169001,1512000,342999,False,162,scaffold_7
14,1556001,1693000,136999,False,162,scaffold_7
15,1817001,1880000,62999,False,162,scaffold_7
16,2725001,2759000,33999,False,162,scaffold_7
17,2851001,2981000,129999,False,162,scaffold_7
18,3016001,3074000,57999,False,162,scaffold_7
19,3128001,3146000,17999,False,162,scaffold_7
20,3292001,3313000,20999,False,162,scaffold_7
21,3325001,3371000,45999,False,162,scaffold_7
22,3393001,3405000,11999,False,162,scaffold_7
23,3440001,3846000,405999,False,162,scaffold_7
24,3915001,3978000,62999,False,162,scaffold_7
25,4028001,4097000,68999,False,162,scaffold_7
26,4322001,4512000,189999,False,162,scaffold_7
27,4528001,4877000,348999,False,162,scaffold_7
28,4943001,5150000,206999,False,162,scaffold_7
29,5401001,5442000,40999,False,162,scaffold_7
30,5470001,5575000,104999,False,162,scaffold_7
31,5725001,5748000,22999,False,162,scaffold_7
32,6070001,6246000,175999,False,162,scaffold_7
33,6329001,6442000,112999,False,162,scaffold_7
34,6464001,6489000,24999,False,162,scaffold_7
35,6499001,6520000,20999,False,162,scaffold_7
36,6557001,6588000,30999,False,162,scaffold_7
37,6603001,6729000,125999,False,162,scaffold_7
38,6752001,6797000,44999,False,162,scaffold_7
39,6847001,6871000,23999,False,162,scaffold_7
40,6946001,6998000,51999,False,162,scaffold_7
41,6999001,7270000,270999,False,162,scaffold_7
42,7271001,7502216,231215,True,162,scaffold_7
0,2001,7000,4999,False,162,scaffold_8
1,30001,85000,54999,False,162,scaffold_8
2,472001,483000,10999,False,162,scaffold_8
3,1363001,1425000,61999,False,162,scaffold_8
4,1513001,1550000,36999,False,162,scaffold_8
5,1677001,1718000,40999,False,162,scaffold_8
6,1734001,1758000,23999,False,162,scaffold_8
7,1836001,2042000,205999,False,162,scaffold_8
8,2086001,2187000,100999,False,162,scaffold_8
9,2340001,2589000,248999,False,162,scaffold_8
10,2646001,2683000,36999,False,162,scaffold_8
11,2684001,2844000,159999,False,162,scaffold_8
12,2846001,2899000,52999,False,162,scaffold_8
13,3002001,3950000,947999,False,162,scaffold_8
14,3999001,4224000,224999,False,162,scaffold_8
15,4243001,4268000,24999,False,162,scaffold_8
16,4332001,4433000,100999,False,162,scaffold_8
17,4609001,4656000,46999,False,162,scaffold_8
18,4748001,4777000,28999,False,162,scaffold_8
19,4814001,4919000,104999,False,162,scaffold_8
20,5028001,5245000,216999,False,162,scaffold_8
21,5512001,5597000,84999,False,162,scaffold_8
22,5654001,5684000,29999,False,162,scaffold_8
23,5777001,5786000,8999,False,162,scaffold_8
24,6321001,6334544,13543,True,162,scaffold_8
0,1,22000,21999,True,162,scaffold_9
1,66001,106000,39999,False,162,scaffold_9
2,109001,118000,8999,False,162,scaffold_9
3,121001,135000,13999,False,162,scaffold_9
4,150001,166000,15999,False,162,scaffold_9
5,298001,411000,112999,False,162,scaffold_9
6,413001,434000,20999,False,162,scaffold_9
7,484001,531000,46999,False,162,scaffold_9
8,547001,563000,15999,False,162,scaffold_9
9,650001,659000,8999,False,162,scaffold_9
10,660001,665000,4999,False,162,scaffold_9
11,669001,711000,41999,False,162,scaffold_9
12,730001,741000,10999,False,162,scaffold_9
13,814001,843000,28999,False,162,scaffold_9
14,886001,986000,99999,False,162,scaffold_9
15,987001,995000,7999,False,162,scaffold_9
16,997001,1085000,87999,False,162,scaffold_9
17,1087001,1186000,98999,False,162,scaffold_9
18,1309001,1377000,67999,False,162,scaffold_9
19,1488001,1501000,12999,False,162,scaffold_9
20,1520001,1546000,25999,False,162,scaffold_9
21,1600001,1618000,17999,False,162,scaffold_9
22,1630001,1690000,59999,False,162,scaffold_9
23,1721001,1807000,85999,False,162,scaffold_9
24,2147001,2171000,23999,False,162,scaffold_9
25,2174001,2198000,23999,False,162,scaffold_9
26,2595001,2723000,127999,False,162,scaffold_9
27,2737001,3381000,643999,False,162,scaffold_9
28,3383001,5020000,1636999,False,162,scaffold_9
29,5021001,5111000,89999,False,162,scaffold_9
30,5112001,5298000,185999,False,162,scaffold_9
31,5299001,5490000,190999,False,162,scaffold_9
32,5493001,6331288,838287,True,162,scaffold_9
0,1,482000,481999,True,162,scaffold_10
1,483001,584000,100999,False,162,scaffold_10
2,602001,882000,279999,False,162,scaffold_10
3,887001,1068000,180999,False,162,scaffold_10
4,1073001,1103000,29999,False,162,scaffold_10
5,1104001,1148000,43999,False,162,scaffold_10
6,1371001,1466000,94999,False,162,scaffold_10
7,1500001,1711000,210999,False,162,scaffold_10
8,1859001,1894000,34999,False,162,scaffold_10
9,2058001,2180000,121999,False,162,scaffold_10
10,2266001,2325000,58999,False,162,scaffold_10
11,2431001,2451000,19999,False,162,scaffold_10
12,2453001,2471000,17999,False,162,scaffold_10
13,2600001,2637000,36999,False,162,scaffold_10
14,2789001,2835000,45999,False,162,scaffold_10
15,3148001,3203000,54999,False,162,scaffold_10
16,3481001,3494000,12999,False,162,scaffold_10
17,3771001,3795000,23999,False,162,scaffold_10
18,4000001,4027000,26999,False,162,scaffold_10
19,4062001,4135000,72999,False,162,scaffold_10
20,4154001,4174000,19999,False,162,scaffold_10
21,4233001,4256000,22999,False,162,scaffold_10
22,4316001,4322000,5999,False,162,scaffold_10
23,4333001,4359000,25999,False,162,scaffold_10
24,4441001,4462000,20999,False,162,scaffold_10
25,4467001,4502000,34999,False,162,scaffold_10
26,4503001,4514000,10999,False,162,scaffold_10
27,4515001,4548000,32999,False,162,scaffold_10
28,4573001,4631000,57999,False,162,scaffold_10
29,4649001,4678000,28999,False,162,scaffold_10
30,4681001,4688000,6999,False,162,scaffold_10
31,4701001,4715000,13999,False,162,scaffold_10
32,4716001,4723000,6999,False,162,scaffold_10
33,4725001,4766000,40999,False,162,scaffold_10
34,4791001,4797000,5999,False,162,scaffold_10
35,4798001,4826000,27999,False,162,scaffold_10
36,4828001,4847000,18999,False,162,scaffold_10
37,4848001,4861000,12999,False,162,scaffold_10
38,4865001,4866973,1972,True,162,scaffold_10
0,11001,93000,81999,False,162,scaffold_11
1,132001,167000,34999,False,162,scaffold_11
2,169001,212000,42999,False,162,scaffold_11
3,213001,236000,22999,False,162,scaffold_11
4,288001,317000,28999,False,162,scaffold_11
5,419001,431000,11999,False,162,scaffold_11
6,433001,447000,13999,False,162,scaffold_11
7,648001,657000,8999,False,162,scaffold_11
8,1403001,1409000,5999,False,162,scaffold_11
9,1423001,1426000,2999,False,162,scaffold_11
10,1474001,1477000,2999,False,162,scaffold_11
11,1773001,1796000,22999,False,162,scaffold_11
12,1971001,2034000,62999,False,162,scaffold_11
13,2338001,2472000,133999,False,162,scaffold_11
14,2598001,2620000,21999,False,162,scaffold_11
15,2685001,2875000,189999,False,162,scaffold_11
16,2946001,3006000,59999,False,162,scaffold_11
17,3007001,3025000,17999,False,162,scaffold_11
18,3059001,3073000,13999,False,162,scaffold_11
19,3086001,3383000,296999,False,162,scaffold_11
20,3408001,3479000,70999,False,162,scaffold_11
21,3492001,3722000,229999,False,162,scaffold_11
22,3744001,3972000,227999,False,162,scaffold_11
23,3984001,4161000,176999,False,162,scaffold_11
24,4186001,4710000,523999,False,162,scaffold_11
25,4713001,4766820,53819,True,162,scaffold_11
0,1,1515000,1514999,True,162,scaffold_12
1,1554001,1589000,34999,False,162,scaffold_12
2,1715001,1733000,17999,False,162,scaffold_12
3,1920001,1959000,38999,False,162,scaffold_12
4,2053001,2087000,33999,False,162,scaffold_12
5,2088001,2092000,3999,False,162,scaffold_12
6,2492001,2519000,26999,False,162,scaffold_12
7,2574001,2619000,44999,False,162,scaffold_12
8,2685001,2708000,22999,False,162,scaffold_12
0,1,761000,760999,True,163,scaffold_1
1,762001,926000,163999,False,163,scaffold_1
2,953001,1292000,338999,False,163,scaffold_1
3,1293001,1442000,148999,False,163,scaffold_1
4,1450001,1504000,53999,False,163,scaffold_1
5,1601001,2031000,429999,False,163,scaffold_1
6,2064001,3240000,1175999,False,163,scaffold_1
7,3243001,3381000,137999,False,163,scaffold_1
8,3397001,3406000,8999,False,163,scaffold_1
9,3407001,5335000,1927999,False,163,scaffold_1
10,5348001,5747000,398999,False,163,scaffold_1
11,5781001,8656000,2874999,False,163,scaffold_1
12,8658001,9584000,925999,False,163,scaffold_1
13,9585001,12559000,2973999,False,163,scaffold_1
14,12560001,13658000,1097999,False,163,scaffold_1
15,13721001,13763000,41999,False,163,scaffold_1
16,13910001,13960000,49999,False,163,scaffold_1
17,13979001,14015000,35999,False,163,scaffold_1
18,14286001,14344000,57999,False,163,scaffold_1
0,1,48000,47999,True,163,scaffold_2
1,50001,160000,109999,False,163,scaffold_2
2,164001,177000,12999,False,163,scaffold_2
3,178001,318000,139999,False,163,scaffold_2
4,319001,454000,134999,False,163,scaffold_2
5,456001,754000,297999,False,163,scaffold_2
6,765001,1307000,541999,False,163,scaffold_2
7,1451001,1571000,119999,False,163,scaffold_2
8,1617001,2113000,495999,False,163,scaffold_2
9,2204001,2245000,40999,False,163,scaffold_2
10,2277001,2691000,413999,False,163,scaffold_2
11,2693001,3160000,466999,False,163,scaffold_2
12,3161001,3695000,533999,False,163,scaffold_2
13,3736001,3877000,140999,False,163,scaffold_2
14,3884001,7562000,3677999,False,163,scaffold_2
15,7563001,9944000,2380999,False,163,scaffold_2
16,10058001,10988000,929999,False,163,scaffold_2
17,10991001,11802476,811475,True,163,scaffold_2
0,1,21000,20999,True,163,scaffold_3
1,130001,177000,46999,False,163,scaffold_3
2,226001,268000,41999,False,163,scaffold_3
3,344001,366000,21999,False,163,scaffold_3
4,496001,553000,56999,False,163,scaffold_3
5,575001,647000,71999,False,163,scaffold_3
6,649001,901000,251999,False,163,scaffold_3
7,902001,935000,32999,False,163,scaffold_3
8,936001,942000,5999,False,163,scaffold_3
9,943001,1362000,418999,False,163,scaffold_3
10,1370001,1399000,28999,False,163,scaffold_3
11,1400001,1508000,107999,False,163,scaffold_3
12,1523001,1862000,338999,False,163,scaffold_3
13,1888001,2431000,542999,False,163,scaffold_3
14,2432001,2755000,322999,False,163,scaffold_3
15,2783001,2826000,42999,False,163,scaffold_3
16,2891001,3018000,126999,False,163,scaffold_3
17,3052001,3095000,42999,False,163,scaffold_3
18,3118001,3189000,70999,False,163,scaffold_3
19,3228001,3443000,214999,False,163,scaffold_3
20,3445001,3485000,39999,False,163,scaffold_3
21,3525001,3544000,18999,False,163,scaffold_3
22,3577001,4523000,945999,False,163,scaffold_3
23,4524001,5227000,702999,False,163,scaffold_3
24,5231001,9634000,4402999,False,163,scaffold_3
25,9645001,9688000,42999,False,163,scaffold_3
26,9705001,10150000,444999,False,163,scaffold_3
27,10151001,11182071,1031070,True,163,scaffold_3
0,1,226000,225999,True,163,scaffold_4
1,227001,280000,52999,False,163,scaffold_4
2,283001,425000,141999,False,163,scaffold_4
3,426001,1209000,782999,False,163,scaffold_4
4,1210001,1597000,386999,False,163,scaffold_4
5,1612001,1849000,236999,False,163,scaffold_4
6,1850001,2117000,266999,False,163,scaffold_4
7,2119001,4201000,2081999,False,163,scaffold_4
8,4211001,6612000,2400999,False,163,scaffold_4
9,6613001,6617000,3999,False,163,scaffold_4
10,6619001,8139000,1519999,False,163,scaffold_4
11,8145001,9845951,1700950,True,163,scaffold_4
0,1,84000,83999,True,163,scaffold_5
1,104001,204000,99999,False,163,scaffold_5
2,265001,279000,13999,False,163,scaffold_5
3,317001,430000,112999,False,163,scaffold_5
4,434001,579000,144999,False,163,scaffold_5
5,591001,635000,43999,False,163,scaffold_5
6,663001,725000,61999,False,163,scaffold_5
7,796001,832000,35999,False,163,scaffold_5
8,833001,898000,64999,False,163,scaffold_5
9,924001,974000,49999,False,163,scaffold_5
10,1004001,1107000,102999,False,163,scaffold_5
11,1110001,1178000,67999,False,163,scaffold_5
12,1221001,1304000,82999,False,163,scaffold_5
13,1338001,1357000,18999,False,163,scaffold_5
14,1458001,1518000,59999,False,163,scaffold_5
15,1538001,1651000,112999,False,163,scaffold_5
16,1722001,1755000,32999,False,163,scaffold_5
17,1813001,2058000,244999,False,163,scaffold_5
18,2105001,2149000,43999,False,163,scaffold_5
19,2228001,2462000,233999,False,163,scaffold_5
20,2463001,6012000,3548999,False,163,scaffold_5
21,6019001,8537000,2517999,False,163,scaffold_5
22,8540001,9364176,824175,True,163,scaffold_5
0,2001,40000,37999,False,163,scaffold_6
1,41001,419000,377999,False,163,scaffold_6
2,429001,476000,46999,False,163,scaffold_6
3,505001,539000,33999,False,163,scaffold_6
4,555001,574000,18999,False,163,scaffold_6
5,602001,724000,121999,False,163,scaffold_6
6,770001,851000,80999,False,163,scaffold_6
7,925001,1035000,109999,False,163,scaffold_6
8,1040001,1116000,75999,False,163,scaffold_6
9,1140001,1315000,174999,False,163,scaffold_6
10,1328001,1935000,606999,False,163,scaffold_6
11,1937001,2924000,986999,False,163,scaffold_6
12,2927001,4207000,1279999,False,163,scaffold_6
13,4209001,4555000,345999,False,163,scaffold_6
14,4571001,4721000,149999,False,163,scaffold_6
15,4734001,4922000,187999,False,163,scaffold_6
16,4924001,4942000,17999,False,163,scaffold_6
17,4944001,5006000,61999,False,163,scaffold_6
18,5007001,7452000,2444999,False,163,scaffold_6
19,7453001,8268281,815280,True,163,scaffold_6
0,1,106000,105999,True,163,scaffold_7
1,282001,510000,227999,False,163,scaffold_7
2,532001,1693000,1160999,False,163,scaffold_7
3,1706001,1774000,67999,False,163,scaffold_7
4,1776001,1975000,198999,False,163,scaffold_7
5,1988001,3076000,1087999,False,163,scaffold_7
6,3097001,3198000,100999,False,163,scaffold_7
7,3280001,5797000,2516999,False,163,scaffold_7
8,5906001,5997000,90999,False,163,scaffold_7
9,6015001,7448000,1432999,False,163,scaffold_7
10,7449001,7502216,53215,True,163,scaffold_7
0,26001,90000,63999,False,163,scaffold_8
1,93001,101000,7999,False,163,scaffold_8
2,103001,314000,210999,False,163,scaffold_8
3,315001,363000,47999,False,163,scaffold_8
4,381001,482000,100999,False,163,scaffold_8
5,494001,584000,89999,False,163,scaffold_8
6,606001,632000,25999,False,163,scaffold_8
7,645001,697000,51999,False,163,scaffold_8
8,953001,994000,40999,False,163,scaffold_8
9,1009001,1268000,258999,False,163,scaffold_8
10,1270001,5719000,4448999,False,163,scaffold_8
11,5924001,5978000,53999,False,163,scaffold_8
12,6140001,6185000,44999,False,163,scaffold_8
13,6198001,6284000,85999,False,163,scaffold_8
14,6318001,6334544,16543,True,163,scaffold_8
0,1,107000,106999,True,163,scaffold_9
1,109001,149000,39999,False,163,scaffold_9
2,150001,263000,112999,False,163,scaffold_9
3,284001,531000,246999,False,163,scaffold_9
4,532001,666000,133999,False,163,scaffold_9
5,669001,739000,69999,False,163,scaffold_9
6,756001,1195000,438999,False,163,scaffold_9
7,1220001,1421000,200999,False,163,scaffold_9
8,1423001,1455000,31999,False,163,scaffold_9
9,1458001,1475000,16999,False,163,scaffold_9
10,1482001,1537000,54999,False,163,scaffold_9
11,1627001,1955000,327999,False,163,scaffold_9
12,1971001,2032000,60999,False,163,scaffold_9
13,2107001,2396000,288999,False,163,scaffold_9
14,2460001,3382000,921999,False,163,scaffold_9
15,3383001,6331288,2948287,True,163,scaffold_9
0,1,2476000,2475999,True,163,scaffold_10
1,2523001,2651000,127999,False,163,scaffold_10
2,2732001,3259000,526999,False,163,scaffold_10
3,3304001,3347000,42999,False,163,scaffold_10
4,3481001,3529000,47999,False,163,scaffold_10
5,3590001,3672000,81999,False,163,scaffold_10
6,3710001,3908000,197999,False,163,scaffold_10
7,3940001,4776000,835999,False,163,scaffold_10
8,4778001,4866973,88972,True,163,scaffold_10
0,9001,466000,456999,False,163,scaffold_11
1,468001,574000,105999,False,163,scaffold_11
2,576001,656000,79999,False,163,scaffold_11
3,661001,669000,7999,False,163,scaffold_11
4,719001,879000,159999,False,163,scaffold_11
5,1005001,1085000,79999,False,163,scaffold_11
6,1195001,1215000,19999,False,163,scaffold_11
7,1482001,1542000,59999,False,163,scaffold_11
8,1699001,1734000,34999,False,163,scaffold_11
9,1773001,1811000,37999,False,163,scaffold_11
10,2101001,2144000,42999,False,163,scaffold_11
11,2175001,2213000,37999,False,163,scaffold_11
12,2237001,4766820,2529819,True,163,scaffold_11
0,1,1620000,1619999,True,163,scaffold_12
1,1649001,1909000,259999,False,163,scaffold_12
2,1920001,1947000,26999,False,163,scaffold_12
3,2253001,2307000,53999,False,163,scaffold_12
4,2386001,2570000,183999,False,163,scaffold_12
5,2571001,2747968,176967,True,163,scaffold_12
0,1,440000,439999,True,164,scaffold_1
1,482001,498000,15999,False,164,scaffold_1
2,553001,643000,89999,False,164,scaffold_1
3,686001,759000,72999,False,164,scaffold_1
4,1059001,1088000,28999,False,164,scaffold_1
5,1279001,1294000,14999,False,164,scaffold_1
6,1604001,1700000,95999,False,164,scaffold_1
7,1809001,1899000,89999,False,164,scaffold_1
8,1915001,1964000,48999,False,164,scaffold_1
9,1965001,1984000,18999,False,164,scaffold_1
10,2353001,2413000,59999,False,164,scaffold_1
11,2449001,2531000,81999,False,164,scaffold_1
12,2550001,2583000,32999,False,164,scaffold_1
13,2721001,2746000,24999,False,164,scaffold_1
14,2902001,3032000,129999,False,164,scaffold_1
15,3048001,3129000,80999,False,164,scaffold_1
16,3156001,3209000,52999,False,164,scaffold_1
17,3446001,3625000,178999,False,164,scaffold_1
18,3703001,3876000,172999,False,164,scaffold_1
19,3901001,3941000,39999,False,164,scaffold_1
20,3985001,4033000,47999,False,164,scaffold_1
21,4062001,4112000,49999,False,164,scaffold_1
22,4307001,4355000,47999,False,164,scaffold_1
23,4927001,5057000,129999,False,164,scaffold_1
24,5086001,5110000,23999,False,164,scaffold_1
25,5437001,5447000,9999,False,164,scaffold_1
26,5481001,5511000,29999,False,164,scaffold_1
27,5532001,5579000,46999,False,164,scaffold_1
28,5849001,5877000,27999,False,164,scaffold_1
29,6108001,6381000,272999,False,164,scaffold_1
30,6384001,6576000,191999,False,164,scaffold_1
31,6790001,6800000,9999,False,164,scaffold_1
32,6835001,6853000,17999,False,164,scaffold_1
33,7037001,7247000,209999,False,164,scaffold_1
34,7248001,7589000,340999,False,164,scaffold_1
35,7590001,8656000,1065999,False,164,scaffold_1
36,8658001,9584000,925999,False,164,scaffold_1
37,9586001,10363000,776999,False,164,scaffold_1
38,10452001,10763000,310999,False,164,scaffold_1
39,10835001,10857000,21999,False,164,scaffold_1
40,11313001,11536000,222999,False,164,scaffold_1
41,11551001,12020000,468999,False,164,scaffold_1
42,12181001,12243000,61999,False,164,scaffold_1
43,12652001,12722000,69999,False,164,scaffold_1
44,12775001,12950000,174999,False,164,scaffold_1
45,12965001,13003000,37999,False,164,scaffold_1
46,13023001,13210000,186999,False,164,scaffold_1
47,13347001,13418000,70999,False,164,scaffold_1
48,14285001,14313000,27999,False,164,scaffold_1
0,1,48000,47999,True,164,scaffold_2
1,95001,159000,63999,False,164,scaffold_2
2,168001,177000,8999,False,164,scaffold_2
3,178001,185000,6999,False,164,scaffold_2
4,296001,318000,21999,False,164,scaffold_2
5,332001,374000,41999,False,164,scaffold_2
6,2086001,2100000,13999,False,164,scaffold_2
7,2326001,2335000,8999,False,164,scaffold_2
8,2336001,2391000,54999,False,164,scaffold_2
9,2397001,2609000,211999,False,164,scaffold_2
10,2646001,2689000,42999,False,164,scaffold_2
11,2694001,2746000,51999,False,164,scaffold_2
12,2766001,2776000,9999,False,164,scaffold_2
13,2777001,2784000,6999,False,164,scaffold_2
14,2818001,2860000,41999,False,164,scaffold_2
15,2868001,3057000,188999,False,164,scaffold_2
16,3271001,3284000,12999,False,164,scaffold_2
17,3335001,3342000,6999,False,164,scaffold_2
18,3362001,3390000,27999,False,164,scaffold_2
19,3450001,3467000,16999,False,164,scaffold_2
20,3756001,3787000,30999,False,164,scaffold_2
21,4238001,4252000,13999,False,164,scaffold_2
22,4335001,4409000,73999,False,164,scaffold_2
23,4426001,4671000,244999,False,164,scaffold_2
24,4694001,4765000,70999,False,164,scaffold_2
25,4780001,4790000,9999,False,164,scaffold_2
26,4793001,4810000,16999,False,164,scaffold_2
27,4905001,4962000,56999,False,164,scaffold_2
28,5020001,5105000,84999,False,164,scaffold_2
29,5140001,5221000,80999,False,164,scaffold_2
30,5286001,5304000,17999,False,164,scaffold_2
31,5409001,5517000,107999,False,164,scaffold_2
32,5627001,5759000,131999,False,164,scaffold_2
33,5840001,5887000,46999,False,164,scaffold_2
34,5910001,6053000,142999,False,164,scaffold_2
35,6232001,6330000,97999,False,164,scaffold_2
36,6331001,6351000,19999,False,164,scaffold_2
37,6390001,6450000,59999,False,164,scaffold_2
38,6507001,6522000,14999,False,164,scaffold_2
39,6574001,6628000,53999,False,164,scaffold_2
40,6812001,6979000,166999,False,164,scaffold_2
41,7005001,7038000,32999,False,164,scaffold_2
42,7063001,7241000,177999,False,164,scaffold_2
43,7290001,7322000,31999,False,164,scaffold_2
44,7340001,7482000,141999,False,164,scaffold_2
45,7491001,7518000,26999,False,164,scaffold_2
46,7550001,7561000,10999,False,164,scaffold_2
47,7563001,8313000,749999,False,164,scaffold_2
48,8335001,8345000,9999,False,164,scaffold_2
49,8346001,8493000,146999,False,164,scaffold_2
50,8495001,8565000,69999,False,164,scaffold_2
51,8802001,8843000,40999,False,164,scaffold_2
52,8995001,9047000,51999,False,164,scaffold_2
53,9140001,9175000,34999,False,164,scaffold_2
54,9242001,9272000,29999,False,164,scaffold_2
55,9329001,9382000,52999,False,164,scaffold_2
56,9407001,9473000,65999,False,164,scaffold_2
57,9557001,9697000,139999,False,164,scaffold_2
58,9850001,9898000,47999,False,164,scaffold_2
59,10163001,10186000,22999,False,164,scaffold_2
60,11026001,11067000,40999,False,164,scaffold_2
61,11367001,11387000,19999,False,164,scaffold_2
62,11390001,11787000,396999,False,164,scaffold_2
0,51001,55000,3999,False,164,scaffold_3
1,529001,539000,9999,False,164,scaffold_3
2,542001,548000,5999,False,164,scaffold_3
3,618001,646000,27999,False,164,scaffold_3
4,756001,765000,8999,False,164,scaffold_3
5,795001,901000,105999,False,164,scaffold_3
6,2007001,2107000,99999,False,164,scaffold_3
7,2265001,2322000,56999,False,164,scaffold_3
8,2488001,2532000,43999,False,164,scaffold_3
9,3713001,3894000,180999,False,164,scaffold_3
10,3926001,3947000,20999,False,164,scaffold_3
11,3998001,4036000,37999,False,164,scaffold_3
12,4108001,4398000,289999,False,164,scaffold_3
13,4418001,4523000,104999,False,164,scaffold_3
14,4531001,4559000,27999,False,164,scaffold_3
15,4566001,4719000,152999,False,164,scaffold_3
16,4776001,4810000,33999,False,164,scaffold_3
17,4864001,4890000,25999,False,164,scaffold_3
18,5181001,5209000,27999,False,164,scaffold_3
19,5431001,5442000,10999,False,164,scaffold_3
20,5864001,5939000,74999,False,164,scaffold_3
21,5990001,6020000,29999,False,164,scaffold_3
22,6516001,6578000,61999,False,164,scaffold_3
23,6657001,6806000,148999,False,164,scaffold_3
24,6910001,6968000,57999,False,164,scaffold_3
25,6979001,7157000,177999,False,164,scaffold_3
26,7231001,7301000,69999,False,164,scaffold_3
27,7333001,7415000,81999,False,164,scaffold_3
28,7449001,7458000,8999,False,164,scaffold_3
29,7483001,7563000,79999,False,164,scaffold_3
30,7577001,7621000,43999,False,164,scaffold_3
31,7692001,7935000,242999,False,164,scaffold_3
32,8175001,8253000,77999,False,164,scaffold_3
33,8398001,8415000,16999,False,164,scaffold_3
34,8427001,8528000,100999,False,164,scaffold_3
35,8574001,8594000,19999,False,164,scaffold_3
36,8607001,8631000,23999,False,164,scaffold_3
37,9059001,9075000,15999,False,164,scaffold_3
38,9963001,10090000,126999,False,164,scaffold_3
39,10277001,10305000,27999,False,164,scaffold_3
40,10461001,10485000,23999,False,164,scaffold_3
41,10551001,10572000,20999,False,164,scaffold_3
42,10574001,11182071,608070,True,164,scaffold_3
0,11001,13000,1999,False,164,scaffold_4
1,17001,32000,14999,False,164,scaffold_4
2,48001,112000,63999,False,164,scaffold_4
3,113001,115000,1999,False,164,scaffold_4
4,155001,160000,4999,False,164,scaffold_4
5,161001,215000,53999,False,164,scaffold_4
6,217001,226000,8999,False,164,scaffold_4
7,227001,266000,38999,False,164,scaffold_4
8,288001,307000,18999,False,164,scaffold_4
9,308001,343000,34999,False,164,scaffold_4
10,355001,373000,17999,False,164,scaffold_4
11,390001,410000,19999,False,164,scaffold_4
12,412001,425000,12999,False,164,scaffold_4
13,429001,531000,101999,False,164,scaffold_4
14,541001,592000,50999,False,164,scaffold_4
15,593001,599000,5999,False,164,scaffold_4
16,600001,606000,5999,False,164,scaffold_4
17,608001,657000,48999,False,164,scaffold_4
18,669001,691000,21999,False,164,scaffold_4
19,1074001,1081000,6999,False,164,scaffold_4
20,1087001,1097000,9999,False,164,scaffold_4
21,1098001,1110000,11999,False,164,scaffold_4
22,1121001,1178000,56999,False,164,scaffold_4
23,1199001,1208000,8999,False,164,scaffold_4
24,1210001,1227000,16999,False,164,scaffold_4
25,1267001,1279000,11999,False,164,scaffold_4
26,1283001,1336000,52999,False,164,scaffold_4
27,1356001,1392000,35999,False,164,scaffold_4
28,1393001,1597000,203999,False,164,scaffold_4
29,1613001,1655000,41999,False,164,scaffold_4
30,1749001,1866000,116999,False,164,scaffold_4
31,1905001,1988000,82999,False,164,scaffold_4
32,2221001,2246000,24999,False,164,scaffold_4
33,2247001,2281000,33999,False,164,scaffold_4
34,2284001,2442000,157999,False,164,scaffold_4
35,2477001,2635000,157999,False,164,scaffold_4
36,2933001,2955000,21999,False,164,scaffold_4
37,3087001,3127000,39999,False,164,scaffold_4
38,3230001,3261000,30999,False,164,scaffold_4
39,3335001,3760000,424999,False,164,scaffold_4
40,4288001,4365000,76999,False,164,scaffold_4
41,4900001,5142000,241999,False,164,scaffold_4
42,5144001,5244000,99999,False,164,scaffold_4
43,5300001,5426000,125999,False,164,scaffold_4
44,5476001,5506000,29999,False,164,scaffold_4
45,5516001,5784000,267999,False,164,scaffold_4
46,5786001,5825000,38999,False,164,scaffold_4
47,6067001,6094000,26999,False,164,scaffold_4
48,6148001,6195000,46999,False,164,scaffold_4
49,6615001,6617000,1999,False,164,scaffold_4
50,6712001,6745000,32999,False,164,scaffold_4
51,6771001,6788000,16999,False,164,scaffold_4
52,6898001,6924000,25999,False,164,scaffold_4
53,6952001,6995000,42999,False,164,scaffold_4
54,7036001,7124000,87999,False,164,scaffold_4
55,7126001,7179000,52999,False,164,scaffold_4
56,7196001,7323000,126999,False,164,scaffold_4
57,7641001,7665000,23999,False,164,scaffold_4
58,8845001,9699000,853999,False,164,scaffold_4
59,9700001,9845951,145950,True,164,scaffold_4
0,141001,173000,31999,False,164,scaffold_5
1,178001,180000,1999,False,164,scaffold_5
2,189001,205000,15999,False,164,scaffold_5
3,319001,427000,107999,False,164,scaffold_5
4,452001,523000,70999,False,164,scaffold_5
5,669001,697000,27999,False,164,scaffold_5
6,933001,947000,13999,False,164,scaffold_5
7,2106001,2137000,30999,False,164,scaffold_5
8,2256001,2314000,57999,False,164,scaffold_5
9,2510001,2515000,4999,False,164,scaffold_5
10,2516001,2527000,10999,False,164,scaffold_5
11,2551001,2881000,329999,False,164,scaffold_5
12,2883001,2887000,3999,False,164,scaffold_5
13,2923001,3004000,80999,False,164,scaffold_5
14,3090001,3511000,420999,False,164,scaffold_5
15,3617001,3657000,39999,False,164,scaffold_5
16,3719001,3751000,31999,False,164,scaffold_5
17,3835001,3878000,42999,False,164,scaffold_5
18,3950001,4376000,425999,False,164,scaffold_5
19,4445001,4926000,480999,False,164,scaffold_5
20,4970001,5026000,55999,False,164,scaffold_5
21,5218001,5275000,56999,False,164,scaffold_5
22,5286001,5345000,58999,False,164,scaffold_5
23,5704001,5737000,32999,False,164,scaffold_5
24,5866001,5891000,24999,False,164,scaffold_5
25,6407001,6443000,35999,False,164,scaffold_5
26,6451001,6666000,214999,False,164,scaffold_5
27,6776001,6788000,11999,False,164,scaffold_5
28,6888001,6907000,18999,False,164,scaffold_5
29,7035001,7086000,50999,False,164,scaffold_5
30,7166001,7242000,75999,False,164,scaffold_5
31,7406001,7444000,37999,False,164,scaffold_5
32,7463001,7512000,48999,False,164,scaffold_5
33,7523001,7661000,137999,False,164,scaffold_5
34,7688001,7746000,57999,False,164,scaffold_5
35,7948001,7975000,26999,False,164,scaffold_5
36,8024001,8047000,22999,False,164,scaffold_5
37,8258001,8266000,7999,False,164,scaffold_5
38,8402001,8470000,67999,False,164,scaffold_5
39,8554001,8616000,61999,False,164,scaffold_5
40,8702001,9364176,662175,True,164,scaffold_5
0,86001,112000,25999,False,164,scaffold_6
1,161001,209000,47999,False,164,scaffold_6
2,239001,253000,13999,False,164,scaffold_6
3,266001,290000,23999,False,164,scaffold_6
4,1236001,1265000,28999,False,164,scaffold_6
5,1478001,1592000,113999,False,164,scaffold_6
6,1862001,1906000,43999,False,164,scaffold_6
7,1998001,2201000,202999,False,164,scaffold_6
8,2236001,2285000,48999,False,164,scaffold_6
9,2321001,2654000,332999,False,164,scaffold_6
10,2658001,2867000,208999,False,164,scaffold_6
11,2928001,3024000,95999,False,164,scaffold_6
12,3078001,3208000,129999,False,164,scaffold_6
13,3223001,3786000,562999,False,164,scaffold_6
14,3880001,3930000,49999,False,164,scaffold_6
15,3966001,4195000,228999,False,164,scaffold_6
16,5269001,5317000,47999,False,164,scaffold_6
17,5559001,5647000,87999,False,164,scaffold_6
18,5937001,5969000,31999,False,164,scaffold_6
19,6008001,6086000,77999,False,164,scaffold_6
20,6776001,6804000,27999,False,164,scaffold_6
21,6832001,6857000,24999,False,164,scaffold_6
22,7164001,7248000,83999,False,164,scaffold_6
23,7263001,7339000,75999,False,164,scaffold_6
24,7362001,7476000,113999,False,164,scaffold_6
25,7541001,8268281,727280,True,164,scaffold_6
0,14001,31000,16999,False,164,scaffold_7
1,298001,508000,209999,False,164,scaffold_7
2,570001,591000,20999,False,164,scaffold_7
3,649001,736000,86999,False,164,scaffold_7
4,760001,827000,66999,False,164,scaffold_7
5,858001,864000,5999,False,164,scaffold_7
6,868001,872000,3999,False,164,scaffold_7
7,874001,948000,73999,False,164,scaffold_7
8,951001,963000,11999,False,164,scaffold_7
9,964001,966000,1999,False,164,scaffold_7
10,968001,981000,12999,False,164,scaffold_7
11,982001,1044000,61999,False,164,scaffold_7
12,1048001,1136000,87999,False,164,scaffold_7
13,1138001,1142000,3999,False,164,scaffold_7
14,1169001,1184000,14999,False,164,scaffold_7
15,1203001,1512000,308999,False,164,scaffold_7
16,1585001,1689000,103999,False,164,scaffold_7
17,2851001,2888000,36999,False,164,scaffold_7
18,2933001,2959000,25999,False,164,scaffold_7
19,3293001,3405000,111999,False,164,scaffold_7
20,3477001,3827000,349999,False,164,scaffold_7
21,3901001,3965000,63999,False,164,scaffold_7
22,4027001,4133000,105999,False,164,scaffold_7
23,4200001,4222000,21999,False,164,scaffold_7
24,4336001,4359000,22999,False,164,scaffold_7
25,4416001,4514000,97999,False,164,scaffold_7
26,4547001,4597000,49999,False,164,scaffold_7
27,4630001,4854000,223999,False,164,scaffold_7
28,4978001,5149000,170999,False,164,scaffold_7
29,5469001,5536000,66999,False,164,scaffold_7
30,5666001,5674000,7999,False,164,scaffold_7
31,6127001,6235000,107999,False,164,scaffold_7
32,6331001,6389000,57999,False,164,scaffold_7
33,6561001,6586000,24999,False,164,scaffold_7
34,6751001,6797000,45999,False,164,scaffold_7
35,6944001,7502216,558215,True,164,scaffold_7
0,36001,85000,48999,False,164,scaffold_8
1,93001,101000,7999,False,164,scaffold_8
2,1363001,1427000,63999,False,164,scaffold_8
3,1733001,1755000,21999,False,164,scaffold_8
4,1800001,1935000,134999,False,164,scaffold_8
5,2079001,2134000,54999,False,164,scaffold_8
6,2223001,2287000,63999,False,164,scaffold_8
7,2355001,2590000,234999,False,164,scaffold_8
8,2644001,2687000,42999,False,164,scaffold_8
9,2704001,2844000,139999,False,164,scaffold_8
10,3037001,3614000,576999,False,164,scaffold_8
11,3615001,3954000,338999,False,164,scaffold_8
12,4039001,4109000,69999,False,164,scaffold_8
13,4202001,4269000,66999,False,164,scaffold_8
14,5091001,5241000,149999,False,164,scaffold_8
15,5579001,5597000,17999,False,164,scaffold_8
16,5650001,5695000,44999,False,164,scaffold_8
17,6332001,6334544,2543,True,164,scaffold_8
0,1,22000,21999,True,164,scaffold_9
1,109001,118000,8999,False,164,scaffold_9
2,121001,138000,16999,False,164,scaffold_9
3,300001,316000,15999,False,164,scaffold_9
4,319001,411000,91999,False,164,scaffold_9
5,413001,434000,20999,False,164,scaffold_9
6,484001,531000,46999,False,164,scaffold_9
7,660001,665000,4999,False,164,scaffold_9
8,671001,697000,25999,False,164,scaffold_9
9,730001,742000,11999,False,164,scaffold_9
10,817001,842000,24999,False,164,scaffold_9
11,886001,986000,99999,False,164,scaffold_9
12,987001,995000,7999,False,164,scaffold_9
13,997001,1031000,33999,False,164,scaffold_9
14,1035001,1085000,49999,False,164,scaffold_9
15,1087001,1160000,72999,False,164,scaffold_9
16,1312001,1378000,65999,False,164,scaffold_9
17,1760001,1801000,40999,False,164,scaffold_9
18,2599001,2636000,36999,False,164,scaffold_9
19,2731001,3381000,649999,False,164,scaffold_9
20,3383001,5100000,1716999,False,164,scaffold_9
21,5101001,5107000,5999,False,164,scaffold_9
22,5111001,5115000,3999,False,164,scaffold_9
23,5116001,5238000,121999,False,164,scaffold_9
24,5239001,5298000,58999,False,164,scaffold_9
25,5300001,6331288,1031287,True,164,scaffold_9
0,1,482000,481999,True,164,scaffold_10
1,483001,584000,100999,False,164,scaffold_10
2,603001,878000,274999,False,164,scaffold_10
3,884001,1068000,183999,False,164,scaffold_10
4,1073001,1149000,75999,False,164,scaffold_10
5,2346001,2399000,52999,False,164,scaffold_10
6,4000001,4011000,10999,False,164,scaffold_10
7,4051001,4112000,60999,False,164,scaffold_10
8,4156001,4174000,17999,False,164,scaffold_10
9,4234001,4256000,21999,False,164,scaffold_10
10,4316001,4364000,47999,False,164,scaffold_10
11,4443001,4502000,58999,False,164,scaffold_10
12,4515001,4548000,32999,False,164,scaffold_10
13,4554001,4562000,7999,False,164,scaffold_10
14,4565001,4596000,30999,False,164,scaffold_10
15,4728001,4732000,3999,False,164,scaffold_10
16,4734001,4776000,41999,False,164,scaffold_10
17,4798001,4846000,47999,False,164,scaffold_10
18,4848001,4861000,12999,False,164,scaffold_10
0,9001,93000,83999,False,164,scaffold_11
1,132001,167000,34999,False,164,scaffold_11
2,169001,191000,21999,False,164,scaffold_11
3,213001,236000,22999,False,164,scaffold_11
4,240001,246000,5999,False,164,scaffold_11
5,289001,321000,31999,False,164,scaffold_11
6,419001,431000,11999,False,164,scaffold_11
7,648001,656000,7999,False,164,scaffold_11
8,1028001,1034000,5999,False,164,scaffold_11
9,1474001,1477000,2999,False,164,scaffold_11
10,2454001,2496000,41999,False,164,scaffold_11
11,2696001,2874000,177999,False,164,scaffold_11
12,2983001,3026000,42999,False,164,scaffold_11
13,3059001,3383000,323999,False,164,scaffold_11
14,3560001,3935000,374999,False,164,scaffold_11
15,4009001,4159000,149999,False,164,scaffold_11
16,4317001,4710000,392999,False,164,scaffold_11
17,4712001,4766820,54819,True,164,scaffold_11
0,1,1469000,1468999,True,164,scaffold_12
1,1717001,1755000,37999,False,164,scaffold_12
2,2492001,2503000,10999,False,164,scaffold_12
3,2571001,2618000,46999,False,164,scaffold_12
4,2667001,2681000,13999,False,164,scaffold_12
5,2685001,2708000,22999,False,164,scaffold_12
0,1,440000,439999,True,165,scaffold_1
1,482001,499000,16999,False,165,scaffold_1
2,572001,643000,70999,False,165,scaffold_1
3,686001,759000,72999,False,165,scaffold_1
4,1023001,1097000,73999,False,165,scaffold_1
5,1261001,1292000,30999,False,165,scaffold_1
6,1631001,1696000,64999,False,165,scaffold_1
7,1765001,1900000,134999,False,165,scaffold_1
8,1916001,1964000,47999,False,165,scaffold_1
9,1965001,1984000,18999,False,165,scaffold_1
10,1986001,2019000,32999,False,165,scaffold_1
11,2256001,2422000,165999,False,165,scaffold_1
12,2449001,2528000,78999,False,165,scaffold_1
13,2544001,2621000,76999,False,165,scaffold_1
14,2663001,2687000,23999,False,165,scaffold_1
15,2688001,2782000,93999,False,165,scaffold_1
16,2825001,2851000,25999,False,165,scaffold_1
17,2866001,3031000,164999,False,165,scaffold_1
18,3048001,3089000,40999,False,165,scaffold_1
19,3100001,3129000,28999,False,165,scaffold_1
20,3153001,3240000,86999,False,165,scaffold_1
21,3440001,3634000,193999,False,165,scaffold_1
22,3682001,3879000,196999,False,165,scaffold_1
23,3907001,3941000,33999,False,165,scaffold_1
24,3945001,4157000,211999,False,165,scaffold_1
25,4265001,4362000,96999,False,165,scaffold_1
26,4490001,4551000,60999,False,165,scaffold_1
27,4707001,4749000,41999,False,165,scaffold_1
28,4918001,5065000,146999,False,165,scaffold_1
29,5085001,5198000,112999,False,165,scaffold_1
30,5356001,5377000,20999,False,165,scaffold_1
31,5480001,5594000,113999,False,165,scaffold_1
32,5836001,5918000,81999,False,165,scaffold_1
33,6108001,6509000,400999,False,165,scaffold_1
34,6510001,6583000,72999,False,165,scaffold_1
35,6602001,6614000,11999,False,165,scaffold_1
36,6642001,6656000,13999,False,165,scaffold_1
37,6726001,6834000,107999,False,165,scaffold_1
38,6835001,6862000,26999,False,165,scaffold_1
39,6864001,6917000,52999,False,165,scaffold_1
40,6997001,7588000,590999,False,165,scaffold_1
41,7590001,8656000,1065999,False,165,scaffold_1
42,8658001,8838000,179999,False,165,scaffold_1
43,8839001,9584000,744999,False,165,scaffold_1
44,9586001,10375000,788999,False,165,scaffold_1
45,10398001,10415000,16999,False,165,scaffold_1
46,10460001,10788000,327999,False,165,scaffold_1
47,10840001,10857000,16999,False,165,scaffold_1
48,10926001,10938000,11999,False,165,scaffold_1
49,11015001,11068000,52999,False,165,scaffold_1
50,11283001,11538000,254999,False,165,scaffold_1
51,11550001,11968000,417999,False,165,scaffold_1
52,12004001,12013000,8999,False,165,scaffold_1
53,12121001,12179000,57999,False,165,scaffold_1
54,12180001,12245000,64999,False,165,scaffold_1
55,12348001,12396000,47999,False,165,scaffold_1
56,12407001,12460000,52999,False,165,scaffold_1
57,12624001,12760000,135999,False,165,scaffold_1
58,12769001,13005000,235999,False,165,scaffold_1
59,13023001,13215000,191999,False,165,scaffold_1
60,13346001,13420000,73999,False,165,scaffold_1
61,13517001,13538000,20999,False,165,scaffold_1
62,13560001,13584000,23999,False,165,scaffold_1
63,13592001,13615000,22999,False,165,scaffold_1
64,14105001,14108000,2999,False,165,scaffold_1
65,14287001,14307000,19999,False,165,scaffold_1
66,14743001,14751000,7999,False,165,scaffold_1
0,1,48000,47999,True,165,scaffold_2
1,65001,94000,28999,False,165,scaffold_2
2,95001,159000,63999,False,165,scaffold_2
3,165001,177000,11999,False,165,scaffold_2
4,239001,288000,48999,False,165,scaffold_2
5,296001,318000,21999,False,165,scaffold_2
6,332001,374000,41999,False,165,scaffold_2
7,458001,480000,21999,False,165,scaffold_2
8,946001,1016000,69999,False,165,scaffold_2
9,1632001,1682000,49999,False,165,scaffold_2
10,1689001,1720000,30999,False,165,scaffold_2
11,1927001,1959000,31999,False,165,scaffold_2
12,2085001,2101000,15999,False,165,scaffold_2
13,2312001,2617000,304999,False,165,scaffold_2
14,2645001,2689000,43999,False,165,scaffold_2
15,2693001,2746000,52999,False,165,scaffold_2
16,2766001,2788000,21999,False,165,scaffold_2
17,2802001,2866000,63999,False,165,scaffold_2
18,2868001,3058000,189999,False,165,scaffold_2
19,3271001,3282000,10999,False,165,scaffold_2
20,3328001,3343000,14999,False,165,scaffold_2
21,3366001,3437000,70999,False,165,scaffold_2
22,3450001,3487000,36999,False,165,scaffold_2
23,3659001,3667000,7999,False,165,scaffold_2
24,3668001,3693000,24999,False,165,scaffold_2
25,3754001,3790000,35999,False,165,scaffold_2
26,3808001,3849000,40999,False,165,scaffold_2
27,4106001,4153000,46999,False,165,scaffold_2
28,4210001,4408000,197999,False,165,scaffold_2
29,4426001,4770000,343999,False,165,scaffold_2
30,4782001,4790000,7999,False,165,scaffold_2
31,4793001,4818000,24999,False,165,scaffold_2
32,4847001,5224000,376999,False,165,scaffold_2
33,5261001,5352000,90999,False,165,scaffold_2
34,5360001,5764000,403999,False,165,scaffold_2
35,5830001,6079000,248999,False,165,scaffold_2
36,6244001,6449000,204999,False,165,scaffold_2
37,6500001,6642000,141999,False,165,scaffold_2
38,6695001,6727000,31999,False,165,scaffold_2
39,6794001,6996000,201999,False,165,scaffold_2
40,7007001,7244000,236999,False,165,scaffold_2
41,7258001,7518000,259999,False,165,scaffold_2
42,7545001,7561000,15999,False,165,scaffold_2
43,7563001,8314000,750999,False,165,scaffold_2
44,8331001,8333000,1999,False,165,scaffold_2
45,8335001,8345000,9999,False,165,scaffold_2
46,8346001,8454000,107999,False,165,scaffold_2
47,8464001,8494000,29999,False,165,scaffold_2
48,8495001,8591000,95999,False,165,scaffold_2
49,8592001,8651000,58999,False,165,scaffold_2
50,8687001,8705000,17999,False,165,scaffold_2
51,8742001,8855000,112999,False,165,scaffold_2
52,8933001,9068000,134999,False,165,scaffold_2
53,9082001,9089000,6999,False,165,scaffold_2
54,9116001,9300000,183999,False,165,scaffold_2
55,9320001,9512000,191999,False,165,scaffold_2
56,9523001,9769000,245999,False,165,scaffold_2
57,9839001,9896000,56999,False,165,scaffold_2
58,10404001,10582000,177999,False,165,scaffold_2
59,10796001,10814000,17999,False,165,scaffold_2
60,10995001,11072000,76999,False,165,scaffold_2
61,11112001,11137000,24999,False,165,scaffold_2
62,11367001,11503000,135999,False,165,scaffold_2
63,11518001,11802476,284475,True,165,scaffold_2
0,352001,367000,14999,False,165,scaffold_3
1,618001,647000,28999,False,165,scaffold_3
2,775001,900000,124999,False,165,scaffold_3
3,1163001,1193000,29999,False,165,scaffold_3
4,1583001,1613000,29999,False,165,scaffold_3
5,1758001,1784000,25999,False,165,scaffold_3
6,2042001,2108000,65999,False,165,scaffold_3
7,2165001,2176000,10999,False,165,scaffold_3
8,2264001,2341000,76999,False,165,scaffold_3
9,2432001,2532000,99999,False,165,scaffold_3
10,2621001,2667000,45999,False,165,scaffold_3
11,3660001,3895000,234999,False,165,scaffold_3
12,4097001,4398000,300999,False,165,scaffold_3
13,4417001,4522000,104999,False,165,scaffold_3
14,4540001,4558000,17999,False,165,scaffold_3
15,4567001,4578000,10999,False,165,scaffold_3
16,4580001,4686000,105999,False,165,scaffold_3
17,4763001,4831000,67999,False,165,scaffold_3
18,4859001,4926000,66999,False,165,scaffold_3
19,4998001,5042000,43999,False,165,scaffold_3
20,5161001,5208000,46999,False,165,scaffold_3
21,5250001,5273000,22999,False,165,scaffold_3
22,5380001,5444000,63999,False,165,scaffold_3
23,5805001,5953000,147999,False,165,scaffold_3
24,5990001,6024000,33999,False,165,scaffold_3
25,6221001,6245000,23999,False,165,scaffold_3
26,6281001,6323000,41999,False,165,scaffold_3
27,6428001,6442000,13999,False,165,scaffold_3
28,6477001,6962000,484999,False,165,scaffold_3
29,6963001,7098000,134999,False,165,scaffold_3
30,7115001,7157000,41999,False,165,scaffold_3
31,7227001,7325000,97999,False,165,scaffold_3
32,7332001,7403000,70999,False,165,scaffold_3
33,7462001,7480000,17999,False,165,scaffold_3
34,7482001,7556000,73999,False,165,scaffold_3
35,7577001,7635000,57999,False,165,scaffold_3
36,7677001,7909000,231999,False,165,scaffold_3
37,7910001,7975000,64999,False,165,scaffold_3
38,8046001,8156000,109999,False,165,scaffold_3
39,8177001,8255000,77999,False,165,scaffold_3
40,8377001,8528000,150999,False,165,scaffold_3
41,8570001,8594000,23999,False,165,scaffold_3
42,8605001,8636000,30999,False,165,scaffold_3
43,8760001,8769000,8999,False,165,scaffold_3
44,9005001,9075000,69999,False,165,scaffold_3
45,9182001,9254000,71999,False,165,scaffold_3
46,9303001,9317000,13999,False,165,scaffold_3
47,9324001,9363000,38999,False,165,scaffold_3
48,9438001,9457000,18999,False,165,scaffold_3
49,9484001,9537000,52999,False,165,scaffold_3
50,9730001,9787000,56999,False,165,scaffold_3
51,9933001,10147000,213999,False,165,scaffold_3
52,10233001,10458000,224999,False,165,scaffold_3
53,10461001,10484000,22999,False,165,scaffold_3
54,10493001,11182071,689070,True,165,scaffold_3
0,14001,16000,1999,False,165,scaffold_4
1,17001,32000,14999,False,165,scaffold_4
2,48001,86000,37999,False,165,scaffold_4
3,87001,151000,63999,False,165,scaffold_4
4,155001,215000,59999,False,165,scaffold_4
5,218001,226000,7999,False,165,scaffold_4
6,227001,238000,10999,False,165,scaffold_4
7,239001,278000,38999,False,165,scaffold_4
8,283001,307000,23999,False,165,scaffold_4
9,313001,344000,30999,False,165,scaffold_4
10,355001,410000,54999,False,165,scaffold_4
11,412001,425000,12999,False,165,scaffold_4
12,426001,428000,1999,False,165,scaffold_4
13,429001,504000,74999,False,165,scaffold_4
14,510001,592000,81999,False,165,scaffold_4
15,593001,607000,13999,False,165,scaffold_4
16,608001,691000,82999,False,165,scaffold_4
17,695001,697000,1999,False,165,scaffold_4
18,700001,724000,23999,False,165,scaffold_4
19,1053001,1086000,32999,False,165,scaffold_4
20,1087001,1110000,22999,False,165,scaffold_4
21,1112001,1136000,23999,False,165,scaffold_4
22,1138001,1198000,59999,False,165,scaffold_4
23,1199001,1226000,26999,False,165,scaffold_4
24,1254001,1279000,24999,False,165,scaffold_4
25,1283001,1337000,53999,False,165,scaffold_4
26,1353001,1598000,244999,False,165,scaffold_4
27,1613001,1849000,235999,False,165,scaffold_4
28,1850001,2068000,217999,False,165,scaffold_4
29,2073001,2099000,25999,False,165,scaffold_4
30,2200001,2208000,7999,False,165,scaffold_4
31,2210001,2246000,35999,False,165,scaffold_4
32,2247001,2280000,32999,False,165,scaffold_4
33,2284001,2471000,186999,False,165,scaffold_4
34,2475001,2635000,159999,False,165,scaffold_4
35,2698001,2751000,52999,False,165,scaffold_4
36,2934001,3127000,192999,False,165,scaffold_4
37,3202001,3267000,64999,False,165,scaffold_4
38,3334001,3761000,426999,False,165,scaffold_4
39,3850001,3951000,100999,False,165,scaffold_4
40,4058001,4106000,47999,False,165,scaffold_4
41,4184001,4195000,10999,False,165,scaffold_4
42,4255001,4377000,121999,False,165,scaffold_4
43,4515001,4643000,127999,False,165,scaffold_4
44,4644001,4695000,50999,False,165,scaffold_4
45,4707001,4745000,37999,False,165,scaffold_4
46,4823001,5245000,421999,False,165,scaffold_4
47,5271001,5466000,194999,False,165,scaffold_4
48,5475001,5506000,30999,False,165,scaffold_4
49,5515001,5784000,268999,False,165,scaffold_4
50,5786001,6113000,326999,False,165,scaffold_4
51,6146001,6311000,164999,False,165,scaffold_4
52,6615001,6617000,1999,False,165,scaffold_4
53,6619001,6639000,19999,False,165,scaffold_4
54,6727001,6817000,89999,False,165,scaffold_4
55,6873001,6924000,50999,False,165,scaffold_4
56,6926001,7429000,502999,False,165,scaffold_4
57,7506001,7571000,64999,False,165,scaffold_4
58,7627001,7665000,37999,False,165,scaffold_4
59,7985001,8002000,16999,False,165,scaffold_4
60,8294001,8325000,30999,False,165,scaffold_4
61,8395001,8407000,11999,False,165,scaffold_4
62,8701001,8811000,109999,False,165,scaffold_4
63,8843001,8974000,130999,False,165,scaffold_4
64,8975001,9699000,723999,False,165,scaffold_4
65,9700001,9845951,145950,True,165,scaffold_4
0,1,16000,15999,True,165,scaffold_5
1,141001,173000,31999,False,165,scaffold_5
2,182001,205000,22999,False,165,scaffold_5
3,318001,419000,100999,False,165,scaffold_5
4,452001,524000,71999,False,165,scaffold_5
5,663001,702000,38999,False,165,scaffold_5
6,836001,856000,19999,False,165,scaffold_5
7,933001,947000,13999,False,165,scaffold_5
8,2106001,2117000,10999,False,165,scaffold_5
9,2258001,2312000,53999,False,165,scaffold_5
10,2475001,2494000,18999,False,165,scaffold_5
11,2505001,2515000,9999,False,165,scaffold_5
12,2516001,3066000,549999,False,165,scaffold_5
13,3090001,3519000,428999,False,165,scaffold_5
14,3533001,3564000,30999,False,165,scaffold_5
15,3615001,3679000,63999,False,165,scaffold_5
16,3719001,4223000,503999,False,165,scaffold_5
17,4225001,4413000,187999,False,165,scaffold_5
18,4444001,4926000,481999,False,165,scaffold_5
19,4965001,5115000,149999,False,165,scaffold_5
20,5133001,5344000,210999,False,165,scaffold_5
21,5498001,5551000,52999,False,165,scaffold_5
22,5692001,5737000,44999,False,165,scaffold_5
23,5869001,5891000,21999,False,165,scaffold_5
24,6330001,6361000,30999,False,165,scaffold_5
25,6407001,6921000,513999,False,165,scaffold_5
26,7015001,7087000,71999,False,165,scaffold_5
27,7118001,7142000,23999,False,165,scaffold_5
28,7173001,7268000,94999,False,165,scaffold_5
29,7296001,7384000,87999,False,165,scaffold_5
30,7406001,7438000,31999,False,165,scaffold_5
31,7454001,7512000,57999,False,165,scaffold_5
32,7526001,7671000,144999,False,165,scaffold_5
33,7732001,7881000,148999,False,165,scaffold_5
34,7882001,7893000,10999,False,165,scaffold_5
35,7938001,7972000,33999,False,165,scaffold_5
36,8258001,8472000,213999,False,165,scaffold_5
37,8550001,8616000,65999,False,165,scaffold_5
38,8674001,9364176,690175,True,165,scaffold_5
0,16001,39000,22999,False,165,scaffold_6
1,86001,112000,25999,False,165,scaffold_6
2,147001,210000,62999,False,165,scaffold_6
3,239001,252000,12999,False,165,scaffold_6
4,267001,376000,108999,False,165,scaffold_6
5,377001,419000,41999,False,165,scaffold_6
6,550001,568000,17999,False,165,scaffold_6
7,1156001,1265000,108999,False,165,scaffold_6
8,1283001,1309000,25999,False,165,scaffold_6
9,1433001,1548000,114999,False,165,scaffold_6
10,1558001,1598000,39999,False,165,scaffold_6
11,1658001,1717000,58999,False,165,scaffold_6
12,1768001,1800000,31999,False,165,scaffold_6
13,1825001,1935000,109999,False,165,scaffold_6
14,1937001,1950000,12999,False,165,scaffold_6
15,2025001,2104000,78999,False,165,scaffold_6
16,2122001,2211000,88999,False,165,scaffold_6
17,2236001,2287000,50999,False,165,scaffold_6
18,2332001,2653000,320999,False,165,scaffold_6
19,2655001,2872000,216999,False,165,scaffold_6
20,2927001,3207000,279999,False,165,scaffold_6
21,3222001,3359000,136999,False,165,scaffold_6
22,3373001,3806000,432999,False,165,scaffold_6
23,3810001,3916000,105999,False,165,scaffold_6
24,3966001,4207000,240999,False,165,scaffold_6
25,4222001,4229000,6999,False,165,scaffold_6
26,4924001,4932000,7999,False,165,scaffold_6
27,4951001,5006000,54999,False,165,scaffold_6
28,5282001,5416000,133999,False,165,scaffold_6
29,5435001,5504000,68999,False,165,scaffold_6
30,5525001,5647000,121999,False,165,scaffold_6
31,5656001,5747000,90999,False,165,scaffold_6
32,5775001,5973000,197999,False,165,scaffold_6
33,5988001,6088000,99999,False,165,scaffold_6
34,6122001,6183000,60999,False,165,scaffold_6
35,6250001,6277000,26999,False,165,scaffold_6
36,6476001,6506000,29999,False,165,scaffold_6
37,6688001,6701000,12999,False,165,scaffold_6
38,6702001,6726000,23999,False,165,scaffold_6
39,6748001,6954000,205999,False,165,scaffold_6
40,6973001,7090000,116999,False,165,scaffold_6
41,7156001,7347000,190999,False,165,scaffold_6
42,7361001,7681000,319999,False,165,scaffold_6
43,7682001,8268281,586280,True,165,scaffold_6
0,1,7000,6999,True,165,scaffold_7
1,13001,31000,17999,False,165,scaffold_7
2,296001,316000,19999,False,165,scaffold_7
3,317001,341000,23999,False,165,scaffold_7
4,342001,505000,162999,False,165,scaffold_7
5,572001,598000,25999,False,165,scaffold_7
6,622001,736000,113999,False,165,scaffold_7
7,760001,829000,68999,False,165,scaffold_7
8,858001,864000,5999,False,165,scaffold_7
9,868001,963000,94999,False,165,scaffold_7
10,964001,966000,1999,False,165,scaffold_7
11,968001,979000,10999,False,165,scaffold_7
12,982001,1044000,61999,False,165,scaffold_7
13,1048001,1150000,101999,False,165,scaffold_7
14,1194001,1512000,317999,False,165,scaffold_7
15,1536001,1692000,155999,False,165,scaffold_7
16,1817001,1891000,73999,False,165,scaffold_7
17,2109001,2158000,48999,False,165,scaffold_7
18,2183001,2211000,27999,False,165,scaffold_7
19,2721001,2759000,37999,False,165,scaffold_7
20,2834001,3072000,237999,False,165,scaffold_7
21,3292001,3985000,692999,False,165,scaffold_7
22,4027001,4154000,126999,False,165,scaffold_7
23,4201001,4239000,37999,False,165,scaffold_7
24,4317001,4513000,195999,False,165,scaffold_7
25,4546001,4611000,64999,False,165,scaffold_7
26,4622001,5296000,673999,False,165,scaffold_7
27,5400001,5536000,135999,False,165,scaffold_7
28,6070001,6389000,318999,False,165,scaffold_7
29,6565001,6589000,23999,False,165,scaffold_7
30,6601001,6665000,63999,False,165,scaffold_7
31,6751001,6797000,45999,False,165,scaffold_7
32,6815001,6871000,55999,False,165,scaffold_7
33,6946001,7270000,323999,False,165,scaffold_7
34,7271001,7502216,231215,True,165,scaffold_7
0,31001,64000,32999,False,165,scaffold_8
1,66001,89000,22999,False,165,scaffold_8
2,93001,101000,7999,False,165,scaffold_8
3,729001,732000,2999,False,165,scaffold_8
4,1009001,1052000,42999,False,165,scaffold_8
5,1338001,1429000,90999,False,165,scaffold_8
6,1669001,1716000,46999,False,165,scaffold_8
7,1733001,1752000,18999,False,165,scaffold_8
8,1799001,2331000,531999,False,165,scaffold_8
9,2332001,2590000,257999,False,165,scaffold_8
10,2651001,2683000,31999,False,165,scaffold_8
11,2685001,2844000,158999,False,165,scaffold_8
12,3032001,3614000,581999,False,165,scaffold_8
13,3615001,4268000,652999,False,165,scaffold_8
14,4308001,4434000,125999,False,165,scaffold_8
15,4609001,4641000,31999,False,165,scaffold_8
16,4820001,4849000,28999,False,165,scaffold_8
17,4879001,4919000,39999,False,165,scaffold_8
18,4969001,5244000,274999,False,165,scaffold_8
19,5388001,5597000,208999,False,165,scaffold_8
20,5624001,5694000,69999,False,165,scaffold_8
21,6327001,6334544,7543,True,165,scaffold_8
0,1,32000,31999,True,165,scaffold_9
1,64001,106000,41999,False,165,scaffold_9
2,109001,118000,8999,False,165,scaffold_9
3,121001,138000,16999,False,165,scaffold_9
4,296001,353000,56999,False,165,scaffold_9
5,354001,411000,56999,False,165,scaffold_9
6,413001,435000,21999,False,165,scaffold_9
7,477001,531000,53999,False,165,scaffold_9
8,532001,545000,12999,False,165,scaffold_9
9,547001,566000,18999,False,165,scaffold_9
10,608001,632000,23999,False,165,scaffold_9
11,633001,665000,31999,False,165,scaffold_9
12,669001,709000,39999,False,165,scaffold_9
13,816001,842000,25999,False,165,scaffold_9
14,877001,986000,108999,False,165,scaffold_9
15,987001,996000,8999,False,165,scaffold_9
16,1009001,1032000,22999,False,165,scaffold_9
17,1035001,1085000,49999,False,165,scaffold_9
18,1087001,1150000,62999,False,165,scaffold_9
19,1151001,1170000,18999,False,165,scaffold_9
20,1249001,1379000,129999,False,165,scaffold_9
21,1728001,1807000,78999,False,165,scaffold_9
22,1976001,2008000,31999,False,165,scaffold_9
23,2601001,2673000,71999,False,165,scaffold_9
24,2737001,3381000,643999,False,165,scaffold_9
25,3383001,5111000,1727999,False,165,scaffold_9
26,5112001,5238000,125999,False,165,scaffold_9
27,5239001,5298000,58999,False,165,scaffold_9
28,5300001,6331288,1031287,True,165,scaffold_9
0,1,414000,413999,True,165,scaffold_10
1,415001,482000,66999,False,165,scaffold_10
2,483001,1069000,585999,False,165,scaffold_10
3,1073001,1154000,80999,False,165,scaffold_10
4,1317001,1336000,18999,False,165,scaffold_10
5,1539001,1676000,136999,False,165,scaffold_10
6,1774001,1820000,45999,False,165,scaffold_10
7,2081001,2107000,25999,False,165,scaffold_10
8,2136001,2179000,42999,False,165,scaffold_10
9,2279001,2289000,9999,False,165,scaffold_10
10,2346001,2404000,57999,False,165,scaffold_10
11,2601001,2622000,20999,False,165,scaffold_10
12,3481001,3493000,11999,False,165,scaffold_10
13,3633001,3674000,40999,False,165,scaffold_10
14,3770001,3795000,24999,False,165,scaffold_10
15,3874001,3896000,21999,False,165,scaffold_10
16,4049001,4136000,86999,False,165,scaffold_10
17,4157001,4183000,25999,False,165,scaffold_10
18,4214001,4245000,30999,False,165,scaffold_10
19,4316001,4466000,149999,False,165,scaffold_10
20,4467001,4513000,45999,False,165,scaffold_10
21,4515001,4548000,32999,False,165,scaffold_10
22,4553001,4562000,8999,False,165,scaffold_10
23,4565001,4634000,68999,False,165,scaffold_10
24,4740001,4776000,35999,False,165,scaffold_10
25,4798001,4824000,25999,False,165,scaffold_10
26,4827001,4846000,18999,False,165,scaffold_10
27,4848001,4861000,12999,False,165,scaffold_10
28,4865001,4866973,1972,True,165,scaffold_10
0,9001,108000,98999,False,165,scaffold_11
1,132001,167000,34999,False,165,scaffold_11
2,169001,248000,78999,False,165,scaffold_11
3,285001,329000,43999,False,165,scaffold_11
4,384001,416000,31999,False,165,scaffold_11
5,419001,431000,11999,False,165,scaffold_11
6,648001,656000,7999,False,165,scaffold_11
7,1028001,1034000,5999,False,165,scaffold_11
8,1774001,1796000,21999,False,165,scaffold_11
9,2328001,2634000,305999,False,165,scaffold_11
10,2691001,2879000,187999,False,165,scaffold_11
11,2952001,3023000,70999,False,165,scaffold_11
12,3053001,3383000,329999,False,165,scaffold_11
13,3486001,3972000,485999,False,165,scaffold_11
14,4008001,4218000,209999,False,165,scaffold_11
15,4248001,4710000,461999,False,165,scaffold_11
16,4713001,4766820,53819,True,165,scaffold_11
0,1,1446000,1445999,True,165,scaffold_12
1,1457001,1501000,43999,False,165,scaffold_12
2,1542001,1587000,44999,False,165,scaffold_12
3,1718001,1754000,35999,False,165,scaffold_12
4,2037001,2041000,3999,False,165,scaffold_12
5,2463001,2484000,20999,False,165,scaffold_12
6,2571001,2619000,47999,False,165,scaffold_12
7,2685001,2707000,21999,False,165,scaffold_12
0,1,1291000,1290999,True,166,scaffold_1
1,1297001,1790000,492999,False,166,scaffold_1
2,1816001,1901000,84999,False,166,scaffold_1
3,1947001,1964000,16999,False,166,scaffold_1
4,1965001,1996000,30999,False,166,scaffold_1
5,2362001,2413000,50999,False,166,scaffold_1
6,2451001,2518000,66999,False,166,scaffold_1
7,2563001,2619000,55999,False,166,scaffold_1
8,2769001,2785000,15999,False,166,scaffold_1
9,2887001,2927000,39999,False,166,scaffold_1
10,3000001,3021000,20999,False,166,scaffold_1
11,3049001,3087000,37999,False,166,scaffold_1
12,3189001,3208000,18999,False,166,scaffold_1
13,3244001,3264000,19999,False,166,scaffold_1
14,3454001,3623000,168999,False,166,scaffold_1
15,3701001,3750000,48999,False,166,scaffold_1
16,3820001,3880000,59999,False,166,scaffold_1
17,3925001,3935000,9999,False,166,scaffold_1
18,3946001,4038000,91999,False,166,scaffold_1
19,4060001,4112000,51999,False,166,scaffold_1
20,4271001,4283000,11999,False,166,scaffold_1
21,4314001,4354000,39999,False,166,scaffold_1
22,4716001,4755000,38999,False,166,scaffold_1
23,4796001,4821000,24999,False,166,scaffold_1
24,4926001,4976000,49999,False,166,scaffold_1
25,5023001,5047000,23999,False,166,scaffold_1
26,5087001,5120000,32999,False,166,scaffold_1
27,5355001,5378000,22999,False,166,scaffold_1
28,5436001,5456000,19999,False,166,scaffold_1
29,5535001,5593000,57999,False,166,scaffold_1
30,5756001,5758000,1999,False,166,scaffold_1
31,5854001,5915000,60999,False,166,scaffold_1
32,6076001,7247000,1170999,False,166,scaffold_1
33,7248001,7588000,339999,False,166,scaffold_1
34,7590001,8656000,1065999,False,166,scaffold_1
35,8657001,9584000,926999,False,166,scaffold_1
36,9586001,11138000,1551999,False,166,scaffold_1
37,11285001,11304000,18999,False,166,scaffold_1
38,11329001,11428000,98999,False,166,scaffold_1
39,11444001,11528000,83999,False,166,scaffold_1
40,11570001,11869000,298999,False,166,scaffold_1
41,11893001,11918000,24999,False,166,scaffold_1
42,12652001,12722000,69999,False,166,scaffold_1
43,12825001,12888000,62999,False,166,scaffold_1
44,12964001,13001000,36999,False,166,scaffold_1
45,13023001,13065000,41999,False,166,scaffold_1
46,13094001,13216000,121999,False,166,scaffold_1
47,13342001,13387000,44999,False,166,scaffold_1
48,13557001,13589000,31999,False,166,scaffold_1
49,13594001,13615000,20999,False,166,scaffold_1
50,14133001,14138000,4999,False,166,scaffold_1
51,14450001,14469000,18999,False,166,scaffold_1
0,1,48000,47999,True,166,scaffold_2
1,51001,91000,39999,False,166,scaffold_2
2,95001,160000,64999,False,166,scaffold_2
3,164001,177000,12999,False,166,scaffold_2
4,213001,264000,50999,False,166,scaffold_2
5,333001,353000,19999,False,166,scaffold_2
6,563001,583000,19999,False,166,scaffold_2
7,585001,625000,39999,False,166,scaffold_2
8,1791001,1831000,39999,False,166,scaffold_2
9,2311001,2408000,96999,False,166,scaffold_2
10,2429001,2560000,130999,False,166,scaffold_2
11,2561001,2612000,50999,False,166,scaffold_2
12,2652001,2689000,36999,False,166,scaffold_2
13,2694001,2775000,80999,False,166,scaffold_2
14,2819001,2904000,84999,False,166,scaffold_2
15,2973001,3047000,73999,False,166,scaffold_2
16,3068001,3078000,9999,False,166,scaffold_2
17,3171001,3181000,9999,False,166,scaffold_2
18,3361001,3490000,128999,False,166,scaffold_2
19,3745001,3782000,36999,False,166,scaffold_2
20,3835001,3847000,11999,False,166,scaffold_2
21,4360001,4412000,51999,False,166,scaffold_2
22,4426001,4574000,147999,False,166,scaffold_2
23,4592001,4737000,144999,False,166,scaffold_2
24,4786001,4790000,3999,False,166,scaffold_2
25,4919001,4954000,34999,False,166,scaffold_2
26,5010001,5103000,92999,False,166,scaffold_2
27,5197001,5221000,23999,False,166,scaffold_2
28,5322001,5339000,16999,False,166,scaffold_2
29,5362001,5441000,78999,False,166,scaffold_2
30,5442001,5481000,38999,False,166,scaffold_2
31,5483001,5538000,54999,False,166,scaffold_2
32,5621001,5703000,81999,False,166,scaffold_2
33,5717001,5766000,48999,False,166,scaffold_2
34,5841001,5888000,46999,False,166,scaffold_2
35,5903001,6145000,241999,False,166,scaffold_2
36,6233001,6257000,23999,False,166,scaffold_2
37,6262001,6560000,297999,False,166,scaffold_2
38,6589001,6631000,41999,False,166,scaffold_2
39,6666001,6773000,106999,False,166,scaffold_2
40,6817001,7225000,407999,False,166,scaffold_2
41,7227001,7501000,273999,False,166,scaffold_2
42,7547001,7562000,14999,False,166,scaffold_2
43,7563001,8235000,671999,False,166,scaffold_2
44,8256001,8294000,37999,False,166,scaffold_2
45,8335001,8344000,8999,False,166,scaffold_2
46,8346001,8493000,146999,False,166,scaffold_2
47,8495001,8534000,38999,False,166,scaffold_2
48,8612001,8662000,49999,False,166,scaffold_2
49,8773001,8898000,124999,False,166,scaffold_2
50,8934001,9101000,166999,False,166,scaffold_2
51,9113001,9175000,61999,False,166,scaffold_2
52,9182001,9271000,88999,False,166,scaffold_2
53,9318001,9544000,225999,False,166,scaffold_2
54,9578001,9740000,161999,False,166,scaffold_2
55,9810001,9900000,89999,False,166,scaffold_2
56,10082001,10094000,11999,False,166,scaffold_2
57,10096001,10113000,16999,False,166,scaffold_2
58,10480001,10502000,21999,False,166,scaffold_2
59,10768001,10820000,51999,False,166,scaffold_2
60,10991001,10994000,2999,False,166,scaffold_2
61,10995001,11045000,49999,False,166,scaffold_2
62,11325001,11365000,39999,False,166,scaffold_2
63,11369001,11801000,431999,False,166,scaffold_2
0,528001,539000,10999,False,166,scaffold_3
1,575001,594000,18999,False,166,scaffold_3
2,618001,639000,20999,False,166,scaffold_3
3,674001,737000,62999,False,166,scaffold_3
4,773001,899000,125999,False,166,scaffold_3
5,1086001,1093000,6999,False,166,scaffold_3
6,1163001,1167000,3999,False,166,scaffold_3
7,1575001,1582000,6999,False,166,scaffold_3
8,1988001,2101000,112999,False,166,scaffold_3
9,2410001,2533000,122999,False,166,scaffold_3
10,2534001,2548000,13999,False,166,scaffold_3
11,2691001,2697000,5999,False,166,scaffold_3
12,2725001,2755000,29999,False,166,scaffold_3
13,3718001,3901000,182999,False,166,scaffold_3
14,3906001,3921000,14999,False,166,scaffold_3
15,3922001,3939000,16999,False,166,scaffold_3
16,4007001,4037000,29999,False,166,scaffold_3
17,4110001,4153000,42999,False,166,scaffold_3
18,4168001,4182000,13999,False,166,scaffold_3
19,4186001,4403000,216999,False,166,scaffold_3
20,4421001,4554000,132999,False,166,scaffold_3
21,4580001,4599000,18999,False,166,scaffold_3
22,5254001,5272000,17999,False,166,scaffold_3
23,5663001,5676000,12999,False,166,scaffold_3
24,5862001,5906000,43999,False,166,scaffold_3
25,5907001,5945000,37999,False,166,scaffold_3
26,6526001,6573000,46999,False,166,scaffold_3
27,6672001,6774000,101999,False,166,scaffold_3
28,6827001,7126000,298999,False,166,scaffold_3
29,7162001,7399000,236999,False,166,scaffold_3
30,7431001,7445000,13999,False,166,scaffold_3
31,7482001,7631000,148999,False,166,scaffold_3
32,7664001,7801000,136999,False,166,scaffold_3
33,7825001,7863000,37999,False,166,scaffold_3
34,8060001,8073000,12999,False,166,scaffold_3
35,8088001,8115000,26999,False,166,scaffold_3
36,8119001,8152000,32999,False,166,scaffold_3
37,8171001,8256000,84999,False,166,scaffold_3
38,8462001,8525000,62999,False,166,scaffold_3
39,8583001,8597000,13999,False,166,scaffold_3
40,9299001,9329000,29999,False,166,scaffold_3
41,9889001,10006000,116999,False,166,scaffold_3
42,10117001,10148000,30999,False,166,scaffold_3
43,10255001,10394000,138999,False,166,scaffold_3
44,10461001,11182071,721070,True,166,scaffold_3
0,1,7000,6999,True,166,scaffold_4
1,11001,13000,1999,False,166,scaffold_4
2,48001,112000,63999,False,166,scaffold_4
3,140001,151000,10999,False,166,scaffold_4
4,161001,215000,53999,False,166,scaffold_4
5,217001,226000,8999,False,166,scaffold_4
6,227001,263000,35999,False,166,scaffold_4
7,283001,307000,23999,False,166,scaffold_4
8,313001,353000,39999,False,166,scaffold_4
9,355001,380000,24999,False,166,scaffold_4
10,412001,425000,12999,False,166,scaffold_4
11,426001,428000,1999,False,166,scaffold_4
12,429001,494000,64999,False,166,scaffold_4
13,539001,592000,52999,False,166,scaffold_4
14,608001,691000,82999,False,166,scaffold_4
15,1029001,1042000,12999,False,166,scaffold_4
16,1087001,1136000,48999,False,166,scaffold_4
17,1138001,1182000,43999,False,166,scaffold_4
18,1210001,1216000,5999,False,166,scaffold_4
19,1237001,1253000,15999,False,166,scaffold_4
20,1294001,1313000,18999,False,166,scaffold_4
21,1354001,1597000,242999,False,166,scaffold_4
22,1613001,1715000,101999,False,166,scaffold_4
23,1770001,1799000,28999,False,166,scaffold_4
24,1905001,1988000,82999,False,166,scaffold_4
25,2038001,2062000,23999,False,166,scaffold_4
26,2219001,2229000,9999,False,166,scaffold_4
27,2231001,2246000,14999,False,166,scaffold_4
28,2247001,2250000,2999,False,166,scaffold_4
29,2252001,2274000,21999,False,166,scaffold_4
30,2285001,2357000,71999,False,166,scaffold_4
31,2371001,2394000,22999,False,166,scaffold_4
32,2417001,2460000,42999,False,166,scaffold_4
33,2480001,2549000,68999,False,166,scaffold_4
34,2608001,2635000,26999,False,166,scaffold_4
35,2978001,3006000,27999,False,166,scaffold_4
36,3084001,3128000,43999,False,166,scaffold_4
37,3334001,3766000,431999,False,166,scaffold_4
38,4052001,4086000,33999,False,166,scaffold_4
39,4241001,4317000,75999,False,166,scaffold_4
40,4533001,4545000,11999,False,166,scaffold_4
41,4670001,4688000,17999,False,166,scaffold_4
42,4703001,4755000,51999,False,166,scaffold_4
43,4905001,4985000,79999,False,166,scaffold_4
44,4988001,4999000,10999,False,166,scaffold_4
45,5171001,5208000,36999,False,166,scaffold_4
46,5306001,5409000,102999,False,166,scaffold_4
47,5472001,5506000,33999,False,166,scaffold_4
48,5516001,5784000,267999,False,166,scaffold_4
49,5786001,5818000,31999,False,166,scaffold_4
50,6149001,6195000,45999,False,166,scaffold_4
51,6414001,6438000,23999,False,166,scaffold_4
52,6615001,6617000,1999,False,166,scaffold_4
53,7037001,7102000,64999,False,166,scaffold_4
54,8849001,9014000,164999,False,166,scaffold_4
55,9030001,9699000,668999,False,166,scaffold_4
56,9700001,9845951,145950,True,166,scaffold_4
0,189001,204000,14999,False,166,scaffold_5
1,319001,401000,81999,False,166,scaffold_5
2,402001,416000,13999,False,166,scaffold_5
3,445001,523000,77999,False,166,scaffold_5
4,933001,947000,13999,False,166,scaffold_5
5,1540001,1557000,16999,False,166,scaffold_5
6,2094001,2104000,9999,False,166,scaffold_5
7,2258001,2283000,24999,False,166,scaffold_5
8,2349001,2370000,20999,False,166,scaffold_5
9,2476001,2515000,38999,False,166,scaffold_5
10,2542001,2729000,186999,False,166,scaffold_5
11,2817001,3256000,438999,False,166,scaffold_5
12,3279001,3399000,119999,False,166,scaffold_5
13,3402001,3502000,99999,False,166,scaffold_5
14,3549001,3574000,24999,False,166,scaffold_5
15,3621001,3641000,19999,False,166,scaffold_5
16,3771001,3883000,111999,False,166,scaffold_5
17,3956001,4061000,104999,False,166,scaffold_5
18,4118001,4366000,247999,False,166,scaffold_5
19,4387001,4495000,107999,False,166,scaffold_5
20,4609001,4808000,198999,False,166,scaffold_5
21,4826001,4924000,97999,False,166,scaffold_5
22,4952001,5118000,165999,False,166,scaffold_5
23,5171001,5184000,12999,False,166,scaffold_5
24,5223001,5345000,121999,False,166,scaffold_5
25,5348001,5359000,10999,False,166,scaffold_5
26,5694001,5770000,75999,False,166,scaffold_5
27,5862001,5889000,26999,False,166,scaffold_5
28,5922001,5935000,12999,False,166,scaffold_5
29,6391001,6441000,49999,False,166,scaffold_5
30,6492001,6750000,257999,False,166,scaffold_5
31,6879001,6907000,27999,False,166,scaffold_5
32,7161001,7221000,59999,False,166,scaffold_5
33,7225001,7226000,999,False,166,scaffold_5
34,7353001,7387000,33999,False,166,scaffold_5
35,7457001,7487000,29999,False,166,scaffold_5
36,7544001,7607000,62999,False,166,scaffold_5
37,7622001,7659000,36999,False,166,scaffold_5
38,7714001,7775000,60999,False,166,scaffold_5
39,8025001,8049000,23999,False,166,scaffold_5
40,8261001,8281000,19999,False,166,scaffold_5
41,8320001,8452000,131999,False,166,scaffold_5
42,8555001,9217000,661999,False,166,scaffold_5
43,9219001,9364176,145175,True,166,scaffold_5
0,69001,75000,5999,False,166,scaffold_6
1,77001,84000,6999,False,166,scaffold_6
2,86001,114000,27999,False,166,scaffold_6
3,164001,252000,87999,False,166,scaffold_6
4,268001,282000,13999,False,166,scaffold_6
5,312001,338000,25999,False,166,scaffold_6
6,1238001,1256000,17999,False,166,scaffold_6
7,1435001,1461000,25999,False,166,scaffold_6
8,1478001,1546000,67999,False,166,scaffold_6
9,2026001,2102000,75999,False,166,scaffold_6
10,2127001,2180000,52999,False,166,scaffold_6
11,2242001,2284000,41999,False,166,scaffold_6
12,2358001,2653000,294999,False,166,scaffold_6
13,2660001,2691000,30999,False,166,scaffold_6
14,2713001,2839000,125999,False,166,scaffold_6
15,2934001,3013000,78999,False,166,scaffold_6
16,3115001,3150000,34999,False,166,scaffold_6
17,3226001,3333000,106999,False,166,scaffold_6
18,3398001,3767000,368999,False,166,scaffold_6
19,3852001,3915000,62999,False,166,scaffold_6
20,3965001,4194000,228999,False,166,scaffold_6
21,5248001,5327000,78999,False,166,scaffold_6
22,5443001,5470000,26999,False,166,scaffold_6
23,5596001,5641000,44999,False,166,scaffold_6
24,5667001,5742000,74999,False,166,scaffold_6
25,5949001,6076000,126999,False,166,scaffold_6
26,6140001,6182000,41999,False,166,scaffold_6
27,6758001,6804000,45999,False,166,scaffold_6
28,6921001,6951000,29999,False,166,scaffold_6
29,7165001,7173000,7999,False,166,scaffold_6
30,7184001,7291000,106999,False,166,scaffold_6
31,7425001,7444000,18999,False,166,scaffold_6
32,7541001,8268281,727280,True,166,scaffold_6
0,14001,47000,32999,False,166,scaffold_7
1,323001,508000,184999,False,166,scaffold_7
2,571001,577000,5999,False,166,scaffold_7
3,622001,753000,130999,False,166,scaffold_7
4,764001,809000,44999,False,166,scaffold_7
5,810001,829000,18999,False,166,scaffold_7
6,830001,843000,12999,False,166,scaffold_7
7,868001,910000,41999,False,166,scaffold_7
8,914001,963000,48999,False,166,scaffold_7
9,964001,979000,14999,False,166,scaffold_7
10,982001,1044000,61999,False,166,scaffold_7
11,1072001,1099000,26999,False,166,scaffold_7
12,1191001,2125000,933999,False,166,scaffold_7
13,2791001,5170000,2378999,False,166,scaffold_7
14,5492001,5554000,61999,False,166,scaffold_7
15,6193001,6522000,328999,False,166,scaffold_7
16,6524001,7270000,745999,False,166,scaffold_7
17,7271001,7502216,231215,True,166,scaffold_7
0,1,7000,6999,True,166,scaffold_8
1,12001,23000,10999,False,166,scaffold_8
2,31001,64000,32999,False,166,scaffold_8
3,68001,85000,16999,False,166,scaffold_8
4,91001,101000,9999,False,166,scaffold_8
5,333001,355000,21999,False,166,scaffold_8
6,969001,971000,1999,False,166,scaffold_8
7,1021001,1042000,20999,False,166,scaffold_8
8,1363001,1426000,62999,False,166,scaffold_8
9,1801001,1940000,138999,False,166,scaffold_8
10,2068001,2134000,65999,False,166,scaffold_8
11,2249001,2584000,334999,False,166,scaffold_8
12,2652001,2683000,30999,False,166,scaffold_8
13,2685001,2722000,36999,False,166,scaffold_8
14,2741001,2755000,13999,False,166,scaffold_8
15,2799001,2844000,44999,False,166,scaffold_8
16,2865001,2883000,17999,False,166,scaffold_8
17,3057001,3130000,72999,False,166,scaffold_8
18,3131001,3613000,481999,False,166,scaffold_8
19,3615001,3985000,369999,False,166,scaffold_8
20,4007001,4111000,103999,False,166,scaffold_8
21,4168001,4286000,117999,False,166,scaffold_8
22,4565001,4671000,105999,False,166,scaffold_8
23,4821001,4879000,57999,False,166,scaffold_8
24,5009001,5243000,233999,False,166,scaffold_8
25,6327001,6334544,7543,True,166,scaffold_8
0,119001,148000,28999,False,166,scaffold_9
1,150001,170000,19999,False,166,scaffold_9
2,196001,216000,19999,False,166,scaffold_9
3,319001,411000,91999,False,166,scaffold_9
4,413001,435000,21999,False,166,scaffold_9
5,436001,464000,27999,False,166,scaffold_9
6,466001,531000,64999,False,166,scaffold_9
7,532001,579000,46999,False,166,scaffold_9
8,671001,697000,25999,False,166,scaffold_9
9,1414001,1420000,5999,False,166,scaffold_9
10,1768001,1793000,24999,False,166,scaffold_9
11,2601001,2682000,80999,False,166,scaffold_9
12,2730001,2798000,67999,False,166,scaffold_9
13,2843001,3269000,425999,False,166,scaffold_9
14,3277001,3362000,84999,False,166,scaffold_9
15,3371001,3381000,9999,False,166,scaffold_9
16,3399001,3636000,236999,False,166,scaffold_9
17,3680001,3757000,76999,False,166,scaffold_9
18,3762001,3780000,17999,False,166,scaffold_9
19,3959001,4027000,67999,False,166,scaffold_9
20,4050001,4227000,176999,False,166,scaffold_9
21,4314001,4393000,78999,False,166,scaffold_9
22,4439001,4456000,16999,False,166,scaffold_9
23,4531001,4613000,81999,False,166,scaffold_9
24,4689001,4731000,41999,False,166,scaffold_9
25,4821001,4846000,24999,False,166,scaffold_9
26,4873001,4900000,26999,False,166,scaffold_9
27,5031001,5083000,51999,False,166,scaffold_9
28,5112001,5238000,125999,False,166,scaffold_9
29,5239001,5298000,58999,False,166,scaffold_9
30,5300001,5745000,444999,False,166,scaffold_9
31,5770001,5847000,76999,False,166,scaffold_9
32,5857001,6011000,153999,False,166,scaffold_9
33,6019001,6087000,67999,False,166,scaffold_9
34,6088001,6138000,49999,False,166,scaffold_9
35,6170001,6234000,63999,False,166,scaffold_9
0,1,482000,481999,True,166,scaffold_10
1,483001,582000,98999,False,166,scaffold_10
2,596001,879000,282999,False,166,scaffold_10
3,891001,994000,102999,False,166,scaffold_10
4,1038001,1069000,30999,False,166,scaffold_10
5,1073001,1152000,78999,False,166,scaffold_10
6,1565001,1618000,52999,False,166,scaffold_10
7,2354001,2403000,48999,False,166,scaffold_10
8,4048001,4137000,88999,False,166,scaffold_10
9,4385001,4411000,25999,False,166,scaffold_10
10,4412001,4461000,48999,False,166,scaffold_10
11,4509001,4513000,3999,False,166,scaffold_10
12,4515001,4523000,7999,False,166,scaffold_10
13,4554001,4562000,7999,False,166,scaffold_10
14,4565001,4615000,49999,False,166,scaffold_10
15,4700001,4715000,14999,False,166,scaffold_10
16,4735001,4751000,15999,False,166,scaffold_10
17,4752001,4776000,23999,False,166,scaffold_10
18,4798001,4824000,25999,False,166,scaffold_10
19,4827001,4861000,33999,False,166,scaffold_10
20,4865001,4866973,1972,True,166,scaffold_10
0,9001,93000,83999,False,166,scaffold_11
1,132001,252000,119999,False,166,scaffold_11
2,404001,416000,11999,False,166,scaffold_11
3,419001,431000,11999,False,166,scaffold_11
4,433001,448000,14999,False,166,scaffold_11
5,649001,656000,6999,False,166,scaffold_11
6,1027001,1034000,6999,False,166,scaffold_11
7,1423001,1426000,2999,False,166,scaffold_11
8,1587001,1634000,46999,False,166,scaffold_11
9,1646001,1791000,144999,False,166,scaffold_11
10,2323001,2363000,39999,False,166,scaffold_11
11,2418001,2460000,41999,False,166,scaffold_11
12,2688001,2877000,188999,False,166,scaffold_11
13,2969001,3020000,50999,False,166,scaffold_11
14,3060001,3287000,226999,False,166,scaffold_11
15,3310001,3324000,13999,False,166,scaffold_11
16,3328001,3382000,53999,False,166,scaffold_11
17,3566001,3614000,47999,False,166,scaffold_11
18,3643001,3670000,26999,False,166,scaffold_11
19,3736001,3968000,231999,False,166,scaffold_11
20,4015001,4710000,694999,False,166,scaffold_11
21,4713001,4766820,53819,True,166,scaffold_11
0,1,1467000,1466999,True,166,scaffold_12
1,2463001,2479000,15999,False,166,scaffold_12
2,2559001,2566000,6999,False,166,scaffold_12
3,2571001,2618000,46999,False,166,scaffold_12
4,2625001,2641000,15999,False,166,scaffold_12
5,2642001,2657000,14999,False,166,scaffold_12
6,2685001,2699000,13999,False,166,scaffold_12
7,2710001,2718000,7999,False,166,scaffold_12
0,1,440000,439999,True,167,scaffold_1
1,482001,498000,15999,False,167,scaffold_1
2,571001,643000,71999,False,167,scaffold_1
3,686001,759000,72999,False,167,scaffold_1
4,1053001,1108000,54999,False,167,scaffold_1
5,1215001,1292000,76999,False,167,scaffold_1
6,1767001,1899000,131999,False,167,scaffold_1
7,1915001,1984000,68999,False,167,scaffold_1
8,2259001,2279000,19999,False,167,scaffold_1
9,2288001,2332000,43999,False,167,scaffold_1
10,2353001,2421000,67999,False,167,scaffold_1
11,2448001,2625000,176999,False,167,scaffold_1
12,2659001,2678000,18999,False,167,scaffold_1
13,2719001,3209000,489999,False,167,scaffold_1
14,3394001,3405000,10999,False,167,scaffold_1
15,3443001,3625000,181999,False,167,scaffold_1
16,3682001,3834000,151999,False,167,scaffold_1
17,3849001,3877000,27999,False,167,scaffold_1
18,3901001,4059000,157999,False,167,scaffold_1
19,4060001,4158000,97999,False,167,scaffold_1
20,4271001,4295000,23999,False,167,scaffold_1
21,4304001,4363000,58999,False,167,scaffold_1
22,4707001,4787000,79999,False,167,scaffold_1
23,4797001,4812000,14999,False,167,scaffold_1
24,4921001,5060000,138999,False,167,scaffold_1
25,5087001,5199000,111999,False,167,scaffold_1
26,5482001,5511000,28999,False,167,scaffold_1
27,5535001,5579000,43999,False,167,scaffold_1
28,5841001,5911000,69999,False,167,scaffold_1
29,6108001,6580000,471999,False,167,scaffold_1
30,6636001,6659000,22999,False,167,scaffold_1
31,6838001,6851000,12999,False,167,scaffold_1
32,7015001,7029000,13999,False,167,scaffold_1
33,7037001,7584000,546999,False,167,scaffold_1
34,7590001,8656000,1065999,False,167,scaffold_1
35,8658001,9584000,925999,False,167,scaffold_1
36,9586001,10370000,783999,False,167,scaffold_1
37,10450001,10790000,339999,False,167,scaffold_1
38,10835001,10873000,37999,False,167,scaffold_1
39,10971001,10978000,6999,False,167,scaffold_1
40,11280001,11307000,26999,False,167,scaffold_1
41,11308001,11535000,226999,False,167,scaffold_1
42,11550001,11988000,437999,False,167,scaffold_1
43,11994001,12020000,25999,False,167,scaffold_1
44,12122001,12243000,120999,False,167,scaffold_1
45,12397001,12442000,44999,False,167,scaffold_1
46,12630001,12722000,91999,False,167,scaffold_1
47,12772001,12947000,174999,False,167,scaffold_1
48,12961001,13010000,48999,False,167,scaffold_1
49,13022001,13211000,188999,False,167,scaffold_1
50,13346001,13423000,76999,False,167,scaffold_1
51,13517001,13537000,19999,False,167,scaffold_1
52,13592001,13611000,18999,False,167,scaffold_1
53,13901001,13907000,5999,False,167,scaffold_1
54,14290001,14309000,18999,False,167,scaffold_1
55,14357001,14366000,8999,False,167,scaffold_1
56,14743001,14751000,7999,False,167,scaffold_1
0,5001,48000,42999,False,167,scaffold_2
1,74001,159000,84999,False,167,scaffold_2
2,168001,177000,8999,False,167,scaffold_2
3,240001,282000,41999,False,167,scaffold_2
4,297001,318000,20999,False,167,scaffold_2
5,332001,375000,42999,False,167,scaffold_2
6,706001,739000,32999,False,167,scaffold_2
7,1923001,1960000,36999,False,167,scaffold_2
8,2085001,2107000,21999,False,167,scaffold_2
9,2312001,2560000,247999,False,167,scaffold_2
10,2561001,2638000,76999,False,167,scaffold_2
11,2646001,2691000,44999,False,167,scaffold_2
12,2694001,2746000,51999,False,167,scaffold_2
13,2803001,2857000,53999,False,167,scaffold_2
14,2868001,3046000,177999,False,167,scaffold_2
15,3271001,3279000,7999,False,167,scaffold_2
16,3334001,3344000,9999,False,167,scaffold_2
17,3360001,3439000,78999,False,167,scaffold_2
18,3454001,3486000,31999,False,167,scaffold_2
19,3670001,3690000,19999,False,167,scaffold_2
20,3752001,3790000,37999,False,167,scaffold_2
21,4229001,4277000,47999,False,167,scaffold_2
22,4339001,4765000,425999,False,167,scaffold_2
23,4782001,4790000,7999,False,167,scaffold_2
24,4866001,4954000,87999,False,167,scaffold_2
25,5021001,5105000,83999,False,167,scaffold_2
26,5107001,5170000,62999,False,167,scaffold_2
27,5171001,5224000,52999,False,167,scaffold_2
28,5250001,5565000,314999,False,167,scaffold_2
29,5616001,5764000,147999,False,167,scaffold_2
30,5835001,5888000,52999,False,167,scaffold_2
31,5900001,6079000,178999,False,167,scaffold_2
32,6244001,6330000,85999,False,167,scaffold_2
33,6331001,6351000,19999,False,167,scaffold_2
34,6384001,6449000,64999,False,167,scaffold_2
35,6501001,6645000,143999,False,167,scaffold_2
36,6710001,7241000,530999,False,167,scaffold_2
37,7264001,7478000,213999,False,167,scaffold_2
38,7491001,7526000,34999,False,167,scaffold_2
39,7548001,7561000,12999,False,167,scaffold_2
40,7563001,7732000,168999,False,167,scaffold_2
41,7759001,8311000,551999,False,167,scaffold_2
42,8340001,8345000,4999,False,167,scaffold_2
43,8346001,8455000,108999,False,167,scaffold_2
44,8461001,8493000,31999,False,167,scaffold_2
45,8495001,8591000,95999,False,167,scaffold_2
46,8612001,8651000,38999,False,167,scaffold_2
47,8804001,8848000,43999,False,167,scaffold_2
48,8933001,9097000,163999,False,167,scaffold_2
49,9146001,9308000,161999,False,167,scaffold_2
50,9321001,9508000,186999,False,167,scaffold_2
51,9563001,9697000,133999,False,167,scaffold_2
52,9840001,9896000,55999,False,167,scaffold_2
53,10445001,10467000,21999,False,167,scaffold_2
54,10471001,10562000,90999,False,167,scaffold_2
55,10757001,10766000,8999,False,167,scaffold_2
56,10773001,10819000,45999,False,167,scaffold_2
57,11029001,11076000,46999,False,167,scaffold_2
58,11315001,11345000,29999,False,167,scaffold_2
59,11366001,11502000,135999,False,167,scaffold_2
60,11520001,11802476,282475,True,167,scaffold_2
0,51001,55000,3999,False,167,scaffold_3
1,618001,646000,27999,False,167,scaffold_3
2,686001,737000,50999,False,167,scaffold_3
3,795001,901000,105999,False,167,scaffold_3
4,1076001,1084000,7999,False,167,scaffold_3
5,1166001,1192000,25999,False,167,scaffold_3
6,2050001,2108000,57999,False,167,scaffold_3
7,2110001,2117000,6999,False,167,scaffold_3
8,2263001,2339000,75999,False,167,scaffold_3
9,2434001,2532000,97999,False,167,scaffold_3
10,3731001,3821000,89999,False,167,scaffold_3
11,3822001,3894000,71999,False,167,scaffold_3
12,4108001,4403000,294999,False,167,scaffold_3
13,4410001,4559000,148999,False,167,scaffold_3
14,4567001,4578000,10999,False,167,scaffold_3
15,4580001,4704000,123999,False,167,scaffold_3
16,4730001,4819000,88999,False,167,scaffold_3
17,4855001,4903000,47999,False,167,scaffold_3
18,5159001,5196000,36999,False,167,scaffold_3
19,5254001,5271000,16999,False,167,scaffold_3
20,5409001,5443000,33999,False,167,scaffold_3
21,5808001,5954000,145999,False,167,scaffold_3
22,5989001,6024000,34999,False,167,scaffold_3
23,6447001,6588000,140999,False,167,scaffold_3
24,6621001,6962000,340999,False,167,scaffold_3
25,6980001,7098000,117999,False,167,scaffold_3
26,7113001,7157000,43999,False,167,scaffold_3
27,7222001,7301000,78999,False,167,scaffold_3
28,7333001,7416000,82999,False,167,scaffold_3
29,7462001,7480000,17999,False,167,scaffold_3
30,7482001,7565000,82999,False,167,scaffold_3
31,7574001,7632000,57999,False,167,scaffold_3
32,7672001,7867000,194999,False,167,scaffold_3
33,7910001,7943000,32999,False,167,scaffold_3
34,8026001,8043000,16999,False,167,scaffold_3
35,8044001,8118000,73999,False,167,scaffold_3
36,8174001,8255000,80999,False,167,scaffold_3
37,8402001,8527000,124999,False,167,scaffold_3
38,8574001,8594000,19999,False,167,scaffold_3
39,8605001,8634000,28999,False,167,scaffold_3
40,9020001,9075000,54999,False,167,scaffold_3
41,9966001,10147000,180999,False,167,scaffold_3
42,10225001,10458000,232999,False,167,scaffold_3
43,10461001,11182071,721070,True,167,scaffold_3
0,1,9000,8999,True,167,scaffold_4
1,17001,33000,15999,False,167,scaffold_4
2,48001,112000,63999,False,167,scaffold_4
3,148001,151000,2999,False,167,scaffold_4
4,154001,214000,59999,False,167,scaffold_4
5,217001,226000,8999,False,167,scaffold_4
6,227001,273000,45999,False,167,scaffold_4
7,283001,307000,23999,False,167,scaffold_4
8,316001,353000,36999,False,167,scaffold_4
9,355001,373000,17999,False,167,scaffold_4
10,375001,380000,4999,False,167,scaffold_4
11,383001,410000,26999,False,167,scaffold_4
12,412001,425000,12999,False,167,scaffold_4
13,426001,428000,1999,False,167,scaffold_4
14,429001,607000,177999,False,167,scaffold_4
15,608001,691000,82999,False,167,scaffold_4
16,1050001,1068000,17999,False,167,scaffold_4
17,1069001,1086000,16999,False,167,scaffold_4
18,1087001,1097000,9999,False,167,scaffold_4
19,1098001,1209000,110999,False,167,scaffold_4
20,1210001,1216000,5999,False,167,scaffold_4
21,1265001,1279000,13999,False,167,scaffold_4
22,1284001,1335000,50999,False,167,scaffold_4
23,1353001,1597000,243999,False,167,scaffold_4
24,1613001,1662000,48999,False,167,scaffold_4
25,1749001,1849000,99999,False,167,scaffold_4
26,1850001,1864000,13999,False,167,scaffold_4
27,1904001,1988000,83999,False,167,scaffold_4
28,2022001,2055000,32999,False,167,scaffold_4
29,2056001,2065000,8999,False,167,scaffold_4
30,2074001,2117000,42999,False,167,scaffold_4
31,2247001,2281000,33999,False,167,scaffold_4
32,2284001,2339000,54999,False,167,scaffold_4
33,2360001,2462000,101999,False,167,scaffold_4
34,2480001,2636000,155999,False,167,scaffold_4
35,2939001,3067000,127999,False,167,scaffold_4
36,3104001,3128000,23999,False,167,scaffold_4
37,3205001,3255000,49999,False,167,scaffold_4
38,3298001,3331000,32999,False,167,scaffold_4
39,3334001,3760000,425999,False,167,scaffold_4
40,3934001,3955000,20999,False,167,scaffold_4
41,4055001,4074000,18999,False,167,scaffold_4
42,4285001,4489000,203999,False,167,scaffold_4
43,4518001,4564000,45999,False,167,scaffold_4
44,4673001,4689000,15999,False,167,scaffold_4
45,4900001,5142000,241999,False,167,scaffold_4
46,5144001,5438000,293999,False,167,scaffold_4
47,5471001,5510000,38999,False,167,scaffold_4
48,5513001,5784000,270999,False,167,scaffold_4
49,5786001,5819000,32999,False,167,scaffold_4
50,5842001,5914000,71999,False,167,scaffold_4
51,5926001,5957000,30999,False,167,scaffold_4
52,6005001,6114000,108999,False,167,scaffold_4
53,6130001,6144000,13999,False,167,scaffold_4
54,6145001,6296000,150999,False,167,scaffold_4
55,6468001,6506000,37999,False,167,scaffold_4
56,6705001,6817000,111999,False,167,scaffold_4
57,6858001,6924000,65999,False,167,scaffold_4
58,6926001,7022000,95999,False,167,scaffold_4
59,7036001,7100000,63999,False,167,scaffold_4
60,7192001,7322000,129999,False,167,scaffold_4
61,7628001,7666000,37999,False,167,scaffold_4
62,7864001,7883000,18999,False,167,scaffold_4
63,7985001,8031000,45999,False,167,scaffold_4
64,8042001,8081000,38999,False,167,scaffold_4
65,8388001,8415000,26999,False,167,scaffold_4
66,8701001,8820000,118999,False,167,scaffold_4
67,8844001,9699000,854999,False,167,scaffold_4
68,9700001,9845951,145950,True,167,scaffold_4
0,1,15000,14999,True,167,scaffold_5
1,182001,204000,21999,False,167,scaffold_5
2,323001,419000,95999,False,167,scaffold_5
3,454001,523000,68999,False,167,scaffold_5
4,933001,956000,22999,False,167,scaffold_5
5,1275001,1283000,7999,False,167,scaffold_5
6,1531001,1557000,25999,False,167,scaffold_5
7,2094001,2097000,2999,False,167,scaffold_5
8,2100001,2104000,3999,False,167,scaffold_5
9,2106001,2117000,10999,False,167,scaffold_5
10,2258001,2317000,58999,False,167,scaffold_5
11,2476001,2493000,16999,False,167,scaffold_5
12,2546001,2755000,208999,False,167,scaffold_5
13,2791001,3042000,250999,False,167,scaffold_5
14,3051001,3564000,512999,False,167,scaffold_5
15,3607001,3755000,147999,False,167,scaffold_5
16,3836001,4377000,540999,False,167,scaffold_5
17,4393001,4527000,133999,False,167,scaffold_5
18,4557001,4751000,193999,False,167,scaffold_5
19,4752001,4926000,173999,False,167,scaffold_5
20,4964001,5097000,132999,False,167,scaffold_5
21,5141001,5347000,205999,False,167,scaffold_5
22,5348001,5356000,7999,False,167,scaffold_5
23,5499001,5544000,44999,False,167,scaffold_5
24,5546001,5571000,24999,False,167,scaffold_5
25,5686001,5738000,51999,False,167,scaffold_5
26,5751001,5766000,14999,False,167,scaffold_5
27,5863001,5889000,25999,False,167,scaffold_5
28,6326001,6727000,400999,False,167,scaffold_5
29,6760001,6935000,174999,False,167,scaffold_5
30,7049001,7083000,33999,False,167,scaffold_5
31,7164001,7242000,77999,False,167,scaffold_5
32,7292001,7328000,35999,False,167,scaffold_5
33,7334001,7387000,52999,False,167,scaffold_5
34,7406001,7449000,42999,False,167,scaffold_5
35,7454001,7514000,59999,False,167,scaffold_5
36,7516001,7698000,181999,False,167,scaffold_5
37,7718001,7747000,28999,False,167,scaffold_5
38,7782001,7803000,20999,False,167,scaffold_5
39,8019001,8032000,12999,False,167,scaffold_5
40,8258001,8282000,23999,False,167,scaffold_5
41,8292001,8309000,16999,False,167,scaffold_5
42,8322001,8345000,22999,False,167,scaffold_5
43,8358001,8470000,111999,False,167,scaffold_5
44,8552001,8616000,63999,False,167,scaffold_5
45,8666001,8687000,20999,False,167,scaffold_5
46,8712001,9364176,652175,True,167,scaffold_5
0,22001,39000,16999,False,167,scaffold_6
1,51001,75000,23999,False,167,scaffold_6
2,77001,121000,43999,False,167,scaffold_6
3,162001,253000,90999,False,167,scaffold_6
4,267001,376000,108999,False,167,scaffold_6
5,993001,1039000,45999,False,167,scaffold_6
6,1202001,1227000,24999,False,167,scaffold_6
7,1228001,1265000,36999,False,167,scaffold_6
8,1445001,1583000,137999,False,167,scaffold_6
9,1657001,1720000,62999,False,167,scaffold_6
10,1824001,1901000,76999,False,167,scaffold_6
11,2007001,2104000,96999,False,167,scaffold_6
12,2123001,2201000,77999,False,167,scaffold_6
13,2236001,2276000,39999,False,167,scaffold_6
14,2315001,2872000,556999,False,167,scaffold_6
15,2928001,3178000,249999,False,167,scaffold_6
16,3222001,3806000,583999,False,167,scaffold_6
17,3810001,4072000,261999,False,167,scaffold_6
18,4073001,4195000,121999,False,167,scaffold_6
19,5279001,5415000,135999,False,167,scaffold_6
20,5436001,5471000,34999,False,167,scaffold_6
21,5523001,5647000,123999,False,167,scaffold_6
22,5678001,5743000,64999,False,167,scaffold_6
23,5775001,5813000,37999,False,167,scaffold_6
24,5858001,5969000,110999,False,167,scaffold_6
25,6001001,6093000,91999,False,167,scaffold_6
26,6344001,6370000,25999,False,167,scaffold_6
27,6792001,6803000,10999,False,167,scaffold_6
28,6813001,6858000,44999,False,167,scaffold_6
29,6912001,7138000,225999,False,167,scaffold_6
30,7164001,7337000,172999,False,167,scaffold_6
31,7363001,7527000,163999,False,167,scaffold_6
32,7541001,8268281,727280,True,167,scaffold_6
0,1,31000,30999,True,167,scaffold_7
1,298001,340000,41999,False,167,scaffold_7
2,342001,409000,66999,False,167,scaffold_7
3,410001,508000,97999,False,167,scaffold_7
4,613001,753000,139999,False,167,scaffold_7
5,760001,841000,80999,False,167,scaffold_7
6,876001,963000,86999,False,167,scaffold_7
7,964001,966000,1999,False,167,scaffold_7
8,968001,981000,12999,False,167,scaffold_7
9,982001,1044000,61999,False,167,scaffold_7
10,1048001,1148000,99999,False,167,scaffold_7
11,1190001,1512000,321999,False,167,scaffold_7
12,1537001,1548000,10999,False,167,scaffold_7
13,1578001,1689000,110999,False,167,scaffold_7
14,1851001,1884000,32999,False,167,scaffold_7
15,2421001,2424000,2999,False,167,scaffold_7
16,2728001,2759000,30999,False,167,scaffold_7
17,2851001,3031000,179999,False,167,scaffold_7
18,3294001,3405000,110999,False,167,scaffold_7
19,3443001,3985000,541999,False,167,scaffold_7
20,4014001,4153000,138999,False,167,scaffold_7
21,4190001,4229000,38999,False,167,scaffold_7
22,4324001,4369000,44999,False,167,scaffold_7
23,4413001,4517000,103999,False,167,scaffold_7
24,4522001,4905000,382999,False,167,scaffold_7
25,4986001,5248000,261999,False,167,scaffold_7
26,5369001,5536000,166999,False,167,scaffold_7
27,6069001,6181000,111999,False,167,scaffold_7
28,6195001,6401000,205999,False,167,scaffold_7
29,6558001,6592000,33999,False,167,scaffold_7
30,6752001,6799000,46999,False,167,scaffold_7
31,6953001,7502216,549215,True,167,scaffold_7
0,30001,64000,33999,False,167,scaffold_8
1,66001,85000,18999,False,167,scaffold_8
2,900001,902000,1999,False,167,scaffold_8
3,1009001,1034000,24999,False,167,scaffold_8
4,1361001,1428000,66999,False,167,scaffold_8
5,1598001,1649000,50999,False,167,scaffold_8
6,1694001,1719000,24999,False,167,scaffold_8
7,1733001,1757000,23999,False,167,scaffold_8
8,1800001,2046000,245999,False,167,scaffold_8
9,2086001,2588000,501999,False,167,scaffold_8
10,2625001,2683000,57999,False,167,scaffold_8
11,2684001,2844000,159999,False,167,scaffold_8
12,3059001,3125000,65999,False,167,scaffold_8
13,3126001,3612000,485999,False,167,scaffold_8
14,3615001,3978000,362999,False,167,scaffold_8
15,4012001,4108000,95999,False,167,scaffold_8
16,4169001,4268000,98999,False,167,scaffold_8
17,4332001,4435000,102999,False,167,scaffold_8
18,4566001,4647000,80999,False,167,scaffold_8
19,5010001,5241000,230999,False,167,scaffold_8
20,5500001,5603000,102999,False,167,scaffold_8
21,5649001,5695000,45999,False,167,scaffold_8
22,6328001,6334544,6543,True,167,scaffold_8
0,1,24000,23999,True,167,scaffold_9
1,64001,106000,41999,False,167,scaffold_9
2,109001,117000,7999,False,167,scaffold_9
3,121001,138000,16999,False,167,scaffold_9
4,150001,182000,31999,False,167,scaffold_9
5,298001,318000,19999,False,167,scaffold_9
6,319001,338000,18999,False,167,scaffold_9
7,339001,411000,71999,False,167,scaffold_9
8,413001,434000,20999,False,167,scaffold_9
9,483001,531000,47999,False,167,scaffold_9
10,547001,563000,15999,False,167,scaffold_9
11,607001,659000,51999,False,167,scaffold_9
12,660001,665000,4999,False,167,scaffold_9
13,671001,698000,26999,False,167,scaffold_9
14,732001,743000,10999,False,167,scaffold_9
15,814001,847000,32999,False,167,scaffold_9
16,848001,861000,12999,False,167,scaffold_9
17,873001,986000,112999,False,167,scaffold_9
18,988001,995000,6999,False,167,scaffold_9
19,1010001,1031000,20999,False,167,scaffold_9
20,1034001,1085000,50999,False,167,scaffold_9
21,1087001,1165000,77999,False,167,scaffold_9
22,1284001,1378000,93999,False,167,scaffold_9
23,1760001,1792000,31999,False,167,scaffold_9
24,2600001,2673000,72999,False,167,scaffold_9
25,2735001,3381000,645999,False,167,scaffold_9
26,3383001,5110000,1726999,False,167,scaffold_9
27,5112001,5238000,125999,False,167,scaffold_9
28,5239001,5298000,58999,False,167,scaffold_9
29,5300001,6331288,1031287,True,167,scaffold_9
0,1,414000,413999,True,167,scaffold_10
1,415001,482000,66999,False,167,scaffold_10
2,483001,584000,100999,False,167,scaffold_10
3,596001,917000,320999,False,167,scaffold_10
4,923001,993000,69999,False,167,scaffold_10
5,1009001,1018000,8999,False,167,scaffold_10
6,1027001,1068000,40999,False,167,scaffold_10
7,1073001,1145000,71999,False,167,scaffold_10
8,1512001,1675000,162999,False,167,scaffold_10
9,2086001,2107000,20999,False,167,scaffold_10
10,2141001,2171000,29999,False,167,scaffold_10
11,2346001,2389000,42999,False,167,scaffold_10
12,4001001,4011000,9999,False,167,scaffold_10
13,4050001,4113000,62999,False,167,scaffold_10
14,4155001,4181000,25999,False,167,scaffold_10
15,4223001,4257000,33999,False,167,scaffold_10
16,4316001,4362000,45999,False,167,scaffold_10
17,4390001,4427000,36999,False,167,scaffold_10
18,4443001,4466000,22999,False,167,scaffold_10
19,4467001,4514000,46999,False,167,scaffold_10
20,4515001,4547000,31999,False,167,scaffold_10
21,4574001,4626000,51999,False,167,scaffold_10
22,4700001,4715000,14999,False,167,scaffold_10
23,4716001,4772000,55999,False,167,scaffold_10
24,4773001,4776000,2999,False,167,scaffold_10
25,4785001,4790000,4999,False,167,scaffold_10
26,4791001,4797000,5999,False,167,scaffold_10
27,4798001,4824000,25999,False,167,scaffold_10
28,4828001,4861000,32999,False,167,scaffold_10
29,4862001,4866973,4972,True,167,scaffold_10
0,11001,97000,85999,False,167,scaffold_11
1,132001,167000,34999,False,167,scaffold_11
2,169001,236000,66999,False,167,scaffold_11
3,240001,252000,11999,False,167,scaffold_11
4,278001,321000,42999,False,167,scaffold_11
5,369001,394000,24999,False,167,scaffold_11
6,419001,431000,11999,False,167,scaffold_11
7,433001,459000,25999,False,167,scaffold_11
8,648001,657000,8999,False,167,scaffold_11
9,741001,749000,7999,False,167,scaffold_11
10,1474001,1477000,2999,False,167,scaffold_11
11,2338001,2630000,291999,False,167,scaffold_11
12,2701001,2875000,173999,False,167,scaffold_11
13,2953001,3019000,65999,False,167,scaffold_11
14,3054001,3325000,270999,False,167,scaffold_11
15,3327001,3391000,63999,False,167,scaffold_11
16,3449001,3478000,28999,False,167,scaffold_11
17,3525001,3657000,131999,False,167,scaffold_11
18,3669001,3975000,305999,False,167,scaffold_11
19,3985001,4159000,173999,False,167,scaffold_11
20,4319001,4710000,390999,False,167,scaffold_11
21,4713001,4766820,53819,True,167,scaffold_11
0,1,1518000,1517999,True,167,scaffold_12
1,1541001,1588000,46999,False,167,scaffold_12
2,1716001,1762000,45999,False,167,scaffold_12
3,2571001,2618000,46999,False,167,scaffold_12
4,2660001,2708000,47999,False,167,scaffold_12
5,2709001,2722000,12999,False,167,scaffold_12
0,1,440000,439999,True,168,scaffold_1
1,482001,498000,15999,False,168,scaffold_1
2,570001,643000,72999,False,168,scaffold_1
3,684001,759000,74999,False,168,scaffold_1
4,795001,900000,104999,False,168,scaffold_1
5,1044001,1087000,42999,False,168,scaffold_1
6,1167001,1292000,124999,False,168,scaffold_1
7,1618001,1660000,41999,False,168,scaffold_1
8,1818001,1900000,81999,False,168,scaffold_1
9,1915001,1964000,48999,False,168,scaffold_1
10,1965001,1984000,18999,False,168,scaffold_1
11,1988001,2019000,30999,False,168,scaffold_1
12,2262001,2312000,49999,False,168,scaffold_1
13,2341001,2415000,73999,False,168,scaffold_1
14,2449001,2518000,68999,False,168,scaffold_1
15,2562001,2583000,20999,False,168,scaffold_1
16,2664001,2677000,12999,False,168,scaffold_1
17,2725001,2746000,20999,False,168,scaffold_1
18,2887001,2925000,37999,False,168,scaffold_1
19,2960001,3210000,249999,False,168,scaffold_1
20,3444001,3628000,183999,False,168,scaffold_1
21,3703001,4032000,328999,False,168,scaffold_1
22,4066001,4157000,90999,False,168,scaffold_1
23,4259001,4300000,40999,False,168,scaffold_1
24,4304001,4368000,63999,False,168,scaffold_1
25,4480001,4543000,62999,False,168,scaffold_1
26,4706001,4786000,79999,False,168,scaffold_1
27,4796001,4813000,16999,False,168,scaffold_1
28,4918001,5067000,148999,False,168,scaffold_1
29,5084001,5200000,115999,False,168,scaffold_1
30,5480001,5519000,38999,False,168,scaffold_1
31,5535001,5586000,50999,False,168,scaffold_1
32,5851001,5947000,95999,False,168,scaffold_1
33,6031001,6069000,37999,False,168,scaffold_1
34,6108001,6381000,272999,False,168,scaffold_1
35,6384001,6575000,190999,False,168,scaffold_1
36,6635001,6658000,22999,False,168,scaffold_1
37,6724001,6760000,35999,False,168,scaffold_1
38,6790001,6859000,68999,False,168,scaffold_1
39,7000001,7589000,588999,False,168,scaffold_1
40,7590001,8640000,1049999,False,168,scaffold_1
41,8644001,8656000,11999,False,168,scaffold_1
42,8658001,9584000,925999,False,168,scaffold_1
43,9586001,10401000,814999,False,168,scaffold_1
44,10448001,10788000,339999,False,168,scaffold_1
45,10839001,10858000,18999,False,168,scaffold_1
46,10915001,10940000,24999,False,168,scaffold_1
47,10947001,10990000,42999,False,168,scaffold_1
48,11014001,11073000,58999,False,168,scaffold_1
49,11265001,11963000,697999,False,168,scaffold_1
50,12058001,12251000,192999,False,168,scaffold_1
51,12426001,12450000,23999,False,168,scaffold_1
52,12492001,12544000,51999,False,168,scaffold_1
53,12623001,12990000,366999,False,168,scaffold_1
54,12991001,13216000,224999,False,168,scaffold_1
55,13334001,13446000,111999,False,168,scaffold_1
56,13559001,13589000,29999,False,168,scaffold_1
57,13591001,13611000,19999,False,168,scaffold_1
58,14290001,14307000,16999,False,168,scaffold_1
0,1,48000,47999,True,168,scaffold_2
1,67001,159000,91999,False,168,scaffold_2
2,168001,176000,7999,False,168,scaffold_2
3,253001,290000,36999,False,168,scaffold_2
4,301001,318000,16999,False,168,scaffold_2
5,332001,381000,48999,False,168,scaffold_2
6,719001,739000,19999,False,168,scaffold_2
7,1522001,1562000,39999,False,168,scaffold_2
8,1813001,1861000,47999,False,168,scaffold_2
9,2085001,2111000,25999,False,168,scaffold_2
10,2303001,2334000,30999,False,168,scaffold_2
11,2336001,2637000,300999,False,168,scaffold_2
12,2647001,2689000,41999,False,168,scaffold_2
13,2693001,2747000,53999,False,168,scaffold_2
14,2766001,2788000,21999,False,168,scaffold_2
15,2803001,2856000,52999,False,168,scaffold_2
16,2868001,3021000,152999,False,168,scaffold_2
17,3022001,3095000,72999,False,168,scaffold_2
18,3332001,3436000,103999,False,168,scaffold_2
19,3450001,3487000,36999,False,168,scaffold_2
20,3676001,3690000,13999,False,168,scaffold_2
21,3754001,3791000,36999,False,168,scaffold_2
22,4095001,4139000,43999,False,168,scaffold_2
23,4208001,4766000,557999,False,168,scaffold_2
24,4783001,4790000,6999,False,168,scaffold_2
25,4793001,4799000,5999,False,168,scaffold_2
26,4904001,4970000,65999,False,168,scaffold_2
27,5018001,5104000,85999,False,168,scaffold_2
28,5173001,5222000,48999,False,168,scaffold_2
29,5250001,5284000,33999,False,168,scaffold_2
30,5285001,5782000,496999,False,168,scaffold_2
31,5840001,6079000,238999,False,168,scaffold_2
32,6091001,6185000,93999,False,168,scaffold_2
33,6235001,6351000,115999,False,168,scaffold_2
34,6392001,6483000,90999,False,168,scaffold_2
35,6505001,6632000,126999,False,168,scaffold_2
36,6688001,6762000,73999,False,168,scaffold_2
37,6798001,6991000,192999,False,168,scaffold_2
38,7005001,7038000,32999,False,168,scaffold_2
39,7050001,7237000,186999,False,168,scaffold_2
40,7331001,7478000,146999,False,168,scaffold_2
41,7488001,7518000,29999,False,168,scaffold_2
42,7546001,7561000,14999,False,168,scaffold_2
43,7563001,8329000,765999,False,168,scaffold_2
44,8331001,8345000,13999,False,168,scaffold_2
45,8346001,8564000,217999,False,168,scaffold_2
46,8809001,8825000,15999,False,168,scaffold_2
47,8930001,9099000,168999,False,168,scaffold_2
48,9146001,9302000,155999,False,168,scaffold_2
49,9303001,9549000,245999,False,168,scaffold_2
50,9563001,9809000,245999,False,168,scaffold_2
51,10234001,10251000,16999,False,168,scaffold_2
52,10338001,10348000,9999,False,168,scaffold_2
53,10438001,10466000,27999,False,168,scaffold_2
54,10475001,10560000,84999,False,168,scaffold_2
55,10678001,10694000,15999,False,168,scaffold_2
56,10709001,10730000,20999,False,168,scaffold_2
57,11060001,11106000,45999,False,168,scaffold_2
58,11367001,11503000,135999,False,168,scaffold_2
59,11517001,11802476,285475,True,168,scaffold_2
0,618001,647000,28999,False,168,scaffold_3
1,798001,901000,102999,False,168,scaffold_3
2,902001,921000,18999,False,168,scaffold_3
3,1068001,1084000,15999,False,168,scaffold_3
4,1163001,1193000,29999,False,168,scaffold_3
5,1941001,1980000,38999,False,168,scaffold_3
6,1998001,2147000,148999,False,168,scaffold_3
7,2288001,2344000,55999,False,168,scaffold_3
8,2403001,2428000,24999,False,168,scaffold_3
9,2433001,2560000,126999,False,168,scaffold_3
10,2655001,2750000,94999,False,168,scaffold_3
11,3066001,3086000,19999,False,168,scaffold_3
12,3109001,3144000,34999,False,168,scaffold_3
13,3260001,3340000,79999,False,168,scaffold_3
14,3605001,3894000,288999,False,168,scaffold_3
15,3994001,4037000,42999,False,168,scaffold_3
16,4096001,4398000,301999,False,168,scaffold_3
17,4411001,4522000,110999,False,168,scaffold_3
18,4545001,4558000,12999,False,168,scaffold_3
19,4568001,4578000,9999,False,168,scaffold_3
20,4580001,4599000,18999,False,168,scaffold_3
21,4652001,4682000,29999,False,168,scaffold_3
22,4697001,4724000,26999,False,168,scaffold_3
23,4776001,4811000,34999,False,168,scaffold_3
24,4896001,4926000,29999,False,168,scaffold_3
25,4971001,5053000,81999,False,168,scaffold_3
26,5054001,5208000,153999,False,168,scaffold_3
27,5240001,5272000,31999,False,168,scaffold_3
28,5349001,5470000,120999,False,168,scaffold_3
29,5494001,5506000,11999,False,168,scaffold_3
30,5807001,6030000,222999,False,168,scaffold_3
31,6039001,6128000,88999,False,168,scaffold_3
32,6479001,6606000,126999,False,168,scaffold_3
33,6608001,6617000,8999,False,168,scaffold_3
34,6619001,7157000,537999,False,168,scaffold_3
35,7222001,7328000,105999,False,168,scaffold_3
36,7333001,7399000,65999,False,168,scaffold_3
37,7483001,7557000,73999,False,168,scaffold_3
38,7572001,7622000,49999,False,168,scaffold_3
39,7681001,7909000,227999,False,168,scaffold_3
40,7910001,7980000,69999,False,168,scaffold_3
41,8027001,8116000,88999,False,168,scaffold_3
42,8121001,8156000,34999,False,168,scaffold_3
43,8175001,8256000,80999,False,168,scaffold_3
44,8335001,8350000,14999,False,168,scaffold_3
45,8378001,8529000,150999,False,168,scaffold_3
46,8542001,8594000,51999,False,168,scaffold_3
47,8605001,8627000,21999,False,168,scaffold_3
48,8653001,8683000,29999,False,168,scaffold_3
49,8757001,8806000,48999,False,168,scaffold_3
50,9004001,9080000,75999,False,168,scaffold_3
51,9337001,9369000,31999,False,168,scaffold_3
52,9498001,9579000,80999,False,168,scaffold_3
53,9967001,10149000,181999,False,168,scaffold_3
54,10223001,10388000,164999,False,168,scaffold_3
55,10418001,10458000,39999,False,168,scaffold_3
56,10461001,10547000,85999,False,168,scaffold_3
57,10548001,11182071,634070,True,168,scaffold_3
0,1,7000,6999,True,168,scaffold_4
1,11001,13000,1999,False,168,scaffold_4
2,14001,16000,1999,False,168,scaffold_4
3,48001,88000,39999,False,168,scaffold_4
4,91001,115000,23999,False,168,scaffold_4
5,120001,146000,25999,False,168,scaffold_4
6,147001,151000,3999,False,168,scaffold_4
7,155001,215000,59999,False,168,scaffold_4
8,217001,226000,8999,False,168,scaffold_4
9,227001,276000,48999,False,168,scaffold_4
10,283001,310000,26999,False,168,scaffold_4
11,318001,342000,23999,False,168,scaffold_4
12,355001,372000,16999,False,168,scaffold_4
13,389001,425000,35999,False,168,scaffold_4
14,429001,504000,74999,False,168,scaffold_4
15,510001,592000,81999,False,168,scaffold_4
16,593001,691000,97999,False,168,scaffold_4
17,701001,726000,24999,False,168,scaffold_4
18,1043001,1048000,4999,False,168,scaffold_4
19,1087001,1097000,9999,False,168,scaffold_4
20,1120001,1136000,15999,False,168,scaffold_4
21,1137001,1208000,70999,False,168,scaffold_4
22,1210001,1226000,15999,False,168,scaffold_4
23,1268001,1279000,10999,False,168,scaffold_4
24,1284001,1600000,315999,False,168,scaffold_4
25,1613001,2117000,503999,False,168,scaffold_4
26,2119001,2186000,66999,False,168,scaffold_4
27,2219001,2246000,26999,False,168,scaffold_4
28,2247001,2279000,31999,False,168,scaffold_4
29,2283001,2461000,177999,False,168,scaffold_4
30,2480001,2812000,331999,False,168,scaffold_4
31,2917001,3127000,209999,False,168,scaffold_4
32,3205001,3840000,634999,False,168,scaffold_4
33,3910001,3952000,41999,False,168,scaffold_4
34,3996001,4124000,127999,False,168,scaffold_4
35,4219001,4308000,88999,False,168,scaffold_4
36,4344001,4413000,68999,False,168,scaffold_4
37,4531001,4551000,19999,False,168,scaffold_4
38,4703001,4739000,35999,False,168,scaffold_4
39,4831001,4881000,49999,False,168,scaffold_4
40,4900001,5505000,604999,False,168,scaffold_4
41,5514001,5784000,269999,False,168,scaffold_4
42,5786001,5968000,181999,False,168,scaffold_4
43,6048001,6144000,95999,False,168,scaffold_4
44,6145001,6200000,54999,False,168,scaffold_4
45,6212001,6277000,64999,False,168,scaffold_4
46,6329001,6510000,180999,False,168,scaffold_4
47,6620001,6635000,14999,False,168,scaffold_4
48,6697001,6817000,119999,False,168,scaffold_4
49,6841001,6924000,82999,False,168,scaffold_4
50,6926001,7124000,197999,False,168,scaffold_4
51,7147001,7477000,329999,False,168,scaffold_4
52,7497001,7556000,58999,False,168,scaffold_4
53,7628001,7668000,39999,False,168,scaffold_4
54,7860001,7911000,50999,False,168,scaffold_4
55,7985001,8019000,33999,False,168,scaffold_4
56,8355001,8364000,8999,False,168,scaffold_4
57,8391001,8427000,35999,False,168,scaffold_4
58,8844001,9699000,854999,False,168,scaffold_4
59,9700001,9845951,145950,True,168,scaffold_4
0,127001,166000,38999,False,168,scaffold_5
1,318001,419000,100999,False,168,scaffold_5
2,442001,526000,83999,False,168,scaffold_5
3,669001,698000,28999,False,168,scaffold_5
4,933001,956000,22999,False,168,scaffold_5
5,2477001,2501000,23999,False,168,scaffold_5
6,2502001,2515000,12999,False,168,scaffold_5
7,2516001,3027000,510999,False,168,scaffold_5
8,3094001,3564000,469999,False,168,scaffold_5
9,3608001,3660000,51999,False,168,scaffold_5
10,3718001,3872000,153999,False,168,scaffold_5
11,3892001,4341000,448999,False,168,scaffold_5
12,4342001,4861000,518999,False,168,scaffold_5
13,4892001,4924000,31999,False,168,scaffold_5
14,4959001,5106000,146999,False,168,scaffold_5
15,5131001,5345000,213999,False,168,scaffold_5
16,5497001,5537000,39999,False,168,scaffold_5
17,5696001,5737000,40999,False,168,scaffold_5
18,6206001,6262000,55999,False,168,scaffold_5
19,6328001,6354000,25999,False,168,scaffold_5
20,6391001,6907000,515999,False,168,scaffold_5
21,7034001,7086000,51999,False,168,scaffold_5
22,7153001,7273000,119999,False,168,scaffold_5
23,7291001,7330000,38999,False,168,scaffold_5
24,7334001,7386000,51999,False,168,scaffold_5
25,7408001,7425000,16999,False,168,scaffold_5
26,7454001,7514000,59999,False,168,scaffold_5
27,7523001,7806000,282999,False,168,scaffold_5
28,7857001,7898000,40999,False,168,scaffold_5
29,7947001,7968000,20999,False,168,scaffold_5
30,8258001,8313000,54999,False,168,scaffold_5
31,8370001,8469000,98999,False,168,scaffold_5
32,8551001,8617000,65999,False,168,scaffold_5
33,8653001,8687000,33999,False,168,scaffold_5
34,8705001,9364176,659175,True,168,scaffold_5
0,78001,84000,5999,False,168,scaffold_6
1,86001,121000,34999,False,168,scaffold_6
2,162001,210000,47999,False,168,scaffold_6
3,240001,253000,12999,False,168,scaffold_6
4,266001,371000,104999,False,168,scaffold_6
5,833001,846000,12999,False,168,scaffold_6
6,965001,1024000,58999,False,168,scaffold_6
7,1142001,1226000,83999,False,168,scaffold_6
8,1228001,1264000,35999,False,168,scaffold_6
9,1284001,1310000,25999,False,168,scaffold_6
10,1431001,1598000,166999,False,168,scaffold_6
11,1657001,1905000,247999,False,168,scaffold_6
12,2024001,2214000,189999,False,168,scaffold_6
13,2235001,2286000,50999,False,168,scaffold_6
14,2334001,2871000,536999,False,168,scaffold_6
15,2927001,3806000,878999,False,168,scaffold_6
16,3810001,3848000,37999,False,168,scaffold_6
17,3887001,3889000,1999,False,168,scaffold_6
18,3893001,4195000,301999,False,168,scaffold_6
19,4609001,4659000,49999,False,168,scaffold_6
20,4838001,4867000,28999,False,168,scaffold_6
21,4954001,5006000,51999,False,168,scaffold_6
22,5282001,5407000,124999,False,168,scaffold_6
23,5436001,5652000,215999,False,168,scaffold_6
24,5678001,5772000,93999,False,168,scaffold_6
25,5774001,5825000,50999,False,168,scaffold_6
26,5859001,6189000,329999,False,168,scaffold_6
27,6253001,6275000,21999,False,168,scaffold_6
28,6718001,6804000,85999,False,168,scaffold_6
29,6833001,6869000,35999,False,168,scaffold_6
30,6911001,6942000,30999,False,168,scaffold_6
31,6973001,7140000,166999,False,168,scaffold_6
32,7165001,7342000,176999,False,168,scaffold_6
33,7382001,7489000,106999,False,168,scaffold_6
34,7544001,7867000,322999,False,168,scaffold_6
35,7868001,8268281,400280,True,168,scaffold_6
0,309001,340000,30999,False,168,scaffold_7
1,343001,507000,163999,False,168,scaffold_7
2,554001,563000,8999,False,168,scaffold_7
3,571001,591000,19999,False,168,scaffold_7
4,614001,753000,138999,False,168,scaffold_7
5,764001,829000,64999,False,168,scaffold_7
6,868001,872000,3999,False,168,scaffold_7
7,874001,945000,70999,False,168,scaffold_7
8,964001,966000,1999,False,168,scaffold_7
9,968001,1044000,75999,False,168,scaffold_7
10,1048001,1101000,52999,False,168,scaffold_7
11,1191001,1512000,320999,False,168,scaffold_7
12,1588001,1694000,105999,False,168,scaffold_7
13,1975001,2015000,39999,False,168,scaffold_7
14,2223001,2262000,38999,False,168,scaffold_7
15,2450001,2465000,14999,False,168,scaffold_7
16,2610001,2652000,41999,False,168,scaffold_7
17,2851001,2953000,101999,False,168,scaffold_7
18,3095001,3125000,29999,False,168,scaffold_7
19,3293001,3422000,128999,False,168,scaffold_7
20,3433001,3978000,544999,False,168,scaffold_7
21,4021001,4067000,45999,False,168,scaffold_7
22,4134001,4153000,18999,False,168,scaffold_7
23,4297001,4517000,219999,False,168,scaffold_7
24,4547001,4967000,419999,False,168,scaffold_7
25,4978001,5202000,223999,False,168,scaffold_7
26,5322001,5327000,4999,False,168,scaffold_7
27,5366001,5438000,71999,False,168,scaffold_7
28,5470001,5537000,66999,False,168,scaffold_7
29,6102001,6420000,317999,False,168,scaffold_7
30,6557001,6668000,110999,False,168,scaffold_7
31,6694001,6799000,104999,False,168,scaffold_7
32,6939001,7502216,563215,True,168,scaffold_7
0,31001,85000,53999,False,168,scaffold_8
1,1362001,1426000,63999,False,168,scaffold_8
2,1733001,1761000,27999,False,168,scaffold_8
3,1800001,1978000,177999,False,168,scaffold_8
4,2077001,2192000,114999,False,168,scaffold_8
5,2199001,2586000,386999,False,168,scaffold_8
6,2651001,2844000,192999,False,168,scaffold_8
7,2847001,2890000,42999,False,168,scaffold_8
8,2950001,3612000,661999,False,168,scaffold_8
9,3615001,4128000,512999,False,168,scaffold_8
10,4169001,4232000,62999,False,168,scaffold_8
11,4330001,4432000,101999,False,168,scaffold_8
12,4561001,4670000,108999,False,168,scaffold_8
13,4860001,4885000,24999,False,168,scaffold_8
14,4906001,4914000,7999,False,168,scaffold_8
15,4999001,5042000,42999,False,168,scaffold_8
16,5068001,5270000,201999,False,168,scaffold_8
17,5440001,5598000,157999,False,168,scaffold_8
18,5651001,5703000,51999,False,168,scaffold_8
19,6226001,6285000,58999,False,168,scaffold_8
20,6323001,6334544,11543,True,168,scaffold_8
0,109001,119000,9999,False,168,scaffold_9
1,121001,138000,16999,False,168,scaffold_9
2,271001,276000,4999,False,168,scaffold_9
3,358001,411000,52999,False,168,scaffold_9
4,413001,423000,9999,False,168,scaffold_9
5,502001,531000,28999,False,168,scaffold_9
6,533001,534000,999,False,168,scaffold_9
7,540001,545000,4999,False,168,scaffold_9
8,547001,563000,15999,False,168,scaffold_9
9,634001,665000,30999,False,168,scaffold_9
10,671001,697000,25999,False,168,scaffold_9
11,817001,847000,29999,False,168,scaffold_9
12,850001,864000,13999,False,168,scaffold_9
13,870001,986000,115999,False,168,scaffold_9
14,988001,995000,6999,False,168,scaffold_9
15,1001001,1150000,148999,False,168,scaffold_9
16,1151001,1176000,24999,False,168,scaffold_9
17,1239001,1256000,16999,False,168,scaffold_9
18,1312001,1377000,64999,False,168,scaffold_9
19,1749001,1792000,42999,False,168,scaffold_9
20,1987001,2032000,44999,False,168,scaffold_9
21,2138001,2198000,59999,False,168,scaffold_9
22,2317001,2329000,11999,False,168,scaffold_9
23,2594001,2696000,101999,False,168,scaffold_9
24,2735001,3381000,645999,False,168,scaffold_9
25,3383001,5110000,1726999,False,168,scaffold_9
26,5112001,5115000,2999,False,168,scaffold_9
27,5116001,5298000,181999,False,168,scaffold_9
28,5300001,6331288,1031287,True,168,scaffold_9
0,1,482000,481999,True,168,scaffold_10
1,483001,793000,309999,False,168,scaffold_10
2,805001,1069000,263999,False,168,scaffold_10
3,1073001,1209000,135999,False,168,scaffold_10
4,1384001,1466000,81999,False,168,scaffold_10
5,1500001,1676000,175999,False,168,scaffold_10
6,1803001,1820000,16999,False,168,scaffold_10
7,2040001,2109000,68999,False,168,scaffold_10
8,2140001,2172000,31999,False,168,scaffold_10
9,2263001,2327000,63999,False,168,scaffold_10
10,2336001,2442000,105999,False,168,scaffold_10
11,2552001,2630000,77999,False,168,scaffold_10
12,2807001,2865000,57999,False,168,scaffold_10
13,3110001,3133000,22999,False,168,scaffold_10
14,3397001,3402000,4999,False,168,scaffold_10
15,4050001,4091000,40999,False,168,scaffold_10
16,4154001,4175000,20999,False,168,scaffold_10
17,4232001,4257000,24999,False,168,scaffold_10
18,4316001,4324000,7999,False,168,scaffold_10
19,4334001,4367000,32999,False,168,scaffold_10
20,4441001,4466000,24999,False,168,scaffold_10
21,4467001,4513000,45999,False,168,scaffold_10
22,4515001,4548000,32999,False,168,scaffold_10
23,4554001,4562000,7999,False,168,scaffold_10
24,4565001,4631000,65999,False,168,scaffold_10
25,4700001,4715000,14999,False,168,scaffold_10
26,4716001,4732000,15999,False,168,scaffold_10
27,4734001,4751000,16999,False,168,scaffold_10
28,4752001,4766000,13999,False,168,scaffold_10
29,4798001,4824000,25999,False,168,scaffold_10
30,4828001,4843000,14999,False,168,scaffold_10
0,9001,109000,99999,False,168,scaffold_11
1,132001,212000,79999,False,168,scaffold_11
2,213001,236000,22999,False,168,scaffold_11
3,240001,252000,11999,False,168,scaffold_11
4,278001,320000,41999,False,168,scaffold_11
5,419001,431000,11999,False,168,scaffold_11
6,648001,656000,7999,False,168,scaffold_11
7,1028001,1034000,5999,False,168,scaffold_11
8,1403001,1409000,5999,False,168,scaffold_11
9,2115001,2153000,37999,False,168,scaffold_11
10,2406001,2516000,109999,False,168,scaffold_11
11,2540001,2646000,105999,False,168,scaffold_11
12,2660001,2920000,259999,False,168,scaffold_11
13,2948001,3025000,76999,False,168,scaffold_11
14,3059001,3180000,120999,False,168,scaffold_11
15,3185001,3385000,199999,False,168,scaffold_11
16,3429001,3483000,53999,False,168,scaffold_11
17,3518001,3972000,453999,False,168,scaffold_11
18,3985001,4159000,173999,False,168,scaffold_11
19,4180001,4710000,529999,False,168,scaffold_11
20,4712001,4766820,54819,True,168,scaffold_11
0,1,1469000,1468999,True,168,scaffold_12
1,1472001,1496000,23999,False,168,scaffold_12
2,1546001,1588000,41999,False,168,scaffold_12
3,1717001,1812000,94999,False,168,scaffold_12
4,2341001,2362000,20999,False,168,scaffold_12
5,2571001,2618000,46999,False,168,scaffold_12
0,1,351000,350999,True,169,scaffold_1
1,482001,498000,15999,False,169,scaffold_1
2,571001,643000,71999,False,169,scaffold_1
3,686001,759000,72999,False,169,scaffold_1
4,1059001,1094000,34999,False,169,scaffold_1
5,1231001,1292000,60999,False,169,scaffold_1
6,1613001,1693000,79999,False,169,scaffold_1
7,1810001,1899000,88999,False,169,scaffold_1
8,1950001,1964000,13999,False,169,scaffold_1
9,1965001,1984000,18999,False,169,scaffold_1
10,2356001,2413000,56999,False,169,scaffold_1
11,2447001,2534000,86999,False,169,scaffold_1
12,2537001,2621000,83999,False,169,scaffold_1
13,2725001,2749000,23999,False,169,scaffold_1
14,2867001,3026000,158999,False,169,scaffold_1
15,3048001,3089000,40999,False,169,scaffold_1
16,3175001,3209000,33999,False,169,scaffold_1
17,3444001,3499000,54999,False,169,scaffold_1
18,3500001,3628000,127999,False,169,scaffold_1
19,3702001,3783000,80999,False,169,scaffold_1
20,3801001,3833000,31999,False,169,scaffold_1
21,3898001,3941000,42999,False,169,scaffold_1
22,3990001,4033000,42999,False,169,scaffold_1
23,4062001,4153000,90999,False,169,scaffold_1
24,4314001,4360000,45999,False,169,scaffold_1
25,4709001,4745000,35999,False,169,scaffold_1
26,4922001,5057000,134999,False,169,scaffold_1
27,5087001,5120000,32999,False,169,scaffold_1
28,5481001,5511000,29999,False,169,scaffold_1
29,5535001,5595000,59999,False,169,scaffold_1
30,5849001,5917000,67999,False,169,scaffold_1
31,6108001,6153000,44999,False,169,scaffold_1
32,6154001,6579000,424999,False,169,scaffold_1
33,6632001,6658000,25999,False,169,scaffold_1
34,6836001,6853000,16999,False,169,scaffold_1
35,7037001,7587000,549999,False,169,scaffold_1
36,7590001,8656000,1065999,False,169,scaffold_1
37,8658001,9114000,455999,False,169,scaffold_1
38,9115001,9584000,468999,False,169,scaffold_1
39,9586001,10370000,783999,False,169,scaffold_1
40,10460001,10766000,305999,False,169,scaffold_1
41,10835001,10857000,21999,False,169,scaffold_1
42,11013001,11029000,15999,False,169,scaffold_1
43,11283001,11513000,229999,False,169,scaffold_1
44,11551001,11963000,411999,False,169,scaffold_1
45,12184001,12243000,58999,False,169,scaffold_1
46,12645001,12757000,111999,False,169,scaffold_1
47,12775001,12950000,174999,False,169,scaffold_1
48,12965001,13065000,99999,False,169,scaffold_1
49,13094001,13211000,116999,False,169,scaffold_1
50,13347001,13429000,81999,False,169,scaffold_1
51,13517001,13536000,18999,False,169,scaffold_1
52,13561001,13583000,21999,False,169,scaffold_1
53,14093001,14096000,2999,False,169,scaffold_1
54,14285001,14312000,26999,False,169,scaffold_1
0,1,48000,47999,True,169,scaffold_2
1,68001,91000,22999,False,169,scaffold_2
2,93001,159000,65999,False,169,scaffold_2
3,168001,177000,8999,False,169,scaffold_2
4,296001,318000,21999,False,169,scaffold_2
5,332001,374000,41999,False,169,scaffold_2
6,720001,739000,18999,False,169,scaffold_2
7,2336001,2609000,272999,False,169,scaffold_2
8,2647001,2689000,41999,False,169,scaffold_2
9,2694001,2749000,54999,False,169,scaffold_2
10,2766001,2776000,9999,False,169,scaffold_2
11,2777001,2788000,10999,False,169,scaffold_2
12,2822001,2857000,34999,False,169,scaffold_2
13,2870001,2905000,34999,False,169,scaffold_2
14,2972001,3021000,48999,False,169,scaffold_2
15,3022001,3058000,35999,False,169,scaffold_2
16,3333001,3343000,9999,False,169,scaffold_2
17,3365001,3397000,31999,False,169,scaffold_2
18,3450001,3487000,36999,False,169,scaffold_2
19,3754001,3784000,29999,False,169,scaffold_2
20,4242001,4280000,37999,False,169,scaffold_2
21,4300001,4321000,20999,False,169,scaffold_2
22,4337001,4507000,169999,False,169,scaffold_2
23,4520001,4671000,150999,False,169,scaffold_2
24,4718001,4760000,41999,False,169,scaffold_2
25,4783001,4790000,6999,False,169,scaffold_2
26,4891001,4962000,70999,False,169,scaffold_2
27,5020001,5104000,83999,False,169,scaffold_2
28,5176001,5224000,47999,False,169,scaffold_2
29,5285001,5314000,28999,False,169,scaffold_2
30,5361001,5563000,201999,False,169,scaffold_2
31,5606001,5762000,155999,False,169,scaffold_2
32,5840001,6080000,239999,False,169,scaffold_2
33,6226001,6350000,123999,False,169,scaffold_2
34,6384001,6449000,64999,False,169,scaffold_2
35,6507001,6523000,15999,False,169,scaffold_2
36,6591001,6630000,38999,False,169,scaffold_2
37,6695001,6767000,71999,False,169,scaffold_2
38,6810001,6979000,168999,False,169,scaffold_2
39,7005001,7038000,32999,False,169,scaffold_2
40,7050001,7240000,189999,False,169,scaffold_2
41,7331001,7476000,144999,False,169,scaffold_2
42,7491001,7518000,26999,False,169,scaffold_2
43,7547001,7562000,14999,False,169,scaffold_2
44,7563001,7921000,357999,False,169,scaffold_2
45,7934001,8313000,378999,False,169,scaffold_2
46,8346001,8454000,107999,False,169,scaffold_2
47,8465001,8562000,96999,False,169,scaffold_2
48,9017001,9061000,43999,False,169,scaffold_2
49,9118001,9175000,56999,False,169,scaffold_2
50,9316001,9382000,65999,False,169,scaffold_2
51,9421001,9497000,75999,False,169,scaffold_2
52,9572001,9636000,63999,False,169,scaffold_2
53,9673001,9697000,23999,False,169,scaffold_2
54,10474001,10503000,28999,False,169,scaffold_2
55,11025001,11075000,49999,False,169,scaffold_2
56,11367001,11386000,18999,False,169,scaffold_2
57,11392001,11502000,109999,False,169,scaffold_2
58,11519001,11802476,283475,True,169,scaffold_2
0,618001,647000,28999,False,169,scaffold_3
1,796001,901000,104999,False,169,scaffold_3
2,2009001,2108000,98999,False,169,scaffold_3
3,2265001,2325000,59999,False,169,scaffold_3
4,2432001,2458000,25999,False,169,scaffold_3
5,2459001,2533000,73999,False,169,scaffold_3
6,3712001,3891000,178999,False,169,scaffold_3
7,4108001,4400000,291999,False,169,scaffold_3
8,4417001,4522000,104999,False,169,scaffold_3
9,4545001,4558000,12999,False,169,scaffold_3
10,4568001,4578000,9999,False,169,scaffold_3
11,4580001,4600000,19999,False,169,scaffold_3
12,4637001,4682000,44999,False,169,scaffold_3
13,4698001,4719000,20999,False,169,scaffold_3
14,4768001,4809000,40999,False,169,scaffold_3
15,5239001,5272000,32999,False,169,scaffold_3
16,5805001,5918000,112999,False,169,scaffold_3
17,5919001,5954000,34999,False,169,scaffold_3
18,5990001,6019000,28999,False,169,scaffold_3
19,6656001,6699000,42999,False,169,scaffold_3
20,6738001,6794000,55999,False,169,scaffold_3
21,6860001,6962000,101999,False,169,scaffold_3
22,6963001,7156000,192999,False,169,scaffold_3
23,7250001,7302000,51999,False,169,scaffold_3
24,7336001,7401000,64999,False,169,scaffold_3
25,7462001,7563000,100999,False,169,scaffold_3
26,7678001,7838000,159999,False,169,scaffold_3
27,7911001,7943000,31999,False,169,scaffold_3
28,8086001,8112000,25999,False,169,scaffold_3
29,8175001,8254000,78999,False,169,scaffold_3
30,8398001,8528000,129999,False,169,scaffold_3
31,8575001,8594000,18999,False,169,scaffold_3
32,9054001,9075000,20999,False,169,scaffold_3
33,9967001,10006000,38999,False,169,scaffold_3
34,10040001,10087000,46999,False,169,scaffold_3
35,10248001,10367000,118999,False,169,scaffold_3
36,10417001,10458000,40999,False,169,scaffold_3
37,10461001,11182071,721070,True,169,scaffold_3
0,1,7000,6999,True,169,scaffold_4
1,17001,29000,11999,False,169,scaffold_4
2,48001,112000,63999,False,169,scaffold_4
3,120001,151000,30999,False,169,scaffold_4
4,161001,215000,53999,False,169,scaffold_4
5,218001,226000,7999,False,169,scaffold_4
6,227001,266000,38999,False,169,scaffold_4
7,283001,311000,27999,False,169,scaffold_4
8,312001,345000,32999,False,169,scaffold_4
9,355001,372000,16999,False,169,scaffold_4
10,390001,425000,34999,False,169,scaffold_4
11,429001,505000,75999,False,169,scaffold_4
12,510001,592000,81999,False,169,scaffold_4
13,593001,606000,12999,False,169,scaffold_4
14,608001,691000,82999,False,169,scaffold_4
15,1121001,1198000,76999,False,169,scaffold_4
16,1199001,1204000,4999,False,169,scaffold_4
17,1271001,1279000,7999,False,169,scaffold_4
18,1283001,1336000,52999,False,169,scaffold_4
19,1355001,1392000,36999,False,169,scaffold_4
20,1393001,1598000,204999,False,169,scaffold_4
21,1613001,1692000,78999,False,169,scaffold_4
22,1749001,1866000,116999,False,169,scaffold_4
23,1904001,2003000,98999,False,169,scaffold_4
24,2073001,2099000,25999,False,169,scaffold_4
25,2240001,2246000,5999,False,169,scaffold_4
26,2247001,2340000,92999,False,169,scaffold_4
27,2342001,2461000,118999,False,169,scaffold_4
28,2476001,2635000,158999,False,169,scaffold_4
29,2940001,2956000,15999,False,169,scaffold_4
30,3030001,3066000,35999,False,169,scaffold_4
31,3090001,3128000,37999,False,169,scaffold_4
32,3226001,3262000,35999,False,169,scaffold_4
33,3299001,3318000,18999,False,169,scaffold_4
34,3335001,3761000,425999,False,169,scaffold_4
35,4707001,4745000,37999,False,169,scaffold_4
36,4900001,5117000,216999,False,169,scaffold_4
37,5172001,5224000,51999,False,169,scaffold_4
38,5282001,5414000,131999,False,169,scaffold_4
39,5475001,5506000,30999,False,169,scaffold_4
40,5515001,5784000,268999,False,169,scaffold_4
41,5786001,5818000,31999,False,169,scaffold_4
42,6071001,6083000,11999,False,169,scaffold_4
43,6146001,6197000,50999,False,169,scaffold_4
44,6615001,6617000,1999,False,169,scaffold_4
45,6723001,6818000,94999,False,169,scaffold_4
46,6869001,6924000,54999,False,169,scaffold_4
47,7036001,7124000,87999,False,169,scaffold_4
48,7148001,7323000,174999,False,169,scaffold_4
49,7629001,7665000,35999,False,169,scaffold_4
50,7985001,8001000,15999,False,169,scaffold_4
51,8845001,9596000,750999,False,169,scaffold_4
52,9597001,9845951,248950,True,169,scaffold_4
0,1,6000,5999,True,169,scaffold_5
1,139001,173000,33999,False,169,scaffold_5
2,190001,204000,13999,False,169,scaffold_5
3,318001,428000,109999,False,169,scaffold_5
4,441001,523000,81999,False,169,scaffold_5
5,933001,947000,13999,False,169,scaffold_5
6,2106001,2117000,10999,False,169,scaffold_5
7,2257001,2311000,53999,False,169,scaffold_5
8,2549001,2896000,346999,False,169,scaffold_5
9,2963001,3041000,77999,False,169,scaffold_5
10,3132001,3512000,379999,False,169,scaffold_5
11,3615001,3660000,44999,False,169,scaffold_5
12,3720001,3745000,24999,False,169,scaffold_5
13,3961001,4321000,359999,False,169,scaffold_5
14,4446001,5098000,651999,False,169,scaffold_5
15,5258001,5274000,15999,False,169,scaffold_5
16,5283001,5344000,60999,False,169,scaffold_5
17,5498001,5528000,29999,False,169,scaffold_5
18,5686001,5738000,51999,False,169,scaffold_5
19,6392001,6662000,269999,False,169,scaffold_5
20,6888001,6907000,18999,False,169,scaffold_5
21,7017001,7085000,67999,False,169,scaffold_5
22,7168001,7244000,75999,False,169,scaffold_5
23,7406001,7441000,34999,False,169,scaffold_5
24,7453001,7514000,60999,False,169,scaffold_5
25,7516001,7668000,151999,False,169,scaffold_5
26,7711001,7747000,35999,False,169,scaffold_5
27,7985001,7997000,11999,False,169,scaffold_5
28,8258001,8280000,21999,False,169,scaffold_5
29,8332001,8365000,32999,False,169,scaffold_5
30,8400001,8470000,69999,False,169,scaffold_5
31,8550001,8621000,70999,False,169,scaffold_5
32,8641001,8687000,45999,False,169,scaffold_5
33,8702001,9364176,662175,True,169,scaffold_5
0,63001,74000,10999,False,169,scaffold_6
1,86001,121000,34999,False,169,scaffold_6
2,163001,209000,45999,False,169,scaffold_6
3,239001,254000,14999,False,169,scaffold_6
4,268001,313000,44999,False,169,scaffold_6
5,1233001,1265000,31999,False,169,scaffold_6
6,1286001,1303000,16999,False,169,scaffold_6
7,1431001,1583000,151999,False,169,scaffold_6
8,1832001,1906000,73999,False,169,scaffold_6
9,2026001,2105000,78999,False,169,scaffold_6
10,2126001,2211000,84999,False,169,scaffold_6
11,2235001,2284000,48999,False,169,scaffold_6
12,2316001,2653000,336999,False,169,scaffold_6
13,2659001,2864000,204999,False,169,scaffold_6
14,2927001,3031000,103999,False,169,scaffold_6
15,3074001,3177000,102999,False,169,scaffold_6
16,3221001,3350000,128999,False,169,scaffold_6
17,3394001,3806000,411999,False,169,scaffold_6
18,3882001,3913000,30999,False,169,scaffold_6
19,3937001,4072000,134999,False,169,scaffold_6
20,4073001,4195000,121999,False,169,scaffold_6
21,5282001,5314000,31999,False,169,scaffold_6
22,5550001,5747000,196999,False,169,scaffold_6
23,5775001,5805000,29999,False,169,scaffold_6
24,5944001,5969000,24999,False,169,scaffold_6
25,6009001,6083000,73999,False,169,scaffold_6
26,6126001,6183000,56999,False,169,scaffold_6
27,6766001,6804000,37999,False,169,scaffold_6
28,6923001,6953000,29999,False,169,scaffold_6
29,7163001,7339000,175999,False,169,scaffold_6
30,7363001,7529000,165999,False,169,scaffold_6
31,7541001,8268281,727280,True,169,scaffold_6
0,1,7000,6999,True,169,scaffold_7
1,299001,509000,209999,False,169,scaffold_7
2,570001,598000,27999,False,169,scaffold_7
3,616001,675000,58999,False,169,scaffold_7
4,688001,754000,65999,False,169,scaffold_7
5,764001,842000,77999,False,169,scaffold_7
6,867001,908000,40999,False,169,scaffold_7
7,952001,963000,10999,False,169,scaffold_7
8,964001,980000,15999,False,169,scaffold_7
9,982001,1044000,61999,False,169,scaffold_7
10,1048001,1124000,75999,False,169,scaffold_7
11,1191001,1512000,320999,False,169,scaffold_7
12,1567001,1693000,125999,False,169,scaffold_7
13,2187001,2196000,8999,False,169,scaffold_7
14,2851001,2958000,106999,False,169,scaffold_7
15,3015001,3025000,9999,False,169,scaffold_7
16,3292001,3373000,80999,False,169,scaffold_7
17,3381001,3422000,40999,False,169,scaffold_7
18,3485001,3841000,355999,False,169,scaffold_7
19,3915001,3985000,69999,False,169,scaffold_7
20,4029001,4058000,28999,False,169,scaffold_7
21,4190001,4228000,37999,False,169,scaffold_7
22,4323001,4369000,45999,False,169,scaffold_7
23,4414001,4517000,102999,False,169,scaffold_7
24,4552001,4596000,43999,False,169,scaffold_7
25,4622001,4906000,283999,False,169,scaffold_7
26,4978001,5150000,171999,False,169,scaffold_7
27,5400001,5434000,33999,False,169,scaffold_7
28,5472001,5538000,65999,False,169,scaffold_7
29,6103001,6235000,131999,False,169,scaffold_7
30,6312001,6389000,76999,False,169,scaffold_7
31,6558001,6593000,34999,False,169,scaffold_7
32,6751001,6797000,45999,False,169,scaffold_7
33,6953001,7502216,549215,True,169,scaffold_7
0,2001,6000,3999,False,169,scaffold_8
1,31001,85000,53999,False,169,scaffold_8
2,93001,101000,7999,False,169,scaffold_8
3,1393001,1425000,31999,False,169,scaffold_8
4,1733001,1753000,19999,False,169,scaffold_8
5,1828001,1981000,152999,False,169,scaffold_8
6,2087001,2134000,46999,False,169,scaffold_8
7,2223001,2267000,43999,False,169,scaffold_8
8,2354001,2531000,176999,False,169,scaffold_8
9,2647001,2683000,35999,False,169,scaffold_8
10,2738001,2844000,105999,False,169,scaffold_8
11,3058001,3125000,66999,False,169,scaffold_8
12,3126001,3974000,847999,False,169,scaffold_8
13,4012001,4106000,93999,False,169,scaffold_8
14,4173001,4268000,94999,False,169,scaffold_8
15,4330001,4420000,89999,False,169,scaffold_8
16,4822001,4858000,35999,False,169,scaffold_8
17,5029001,5058000,28999,False,169,scaffold_8
18,5076001,5241000,164999,False,169,scaffold_8
19,5500001,5596000,95999,False,169,scaffold_8
20,5652001,5695000,42999,False,169,scaffold_8
21,6329001,6334544,5543,True,169,scaffold_8
0,1,22000,21999,True,169,scaffold_9
1,109001,117000,7999,False,169,scaffold_9
2,121001,138000,16999,False,169,scaffold_9
3,236001,242000,5999,False,169,scaffold_9
4,366001,411000,44999,False,169,scaffold_9
5,413001,433000,19999,False,169,scaffold_9
6,482001,531000,48999,False,169,scaffold_9
7,652001,665000,12999,False,169,scaffold_9
8,671001,697000,25999,False,169,scaffold_9
9,732001,742000,9999,False,169,scaffold_9
10,813001,847000,33999,False,169,scaffold_9
11,848001,861000,12999,False,169,scaffold_9
12,873001,986000,112999,False,169,scaffold_9
13,988001,996000,7999,False,169,scaffold_9
14,1001001,1007000,5999,False,169,scaffold_9
15,1009001,1177000,167999,False,169,scaffold_9
16,1312001,1377000,64999,False,169,scaffold_9
17,1758001,1803000,44999,False,169,scaffold_9
18,2601001,2616000,14999,False,169,scaffold_9
19,2735001,3381000,645999,False,169,scaffold_9
20,3383001,3390000,6999,False,169,scaffold_9
21,3391001,5111000,1719999,False,169,scaffold_9
22,5112001,5115000,2999,False,169,scaffold_9
23,5116001,5238000,121999,False,169,scaffold_9
24,5239001,5298000,58999,False,169,scaffold_9
25,5300001,6331288,1031287,True,169,scaffold_9
0,1,369000,368999,True,169,scaffold_10
1,371001,414000,42999,False,169,scaffold_10
2,415001,482000,66999,False,169,scaffold_10
3,483001,585000,101999,False,169,scaffold_10
4,603001,796000,192999,False,169,scaffold_10
5,811001,878000,66999,False,169,scaffold_10
6,888001,1069000,180999,False,169,scaffold_10
7,1073001,1152000,78999,False,169,scaffold_10
8,1603001,1625000,21999,False,169,scaffold_10
9,2088001,2107000,18999,False,169,scaffold_10
10,2346001,2392000,45999,False,169,scaffold_10
11,4050001,4093000,42999,False,169,scaffold_10
12,4154001,4174000,19999,False,169,scaffold_10
13,4335001,4367000,31999,False,169,scaffold_10
14,4379001,4411000,31999,False,169,scaffold_10
15,4444001,4462000,17999,False,169,scaffold_10
16,4467001,4513000,45999,False,169,scaffold_10
17,4515001,4523000,7999,False,169,scaffold_10
18,4526001,4548000,21999,False,169,scaffold_10
19,4554001,4562000,7999,False,169,scaffold_10
20,4565001,4597000,31999,False,169,scaffold_10
21,4716001,4732000,15999,False,169,scaffold_10
22,4734001,4776000,41999,False,169,scaffold_10
23,4798001,4824000,25999,False,169,scaffold_10
24,4827001,4861000,33999,False,169,scaffold_10
25,4865001,4866973,1972,True,169,scaffold_10
0,10001,93000,82999,False,169,scaffold_11
1,132001,167000,34999,False,169,scaffold_11
2,169001,236000,66999,False,169,scaffold_11
3,240001,252000,11999,False,169,scaffold_11
4,288001,321000,32999,False,169,scaffold_11
5,419001,431000,11999,False,169,scaffold_11
6,433001,441000,7999,False,169,scaffold_11
7,647001,656000,8999,False,169,scaffold_11
8,682001,692000,9999,False,169,scaffold_11
9,1028001,1034000,5999,False,169,scaffold_11
10,1423001,1427000,3999,False,169,scaffold_11
11,2393001,2429000,35999,False,169,scaffold_11
12,2451001,2498000,46999,False,169,scaffold_11
13,2691001,2874000,182999,False,169,scaffold_11
14,2952001,3020000,67999,False,169,scaffold_11
15,3060001,3297000,236999,False,169,scaffold_11
16,3299001,3383000,83999,False,169,scaffold_11
17,3573001,3914000,340999,False,169,scaffold_11
18,3915001,3927000,11999,False,169,scaffold_11
19,3956001,3968000,11999,False,169,scaffold_11
20,4009001,4162000,152999,False,169,scaffold_11
21,4189001,4218000,28999,False,169,scaffold_11
22,4317001,4710000,392999,False,169,scaffold_11
23,4712001,4766820,54819,True,169,scaffold_11
0,1,1470000,1469999,True,169,scaffold_12
1,1551001,1586000,34999,False,169,scaffold_12
2,1719001,1754000,34999,False,169,scaffold_12
3,2571001,2617000,45999,False,169,scaffold_12
4,2660001,2681000,20999,False,169,scaffold_12
5,2685001,2708000,22999,False,169,scaffold_12
6,2710001,2722000,11999,False,169,scaffold_12
0,1,396000,395999,True,170,scaffold_1
1,484001,498000,13999,False,170,scaffold_1
2,570001,643000,72999,False,170,scaffold_1
3,686001,759000,72999,False,170,scaffold_1
4,1246001,1292000,45999,False,170,scaffold_1
5,1611001,1673000,61999,False,170,scaffold_1
6,1806001,1900000,93999,False,170,scaffold_1
7,1950001,1964000,13999,False,170,scaffold_1
8,1965001,1983000,17999,False,170,scaffold_1
9,2267001,2330000,62999,False,170,scaffold_1
10,2355001,2414000,58999,False,170,scaffold_1
11,2448001,2524000,75999,False,170,scaffold_1
12,2554001,2621000,66999,False,170,scaffold_1
13,2656001,2694000,37999,False,170,scaffold_1
14,2725001,2746000,20999,False,170,scaffold_1
15,2905001,2921000,15999,False,170,scaffold_1
16,2960001,3024000,63999,False,170,scaffold_1
17,3101001,3209000,107999,False,170,scaffold_1
18,3442001,3637000,194999,False,170,scaffold_1
19,3700001,4157000,456999,False,170,scaffold_1
20,4305001,4355000,49999,False,170,scaffold_1
21,4649001,4694000,44999,False,170,scaffold_1
22,4709001,4786000,76999,False,170,scaffold_1
23,4928001,5066000,137999,False,170,scaffold_1
24,5087001,5154000,66999,False,170,scaffold_1
25,5436001,5512000,75999,False,170,scaffold_1
26,5534001,5584000,49999,False,170,scaffold_1
27,5850001,5916000,65999,False,170,scaffold_1
28,6108001,6577000,468999,False,170,scaffold_1
29,6640001,6662000,21999,False,170,scaffold_1
30,6835001,6853000,17999,False,170,scaffold_1
31,7037001,7588000,550999,False,170,scaffold_1
32,7590001,8656000,1065999,False,170,scaffold_1
33,8658001,9584000,925999,False,170,scaffold_1
34,9586001,10364000,777999,False,170,scaffold_1
35,10450001,10762000,311999,False,170,scaffold_1
36,10832001,10857000,24999,False,170,scaffold_1
37,10914001,10942000,27999,False,170,scaffold_1
38,11014001,11070000,55999,False,170,scaffold_1
39,11280001,11964000,683999,False,170,scaffold_1
40,12183001,12249000,65999,False,170,scaffold_1
41,12382001,12396000,13999,False,170,scaffold_1
42,12398001,12450000,51999,False,170,scaffold_1
43,12492001,12526000,33999,False,170,scaffold_1
44,12624001,12942000,317999,False,170,scaffold_1
45,12963001,13002000,38999,False,170,scaffold_1
46,13024001,13042000,17999,False,170,scaffold_1
47,13096001,13217000,120999,False,170,scaffold_1
48,13346001,13405000,58999,False,170,scaffold_1
49,13558001,13587000,28999,False,170,scaffold_1
50,14287001,14310000,22999,False,170,scaffold_1
0,1,48000,47999,True,170,scaffold_2
1,68001,91000,22999,False,170,scaffold_2
2,95001,159000,63999,False,170,scaffold_2
3,168001,177000,8999,False,170,scaffold_2
4,296001,318000,21999,False,170,scaffold_2
5,332001,374000,41999,False,170,scaffold_2
6,732001,739000,6999,False,170,scaffold_2
7,2086001,2107000,20999,False,170,scaffold_2
8,2314001,2334000,19999,False,170,scaffold_2
9,2336001,2634000,297999,False,170,scaffold_2
10,2660001,2689000,28999,False,170,scaffold_2
11,2693001,2746000,52999,False,170,scaffold_2
12,2767001,2776000,8999,False,170,scaffold_2
13,2777001,2788000,10999,False,170,scaffold_2
14,2815001,2856000,40999,False,170,scaffold_2
15,2877001,2934000,56999,False,170,scaffold_2
16,2974001,3021000,46999,False,170,scaffold_2
17,3022001,3058000,35999,False,170,scaffold_2
18,3286001,3290000,3999,False,170,scaffold_2
19,3332001,3413000,80999,False,170,scaffold_2
20,3450001,3487000,36999,False,170,scaffold_2
21,3658001,3710000,51999,False,170,scaffold_2
22,3754001,3789000,34999,False,170,scaffold_2
23,4242001,4320000,77999,False,170,scaffold_2
24,4339001,4409000,69999,False,170,scaffold_2
25,4426001,4764000,337999,False,170,scaffold_2
26,4783001,4790000,6999,False,170,scaffold_2
27,4793001,4797000,3999,False,170,scaffold_2
28,4890001,4962000,71999,False,170,scaffold_2
29,5018001,5104000,85999,False,170,scaffold_2
30,5150001,5224000,73999,False,170,scaffold_2
31,5255001,5590000,334999,False,170,scaffold_2
32,5607001,5779000,171999,False,170,scaffold_2
33,5840001,5893000,52999,False,170,scaffold_2
34,5914001,6080000,165999,False,170,scaffold_2
35,6094001,6140000,45999,False,170,scaffold_2
36,6228001,6330000,101999,False,170,scaffold_2
37,6331001,6351000,19999,False,170,scaffold_2
38,6385001,6481000,95999,False,170,scaffold_2
39,6546001,6635000,88999,False,170,scaffold_2
40,6696001,6724000,27999,False,170,scaffold_2
41,6810001,6894000,83999,False,170,scaffold_2
42,6949001,6997000,47999,False,170,scaffold_2
43,7001001,7038000,36999,False,170,scaffold_2
44,7063001,7220000,156999,False,170,scaffold_2
45,7336001,7475000,138999,False,170,scaffold_2
46,7491001,7518000,26999,False,170,scaffold_2
47,7563001,8315000,751999,False,170,scaffold_2
48,8337001,8345000,7999,False,170,scaffold_2
49,8346001,8565000,218999,False,170,scaffold_2
50,8614001,8650000,35999,False,170,scaffold_2
51,8689001,8700000,10999,False,170,scaffold_2
52,8808001,8833000,24999,False,170,scaffold_2
53,8996001,9098000,101999,False,170,scaffold_2
54,9139001,9202000,62999,False,170,scaffold_2
55,9319001,9382000,62999,False,170,scaffold_2
56,9431001,9467000,35999,False,170,scaffold_2
57,9566001,9636000,69999,False,170,scaffold_2
58,9673001,9695000,21999,False,170,scaffold_2
59,9847001,9897000,49999,False,170,scaffold_2
60,10444001,10465000,20999,False,170,scaffold_2
61,10515001,10564000,48999,False,170,scaffold_2
62,10757001,10766000,8999,False,170,scaffold_2
63,10995001,10998000,2999,False,170,scaffold_2
64,11000001,11071000,70999,False,170,scaffold_2
65,11329001,11365000,35999,False,170,scaffold_2
66,11367001,11508000,140999,False,170,scaffold_2
67,11517001,11787000,269999,False,170,scaffold_2
0,618001,647000,28999,False,170,scaffold_3
1,796001,901000,104999,False,170,scaffold_3
2,1068001,1084000,15999,False,170,scaffold_3
3,2007001,2108000,100999,False,170,scaffold_3
4,2291001,2334000,42999,False,170,scaffold_3
5,2415001,2428000,12999,False,170,scaffold_3
6,2433001,2533000,99999,False,170,scaffold_3
7,2658001,2740000,81999,False,170,scaffold_3
8,3114001,3140000,25999,False,170,scaffold_3
9,3606001,3643000,36999,False,170,scaffold_3
10,3710001,3897000,186999,False,170,scaffold_3
11,4097001,4399000,301999,False,170,scaffold_3
12,4413001,4520000,106999,False,170,scaffold_3
13,4547001,4558000,10999,False,170,scaffold_3
14,4638001,4682000,43999,False,170,scaffold_3
15,4761001,4806000,44999,False,170,scaffold_3
16,4855001,4878000,22999,False,170,scaffold_3
17,4999001,5030000,30999,False,170,scaffold_3
18,5154001,5209000,54999,False,170,scaffold_3
19,5369001,5449000,79999,False,170,scaffold_3
20,5491001,5506000,14999,False,170,scaffold_3
21,5812001,5831000,18999,False,170,scaffold_3
22,5863001,5946000,82999,False,170,scaffold_3
23,5974001,6022000,47999,False,170,scaffold_3
24,6517001,6581000,63999,False,170,scaffold_3
25,6662001,6787000,124999,False,170,scaffold_3
26,6838001,7097000,258999,False,170,scaffold_3
27,7254001,7328000,73999,False,170,scaffold_3
28,7332001,7412000,79999,False,170,scaffold_3
29,7483001,7556000,72999,False,170,scaffold_3
30,7574001,7612000,37999,False,170,scaffold_3
31,7678001,7869000,190999,False,170,scaffold_3
32,8029001,8111000,81999,False,170,scaffold_3
33,8175001,8256000,80999,False,170,scaffold_3
34,8380001,8449000,68999,False,170,scaffold_3
35,8458001,8528000,69999,False,170,scaffold_3
36,8574001,8594000,19999,False,170,scaffold_3
37,9006001,9080000,73999,False,170,scaffold_3
38,9968001,10101000,132999,False,170,scaffold_3
39,10277001,10303000,25999,False,170,scaffold_3
40,10461001,10508000,46999,False,170,scaffold_3
41,10551001,11182071,631070,True,170,scaffold_3
0,14001,16000,1999,False,170,scaffold_4
1,17001,32000,14999,False,170,scaffold_4
2,48001,89000,40999,False,170,scaffold_4
3,120001,151000,30999,False,170,scaffold_4
4,155001,215000,59999,False,170,scaffold_4
5,217001,226000,8999,False,170,scaffold_4
6,227001,241000,13999,False,170,scaffold_4
7,242001,268000,25999,False,170,scaffold_4
8,291001,310000,18999,False,170,scaffold_4
9,318001,339000,20999,False,170,scaffold_4
10,355001,370000,14999,False,170,scaffold_4
11,405001,410000,4999,False,170,scaffold_4
12,412001,425000,12999,False,170,scaffold_4
13,429001,498000,68999,False,170,scaffold_4
14,525001,592000,66999,False,170,scaffold_4
15,608001,691000,82999,False,170,scaffold_4
16,698001,727000,28999,False,170,scaffold_4
17,1053001,1064000,10999,False,170,scaffold_4
18,1082001,1086000,3999,False,170,scaffold_4
19,1087001,1097000,9999,False,170,scaffold_4
20,1099001,1109000,9999,False,170,scaffold_4
21,1113001,1226000,112999,False,170,scaffold_4
22,1265001,1279000,13999,False,170,scaffold_4
23,1283001,1392000,108999,False,170,scaffold_4
24,1393001,1605000,211999,False,170,scaffold_4
25,1613001,2114000,500999,False,170,scaffold_4
26,2138001,2172000,33999,False,170,scaffold_4
27,2219001,2268000,48999,False,170,scaffold_4
28,2269001,2281000,11999,False,170,scaffold_4
29,2283001,2462000,178999,False,170,scaffold_4
30,2476001,2635000,158999,False,170,scaffold_4
31,2680001,2812000,131999,False,170,scaffold_4
32,2918001,2964000,45999,False,170,scaffold_4
33,3028001,3127000,98999,False,170,scaffold_4
34,3205001,3820000,614999,False,170,scaffold_4
35,4056001,4086000,29999,False,170,scaffold_4
36,4226001,4306000,79999,False,170,scaffold_4
37,4708001,4745000,36999,False,170,scaffold_4
38,4838001,4885000,46999,False,170,scaffold_4
39,4900001,5106000,205999,False,170,scaffold_4
40,5171001,5224000,52999,False,170,scaffold_4
41,5292001,5506000,213999,False,170,scaffold_4
42,5515001,5784000,268999,False,170,scaffold_4
43,5786001,5824000,37999,False,170,scaffold_4
44,5923001,5938000,14999,False,170,scaffold_4
45,6049001,6144000,94999,False,170,scaffold_4
46,6145001,6195000,49999,False,170,scaffold_4
47,6214001,6298000,83999,False,170,scaffold_4
48,6331001,6423000,91999,False,170,scaffold_4
49,6615001,6617000,1999,False,170,scaffold_4
50,6710001,6781000,70999,False,170,scaffold_4
51,6798001,6817000,18999,False,170,scaffold_4
52,6880001,6924000,43999,False,170,scaffold_4
53,6926001,6931000,4999,False,170,scaffold_4
54,6944001,7022000,77999,False,170,scaffold_4
55,7036001,7323000,286999,False,170,scaffold_4
56,7345001,7429000,83999,False,170,scaffold_4
57,7628001,7665000,36999,False,170,scaffold_4
58,7985001,8018000,32999,False,170,scaffold_4
59,8714001,8828000,113999,False,170,scaffold_4
60,8844001,9699000,854999,False,170,scaffold_4
61,9700001,9845951,145950,True,170,scaffold_4
0,141001,173000,31999,False,170,scaffold_5
1,189001,204000,14999,False,170,scaffold_5
2,319001,418000,98999,False,170,scaffold_5
3,442001,523000,80999,False,170,scaffold_5
4,669001,698000,28999,False,170,scaffold_5
5,924001,947000,22999,False,170,scaffold_5
6,2264001,2300000,35999,False,170,scaffold_5
7,2475001,2497000,21999,False,170,scaffold_5
8,2506001,2515000,8999,False,170,scaffold_5
9,2516001,2529000,12999,False,170,scaffold_5
10,2552001,2896000,343999,False,170,scaffold_5
11,2924001,3035000,110999,False,170,scaffold_5
12,3096001,3514000,417999,False,170,scaffold_5
13,3607001,3659000,51999,False,170,scaffold_5
14,3766001,3875000,108999,False,170,scaffold_5
15,3961001,4376000,414999,False,170,scaffold_5
16,4444001,4541000,96999,False,170,scaffold_5
17,4563001,4681000,117999,False,170,scaffold_5
18,4690001,4862000,171999,False,170,scaffold_5
19,4883001,4924000,40999,False,170,scaffold_5
20,4969001,5034000,64999,False,170,scaffold_5
21,5047001,5114000,66999,False,170,scaffold_5
22,5133001,5180000,46999,False,170,scaffold_5
23,5216001,5345000,128999,False,170,scaffold_5
24,5688001,5738000,49999,False,170,scaffold_5
25,6391001,6727000,335999,False,170,scaffold_5
26,6827001,6907000,79999,False,170,scaffold_5
27,7170001,7274000,103999,False,170,scaffold_5
28,7291001,7329000,37999,False,170,scaffold_5
29,7337001,7360000,22999,False,170,scaffold_5
30,7406001,7441000,34999,False,170,scaffold_5
31,7461001,7513000,51999,False,170,scaffold_5
32,7545001,7665000,119999,False,170,scaffold_5
33,7673001,7748000,74999,False,170,scaffold_5
34,7794001,7801000,6999,False,170,scaffold_5
35,8258001,8280000,21999,False,170,scaffold_5
36,8411001,8462000,50999,False,170,scaffold_5
37,8551001,8619000,67999,False,170,scaffold_5
38,8658001,8689000,30999,False,170,scaffold_5
39,8705001,9364176,659175,True,170,scaffold_5
0,78001,84000,5999,False,170,scaffold_6
1,86001,116000,29999,False,170,scaffold_6
2,148001,209000,60999,False,170,scaffold_6
3,240001,253000,12999,False,170,scaffold_6
4,264001,335000,70999,False,170,scaffold_6
5,1142001,1193000,50999,False,170,scaffold_6
6,1217001,1278000,60999,False,170,scaffold_6
7,1284001,1309000,24999,False,170,scaffold_6
8,1428001,1598000,169999,False,170,scaffold_6
9,1658001,1710000,51999,False,170,scaffold_6
10,1837001,1901000,63999,False,170,scaffold_6
11,1981001,2019000,37999,False,170,scaffold_6
12,2023001,2104000,80999,False,170,scaffold_6
13,2127001,2214000,86999,False,170,scaffold_6
14,2236001,2285000,48999,False,170,scaffold_6
15,2333001,2873000,539999,False,170,scaffold_6
16,2927001,3210000,282999,False,170,scaffold_6
17,3217001,3799000,581999,False,170,scaffold_6
18,3879001,3921000,41999,False,170,scaffold_6
19,3966001,3996000,29999,False,170,scaffold_6
20,4018001,4204000,185999,False,170,scaffold_6
21,4837001,4868000,30999,False,170,scaffold_6
22,4954001,5006000,51999,False,170,scaffold_6
23,5289001,5314000,24999,False,170,scaffold_6
24,5551001,5745000,193999,False,170,scaffold_6
25,5862001,6087000,224999,False,170,scaffold_6
26,6113001,6183000,69999,False,170,scaffold_6
27,6687001,6713000,25999,False,170,scaffold_6
28,6836001,6859000,22999,False,170,scaffold_6
29,7076001,7098000,21999,False,170,scaffold_6
30,7184001,7341000,156999,False,170,scaffold_6
31,7382001,7484000,101999,False,170,scaffold_6
32,7541001,8268281,727280,True,170,scaffold_6
0,13001,34000,20999,False,170,scaffold_7
1,309001,341000,31999,False,170,scaffold_7
2,342001,508000,165999,False,170,scaffold_7
3,571001,589000,17999,False,170,scaffold_7
4,616001,642000,25999,False,170,scaffold_7
5,646001,677000,30999,False,170,scaffold_7
6,688001,736000,47999,False,170,scaffold_7
7,741001,753000,11999,False,170,scaffold_7
8,763001,829000,65999,False,170,scaffold_7
9,859001,864000,4999,False,170,scaffold_7
10,867001,872000,4999,False,170,scaffold_7
11,875001,945000,69999,False,170,scaffold_7
12,982001,1044000,61999,False,170,scaffold_7
13,1048001,1124000,75999,False,170,scaffold_7
14,1202001,1460000,257999,False,170,scaffold_7
15,1461001,1512000,50999,False,170,scaffold_7
16,1588001,1693000,104999,False,170,scaffold_7
17,1982001,2013000,30999,False,170,scaffold_7
18,2442001,2459000,16999,False,170,scaffold_7
19,2851001,2959000,107999,False,170,scaffold_7
20,3293001,3421000,127999,False,170,scaffold_7
21,3489001,3509000,19999,False,170,scaffold_7
22,3517001,3828000,310999,False,170,scaffold_7
23,3914001,3978000,63999,False,170,scaffold_7
24,4021001,4081000,59999,False,170,scaffold_7
25,4323001,4512000,188999,False,170,scaffold_7
26,4547001,4928000,380999,False,170,scaffold_7
27,4978001,5168000,189999,False,170,scaffold_7
28,5409001,5436000,26999,False,170,scaffold_7
29,5471001,5537000,65999,False,170,scaffold_7
30,6103001,6248000,144999,False,170,scaffold_7
31,6331001,6390000,58999,False,170,scaffold_7
32,6558001,6808000,249999,False,170,scaffold_7
33,6954001,7270000,315999,False,170,scaffold_7
34,7271001,7502216,231215,True,170,scaffold_7
0,1,6000,5999,True,170,scaffold_8
1,31001,85000,53999,False,170,scaffold_8
2,1008001,1042000,33999,False,170,scaffold_8
3,1370001,1407000,36999,False,170,scaffold_8
4,1858001,1977000,118999,False,170,scaffold_8
5,2096001,2155000,58999,False,170,scaffold_8
6,2223001,2589000,365999,False,170,scaffold_8
7,2647001,2683000,35999,False,170,scaffold_8
8,2684001,2844000,159999,False,170,scaffold_8
9,2847001,2880000,32999,False,170,scaffold_8
10,3000001,3614000,613999,False,170,scaffold_8
11,3615001,3981000,365999,False,170,scaffold_8
12,4035001,4106000,70999,False,170,scaffold_8
13,4170001,4221000,50999,False,170,scaffold_8
14,4330001,4372000,41999,False,170,scaffold_8
15,4400001,4431000,30999,False,170,scaffold_8
16,4611001,4655000,43999,False,170,scaffold_8
17,4888001,4916000,27999,False,170,scaffold_8
18,5083001,5244000,160999,False,170,scaffold_8
19,5503001,5597000,93999,False,170,scaffold_8
20,5650001,5710000,59999,False,170,scaffold_8
21,6319001,6334544,15543,True,170,scaffold_8
0,1,22000,21999,True,170,scaffold_9
1,109001,118000,8999,False,170,scaffold_9
2,121001,138000,16999,False,170,scaffold_9
3,236001,242000,5999,False,170,scaffold_9
4,271001,277000,5999,False,170,scaffold_9
5,359001,411000,51999,False,170,scaffold_9
6,413001,434000,20999,False,170,scaffold_9
7,483001,531000,47999,False,170,scaffold_9
8,548001,563000,14999,False,170,scaffold_9
9,652001,665000,12999,False,170,scaffold_9
10,671001,697000,25999,False,170,scaffold_9
11,731001,741000,9999,False,170,scaffold_9
12,815001,843000,27999,False,170,scaffold_9
13,873001,986000,112999,False,170,scaffold_9
14,988001,995000,6999,False,170,scaffold_9
15,1001001,1177000,175999,False,170,scaffold_9
16,1312001,1379000,66999,False,170,scaffold_9
17,1637001,1678000,40999,False,170,scaffold_9
18,1749001,1791000,41999,False,170,scaffold_9
19,1992001,2036000,43999,False,170,scaffold_9
20,2596001,2672000,75999,False,170,scaffold_9
21,2735001,3381000,645999,False,170,scaffold_9
22,3383001,5110000,1726999,False,170,scaffold_9
23,5112001,5115000,2999,False,170,scaffold_9
24,5116001,5238000,121999,False,170,scaffold_9
25,5239001,5298000,58999,False,170,scaffold_9
26,5300001,6331288,1031287,True,170,scaffold_9
0,1,482000,481999,True,170,scaffold_10
1,483001,877000,393999,False,170,scaffold_10
2,888001,1069000,180999,False,170,scaffold_10
3,1072001,1155000,82999,False,170,scaffold_10
4,1314001,1344000,29999,False,170,scaffold_10
5,1371001,1429000,57999,False,170,scaffold_10
6,2079001,2108000,28999,False,170,scaffold_10
7,2136001,2177000,40999,False,170,scaffold_10
8,2266001,2324000,57999,False,170,scaffold_10
9,2346001,2403000,56999,False,170,scaffold_10
10,2600001,2637000,36999,False,170,scaffold_10
11,3068001,3132000,63999,False,170,scaffold_10
12,4000001,4009000,8999,False,170,scaffold_10
13,4050001,4086000,35999,False,170,scaffold_10
14,4156001,4181000,24999,False,170,scaffold_10
15,4316001,4323000,6999,False,170,scaffold_10
16,4334001,4367000,32999,False,170,scaffold_10
17,4445001,4462000,16999,False,170,scaffold_10
18,4467001,4513000,45999,False,170,scaffold_10
19,4515001,4523000,7999,False,170,scaffold_10
20,4526001,4548000,21999,False,170,scaffold_10
21,4554001,4562000,7999,False,170,scaffold_10
22,4565001,4597000,31999,False,170,scaffold_10
23,4716001,4732000,15999,False,170,scaffold_10
24,4733001,4747000,13999,False,170,scaffold_10
25,4798001,4824000,25999,False,170,scaffold_10
26,4828001,4843000,14999,False,170,scaffold_10
27,4848001,4861000,12999,False,170,scaffold_10
28,4865001,4866973,1972,True,170,scaffold_10
0,9001,94000,84999,False,170,scaffold_11
1,149001,167000,17999,False,170,scaffold_11
2,169001,212000,42999,False,170,scaffold_11
3,213001,236000,22999,False,170,scaffold_11
4,240001,248000,7999,False,170,scaffold_11
5,419001,431000,11999,False,170,scaffold_11
6,648001,656000,7999,False,170,scaffold_11
7,1474001,1477000,2999,False,170,scaffold_11
8,1855001,1883000,27999,False,170,scaffold_11
9,2450001,2483000,32999,False,170,scaffold_11
10,2658001,2914000,255999,False,170,scaffold_11
11,2950001,3021000,70999,False,170,scaffold_11
12,3060001,3383000,322999,False,170,scaffold_11
13,3429001,3477000,47999,False,170,scaffold_11
14,3519001,3972000,452999,False,170,scaffold_11
15,3987001,4215000,227999,False,170,scaffold_11
16,4249001,4710000,460999,False,170,scaffold_11
17,4713001,4766820,53819,True,170,scaffold_11
0,1,1496000,1495999,True,170,scaffold_12
1,1548001,1588000,39999,False,170,scaffold_12
2,1719001,1739000,19999,False,170,scaffold_12
3,1788001,1812000,23999,False,170,scaffold_12
4,2350001,2379000,28999,False,170,scaffold_12
5,2571001,2616000,44999,False,170,scaffold_12
0,1,396000,395999,True,171,scaffold_1
1,482001,498000,15999,False,171,scaffold_1
2,571001,643000,71999,False,171,scaffold_1
3,686001,759000,72999,False,171,scaffold_1
4,1248001,1292000,43999,False,171,scaffold_1
5,1616001,1660000,43999,False,171,scaffold_1
6,1828001,1900000,71999,False,171,scaffold_1
7,1913001,1934000,20999,False,171,scaffold_1
8,1955001,1984000,28999,False,171,scaffold_1
9,1986001,1995000,8999,False,171,scaffold_1
10,2353001,2414000,60999,False,171,scaffold_1
11,2449001,2520000,70999,False,171,scaffold_1
12,2538001,2583000,44999,False,171,scaffold_1
13,2717001,2746000,28999,False,171,scaffold_1
14,2905001,2921000,15999,False,171,scaffold_1
15,2943001,3024000,80999,False,171,scaffold_1
16,3450001,3623000,172999,False,171,scaffold_1
17,3716001,3941000,224999,False,171,scaffold_1
18,3992001,4033000,40999,False,171,scaffold_1
19,4067001,4115000,47999,False,171,scaffold_1
20,4311001,4355000,43999,False,171,scaffold_1
21,4928001,5022000,93999,False,171,scaffold_1
22,5088001,5119000,30999,False,171,scaffold_1
23,5480001,5511000,30999,False,171,scaffold_1
24,5535001,5570000,34999,False,171,scaffold_1
25,5852001,5877000,24999,False,171,scaffold_1
26,6108001,6177000,68999,False,171,scaffold_1
27,6201001,6380000,178999,False,171,scaffold_1
28,6384001,6576000,191999,False,171,scaffold_1
29,6630001,6659000,28999,False,171,scaffold_1
30,7038001,7588000,549999,False,171,scaffold_1
31,7590001,8477000,886999,False,171,scaffold_1
32,8478001,8656000,177999,False,171,scaffold_1
33,8657001,9584000,926999,False,171,scaffold_1
34,9586001,10360000,773999,False,171,scaffold_1
35,10460001,10641000,180999,False,171,scaffold_1
36,10655001,10757000,101999,False,171,scaffold_1
37,10832001,10858000,25999,False,171,scaffold_1
38,11014001,11030000,15999,False,171,scaffold_1
39,11344001,11510000,165999,False,171,scaffold_1
40,11555001,11961000,405999,False,171,scaffold_1
41,12184001,12243000,58999,False,171,scaffold_1
42,12652001,12756000,103999,False,171,scaffold_1
43,12775001,12886000,110999,False,171,scaffold_1
44,12914001,13003000,88999,False,171,scaffold_1
45,13023001,13216000,192999,False,171,scaffold_1
46,13346001,13406000,59999,False,171,scaffold_1
47,14105001,14106000,999,False,171,scaffold_1
48,14285001,14308000,22999,False,171,scaffold_1
0,21001,48000,26999,False,171,scaffold_2
1,95001,159000,63999,False,171,scaffold_2
2,296001,318000,21999,False,171,scaffold_2
3,332001,374000,41999,False,171,scaffold_2
4,2336001,2603000,266999,False,171,scaffold_2
5,2627001,2639000,11999,False,171,scaffold_2
6,2645001,2689000,43999,False,171,scaffold_2
7,2694001,2742000,47999,False,171,scaffold_2
8,2820001,2856000,35999,False,171,scaffold_2
9,2878001,2937000,58999,False,171,scaffold_2
10,2972001,3012000,39999,False,171,scaffold_2
11,3027001,3046000,18999,False,171,scaffold_2
12,3334001,3343000,8999,False,171,scaffold_2
13,3360001,3390000,29999,False,171,scaffold_2
14,3450001,3466000,15999,False,171,scaffold_2
15,3754001,3784000,29999,False,171,scaffold_2
16,4342001,4409000,66999,False,171,scaffold_2
17,4426001,4458000,31999,False,171,scaffold_2
18,4528001,4658000,129999,False,171,scaffold_2
19,4698001,4772000,73999,False,171,scaffold_2
20,4783001,4790000,6999,False,171,scaffold_2
21,4793001,4804000,10999,False,171,scaffold_2
22,4917001,4954000,36999,False,171,scaffold_2
23,5016001,5104000,87999,False,171,scaffold_2
24,5361001,5394000,32999,False,171,scaffold_2
25,5413001,5481000,67999,False,171,scaffold_2
26,5491001,5575000,83999,False,171,scaffold_2
27,5618001,5761000,142999,False,171,scaffold_2
28,5838001,5887000,48999,False,171,scaffold_2
29,5913001,6049000,135999,False,171,scaffold_2
30,6261001,6350000,88999,False,171,scaffold_2
31,6376001,6449000,72999,False,171,scaffold_2
32,6504001,6518000,13999,False,171,scaffold_2
33,6583001,6628000,44999,False,171,scaffold_2
34,6823001,6894000,70999,False,171,scaffold_2
35,7004001,7047000,42999,False,171,scaffold_2
36,7049001,7097000,47999,False,171,scaffold_2
37,7145001,7233000,87999,False,171,scaffold_2
38,7331001,7473000,141999,False,171,scaffold_2
39,7491001,7518000,26999,False,171,scaffold_2
40,7567001,7707000,139999,False,171,scaffold_2
41,7720001,7931000,210999,False,171,scaffold_2
42,7933001,8163000,229999,False,171,scaffold_2
43,8202001,8219000,16999,False,171,scaffold_2
44,8260001,8313000,52999,False,171,scaffold_2
45,8331001,8333000,1999,False,171,scaffold_2
46,8339001,8345000,5999,False,171,scaffold_2
47,8346001,8454000,107999,False,171,scaffold_2
48,8465001,8564000,98999,False,171,scaffold_2
49,9004001,9047000,42999,False,171,scaffold_2
50,9140001,9174000,33999,False,171,scaffold_2
51,9329001,9382000,52999,False,171,scaffold_2
52,9421001,9472000,50999,False,171,scaffold_2
53,9564001,9636000,71999,False,171,scaffold_2
54,11367001,11427000,59999,False,171,scaffold_2
55,11519001,11786000,266999,False,171,scaffold_2
0,1,2000,1999,True,171,scaffold_3
1,528001,548000,19999,False,171,scaffold_3
2,618001,646000,27999,False,171,scaffold_3
3,797001,900000,102999,False,171,scaffold_3
4,2010001,2108000,97999,False,171,scaffold_3
5,2288001,2321000,32999,False,171,scaffold_3
6,2454001,2533000,78999,False,171,scaffold_3
7,3726001,3865000,138999,False,171,scaffold_3
8,4108001,4398000,289999,False,171,scaffold_3
9,4415001,4519000,103999,False,171,scaffold_3
10,4547001,4558000,10999,False,171,scaffold_3
11,4652001,4685000,32999,False,171,scaffold_3
12,5879001,5910000,30999,False,171,scaffold_3
13,5926001,5946000,19999,False,171,scaffold_3
14,5990001,6022000,31999,False,171,scaffold_3
15,6516001,6579000,62999,False,171,scaffold_3
16,6660001,6700000,39999,False,171,scaffold_3
17,6759001,6807000,47999,False,171,scaffold_3
18,6909001,6967000,57999,False,171,scaffold_3
19,6978001,7096000,117999,False,171,scaffold_3
20,7138001,7157000,18999,False,171,scaffold_3
21,7253001,7302000,48999,False,171,scaffold_3
22,7336001,7399000,62999,False,171,scaffold_3
23,7518001,7556000,37999,False,171,scaffold_3
24,7677001,7842000,164999,False,171,scaffold_3
25,8079001,8109000,29999,False,171,scaffold_3
26,8177001,8255000,77999,False,171,scaffold_3
27,8398001,8527000,128999,False,171,scaffold_3
28,8575001,8594000,18999,False,171,scaffold_3
29,8605001,8625000,19999,False,171,scaffold_3
30,9060001,9074000,13999,False,171,scaffold_3
31,9968001,9996000,27999,False,171,scaffold_3
32,10042001,10086000,43999,False,171,scaffold_3
33,10461001,10485000,23999,False,171,scaffold_3
34,10550001,10572000,21999,False,171,scaffold_3
35,10574001,11168000,593999,False,171,scaffold_3
0,11001,13000,1999,False,171,scaffold_4
1,17001,32000,14999,False,171,scaffold_4
2,48001,89000,40999,False,171,scaffold_4
3,91001,112000,20999,False,171,scaffold_4
4,113001,115000,1999,False,171,scaffold_4
5,120001,151000,30999,False,171,scaffold_4
6,155001,160000,4999,False,171,scaffold_4
7,163001,215000,51999,False,171,scaffold_4
8,217001,226000,8999,False,171,scaffold_4
9,227001,241000,13999,False,171,scaffold_4
10,242001,267000,24999,False,171,scaffold_4
11,283001,308000,24999,False,171,scaffold_4
12,331001,344000,12999,False,171,scaffold_4
13,355001,374000,18999,False,171,scaffold_4
14,390001,410000,19999,False,171,scaffold_4
15,412001,425000,12999,False,171,scaffold_4
16,429001,505000,75999,False,171,scaffold_4
17,510001,528000,17999,False,171,scaffold_4
18,542001,592000,49999,False,171,scaffold_4
19,608001,661000,52999,False,171,scaffold_4
20,669001,691000,21999,False,171,scaffold_4
21,701001,714000,12999,False,171,scaffold_4
22,1053001,1062000,8999,False,171,scaffold_4
23,1121001,1208000,86999,False,171,scaffold_4
24,1210001,1226000,15999,False,171,scaffold_4
25,1283001,1324000,40999,False,171,scaffold_4
26,1326001,1335000,8999,False,171,scaffold_4
27,1358001,1596000,237999,False,171,scaffold_4
28,1609001,1611000,1999,False,171,scaffold_4
29,1613001,1648000,34999,False,171,scaffold_4
30,1746001,1865000,118999,False,171,scaffold_4
31,1905001,1988000,82999,False,171,scaffold_4
32,2210001,2246000,35999,False,171,scaffold_4
33,2247001,2280000,32999,False,171,scaffold_4
34,2284001,2310000,25999,False,171,scaffold_4
35,2311001,2444000,132999,False,171,scaffold_4
36,2476001,2635000,158999,False,171,scaffold_4
37,2681001,2713000,31999,False,171,scaffold_4
38,2926001,2967000,40999,False,171,scaffold_4
39,3035001,3064000,28999,False,171,scaffold_4
40,3094001,3125000,30999,False,171,scaffold_4
41,3336001,3666000,329999,False,171,scaffold_4
42,3675001,3761000,85999,False,171,scaffold_4
43,4057001,4085000,27999,False,171,scaffold_4
44,4900001,5101000,200999,False,171,scaffold_4
45,5169001,5208000,38999,False,171,scaffold_4
46,5300001,5426000,125999,False,171,scaffold_4
47,5472001,5506000,33999,False,171,scaffold_4
48,5514001,5784000,269999,False,171,scaffold_4
49,5786001,5825000,38999,False,171,scaffold_4
50,6147001,6195000,47999,False,171,scaffold_4
51,6796001,6817000,20999,False,171,scaffold_4
52,6875001,6924000,48999,False,171,scaffold_4
53,6926001,6940000,13999,False,171,scaffold_4
54,6969001,6995000,25999,False,171,scaffold_4
55,7036001,7079000,42999,False,171,scaffold_4
56,7153001,7171000,17999,False,171,scaffold_4
57,7192001,7303000,110999,False,171,scaffold_4
58,7643001,7661000,17999,False,171,scaffold_4
59,7986001,7996000,9999,False,171,scaffold_4
60,8844001,9699000,854999,False,171,scaffold_4
61,9703001,9845951,142950,True,171,scaffold_4
0,1,5000,4999,True,171,scaffold_5
1,318001,427000,108999,False,171,scaffold_5
2,445001,523000,77999,False,171,scaffold_5
3,933001,947000,13999,False,171,scaffold_5
4,1062001,1068000,5999,False,171,scaffold_5
5,2257001,2303000,45999,False,171,scaffold_5
6,2473001,2494000,20999,False,171,scaffold_5
7,2510001,2515000,4999,False,171,scaffold_5
8,2516001,2521000,4999,False,171,scaffold_5
9,2552001,2887000,334999,False,171,scaffold_5
10,2923001,2999000,75999,False,171,scaffold_5
11,3091001,3350000,258999,False,171,scaffold_5
12,3351001,3515000,163999,False,171,scaffold_5
13,3616001,3657000,40999,False,171,scaffold_5
14,3958001,4222000,263999,False,171,scaffold_5
15,4246001,4359000,112999,False,171,scaffold_5
16,4444001,4524000,79999,False,171,scaffold_5
17,4599001,4862000,262999,False,171,scaffold_5
18,4883001,4919000,35999,False,171,scaffold_5
19,4969001,4993000,23999,False,171,scaffold_5
20,5059001,5111000,51999,False,171,scaffold_5
21,5249001,5274000,24999,False,171,scaffold_5
22,5287001,5346000,58999,False,171,scaffold_5
23,6396001,6665000,268999,False,171,scaffold_5
24,6886001,6906000,19999,False,171,scaffold_5
25,7166001,7249000,82999,False,171,scaffold_5
26,7523001,7610000,86999,False,171,scaffold_5
27,7611001,7660000,48999,False,171,scaffold_5
28,7731001,7775000,43999,False,171,scaffold_5
29,7786001,7803000,16999,False,171,scaffold_5
30,8258001,8280000,21999,False,171,scaffold_5
31,8416001,8470000,53999,False,171,scaffold_5
32,8553001,8616000,62999,False,171,scaffold_5
33,8667001,8685000,17999,False,171,scaffold_5
34,8713001,9364176,651175,True,171,scaffold_5
0,78001,84000,5999,False,171,scaffold_6
1,86001,113000,26999,False,171,scaffold_6
2,147001,208000,60999,False,171,scaffold_6
3,241001,253000,11999,False,171,scaffold_6
4,267001,339000,71999,False,171,scaffold_6
5,1235001,1266000,30999,False,171,scaffold_6
6,1478001,1551000,72999,False,171,scaffold_6
7,1658001,1689000,30999,False,171,scaffold_6
8,1793001,1902000,108999,False,171,scaffold_6
9,2023001,2101000,77999,False,171,scaffold_6
10,2125001,2209000,83999,False,171,scaffold_6
11,2236001,2282000,45999,False,171,scaffold_6
12,2334001,2595000,260999,False,171,scaffold_6
13,2596001,2654000,57999,False,171,scaffold_6
14,2655001,2872000,216999,False,171,scaffold_6
15,2927001,3026000,98999,False,171,scaffold_6
16,3087001,3209000,121999,False,171,scaffold_6
17,3219001,3521000,301999,False,171,scaffold_6
18,3523001,3806000,282999,False,171,scaffold_6
19,3881001,3913000,31999,False,171,scaffold_6
20,3966001,3998000,31999,False,171,scaffold_6
21,4017001,4192000,174999,False,171,scaffold_6
22,5289001,5320000,30999,False,171,scaffold_6
23,5552001,5637000,84999,False,171,scaffold_6
24,5940001,5969000,28999,False,171,scaffold_6
25,6008001,6087000,78999,False,171,scaffold_6
26,6155001,6185000,29999,False,171,scaffold_6
27,6777001,6803000,25999,False,171,scaffold_6
28,7199001,7248000,48999,False,171,scaffold_6
29,7258001,7340000,81999,False,171,scaffold_6
30,7389001,7478000,88999,False,171,scaffold_6
31,7546001,8268281,722280,True,171,scaffold_6
0,321001,508000,186999,False,171,scaffold_7
1,571001,577000,5999,False,171,scaffold_7
2,580001,590000,9999,False,171,scaffold_7
3,623001,674000,50999,False,171,scaffold_7
4,706001,736000,29999,False,171,scaffold_7
5,764001,809000,44999,False,171,scaffold_7
6,810001,827000,16999,False,171,scaffold_7
7,868001,895000,26999,False,171,scaffold_7
8,967001,980000,12999,False,171,scaffold_7
9,982001,1044000,61999,False,171,scaffold_7
10,1048001,1100000,51999,False,171,scaffold_7
11,1191001,1460000,268999,False,171,scaffold_7
12,1461001,1512000,50999,False,171,scaffold_7
13,1588001,1689000,100999,False,171,scaffold_7
14,3294001,3408000,113999,False,171,scaffold_7
15,3518001,3826000,307999,False,171,scaffold_7
16,3916001,3970000,53999,False,171,scaffold_7
17,4415001,4518000,102999,False,171,scaffold_7
18,4549001,4608000,58999,False,171,scaffold_7
19,4629001,4881000,251999,False,171,scaffold_7
20,4978001,5149000,170999,False,171,scaffold_7
21,5483001,5536000,52999,False,171,scaffold_7
22,5666001,5676000,9999,False,171,scaffold_7
23,6132001,6236000,103999,False,171,scaffold_7
24,6471001,6489000,17999,False,171,scaffold_7
25,6948001,7502216,554215,True,171,scaffold_7
0,67001,85000,17999,False,171,scaffold_8
1,1856001,1928000,71999,False,171,scaffold_8
2,2087001,2117000,29999,False,171,scaffold_8
3,2335001,2552000,216999,False,171,scaffold_8
4,2652001,2683000,30999,False,171,scaffold_8
5,2737001,2766000,28999,False,171,scaffold_8
6,2798001,2844000,45999,False,171,scaffold_8
7,3058001,3558000,499999,False,171,scaffold_8
8,3580001,3612000,31999,False,171,scaffold_8
9,3615001,3950000,334999,False,171,scaffold_8
10,4039001,4106000,66999,False,171,scaffold_8
11,4173001,4221000,47999,False,171,scaffold_8
12,4400001,4432000,31999,False,171,scaffold_8
13,5106001,5241000,134999,False,171,scaffold_8
14,5521001,5596000,74999,False,171,scaffold_8
15,5650001,5695000,44999,False,171,scaffold_8
16,6326001,6334544,8543,True,171,scaffold_8
0,1,21000,20999,True,171,scaffold_9
1,109001,117000,7999,False,171,scaffold_9
2,121001,138000,16999,False,171,scaffold_9
3,303001,315000,11999,False,171,scaffold_9
4,319001,333000,13999,False,171,scaffold_9
5,366001,411000,44999,False,171,scaffold_9
6,413001,434000,20999,False,171,scaffold_9
7,436001,441000,4999,False,171,scaffold_9
8,487001,531000,43999,False,171,scaffold_9
9,652001,665000,12999,False,171,scaffold_9
10,671001,697000,25999,False,171,scaffold_9
11,815001,847000,31999,False,171,scaffold_9
12,848001,862000,13999,False,171,scaffold_9
13,872001,986000,113999,False,171,scaffold_9
14,988001,995000,6999,False,171,scaffold_9
15,1001001,1031000,29999,False,171,scaffold_9
16,1037001,1085000,47999,False,171,scaffold_9
17,1087001,1150000,62999,False,171,scaffold_9
18,1151001,1164000,12999,False,171,scaffold_9
19,1308001,1377000,68999,False,171,scaffold_9
20,1599001,1615000,15999,False,171,scaffold_9
21,1767001,1792000,24999,False,171,scaffold_9
22,1990001,2032000,41999,False,171,scaffold_9
23,2601001,2616000,14999,False,171,scaffold_9
24,2737001,3381000,643999,False,171,scaffold_9
25,3383001,5111000,1727999,False,171,scaffold_9
26,5112001,5115000,2999,False,171,scaffold_9
27,5116001,5298000,181999,False,171,scaffold_9
28,5300001,6331288,1031287,True,171,scaffold_9
0,1,136000,135999,True,171,scaffold_10
1,137001,200000,62999,False,171,scaffold_10
2,257001,414000,156999,False,171,scaffold_10
3,415001,482000,66999,False,171,scaffold_10
4,483001,585000,101999,False,171,scaffold_10
5,602001,797000,194999,False,171,scaffold_10
6,805001,878000,72999,False,171,scaffold_10
7,888001,992000,103999,False,171,scaffold_10
8,994001,1069000,74999,False,171,scaffold_10
9,1072001,1108000,35999,False,171,scaffold_10
10,1126001,1137000,10999,False,171,scaffold_10
11,2346001,2397000,50999,False,171,scaffold_10
12,4050001,4085000,34999,False,171,scaffold_10
13,4154001,4174000,19999,False,171,scaffold_10
14,4338001,4359000,20999,False,171,scaffold_10
15,4445001,4462000,16999,False,171,scaffold_10
16,4467001,4477000,9999,False,171,scaffold_10
17,4503001,4513000,9999,False,171,scaffold_10
18,4515001,4523000,7999,False,171,scaffold_10
19,4526001,4548000,21999,False,171,scaffold_10
20,4574001,4597000,22999,False,171,scaffold_10
21,4716001,4724000,7999,False,171,scaffold_10
22,4726001,4732000,5999,False,171,scaffold_10
23,4734001,4766000,31999,False,171,scaffold_10
24,4798001,4824000,25999,False,171,scaffold_10
25,4827001,4843000,15999,False,171,scaffold_10
26,4844001,4861000,16999,False,171,scaffold_10
27,4865001,4866973,1972,True,171,scaffold_10
0,9001,93000,83999,False,171,scaffold_11
1,132001,167000,34999,False,171,scaffold_11
2,169001,191000,21999,False,171,scaffold_11
3,213001,236000,22999,False,171,scaffold_11
4,240001,247000,6999,False,171,scaffold_11
5,296001,318000,21999,False,171,scaffold_11
6,419001,431000,11999,False,171,scaffold_11
7,648001,656000,7999,False,171,scaffold_11
8,1025001,1034000,8999,False,171,scaffold_11
9,2701001,2875000,173999,False,171,scaffold_11
10,2974001,3019000,44999,False,171,scaffold_11
11,3083001,3383000,299999,False,171,scaffold_11
12,3567001,3927000,359999,False,171,scaffold_11
13,4009001,4073000,63999,False,171,scaffold_11
14,4116001,4159000,42999,False,171,scaffold_11
15,4319001,4710000,390999,False,171,scaffold_11
16,4712001,4766820,54819,True,171,scaffold_11
0,1,1407000,1406999,True,171,scaffold_12
1,1408001,1430000,21999,False,171,scaffold_12
2,1717001,1733000,15999,False,171,scaffold_12
3,2571001,2609000,37999,False,171,scaffold_12
0,1,402000,401999,True,172,scaffold_1
1,482001,498000,15999,False,172,scaffold_1
2,570001,643000,72999,False,172,scaffold_1
3,686001,759000,72999,False,172,scaffold_1
4,1059001,1088000,28999,False,172,scaffold_1
5,1278001,1292000,13999,False,172,scaffold_1
6,1814001,1898000,83999,False,172,scaffold_1
7,1965001,1984000,18999,False,172,scaffold_1
8,2363001,2413000,49999,False,172,scaffold_1
9,2449001,2517000,67999,False,172,scaffold_1
10,2566001,2581000,14999,False,172,scaffold_1
11,2727001,2746000,18999,False,172,scaffold_1
12,2900001,2925000,24999,False,172,scaffold_1
13,3193001,3209000,15999,False,172,scaffold_1
14,3549001,3623000,73999,False,172,scaffold_1
15,3705001,3750000,44999,False,172,scaffold_1
16,3912001,3932000,19999,False,172,scaffold_1
17,4062001,4113000,50999,False,172,scaffold_1
18,4315001,4354000,38999,False,172,scaffold_1
19,4925001,4984000,58999,False,172,scaffold_1
20,5481001,5511000,29999,False,172,scaffold_1
21,5535001,5570000,34999,False,172,scaffold_1
22,5852001,5878000,25999,False,172,scaffold_1
23,6108001,6153000,44999,False,172,scaffold_1
24,6154001,6177000,22999,False,172,scaffold_1
25,6228001,6381000,152999,False,172,scaffold_1
26,6384001,6512000,127999,False,172,scaffold_1
27,6542001,6564000,21999,False,172,scaffold_1
28,6836001,6851000,14999,False,172,scaffold_1
29,7038001,7247000,208999,False,172,scaffold_1
30,7248001,7588000,339999,False,172,scaffold_1
31,7590001,8477000,886999,False,172,scaffold_1
32,8478001,8656000,177999,False,172,scaffold_1
33,8658001,9584000,925999,False,172,scaffold_1
34,9586001,10363000,776999,False,172,scaffold_1
35,10460001,10641000,180999,False,172,scaffold_1
36,10721001,10757000,35999,False,172,scaffold_1
37,10841001,10857000,15999,False,172,scaffold_1
38,11338001,11513000,174999,False,172,scaffold_1
39,11591001,11964000,372999,False,172,scaffold_1
40,12182001,12238000,55999,False,172,scaffold_1
41,12667001,12722000,54999,False,172,scaffold_1
42,12785001,12887000,101999,False,172,scaffold_1
43,12965001,13001000,35999,False,172,scaffold_1
44,13096001,13215000,118999,False,172,scaffold_1
45,13347001,13404000,56999,False,172,scaffold_1
46,13564001,13580000,15999,False,172,scaffold_1
47,13901001,13904000,2999,False,172,scaffold_1
48,14298001,14307000,8999,False,172,scaffold_1
0,25001,48000,22999,False,172,scaffold_2
1,95001,159000,63999,False,172,scaffold_2
2,168001,177000,8999,False,172,scaffold_2
3,248001,265000,16999,False,172,scaffold_2
4,302001,317000,14999,False,172,scaffold_2
5,332001,374000,41999,False,172,scaffold_2
6,2405001,2609000,203999,False,172,scaffold_2
7,2653001,2689000,35999,False,172,scaffold_2
8,2694001,2747000,52999,False,172,scaffold_2
9,2974001,3012000,37999,False,172,scaffold_2
10,3174001,3184000,9999,False,172,scaffold_2
11,3367001,3412000,44999,False,172,scaffold_2
12,3452001,3464000,11999,False,172,scaffold_2
13,3755001,3787000,31999,False,172,scaffold_2
14,4390001,4409000,18999,False,172,scaffold_2
15,4426001,4457000,30999,False,172,scaffold_2
16,4519001,4655000,135999,False,172,scaffold_2
17,4710001,4763000,52999,False,172,scaffold_2
18,4918001,4955000,36999,False,172,scaffold_2
19,5021001,5104000,82999,False,172,scaffold_2
20,5370001,5394000,23999,False,172,scaffold_2
21,5414001,5516000,101999,False,172,scaffold_2
22,5623001,5704000,80999,False,172,scaffold_2
23,5718001,5761000,42999,False,172,scaffold_2
24,5842001,5854000,11999,False,172,scaffold_2
25,5863001,5883000,19999,False,172,scaffold_2
26,6261001,6330000,68999,False,172,scaffold_2
27,6331001,6352000,20999,False,172,scaffold_2
28,6394001,6449000,54999,False,172,scaffold_2
29,6507001,6522000,14999,False,172,scaffold_2
30,6591001,6629000,37999,False,172,scaffold_2
31,6834001,6886000,51999,False,172,scaffold_2
32,7018001,7038000,19999,False,172,scaffold_2
33,7063001,7097000,33999,False,172,scaffold_2
34,7140001,7223000,82999,False,172,scaffold_2
35,7330001,7474000,143999,False,172,scaffold_2
36,7491001,7513000,21999,False,172,scaffold_2
37,7547001,7561000,13999,False,172,scaffold_2
38,7563001,7708000,144999,False,172,scaffold_2
39,7785001,8163000,377999,False,172,scaffold_2
40,8189001,8313000,123999,False,172,scaffold_2
41,8331001,8333000,1999,False,172,scaffold_2
42,8335001,8345000,9999,False,172,scaffold_2
43,8346001,8453000,106999,False,172,scaffold_2
44,8509001,8559000,49999,False,172,scaffold_2
45,9146001,9169000,22999,False,172,scaffold_2
46,9330001,9382000,51999,False,172,scaffold_2
47,9674001,9695000,20999,False,172,scaffold_2
48,11367001,11381000,13999,False,172,scaffold_2
49,11395001,11507000,111999,False,172,scaffold_2
50,11520001,11786000,265999,False,172,scaffold_2
0,1,2000,1999,True,172,scaffold_3
1,51001,54000,2999,False,172,scaffold_3
2,798001,901000,102999,False,172,scaffold_3
3,2050001,2108000,57999,False,172,scaffold_3
4,2288001,2322000,33999,False,172,scaffold_3
5,2446001,2533000,86999,False,172,scaffold_3
6,3768001,3821000,52999,False,172,scaffold_3
7,3822001,3875000,52999,False,172,scaffold_3
8,4149001,4396000,246999,False,172,scaffold_3
9,4415001,4521000,105999,False,172,scaffold_3
10,4537001,4558000,20999,False,172,scaffold_3
11,4645001,4686000,40999,False,172,scaffold_3
12,6517001,6576000,58999,False,172,scaffold_3
13,6738001,6785000,46999,False,172,scaffold_3
14,6908001,6962000,53999,False,172,scaffold_3
15,6980001,7093000,112999,False,172,scaffold_3
16,7146001,7157000,10999,False,172,scaffold_3
17,7336001,7398000,61999,False,172,scaffold_3
18,7522001,7556000,33999,False,172,scaffold_3
19,7679001,7838000,158999,False,172,scaffold_3
20,8091001,8116000,24999,False,172,scaffold_3
21,8206001,8255000,48999,False,172,scaffold_3
22,8462001,8527000,64999,False,172,scaffold_3
23,8575001,8594000,18999,False,172,scaffold_3
24,9970001,10003000,32999,False,172,scaffold_3
25,10277001,10340000,62999,False,172,scaffold_3
26,10461001,10486000,24999,False,172,scaffold_3
27,10551001,11164000,612999,False,172,scaffold_3
0,17001,33000,15999,False,172,scaffold_4
1,48001,89000,40999,False,172,scaffold_4
2,120001,146000,25999,False,172,scaffold_4
3,147001,151000,3999,False,172,scaffold_4
4,155001,215000,59999,False,172,scaffold_4
5,217001,226000,8999,False,172,scaffold_4
6,227001,266000,38999,False,172,scaffold_4
7,412001,425000,12999,False,172,scaffold_4
8,429001,503000,73999,False,172,scaffold_4
9,542001,592000,49999,False,172,scaffold_4
10,608001,691000,82999,False,172,scaffold_4
11,1082001,1086000,3999,False,172,scaffold_4
12,1087001,1097000,9999,False,172,scaffold_4
13,1099001,1109000,9999,False,172,scaffold_4
14,1112001,1198000,85999,False,172,scaffold_4
15,1199001,1208000,8999,False,172,scaffold_4
16,1210001,1214000,3999,False,172,scaffold_4
17,1265001,1279000,13999,False,172,scaffold_4
18,1283001,1324000,40999,False,172,scaffold_4
19,1370001,1598000,227999,False,172,scaffold_4
20,1613001,1641000,27999,False,172,scaffold_4
21,1749001,1849000,99999,False,172,scaffold_4
22,1854001,1863000,8999,False,172,scaffold_4
23,1905001,1923000,17999,False,172,scaffold_4
24,1932001,1988000,55999,False,172,scaffold_4
25,2247001,2268000,20999,False,172,scaffold_4
26,2269001,2279000,9999,False,172,scaffold_4
27,2284001,2310000,25999,False,172,scaffold_4
28,2312001,2340000,27999,False,172,scaffold_4
29,2397001,2461000,63999,False,172,scaffold_4
30,2476001,2574000,97999,False,172,scaffold_4
31,2599001,2635000,35999,False,172,scaffold_4
32,3090001,3128000,37999,False,172,scaffold_4
33,3334001,3760000,425999,False,172,scaffold_4
34,4900001,5023000,122999,False,172,scaffold_4
35,5172001,5244000,71999,False,172,scaffold_4
36,5300001,5425000,124999,False,172,scaffold_4
37,5475001,5506000,30999,False,172,scaffold_4
38,5515001,5699000,183999,False,172,scaffold_4
39,5700001,5784000,83999,False,172,scaffold_4
40,5786001,5823000,36999,False,172,scaffold_4
41,6149001,6195000,45999,False,172,scaffold_4
42,6799001,6817000,17999,False,172,scaffold_4
43,6914001,6924000,9999,False,172,scaffold_4
44,7036001,7097000,60999,False,172,scaffold_4
45,7192001,7283000,90999,False,172,scaffold_4
46,8844001,9699000,854999,False,172,scaffold_4
47,9700001,9845951,145950,True,172,scaffold_4
0,1,4000,3999,True,172,scaffold_5
1,7001,16000,8999,False,172,scaffold_5
2,141001,173000,31999,False,172,scaffold_5
3,296001,299000,2999,False,172,scaffold_5
4,316001,401000,84999,False,172,scaffold_5
5,402001,417000,14999,False,172,scaffold_5
6,461001,523000,61999,False,172,scaffold_5
7,933001,947000,13999,False,172,scaffold_5
8,1062001,1068000,5999,False,172,scaffold_5
9,2512001,2515000,2999,False,172,scaffold_5
10,2564001,2739000,174999,False,172,scaffold_5
11,2816001,2871000,54999,False,172,scaffold_5
12,3097001,3186000,88999,False,172,scaffold_5
13,3218001,3252000,33999,False,172,scaffold_5
14,3321001,3509000,187999,False,172,scaffold_5
15,3963001,4101000,137999,False,172,scaffold_5
16,4125001,4211000,85999,False,172,scaffold_5
17,4233001,4321000,87999,False,172,scaffold_5
18,4446001,4506000,59999,False,172,scaffold_5
19,4603001,4681000,77999,False,172,scaffold_5
20,4694001,4737000,42999,False,172,scaffold_5
21,4760001,4854000,93999,False,172,scaffold_5
22,4904001,4921000,16999,False,172,scaffold_5
23,5287001,5345000,57999,False,172,scaffold_5
24,5704001,5737000,32999,False,172,scaffold_5
25,5867001,5888000,20999,False,172,scaffold_5
26,6409001,6420000,10999,False,172,scaffold_5
27,6457001,6670000,212999,False,172,scaffold_5
28,7167001,7195000,27999,False,172,scaffold_5
29,7373001,7385000,11999,False,172,scaffold_5
30,7454001,7483000,28999,False,172,scaffold_5
31,7550001,7609000,58999,False,172,scaffold_5
32,7622001,7658000,35999,False,172,scaffold_5
33,8258001,8280000,21999,False,172,scaffold_5
34,8436001,8463000,26999,False,172,scaffold_5
35,8555001,8617000,61999,False,172,scaffold_5
36,8713001,9364176,651175,True,172,scaffold_5
0,86001,121000,34999,False,172,scaffold_6
1,163001,210000,46999,False,172,scaffold_6
2,239001,253000,13999,False,172,scaffold_6
3,1229001,1266000,36999,False,172,scaffold_6
4,1435001,1462000,26999,False,172,scaffold_6
5,1476001,1550000,73999,False,172,scaffold_6
6,1855001,1906000,50999,False,172,scaffold_6
7,2026001,2090000,63999,False,172,scaffold_6
8,2116001,2168000,51999,False,172,scaffold_6
9,2240001,2284000,43999,False,172,scaffold_6
10,2316001,2595000,278999,False,172,scaffold_6
11,2596001,2653000,56999,False,172,scaffold_6
12,2657001,2850000,192999,False,172,scaffold_6
13,2928001,3014000,85999,False,172,scaffold_6
14,3080001,3174000,93999,False,172,scaffold_6
15,3222001,3301000,78999,False,172,scaffold_6
16,3399001,3432000,32999,False,172,scaffold_6
17,3459001,3520000,60999,False,172,scaffold_6
18,3524001,3806000,281999,False,172,scaffold_6
19,3897001,3913000,15999,False,172,scaffold_6
20,3966001,4193000,226999,False,172,scaffold_6
21,6009001,6082000,72999,False,172,scaffold_6
22,7219001,7247000,27999,False,172,scaffold_6
23,7263001,7338000,74999,False,172,scaffold_6
24,7382001,7476000,93999,False,172,scaffold_6
25,7547001,7798000,250999,False,172,scaffold_6
26,7811001,8268281,457280,True,172,scaffold_6
0,1,9000,8999,True,172,scaffold_7
1,11001,31000,19999,False,172,scaffold_7
2,323001,340000,16999,False,172,scaffold_7
3,342001,504000,161999,False,172,scaffold_7
4,571001,577000,5999,False,172,scaffold_7
5,622001,642000,19999,False,172,scaffold_7
6,646001,754000,107999,False,172,scaffold_7
7,760001,821000,60999,False,172,scaffold_7
8,859001,864000,4999,False,172,scaffold_7
9,868001,872000,3999,False,172,scaffold_7
10,875001,945000,69999,False,172,scaffold_7
11,964001,966000,1999,False,172,scaffold_7
12,968001,980000,11999,False,172,scaffold_7
13,982001,1044000,61999,False,172,scaffold_7
14,1048001,1099000,50999,False,172,scaffold_7
15,1191001,1512000,320999,False,172,scaffold_7
16,1588001,1664000,75999,False,172,scaffold_7
17,1666001,1693000,26999,False,172,scaffold_7
18,3325001,3369000,43999,False,172,scaffold_7
19,3520001,3809000,288999,False,172,scaffold_7
20,4332001,4368000,35999,False,172,scaffold_7
21,4436001,4534000,97999,False,172,scaffold_7
22,4552001,4597000,44999,False,172,scaffold_7
23,4630001,4768000,137999,False,172,scaffold_7
24,4981001,5149000,167999,False,172,scaffold_7
25,5474001,5536000,61999,False,172,scaffold_7
26,5609001,5628000,18999,False,172,scaffold_7
27,6953001,7270000,316999,False,172,scaffold_7
28,7271001,7502216,231215,True,172,scaffold_7
0,31001,64000,32999,False,172,scaffold_8
1,67001,85000,17999,False,172,scaffold_8
2,1904001,1968000,63999,False,172,scaffold_8
3,2360001,2407000,46999,False,172,scaffold_8
4,2412001,2570000,157999,False,172,scaffold_8
5,2649001,2683000,33999,False,172,scaffold_8
6,2742001,2757000,14999,False,172,scaffold_8
7,2798001,2844000,45999,False,172,scaffold_8
8,3058001,3125000,66999,False,172,scaffold_8
9,3126001,3552000,425999,False,172,scaffold_8
10,3577001,3614000,36999,False,172,scaffold_8
11,3615001,3949000,333999,False,172,scaffold_8
12,4174001,4221000,46999,False,172,scaffold_8
13,5093001,5137000,43999,False,172,scaffold_8
14,5163001,5242000,78999,False,172,scaffold_8
15,5651001,5692000,40999,False,172,scaffold_8
16,6329001,6334544,5543,True,172,scaffold_8
0,1,22000,21999,True,172,scaffold_9
1,109001,117000,7999,False,172,scaffold_9
2,121001,138000,16999,False,172,scaffold_9
3,143001,148000,4999,False,172,scaffold_9
4,347001,411000,63999,False,172,scaffold_9
5,413001,434000,20999,False,172,scaffold_9
6,484001,531000,46999,False,172,scaffold_9
7,653001,664000,10999,False,172,scaffold_9
8,671001,696000,24999,False,172,scaffold_9
9,731001,741000,9999,False,172,scaffold_9
10,817001,842000,24999,False,172,scaffold_9
11,886001,986000,99999,False,172,scaffold_9
12,988001,996000,7999,False,172,scaffold_9
13,1009001,1030000,20999,False,172,scaffold_9
14,1042001,1085000,42999,False,172,scaffold_9
15,1087001,1164000,76999,False,172,scaffold_9
16,1312001,1377000,64999,False,172,scaffold_9
17,1765001,1810000,44999,False,172,scaffold_9
18,2598001,2616000,17999,False,172,scaffold_9
19,2768001,2824000,55999,False,172,scaffold_9
20,2859001,3381000,521999,False,172,scaffold_9
21,3383001,5110000,1726999,False,172,scaffold_9
22,5112001,5114000,1999,False,172,scaffold_9
23,5116001,5298000,181999,False,172,scaffold_9
24,5300001,5490000,189999,False,172,scaffold_9
25,5493001,6331288,838287,True,172,scaffold_9
0,1,236000,235999,True,172,scaffold_10
1,286001,408000,121999,False,172,scaffold_10
2,472001,482000,9999,False,172,scaffold_10
3,483001,582000,98999,False,172,scaffold_10
4,603001,795000,191999,False,172,scaffold_10
5,812001,830000,17999,False,172,scaffold_10
6,888001,917000,28999,False,172,scaffold_10
7,923001,964000,40999,False,172,scaffold_10
8,1073001,1145000,71999,False,172,scaffold_10
9,2145001,2166000,20999,False,172,scaffold_10
10,2346001,2368000,21999,False,172,scaffold_10
11,3264001,3268000,3999,False,172,scaffold_10
12,4052001,4112000,59999,False,172,scaffold_10
13,4154001,4174000,19999,False,172,scaffold_10
14,4445001,4461000,15999,False,172,scaffold_10
15,4467001,4513000,45999,False,172,scaffold_10
16,4515001,4548000,32999,False,172,scaffold_10
17,4554001,4562000,7999,False,172,scaffold_10
18,4574001,4597000,22999,False,172,scaffold_10
19,4734001,4776000,41999,False,172,scaffold_10
20,4781001,4784000,2999,False,172,scaffold_10
21,4798001,4824000,25999,False,172,scaffold_10
22,4827001,4861000,33999,False,172,scaffold_10
23,4865001,4866973,1972,True,172,scaffold_10
0,10001,93000,82999,False,172,scaffold_11
1,132001,167000,34999,False,172,scaffold_11
2,169001,212000,42999,False,172,scaffold_11
3,213001,236000,22999,False,172,scaffold_11
4,240001,253000,12999,False,172,scaffold_11
5,289001,320000,30999,False,172,scaffold_11
6,419001,431000,11999,False,172,scaffold_11
7,649001,656000,6999,False,172,scaffold_11
8,949001,951000,1999,False,172,scaffold_11
9,1027001,1034000,6999,False,172,scaffold_11
10,1423001,1426000,2999,False,172,scaffold_11
11,2703001,2867000,163999,False,172,scaffold_11
12,2981001,3011000,29999,False,172,scaffold_11
13,3059001,3073000,13999,False,172,scaffold_11
14,3083001,3175000,91999,False,172,scaffold_11
15,3188001,3258000,69999,False,172,scaffold_11
16,3327001,3383000,55999,False,172,scaffold_11
17,3587001,3695000,107999,False,172,scaffold_11
18,3696001,3928000,231999,False,172,scaffold_11
19,3950001,3971000,20999,False,172,scaffold_11
20,4132001,4159000,26999,False,172,scaffold_11
21,4321001,4710000,388999,False,172,scaffold_11
22,4712001,4766820,54819,True,172,scaffold_11
0,1,385000,384999,True,172,scaffold_12
1,403001,858000,454999,False,172,scaffold_12
2,863001,1467000,603999,False,172,scaffold_12
3,1719001,1733000,13999,False,172,scaffold_12
4,2492001,2502000,9999,False,172,scaffold_12
5,2571001,2618000,46999,False,172,scaffold_12
6,2718001,2722000,3999,False,172,scaffold_12
0,1,675000,674999,True,173,scaffold_1
1,679001,766000,86999,False,173,scaffold_1
2,793001,866000,72999,False,173,scaffold_1
3,871001,903000,31999,False,173,scaffold_1
4,1053001,1087000,33999,False,173,scaffold_1
5,1168001,1292000,123999,False,173,scaffold_1
6,1550001,1582000,31999,False,173,scaffold_1
7,1609001,1700000,90999,False,173,scaffold_1
8,1726001,1800000,73999,False,173,scaffold_1
9,1814001,1900000,85999,False,173,scaffold_1
10,1914001,1936000,21999,False,173,scaffold_1
11,1950001,1964000,13999,False,173,scaffold_1
12,1965001,1984000,18999,False,173,scaffold_1
13,1988001,2071000,82999,False,173,scaffold_1
14,2269001,2331000,61999,False,173,scaffold_1
15,2332001,2415000,82999,False,173,scaffold_1
16,2449001,2621000,171999,False,173,scaffold_1
17,2641001,2691000,49999,False,173,scaffold_1
18,2722001,2752000,29999,False,173,scaffold_1
19,2906001,2925000,18999,False,173,scaffold_1
20,2960001,3151000,190999,False,173,scaffold_1
21,3156001,3228000,71999,False,173,scaffold_1
22,3444001,3649000,204999,False,173,scaffold_1
23,3707001,3922000,214999,False,173,scaffold_1
24,3923001,4112000,188999,False,173,scaffold_1
25,4183001,4256000,72999,False,173,scaffold_1
26,4304001,4377000,72999,False,173,scaffold_1
27,4484001,4558000,73999,False,173,scaffold_1
28,4650001,4790000,139999,False,173,scaffold_1
29,4796001,5068000,271999,False,173,scaffold_1
30,5083001,5200000,116999,False,173,scaffold_1
31,5348001,5451000,102999,False,173,scaffold_1
32,5480001,5521000,40999,False,173,scaffold_1
33,5535001,5593000,57999,False,173,scaffold_1
34,5827001,5949000,121999,False,173,scaffold_1
35,6041001,6071000,29999,False,173,scaffold_1
36,6088001,6101000,12999,False,173,scaffold_1
37,6108001,6177000,68999,False,173,scaffold_1
38,6201001,6264000,62999,False,173,scaffold_1
39,6267001,6381000,113999,False,173,scaffold_1
40,6384001,6617000,232999,False,173,scaffold_1
41,6633001,6670000,36999,False,173,scaffold_1
42,6806001,6852000,45999,False,173,scaffold_1
43,6864001,6953000,88999,False,173,scaffold_1
44,7000001,7029000,28999,False,173,scaffold_1
45,7034001,7247000,212999,False,173,scaffold_1
46,7248001,8622000,1373999,False,173,scaffold_1
47,8624001,8656000,31999,False,173,scaffold_1
48,8658001,9364000,705999,False,173,scaffold_1
49,9365001,9582000,216999,False,173,scaffold_1
50,9586001,10046000,459999,False,173,scaffold_1
51,10047001,10363000,315999,False,173,scaffold_1
52,10460001,10644000,183999,False,173,scaffold_1
53,10664001,10708000,43999,False,173,scaffold_1
54,10709001,10788000,78999,False,173,scaffold_1
55,10835001,10966000,130999,False,173,scaffold_1
56,11014001,11154000,139999,False,173,scaffold_1
57,11233001,11921000,687999,False,173,scaffold_1
58,12060001,12244000,183999,False,173,scaffold_1
59,12327001,12396000,68999,False,173,scaffold_1
60,12425001,12584000,158999,False,173,scaffold_1
61,12624001,12887000,262999,False,173,scaffold_1
62,12935001,13067000,131999,False,173,scaffold_1
63,13092001,13135000,42999,False,173,scaffold_1
64,13141001,13210000,68999,False,173,scaffold_1
65,13343001,13454000,110999,False,173,scaffold_1
66,13555001,13583000,27999,False,173,scaffold_1
67,13930001,13941000,10999,False,173,scaffold_1
68,13958001,13987000,28999,False,173,scaffold_1
69,14286001,14313000,26999,False,173,scaffold_1
70,14316001,14322000,5999,False,173,scaffold_1
0,26001,40000,13999,False,173,scaffold_2
1,42001,48000,5999,False,173,scaffold_2
2,128001,159000,30999,False,173,scaffold_2
3,168001,177000,8999,False,173,scaffold_2
4,296001,317000,20999,False,173,scaffold_2
5,339001,374000,34999,False,173,scaffold_2
6,460001,527000,66999,False,173,scaffold_2
7,1367001,1398000,30999,False,173,scaffold_2
8,1478001,1558000,79999,False,173,scaffold_2
9,1697001,1705000,7999,False,173,scaffold_2
10,1804001,1860000,55999,False,173,scaffold_2
11,1915001,1959000,43999,False,173,scaffold_2
12,2078001,2111000,32999,False,173,scaffold_2
13,2162001,2179000,16999,False,173,scaffold_2
14,2336001,2391000,54999,False,173,scaffold_2
15,2410001,2609000,198999,False,173,scaffold_2
16,2647001,2689000,41999,False,173,scaffold_2
17,2693001,2746000,52999,False,173,scaffold_2
18,2796001,2855000,58999,False,173,scaffold_2
19,2868001,3021000,152999,False,173,scaffold_2
20,3022001,3103000,80999,False,173,scaffold_2
21,3331001,3375000,43999,False,173,scaffold_2
22,3449001,3600000,150999,False,173,scaffold_2
23,3665001,3692000,26999,False,173,scaffold_2
24,3754001,3789000,34999,False,173,scaffold_2
25,3835001,3927000,91999,False,173,scaffold_2
26,4098001,4161000,62999,False,173,scaffold_2
27,4243001,4409000,165999,False,173,scaffold_2
28,4425001,4790000,364999,False,173,scaffold_2
29,4876001,4963000,86999,False,173,scaffold_2
30,5021001,5104000,82999,False,173,scaffold_2
31,5139001,5224000,84999,False,173,scaffold_2
32,5285001,5304000,18999,False,173,scaffold_2
33,5335001,5780000,444999,False,173,scaffold_2
34,5821001,6215000,393999,False,173,scaffold_2
35,6228001,6351000,122999,False,173,scaffold_2
36,6365001,6406000,40999,False,173,scaffold_2
37,6408001,6480000,71999,False,173,scaffold_2
38,6591001,6727000,135999,False,173,scaffold_2
39,6873001,7038000,164999,False,173,scaffold_2
40,7061001,7097000,35999,False,173,scaffold_2
41,7108001,7221000,112999,False,173,scaffold_2
42,7331001,7472000,140999,False,173,scaffold_2
43,7491001,7504000,12999,False,173,scaffold_2
44,7549001,7561000,11999,False,173,scaffold_2
45,7563001,7707000,143999,False,173,scaffold_2
46,7719001,7881000,161999,False,173,scaffold_2
47,7935001,8057000,121999,False,173,scaffold_2
48,8065001,8217000,151999,False,173,scaffold_2
49,8260001,8328000,67999,False,173,scaffold_2
50,8335001,8344000,8999,False,173,scaffold_2
51,8346001,8454000,107999,False,173,scaffold_2
52,8461001,8564000,102999,False,173,scaffold_2
53,8617001,8651000,33999,False,173,scaffold_2
54,8993001,9108000,114999,False,173,scaffold_2
55,9140001,9508000,367999,False,173,scaffold_2
56,9534001,9540000,5999,False,173,scaffold_2
57,9559001,9786000,226999,False,173,scaffold_2
58,9862001,9900000,37999,False,173,scaffold_2
59,10011001,10046000,34999,False,173,scaffold_2
60,10269001,10322000,52999,False,173,scaffold_2
61,10396001,10462000,65999,False,173,scaffold_2
62,10639001,10727000,87999,False,173,scaffold_2
63,10929001,10963000,33999,False,173,scaffold_2
64,11000001,11107000,106999,False,173,scaffold_2
65,11318001,11384000,65999,False,173,scaffold_2
66,11395001,11503000,107999,False,173,scaffold_2
67,11518001,11749000,230999,False,173,scaffold_2
68,11750001,11786000,35999,False,173,scaffold_2
69,11797001,11802476,5475,True,173,scaffold_2
0,1,2000,1999,True,173,scaffold_3
1,618001,633000,14999,False,173,scaffold_3
2,796001,901000,104999,False,173,scaffold_3
3,1153001,1228000,74999,False,173,scaffold_3
4,1755001,1784000,28999,False,173,scaffold_3
5,1938001,1980000,41999,False,173,scaffold_3
6,2000001,2147000,146999,False,173,scaffold_3
7,2249001,2340000,90999,False,173,scaffold_3
8,2379001,2427000,47999,False,173,scaffold_3
9,2454001,2533000,78999,False,173,scaffold_3
10,2534001,2552000,17999,False,173,scaffold_3
11,2647001,2757000,109999,False,173,scaffold_3
12,3066001,3346000,279999,False,173,scaffold_3
13,3412001,3440000,27999,False,173,scaffold_3
14,3498001,3735000,236999,False,173,scaffold_3
15,3783001,3820000,36999,False,173,scaffold_3
16,3822001,3891000,68999,False,173,scaffold_3
17,3926001,4404000,477999,False,173,scaffold_3
18,4416001,4499000,82999,False,173,scaffold_3
19,4540001,4564000,23999,False,173,scaffold_3
20,4567001,4578000,10999,False,173,scaffold_3
21,4582001,4593000,10999,False,173,scaffold_3
22,4777001,4926000,148999,False,173,scaffold_3
23,4981001,5220000,238999,False,173,scaffold_3
24,5239001,5273000,33999,False,173,scaffold_3
25,5348001,5509000,160999,False,173,scaffold_3
26,5590001,5675000,84999,False,173,scaffold_3
27,5700001,5731000,30999,False,173,scaffold_3
28,5783001,5953000,169999,False,173,scaffold_3
29,5971001,6088000,116999,False,173,scaffold_3
30,6219001,6245000,25999,False,173,scaffold_3
31,6521001,6580000,58999,False,173,scaffold_3
32,6760001,6807000,46999,False,173,scaffold_3
33,6886001,7155000,268999,False,173,scaffold_3
34,7223001,7320000,96999,False,173,scaffold_3
35,7332001,7414000,81999,False,173,scaffold_3
36,7429001,7442000,12999,False,173,scaffold_3
37,7483001,7559000,75999,False,173,scaffold_3
38,7576001,7633000,56999,False,173,scaffold_3
39,7664001,7989000,324999,False,173,scaffold_3
40,8027001,8108000,80999,False,173,scaffold_3
41,8183001,8527000,343999,False,173,scaffold_3
42,8544001,8639000,94999,False,173,scaffold_3
43,8757001,8806000,48999,False,173,scaffold_3
44,8952001,9081000,128999,False,173,scaffold_3
45,9106001,9161000,54999,False,173,scaffold_3
46,9453001,9524000,70999,False,173,scaffold_3
47,9732001,9787000,54999,False,173,scaffold_3
48,9966001,9996000,29999,False,173,scaffold_3
49,10024001,10094000,69999,False,173,scaffold_3
50,10417001,10458000,40999,False,173,scaffold_3
51,10461001,10488000,26999,False,173,scaffold_3
52,10555001,10571000,15999,False,173,scaffold_3
53,10574001,11182071,608070,True,173,scaffold_3
0,1,7000,6999,True,173,scaffold_4
1,17001,32000,14999,False,173,scaffold_4
2,48001,89000,40999,False,173,scaffold_4
3,106001,115000,8999,False,173,scaffold_4
4,119001,151000,31999,False,173,scaffold_4
5,155001,215000,59999,False,173,scaffold_4
6,217001,226000,8999,False,173,scaffold_4
7,242001,269000,26999,False,173,scaffold_4
8,283001,307000,23999,False,173,scaffold_4
9,355001,374000,18999,False,173,scaffold_4
10,412001,425000,12999,False,173,scaffold_4
11,429001,592000,162999,False,173,scaffold_4
12,593001,606000,12999,False,173,scaffold_4
13,608001,646000,37999,False,173,scaffold_4
14,648001,691000,42999,False,173,scaffold_4
15,701001,726000,24999,False,173,scaffold_4
16,1120001,1136000,15999,False,173,scaffold_4
17,1137001,1227000,89999,False,173,scaffold_4
18,1236001,1253000,16999,False,173,scaffold_4
19,1254001,1279000,24999,False,173,scaffold_4
20,1284001,1604000,319999,False,173,scaffold_4
21,1613001,2000000,386999,False,173,scaffold_4
22,2001001,2185000,183999,False,173,scaffold_4
23,2210001,2218000,7999,False,173,scaffold_4
24,2219001,2281000,61999,False,173,scaffold_4
25,2283001,2341000,57999,False,173,scaffold_4
26,2343001,2460000,116999,False,173,scaffold_4
27,2476001,2861000,384999,False,173,scaffold_4
28,2891001,3958000,1066999,False,173,scaffold_4
29,3966001,4104000,137999,False,173,scaffold_4
30,4243001,4309000,65999,False,173,scaffold_4
31,4702001,4737000,34999,False,173,scaffold_4
32,4793001,4890000,96999,False,173,scaffold_4
33,4891001,5135000,243999,False,173,scaffold_4
34,5180001,5506000,325999,False,173,scaffold_4
35,5514001,5641000,126999,False,173,scaffold_4
36,5669001,5750000,80999,False,173,scaffold_4
37,5752001,5784000,31999,False,173,scaffold_4
38,5786001,5856000,69999,False,173,scaffold_4
39,5870001,6112000,241999,False,173,scaffold_4
40,6146001,6197000,50999,False,173,scaffold_4
41,6214001,6283000,68999,False,173,scaffold_4
42,6285001,6439000,153999,False,173,scaffold_4
43,6553001,6612000,58999,False,173,scaffold_4
44,6615001,6617000,1999,False,173,scaffold_4
45,6707001,6817000,109999,False,173,scaffold_4
46,6902001,6924000,21999,False,173,scaffold_4
47,6959001,7401000,441999,False,173,scaffold_4
48,7459001,7571000,111999,False,173,scaffold_4
49,7641001,7656000,14999,False,173,scaffold_4
50,7835001,7917000,81999,False,173,scaffold_4
51,7986001,7999000,12999,False,173,scaffold_4
52,8057001,8098000,40999,False,173,scaffold_4
53,8266001,8317000,50999,False,173,scaffold_4
54,8704001,8769000,64999,False,173,scaffold_4
55,8792001,8827000,34999,False,173,scaffold_4
56,8844001,9699000,854999,False,173,scaffold_4
57,9703001,9845951,142950,True,173,scaffold_4
0,1,4000,3999,True,173,scaffold_5
1,150001,165000,14999,False,173,scaffold_5
2,318001,397000,78999,False,173,scaffold_5
3,445001,522000,76999,False,173,scaffold_5
4,668001,699000,30999,False,173,scaffold_5
5,917001,947000,29999,False,173,scaffold_5
6,2092001,2104000,11999,False,173,scaffold_5
7,2256001,2301000,44999,False,173,scaffold_5
8,2381001,2415000,33999,False,173,scaffold_5
9,2472001,2494000,21999,False,173,scaffold_5
10,2505001,2515000,9999,False,173,scaffold_5
11,2516001,2912000,395999,False,173,scaffold_5
12,3051001,3078000,26999,False,173,scaffold_5
13,3093001,3521000,427999,False,173,scaffold_5
14,3599001,3680000,80999,False,173,scaffold_5
15,3719001,3948000,228999,False,173,scaffold_5
16,3963001,4101000,137999,False,173,scaffold_5
17,4125001,4219000,93999,False,173,scaffold_5
18,4226001,4503000,276999,False,173,scaffold_5
19,4511001,4554000,42999,False,173,scaffold_5
20,4568001,4919000,350999,False,173,scaffold_5
21,4937001,5106000,168999,False,173,scaffold_5
22,5242001,5273000,30999,False,173,scaffold_5
23,5286001,5347000,60999,False,173,scaffold_5
24,5409001,5464000,54999,False,173,scaffold_5
25,5507001,5535000,27999,False,173,scaffold_5
26,5689001,5738000,48999,False,173,scaffold_5
27,5859001,5892000,32999,False,173,scaffold_5
28,6392001,6721000,328999,False,173,scaffold_5
29,6761001,6853000,91999,False,173,scaffold_5
30,6881001,6920000,38999,False,173,scaffold_5
31,7015001,7085000,69999,False,173,scaffold_5
32,7173001,7371000,197999,False,173,scaffold_5
33,7406001,7442000,35999,False,173,scaffold_5
34,7458001,7522000,63999,False,173,scaffold_5
35,7523001,7619000,95999,False,173,scaffold_5
36,7621001,7806000,184999,False,173,scaffold_5
37,7829001,8037000,207999,False,173,scaffold_5
38,8139001,8192000,52999,False,173,scaffold_5
39,8258001,8310000,51999,False,173,scaffold_5
40,8377001,8464000,86999,False,173,scaffold_5
41,8551001,8624000,72999,False,173,scaffold_5
42,8636001,9364176,728175,True,173,scaffold_5
0,79001,84000,4999,False,173,scaffold_6
1,86001,121000,34999,False,173,scaffold_6
2,147001,209000,61999,False,173,scaffold_6
3,228001,254000,25999,False,173,scaffold_6
4,265001,376000,110999,False,173,scaffold_6
5,459001,497000,37999,False,173,scaffold_6
6,553001,579000,25999,False,173,scaffold_6
7,627001,665000,37999,False,173,scaffold_6
8,1143001,1226000,82999,False,173,scaffold_6
9,1228001,1254000,25999,False,173,scaffold_6
10,1285001,1300000,14999,False,173,scaffold_6
11,1432001,1616000,183999,False,173,scaffold_6
12,1656001,2099000,442999,False,173,scaffold_6
13,2124001,2266000,141999,False,173,scaffold_6
14,2332001,2868000,535999,False,173,scaffold_6
15,2927001,3211000,283999,False,173,scaffold_6
16,3223001,3933000,709999,False,173,scaffold_6
17,3970001,4195000,224999,False,173,scaffold_6
18,4251001,4300000,48999,False,173,scaffold_6
19,4616001,4671000,54999,False,173,scaffold_6
20,4773001,4797000,23999,False,173,scaffold_6
21,4816001,4905000,88999,False,173,scaffold_6
22,4927001,5006000,78999,False,173,scaffold_6
23,5102001,5168000,65999,False,173,scaffold_6
24,5290001,5320000,29999,False,173,scaffold_6
25,5558001,5668000,109999,False,173,scaffold_6
26,5670001,5713000,42999,False,173,scaffold_6
27,5714001,5789000,74999,False,173,scaffold_6
28,5861001,5972000,110999,False,173,scaffold_6
29,6020001,6107000,86999,False,173,scaffold_6
30,6122001,6278000,155999,False,173,scaffold_6
31,6525001,6611000,85999,False,173,scaffold_6
32,6765001,6804000,38999,False,173,scaffold_6
33,6814001,6862000,47999,False,173,scaffold_6
34,6898001,6941000,42999,False,173,scaffold_6
35,7075001,7119000,43999,False,173,scaffold_6
36,7179001,7343000,163999,False,173,scaffold_6
37,7362001,7487000,124999,False,173,scaffold_6
38,7531001,7679000,147999,False,173,scaffold_6
39,7689001,7716000,26999,False,173,scaffold_6
40,7733001,8268281,535280,True,173,scaffold_6
0,306001,340000,33999,False,173,scaffold_7
1,342001,509000,166999,False,173,scaffold_7
2,651001,674000,22999,False,173,scaffold_7
3,706001,736000,29999,False,173,scaffold_7
4,763001,809000,45999,False,173,scaffold_7
5,858001,864000,5999,False,173,scaffold_7
6,888001,943000,54999,False,173,scaffold_7
7,990001,1044000,53999,False,173,scaffold_7
8,1048001,1099000,50999,False,173,scaffold_7
9,1169001,1318000,148999,False,173,scaffold_7
10,1319001,1512000,192999,False,173,scaffold_7
11,1588001,1694000,105999,False,173,scaffold_7
12,1727001,1757000,29999,False,173,scaffold_7
13,1972001,2013000,40999,False,173,scaffold_7
14,2561001,2711000,149999,False,173,scaffold_7
15,2719001,2743000,23999,False,173,scaffold_7
16,2804001,2954000,149999,False,173,scaffold_7
17,2998001,3024000,25999,False,173,scaffold_7
18,3097001,3205000,107999,False,173,scaffold_7
19,3293001,3422000,128999,False,173,scaffold_7
20,3440001,3493000,52999,False,173,scaffold_7
21,3503001,3508000,4999,False,173,scaffold_7
22,3513001,3664000,150999,False,173,scaffold_7
23,3688001,3979000,290999,False,173,scaffold_7
24,4021001,4081000,59999,False,173,scaffold_7
25,4199001,4221000,21999,False,173,scaffold_7
26,4265001,4598000,332999,False,173,scaffold_7
27,4621001,5210000,588999,False,173,scaffold_7
28,5313001,5432000,118999,False,173,scaffold_7
29,5474001,5574000,99999,False,173,scaffold_7
30,5609001,5645000,35999,False,173,scaffold_7
31,5719001,5761000,41999,False,173,scaffold_7
32,6033001,6430000,396999,False,173,scaffold_7
33,6464001,6492000,27999,False,173,scaffold_7
34,6557001,6676000,118999,False,173,scaffold_7
35,6696001,6801000,104999,False,173,scaffold_7
36,6816001,6866000,49999,False,173,scaffold_7
37,6944001,7502216,558215,True,173,scaffold_7
0,1,6000,5999,True,173,scaffold_8
1,59001,85000,25999,False,173,scaffold_8
2,112001,117000,4999,False,173,scaffold_8
3,1362001,1388000,25999,False,173,scaffold_8
4,1560001,1657000,96999,False,173,scaffold_8
5,1742001,1746000,3999,False,173,scaffold_8
6,1856001,1984000,127999,False,173,scaffold_8
7,2084001,2153000,68999,False,173,scaffold_8
8,2219001,2530000,310999,False,173,scaffold_8
9,2536001,2617000,80999,False,173,scaffold_8
10,2648001,2844000,195999,False,173,scaffold_8
11,2847001,3125000,277999,False,173,scaffold_8
12,3126001,3614000,487999,False,173,scaffold_8
13,3615001,3810000,194999,False,173,scaffold_8
14,3811001,4187000,375999,False,173,scaffold_8
15,4202001,4221000,18999,False,173,scaffold_8
16,4243001,4275000,31999,False,173,scaffold_8
17,4329001,4377000,47999,False,173,scaffold_8
18,4394001,4425000,30999,False,173,scaffold_8
19,4732001,4849000,116999,False,173,scaffold_8
20,4859001,4873000,13999,False,173,scaffold_8
21,4887001,4960000,72999,False,173,scaffold_8
22,4982001,5137000,154999,False,173,scaffold_8
23,5158001,5241000,82999,False,173,scaffold_8
24,5358001,5414000,55999,False,173,scaffold_8
25,5503001,5632000,128999,False,173,scaffold_8
26,5650001,5716000,65999,False,173,scaffold_8
27,5752001,5775000,22999,False,173,scaffold_8
28,5776001,5789000,12999,False,173,scaffold_8
29,5813001,5989000,175999,False,173,scaffold_8
30,6025001,6117000,91999,False,173,scaffold_8
31,6222001,6334544,112543,True,173,scaffold_8
0,1,22000,21999,True,173,scaffold_9
1,64001,106000,41999,False,173,scaffold_9
2,369001,411000,41999,False,173,scaffold_9
3,413001,430000,16999,False,173,scaffold_9
4,481001,531000,49999,False,173,scaffold_9
5,547001,574000,26999,False,173,scaffold_9
6,660001,665000,4999,False,173,scaffold_9
7,671001,697000,25999,False,173,scaffold_9
8,720001,741000,20999,False,173,scaffold_9
9,814001,842000,27999,False,173,scaffold_9
10,872001,986000,113999,False,173,scaffold_9
11,988001,995000,6999,False,173,scaffold_9
12,1001001,1031000,29999,False,173,scaffold_9
13,1037001,1170000,132999,False,173,scaffold_9
14,1202001,1257000,54999,False,173,scaffold_9
15,1311001,1383000,71999,False,173,scaffold_9
16,1427001,1440000,12999,False,173,scaffold_9
17,1457001,1467000,9999,False,173,scaffold_9
18,1483001,1531000,47999,False,173,scaffold_9
19,1550001,1585000,34999,False,173,scaffold_9
20,1600001,1691000,90999,False,173,scaffold_9
21,1705001,1791000,85999,False,173,scaffold_9
22,1885001,1934000,48999,False,173,scaffold_9
23,1947001,2173000,225999,False,173,scaffold_9
24,2175001,2432000,256999,False,173,scaffold_9
25,2476001,2824000,347999,False,173,scaffold_9
26,2844001,3381000,536999,False,173,scaffold_9
27,3383001,5107000,1723999,False,173,scaffold_9
28,5116001,5298000,181999,False,173,scaffold_9
29,5300001,6331288,1031287,True,173,scaffold_9
0,1,482000,481999,True,173,scaffold_10
1,483001,670000,186999,False,173,scaffold_10
2,671001,878000,206999,False,173,scaffold_10
3,888001,979000,90999,False,173,scaffold_10
4,980001,1069000,88999,False,173,scaffold_10
5,1073001,1178000,104999,False,173,scaffold_10
6,1227001,1475000,247999,False,173,scaffold_10
7,1605001,1757000,151999,False,173,scaffold_10
8,1803001,1835000,31999,False,173,scaffold_10
9,1860001,1916000,55999,False,173,scaffold_10
10,2012001,2181000,168999,False,173,scaffold_10
11,2196001,2471000,274999,False,173,scaffold_10
12,2509001,2520000,10999,False,173,scaffold_10
13,2533001,2653000,119999,False,173,scaffold_10
14,2673001,2813000,139999,False,173,scaffold_10
15,2816001,2861000,44999,False,173,scaffold_10
16,3067001,3132000,64999,False,173,scaffold_10
17,3481001,3506000,24999,False,173,scaffold_10
18,3634001,3656000,21999,False,173,scaffold_10
19,4049001,4088000,38999,False,173,scaffold_10
20,4154001,4184000,29999,False,173,scaffold_10
21,4336001,4367000,30999,False,173,scaffold_10
22,4443001,4462000,18999,False,173,scaffold_10
23,4503001,4513000,9999,False,173,scaffold_10
24,4515001,4523000,7999,False,173,scaffold_10
25,4527001,4548000,20999,False,173,scaffold_10
26,4565001,4630000,64999,False,173,scaffold_10
27,4679001,4688000,8999,False,173,scaffold_10
28,4701001,4715000,13999,False,173,scaffold_10
29,4716001,4732000,15999,False,173,scaffold_10
30,4734001,4776000,41999,False,173,scaffold_10
31,4798001,4824000,25999,False,173,scaffold_10
32,4827001,4843000,15999,False,173,scaffold_10
33,4848001,4860000,11999,False,173,scaffold_10
0,10001,93000,82999,False,173,scaffold_11
1,143001,167000,23999,False,173,scaffold_11
2,169001,191000,21999,False,173,scaffold_11
3,213001,236000,22999,False,173,scaffold_11
4,240001,252000,11999,False,173,scaffold_11
5,278001,314000,35999,False,173,scaffold_11
6,419001,431000,11999,False,173,scaffold_11
7,433001,446000,12999,False,173,scaffold_11
8,648001,656000,7999,False,173,scaffold_11
9,1030001,1034000,3999,False,173,scaffold_11
10,1219001,1249000,29999,False,173,scaffold_11
11,1316001,1338000,21999,False,173,scaffold_11
12,1474001,1478000,3999,False,173,scaffold_11
13,1859001,1880000,20999,False,173,scaffold_11
14,1905001,1989000,83999,False,173,scaffold_11
15,2087001,2162000,74999,False,173,scaffold_11
16,2572001,2605000,32999,False,173,scaffold_11
17,2657001,2920000,262999,False,173,scaffold_11
18,2953001,3037000,83999,False,173,scaffold_11
19,3059001,3176000,116999,False,173,scaffold_11
20,3185001,3483000,297999,False,173,scaffold_11
21,3518001,3722000,203999,False,173,scaffold_11
22,3744001,3972000,227999,False,173,scaffold_11
23,3984001,4076000,91999,False,173,scaffold_11
24,4077001,4710000,632999,False,173,scaffold_11
25,4712001,4766820,54819,True,173,scaffold_11
0,1,36000,35999,True,173,scaffold_12
1,37001,1498000,1460999,False,173,scaffold_12
2,1549001,1592000,42999,False,173,scaffold_12
3,1640001,1684000,43999,False,173,scaffold_12
4,1719001,1763000,43999,False,173,scaffold_12
5,1765001,1812000,46999,False,173,scaffold_12
6,1881001,2008000,126999,False,173,scaffold_12
7,2045001,2103000,57999,False,173,scaffold_12
8,2130001,2181000,50999,False,173,scaffold_12
9,2340001,2377000,36999,False,173,scaffold_12
10,2431001,2438000,6999,False,173,scaffold_12
11,2460001,2470000,9999,False,173,scaffold_12
12,2571001,2618000,46999,False,173,scaffold_12
0,1,330000,329999,True,174,scaffold_1
1,483001,498000,14999,False,174,scaffold_1
2,686001,755000,68999,False,174,scaffold_1
3,1279001,1292000,12999,False,174,scaffold_1
4,1630001,1660000,29999,False,174,scaffold_1
5,1965001,1984000,18999,False,174,scaffold_1
6,2372001,2386000,13999,False,174,scaffold_1
7,2447001,2519000,71999,False,174,scaffold_1
8,2567001,2580000,12999,False,174,scaffold_1
9,2729001,2746000,16999,False,174,scaffold_1
10,2900001,2925000,24999,False,174,scaffold_1
11,3194001,3205000,10999,False,174,scaffold_1
12,3444001,3480000,35999,False,174,scaffold_1
13,3715001,3743000,27999,False,174,scaffold_1
14,3902001,3940000,37999,False,174,scaffold_1
15,4005001,4012000,6999,False,174,scaffold_1
16,4067001,4112000,44999,False,174,scaffold_1
17,4314001,4353000,38999,False,174,scaffold_1
18,4927001,5017000,89999,False,174,scaffold_1
19,5087001,5117000,29999,False,174,scaffold_1
20,5483001,5521000,37999,False,174,scaffold_1
21,5859001,5866000,6999,False,174,scaffold_1
22,6205001,6318000,112999,False,174,scaffold_1
23,6385001,6443000,57999,False,174,scaffold_1
24,6470001,6504000,33999,False,174,scaffold_1
25,7041001,7247000,205999,False,174,scaffold_1
26,7248001,7589000,340999,False,174,scaffold_1
27,7590001,8394000,803999,False,174,scaffold_1
28,8396001,8600000,203999,False,174,scaffold_1
29,8601001,8642000,40999,False,174,scaffold_1
30,8646001,8656000,9999,False,174,scaffold_1
31,8658001,8775000,116999,False,174,scaffold_1
32,8776001,9584000,807999,False,174,scaffold_1
33,9586001,10360000,773999,False,174,scaffold_1
34,10461001,10640000,178999,False,174,scaffold_1
35,11360001,11404000,43999,False,174,scaffold_1
36,11419001,11498000,78999,False,174,scaffold_1
37,11550001,11634000,83999,False,174,scaffold_1
38,11671001,11681000,9999,False,174,scaffold_1
39,11714001,11826000,111999,False,174,scaffold_1
40,12664001,12717000,52999,False,174,scaffold_1
41,12788001,12866000,77999,False,174,scaffold_1
42,12972001,12992000,19999,False,174,scaffold_1
43,13178001,13216000,37999,False,174,scaffold_1
44,13346001,13405000,58999,False,174,scaffold_1
45,14285001,14310000,24999,False,174,scaffold_1
0,44001,48000,3999,False,174,scaffold_2
1,130001,159000,28999,False,174,scaffold_2
2,165001,177000,11999,False,174,scaffold_2
3,1693001,1705000,11999,False,174,scaffold_2
4,2336001,2421000,84999,False,174,scaffold_2
5,2446001,2600000,153999,False,174,scaffold_2
6,2679001,2689000,9999,False,174,scaffold_2
7,2693001,2745000,51999,False,174,scaffold_2
8,2803001,2854000,50999,False,174,scaffold_2
9,2878001,2900000,21999,False,174,scaffold_2
10,3454001,3465000,10999,False,174,scaffold_2
11,4397001,4408000,10999,False,174,scaffold_2
12,4519001,4630000,110999,False,174,scaffold_2
13,4918001,4954000,35999,False,174,scaffold_2
14,5201001,5222000,20999,False,174,scaffold_2
15,5414001,5481000,66999,False,174,scaffold_2
16,5492001,5517000,24999,False,174,scaffold_2
17,5678001,5759000,80999,False,174,scaffold_2
18,5910001,5951000,40999,False,174,scaffold_2
19,6261001,6312000,50999,False,174,scaffold_2
20,6313001,6330000,16999,False,174,scaffold_2
21,7004001,7030000,25999,False,174,scaffold_2
22,7346001,7438000,91999,False,174,scaffold_2
23,7439001,7462000,22999,False,174,scaffold_2
24,7563001,7581000,17999,False,174,scaffold_2
25,7628001,7698000,69999,False,174,scaffold_2
26,7786001,7887000,100999,False,174,scaffold_2
27,7989001,8139000,149999,False,174,scaffold_2
28,8265001,8313000,47999,False,174,scaffold_2
29,8331001,8333000,1999,False,174,scaffold_2
30,8507001,8549000,41999,False,174,scaffold_2
31,10710001,10725000,14999,False,174,scaffold_2
32,10776001,10780000,3999,False,174,scaffold_2
33,11367001,11376000,8999,False,174,scaffold_2
34,11547001,11789000,241999,False,174,scaffold_2
0,528001,538000,9999,False,174,scaffold_3
1,795001,901000,105999,False,174,scaffold_3
2,1163001,1185000,21999,False,174,scaffold_3
3,2085001,2108000,22999,False,174,scaffold_3
4,2291001,2321000,29999,False,174,scaffold_3
5,2487001,2533000,45999,False,174,scaffold_3
6,2716001,2737000,20999,False,174,scaffold_3
7,3831001,3878000,46999,False,174,scaffold_3
8,4107001,4345000,237999,False,174,scaffold_3
9,4415001,4495000,79999,False,174,scaffold_3
10,4543001,4558000,14999,False,174,scaffold_3
11,5154001,5209000,54999,False,174,scaffold_3
12,5493001,5506000,12999,False,174,scaffold_3
13,5863001,5953000,89999,False,174,scaffold_3
14,6761001,6784000,22999,False,174,scaffold_3
15,6910001,6956000,45999,False,174,scaffold_3
16,6979001,7096000,116999,False,174,scaffold_3
17,7286001,7301000,14999,False,174,scaffold_3
18,7334001,7401000,66999,False,174,scaffold_3
19,7449001,7458000,8999,False,174,scaffold_3
20,7483001,7555000,71999,False,174,scaffold_3
21,7694001,7764000,69999,False,174,scaffold_3
22,8187001,8253000,65999,False,174,scaffold_3
23,8424001,8449000,24999,False,174,scaffold_3
24,8459001,8527000,67999,False,174,scaffold_3
25,8575001,8593000,17999,False,174,scaffold_3
26,8760001,8769000,8999,False,174,scaffold_3
27,9007001,9033000,25999,False,174,scaffold_3
28,9967001,10000000,32999,False,174,scaffold_3
29,10597001,10970000,372999,False,174,scaffold_3
30,10971001,11167000,195999,False,174,scaffold_3
31,11174001,11182071,8070,True,174,scaffold_3
0,17001,32000,14999,False,174,scaffold_4
1,48001,89000,40999,False,174,scaffold_4
2,120001,151000,30999,False,174,scaffold_4
3,155001,160000,4999,False,174,scaffold_4
4,161001,215000,53999,False,174,scaffold_4
5,217001,226000,8999,False,174,scaffold_4
6,248001,266000,17999,False,174,scaffold_4
7,288001,307000,18999,False,174,scaffold_4
8,312001,349000,36999,False,174,scaffold_4
9,412001,425000,12999,False,174,scaffold_4
10,429001,500000,70999,False,174,scaffold_4
11,608001,634000,25999,False,174,scaffold_4
12,635001,659000,23999,False,174,scaffold_4
13,675001,691000,15999,False,174,scaffold_4
14,1050001,1066000,15999,False,174,scaffold_4
15,1087001,1097000,9999,False,174,scaffold_4
16,1099001,1110000,10999,False,174,scaffold_4
17,1113001,1136000,22999,False,174,scaffold_4
18,1137001,1179000,41999,False,174,scaffold_4
19,1268001,1279000,10999,False,174,scaffold_4
20,1283001,1337000,53999,False,174,scaffold_4
21,1369001,1588000,218999,False,174,scaffold_4
22,1613001,1711000,97999,False,174,scaffold_4
23,1749001,1997000,247999,False,174,scaffold_4
24,2024001,2065000,40999,False,174,scaffold_4
25,2076001,2117000,40999,False,174,scaffold_4
26,2269001,2281000,11999,False,174,scaffold_4
27,2284001,2387000,102999,False,174,scaffold_4
28,2391001,2461000,69999,False,174,scaffold_4
29,2476001,2567000,90999,False,174,scaffold_4
30,2739001,2794000,54999,False,174,scaffold_4
31,2942001,2968000,25999,False,174,scaffold_4
32,3088001,3126000,37999,False,174,scaffold_4
33,3299001,3325000,25999,False,174,scaffold_4
34,3339001,3370000,30999,False,174,scaffold_4
35,3384001,3601000,216999,False,174,scaffold_4
36,3676001,3761000,84999,False,174,scaffold_4
37,4944001,4985000,40999,False,174,scaffold_4
38,5168001,5222000,53999,False,174,scaffold_4
39,5342001,5355000,12999,False,174,scaffold_4
40,5418001,5442000,23999,False,174,scaffold_4
41,5477001,5506000,28999,False,174,scaffold_4
42,5525001,5596000,70999,False,174,scaffold_4
43,5701001,5784000,82999,False,174,scaffold_4
44,5786001,5788000,1999,False,174,scaffold_4
45,5789001,5819000,29999,False,174,scaffold_4
46,6145001,6168000,22999,False,174,scaffold_4
47,6615001,6617000,1999,False,174,scaffold_4
48,6894001,6924000,29999,False,174,scaffold_4
49,6950001,6989000,38999,False,174,scaffold_4
50,7153001,7173000,19999,False,174,scaffold_4
51,7985001,7998000,12999,False,174,scaffold_4
52,8844001,9188000,343999,False,174,scaffold_4
53,9190001,9225000,34999,False,174,scaffold_4
54,9226001,9324000,97999,False,174,scaffold_4
55,9326001,9699000,372999,False,174,scaffold_4
56,9703001,9758000,54999,False,174,scaffold_4
57,9759001,9845951,86950,True,174,scaffold_4
0,319001,349000,29999,False,174,scaffold_5
1,463001,523000,59999,False,174,scaffold_5
2,923001,947000,23999,False,174,scaffold_5
3,2475001,2493000,17999,False,174,scaffold_5
4,2551001,2582000,30999,False,174,scaffold_5
5,2624001,2782000,157999,False,174,scaffold_5
6,2813001,2871000,57999,False,174,scaffold_5
7,3217001,3289000,71999,False,174,scaffold_5
8,3383001,3416000,32999,False,174,scaffold_5
9,3451001,3514000,62999,False,174,scaffold_5
10,3623001,3657000,33999,False,174,scaffold_5
11,3963001,4101000,137999,False,174,scaffold_5
12,4128001,4216000,87999,False,174,scaffold_5
13,4233001,4263000,29999,False,174,scaffold_5
14,4445001,4506000,60999,False,174,scaffold_5
15,4591001,4663000,71999,False,174,scaffold_5
16,4664001,4800000,135999,False,174,scaffold_5
17,4820001,4857000,36999,False,174,scaffold_5
18,4968001,4988000,19999,False,174,scaffold_5
19,5255001,5275000,19999,False,174,scaffold_5
20,5281001,5312000,30999,False,174,scaffold_5
21,5318001,5341000,22999,False,174,scaffold_5
22,6409001,6420000,10999,False,174,scaffold_5
23,6535001,6566000,30999,False,174,scaffold_5
24,7461001,7487000,25999,False,174,scaffold_5
25,7559001,7619000,59999,False,174,scaffold_5
26,7622001,7656000,33999,False,174,scaffold_5
27,8571001,8616000,44999,False,174,scaffold_5
28,8714001,9218000,503999,False,174,scaffold_5
29,9219001,9364176,145175,True,174,scaffold_5
0,86001,113000,26999,False,174,scaffold_6
1,268001,284000,15999,False,174,scaffold_6
2,1485001,1546000,60999,False,174,scaffold_6
3,2025001,2085000,59999,False,174,scaffold_6
4,2136001,2189000,52999,False,174,scaffold_6
5,2374001,2653000,278999,False,174,scaffold_6
6,2664001,2818000,153999,False,174,scaffold_6
7,2934001,2978000,43999,False,174,scaffold_6
8,3119001,3177000,57999,False,174,scaffold_6
9,3224001,3343000,118999,False,174,scaffold_6
10,3533001,3786000,252999,False,174,scaffold_6
11,3882001,3913000,30999,False,174,scaffold_6
12,4018001,4065000,46999,False,174,scaffold_6
13,4105001,4204000,98999,False,174,scaffold_6
14,6020001,6063000,42999,False,174,scaffold_6
15,7264001,7338000,73999,False,174,scaffold_6
16,7394001,7440000,45999,False,174,scaffold_6
17,7546001,7566000,19999,False,174,scaffold_6
18,7567001,7629000,61999,False,174,scaffold_6
19,7657001,7681000,23999,False,174,scaffold_6
20,7690001,7714000,23999,False,174,scaffold_6
21,7733001,7774000,40999,False,174,scaffold_6
22,7814001,8268281,454280,True,174,scaffold_6
0,50001,60000,9999,False,174,scaffold_7
1,323001,340000,16999,False,174,scaffold_7
2,342001,364000,21999,False,174,scaffold_7
3,387001,509000,121999,False,174,scaffold_7
4,706001,753000,46999,False,174,scaffold_7
5,764001,829000,64999,False,174,scaffold_7
6,858001,864000,5999,False,174,scaffold_7
7,964001,979000,14999,False,174,scaffold_7
8,991001,1044000,52999,False,174,scaffold_7
9,1203001,1510000,306999,False,174,scaffold_7
10,1588001,1695000,106999,False,174,scaffold_7
11,3524001,3671000,146999,False,174,scaffold_7
12,3717001,3794000,76999,False,174,scaffold_7
13,4433001,4512000,78999,False,174,scaffold_7
14,4705001,4741000,35999,False,174,scaffold_7
15,4978001,5030000,51999,False,174,scaffold_7
16,5032001,5149000,116999,False,174,scaffold_7
17,6954001,7047000,92999,False,174,scaffold_7
18,7048001,7270000,221999,False,174,scaffold_7
19,7292001,7442000,149999,False,174,scaffold_7
20,7443001,7502216,59215,True,174,scaffold_7
0,2001,6000,3999,False,174,scaffold_8
1,66001,85000,18999,False,174,scaffold_8
2,1856001,1927000,70999,False,174,scaffold_8
3,2096001,2130000,33999,False,174,scaffold_8
4,2445001,2477000,31999,False,174,scaffold_8
5,2721001,2758000,36999,False,174,scaffold_8
6,2808001,2844000,35999,False,174,scaffold_8
7,3060001,3452000,391999,False,174,scaffold_8
8,3453001,3612000,158999,False,174,scaffold_8
9,3615001,3951000,335999,False,174,scaffold_8
10,4044001,4110000,65999,False,174,scaffold_8
11,4203001,4221000,17999,False,174,scaffold_8
12,4763001,4777000,13999,False,174,scaffold_8
13,5095001,5137000,41999,False,174,scaffold_8
14,5187001,5231000,43999,False,174,scaffold_8
15,5649001,5693000,43999,False,174,scaffold_8
16,6321001,6334544,13543,True,174,scaffold_8
0,109001,118000,8999,False,174,scaffold_9
1,121001,136000,14999,False,174,scaffold_9
2,366001,411000,44999,False,174,scaffold_9
3,413001,434000,20999,False,174,scaffold_9
4,483001,531000,47999,False,174,scaffold_9
5,551001,560000,8999,False,174,scaffold_9
6,655001,659000,3999,False,174,scaffold_9
7,660001,665000,4999,False,174,scaffold_9
8,671001,696000,24999,False,174,scaffold_9
9,817001,843000,25999,False,174,scaffold_9
10,872001,986000,113999,False,174,scaffold_9
11,987001,995000,7999,False,174,scaffold_9
12,1009001,1031000,21999,False,174,scaffold_9
13,1035001,1085000,49999,False,174,scaffold_9
14,1087001,1165000,77999,False,174,scaffold_9
15,1316001,1378000,61999,False,174,scaffold_9
16,1986001,2022000,35999,False,174,scaffold_9
17,2147001,2171000,23999,False,174,scaffold_9
18,2844001,3381000,536999,False,174,scaffold_9
19,3383001,5100000,1716999,False,174,scaffold_9
20,5101001,5110000,8999,False,174,scaffold_9
21,5112001,5237000,124999,False,174,scaffold_9
22,5239001,5298000,58999,False,174,scaffold_9
23,5300001,6014000,713999,False,174,scaffold_9
24,6015001,6331288,316287,True,174,scaffold_9
0,1,233000,232999,True,174,scaffold_10
1,270001,482000,211999,False,174,scaffold_10
2,483001,585000,101999,False,174,scaffold_10
3,595001,743000,147999,False,174,scaffold_10
4,888001,912000,23999,False,174,scaffold_10
5,923001,961000,37999,False,174,scaffold_10
6,2347001,2365000,17999,False,174,scaffold_10
7,2599001,2621000,21999,False,174,scaffold_10
8,3590001,3595000,4999,False,174,scaffold_10
9,4065001,4087000,21999,False,174,scaffold_10
10,4125001,4135000,9999,False,174,scaffold_10
11,4154001,4174000,19999,False,174,scaffold_10
12,4336001,4353000,16999,False,174,scaffold_10
13,4443001,4460000,16999,False,174,scaffold_10
14,4467001,4513000,45999,False,174,scaffold_10
15,4515001,4548000,32999,False,174,scaffold_10
16,4554001,4562000,7999,False,174,scaffold_10
17,4752001,4776000,23999,False,174,scaffold_10
18,4798001,4824000,25999,False,174,scaffold_10
19,4828001,4843000,14999,False,174,scaffold_10
20,4848001,4861000,12999,False,174,scaffold_10
21,4865001,4866973,1972,True,174,scaffold_10
0,13001,93000,79999,False,174,scaffold_11
1,148001,167000,18999,False,174,scaffold_11
2,169001,192000,22999,False,174,scaffold_11
3,213001,236000,22999,False,174,scaffold_11
4,240001,245000,4999,False,174,scaffold_11
5,296001,312000,15999,False,174,scaffold_11
6,419001,431000,11999,False,174,scaffold_11
7,649001,656000,6999,False,174,scaffold_11
8,1423001,1427000,3999,False,174,scaffold_11
9,2747001,2822000,74999,False,174,scaffold_11
10,2836001,2867000,30999,False,174,scaffold_11
11,2978001,3019000,40999,False,174,scaffold_11
12,3075001,3173000,97999,False,174,scaffold_11
13,3217001,3296000,78999,False,174,scaffold_11
14,3327001,3383000,55999,False,174,scaffold_11
15,3746001,3871000,124999,False,174,scaffold_11
16,4009001,4027000,17999,False,174,scaffold_11
17,4099001,4161000,61999,False,174,scaffold_11
18,4263001,4294000,30999,False,174,scaffold_11
19,4317001,4383000,65999,False,174,scaffold_11
20,4395001,4710000,314999,False,174,scaffold_11
21,4713001,4766820,53819,True,174,scaffold_11
0,1,387000,386999,True,174,scaffold_12
1,402001,680000,277999,False,174,scaffold_12
2,689001,721000,31999,False,174,scaffold_12
3,776001,1183000,406999,False,174,scaffold_12
4,1215001,1333000,117999,False,174,scaffold_12
5,1718001,1733000,14999,False,174,scaffold_12
6,2067001,2086000,18999,False,174,scaffold_12
7,2571001,2617000,45999,False,174,scaffold_12
0,1,330000,329999,True,175,scaffold_1
1,482001,498000,15999,False,175,scaffold_1
2,571001,604000,32999,False,175,scaffold_1
3,605001,643000,37999,False,175,scaffold_1
4,686001,759000,72999,False,175,scaffold_1
5,1271001,1292000,20999,False,175,scaffold_1
6,1820001,1898000,77999,False,175,scaffold_1
7,1951001,1964000,12999,False,175,scaffold_1
8,1965001,1984000,18999,False,175,scaffold_1
9,1986001,1995000,8999,False,175,scaffold_1
10,2449001,2517000,67999,False,175,scaffold_1
11,2562001,2583000,20999,False,175,scaffold_1
12,2721001,2750000,28999,False,175,scaffold_1
13,2893001,2921000,27999,False,175,scaffold_1
14,3161001,3209000,47999,False,175,scaffold_1
15,3444001,3477000,32999,False,175,scaffold_1
16,3714001,3878000,163999,False,175,scaffold_1
17,3902001,3941000,38999,False,175,scaffold_1
18,4003001,4031000,27999,False,175,scaffold_1
19,4062001,4111000,48999,False,175,scaffold_1
20,4314001,4356000,41999,False,175,scaffold_1
21,4927001,5061000,133999,False,175,scaffold_1
22,5480001,5512000,31999,False,175,scaffold_1
23,5856001,5917000,60999,False,175,scaffold_1
24,6108001,6153000,44999,False,175,scaffold_1
25,6205001,6381000,175999,False,175,scaffold_1
26,6384001,6511000,126999,False,175,scaffold_1
27,6542001,6557000,14999,False,175,scaffold_1
28,7038001,7589000,550999,False,175,scaffold_1
29,7590001,7634000,43999,False,175,scaffold_1
30,7636001,8497000,860999,False,175,scaffold_1
31,8498001,8656000,157999,False,175,scaffold_1
32,8658001,9584000,925999,False,175,scaffold_1
33,9586001,9622000,35999,False,175,scaffold_1
34,9623001,10362000,738999,False,175,scaffold_1
35,10450001,10641000,190999,False,175,scaffold_1
36,10728001,10767000,38999,False,175,scaffold_1
37,10840001,10858000,17999,False,175,scaffold_1
38,11343001,11503000,159999,False,175,scaffold_1
39,11609001,11725000,115999,False,175,scaffold_1
40,11726001,11964000,237999,False,175,scaffold_1
41,12183001,12206000,22999,False,175,scaffold_1
42,12652001,12723000,70999,False,175,scaffold_1
43,12775001,12879000,103999,False,175,scaffold_1
44,12916001,12949000,32999,False,175,scaffold_1
45,13024001,13067000,42999,False,175,scaffold_1
46,13095001,13217000,121999,False,175,scaffold_1
47,13346001,13380000,33999,False,175,scaffold_1
48,13564001,13581000,16999,False,175,scaffold_1
49,14285001,14307000,21999,False,175,scaffold_1
0,26001,36000,9999,False,175,scaffold_2
1,42001,48000,5999,False,175,scaffold_2
2,95001,159000,63999,False,175,scaffold_2
3,168001,177000,8999,False,175,scaffold_2
4,316001,318000,1999,False,175,scaffold_2
5,332001,374000,41999,False,175,scaffold_2
6,2350001,2357000,6999,False,175,scaffold_2
7,2398001,2560000,161999,False,175,scaffold_2
8,2645001,2689000,43999,False,175,scaffold_2
9,2693001,2738000,44999,False,175,scaffold_2
10,2820001,2854000,33999,False,175,scaffold_2
11,2880001,2899000,18999,False,175,scaffold_2
12,2973001,3021000,47999,False,175,scaffold_2
13,3022001,3044000,21999,False,175,scaffold_2
14,3332001,3344000,11999,False,175,scaffold_2
15,3361001,3384000,22999,False,175,scaffold_2
16,3754001,3784000,29999,False,175,scaffold_2
17,4243001,4278000,34999,False,175,scaffold_2
18,4427001,4458000,30999,False,175,scaffold_2
19,4520001,4558000,37999,False,175,scaffold_2
20,4611001,4659000,47999,False,175,scaffold_2
21,4783001,4790000,6999,False,175,scaffold_2
22,4912001,4960000,47999,False,175,scaffold_2
23,5034001,5104000,69999,False,175,scaffold_2
24,5174001,5221000,46999,False,175,scaffold_2
25,5285001,5313000,27999,False,175,scaffold_2
26,5370001,5393000,22999,False,175,scaffold_2
27,5409001,5515000,105999,False,175,scaffold_2
28,5525001,5558000,32999,False,175,scaffold_2
29,5608001,5759000,150999,False,175,scaffold_2
30,5840001,5889000,48999,False,175,scaffold_2
31,5910001,6053000,142999,False,175,scaffold_2
32,6261001,6330000,68999,False,175,scaffold_2
33,6331001,6352000,20999,False,175,scaffold_2
34,6413001,6449000,35999,False,175,scaffold_2
35,6586001,6629000,42999,False,175,scaffold_2
36,6835001,6894000,58999,False,175,scaffold_2
37,6954001,6997000,42999,False,175,scaffold_2
38,6999001,7038000,38999,False,175,scaffold_2
39,7049001,7098000,48999,False,175,scaffold_2
40,7340001,7476000,135999,False,175,scaffold_2
41,7563001,7697000,133999,False,175,scaffold_2
42,7780001,7852000,71999,False,175,scaffold_2
43,7855001,7885000,29999,False,175,scaffold_2
44,7933001,8175000,241999,False,175,scaffold_2
45,8186001,8233000,46999,False,175,scaffold_2
46,8260001,8315000,54999,False,175,scaffold_2
47,8339001,8345000,5999,False,175,scaffold_2
48,8346001,8454000,107999,False,175,scaffold_2
49,8487001,8565000,77999,False,175,scaffold_2
50,9031001,9052000,20999,False,175,scaffold_2
51,9140001,9169000,28999,False,175,scaffold_2
52,9327001,9400000,72999,False,175,scaffold_2
53,9563001,9635000,71999,False,175,scaffold_2
54,9677001,9714000,36999,False,175,scaffold_2
55,11366001,11387000,20999,False,175,scaffold_2
56,11394001,11425000,30999,False,175,scaffold_2
57,11519001,11786000,266999,False,175,scaffold_2
58,11798001,11802476,4475,True,175,scaffold_2
0,51001,55000,3999,False,175,scaffold_3
1,618001,646000,27999,False,175,scaffold_3
2,798001,900000,101999,False,175,scaffold_3
3,1163001,1192000,28999,False,175,scaffold_3
4,2041001,2108000,66999,False,175,scaffold_3
5,2291001,2336000,44999,False,175,scaffold_3
6,2448001,2533000,84999,False,175,scaffold_3
7,3715001,3737000,21999,False,175,scaffold_3
8,3768001,3892000,123999,False,175,scaffold_3
9,4108001,4398000,289999,False,175,scaffold_3
10,4416001,4514000,97999,False,175,scaffold_3
11,4547001,4558000,10999,False,175,scaffold_3
12,4567001,4578000,10999,False,175,scaffold_3
13,4653001,4672000,18999,False,175,scaffold_3
14,5161001,5194000,32999,False,175,scaffold_3
15,5991001,6019000,27999,False,175,scaffold_3
16,6518001,6556000,37999,False,175,scaffold_3
17,6662001,6786000,123999,False,175,scaffold_3
18,6895001,6968000,72999,False,175,scaffold_3
19,6979001,7079000,99999,False,175,scaffold_3
20,7255001,7301000,45999,False,175,scaffold_3
21,7336001,7401000,64999,False,175,scaffold_3
22,7449001,7460000,10999,False,175,scaffold_3
23,7483001,7556000,72999,False,175,scaffold_3
24,7692001,7791000,98999,False,175,scaffold_3
25,7818001,7850000,31999,False,175,scaffold_3
26,8059001,8065000,5999,False,175,scaffold_3
27,8086001,8116000,29999,False,175,scaffold_3
28,8175001,8255000,79999,False,175,scaffold_3
29,8463001,8527000,63999,False,175,scaffold_3
30,8575001,8594000,18999,False,175,scaffold_3
31,9968001,9994000,25999,False,175,scaffold_3
32,10316001,10335000,18999,False,175,scaffold_3
33,10461001,10477000,15999,False,175,scaffold_3
34,10550001,10571000,20999,False,175,scaffold_3
35,10589001,11182071,593070,True,175,scaffold_3
0,17001,24000,6999,False,175,scaffold_4
1,48001,89000,40999,False,175,scaffold_4
2,98001,115000,16999,False,175,scaffold_4
3,132001,151000,18999,False,175,scaffold_4
4,155001,215000,59999,False,175,scaffold_4
5,217001,226000,8999,False,175,scaffold_4
6,248001,266000,17999,False,175,scaffold_4
7,289001,307000,17999,False,175,scaffold_4
8,355001,374000,18999,False,175,scaffold_4
9,412001,425000,12999,False,175,scaffold_4
10,429001,592000,162999,False,175,scaffold_4
11,593001,606000,12999,False,175,scaffold_4
12,608001,657000,48999,False,175,scaffold_4
13,677001,691000,13999,False,175,scaffold_4
14,695001,697000,1999,False,175,scaffold_4
15,701001,717000,15999,False,175,scaffold_4
16,1113001,1208000,94999,False,175,scaffold_4
17,1210001,1226000,15999,False,175,scaffold_4
18,1283001,1324000,40999,False,175,scaffold_4
19,1357001,1392000,34999,False,175,scaffold_4
20,1393001,1595000,201999,False,175,scaffold_4
21,1613001,1870000,256999,False,175,scaffold_4
22,1904001,1992000,87999,False,175,scaffold_4
23,2073001,2099000,25999,False,175,scaffold_4
24,2222001,2246000,23999,False,175,scaffold_4
25,2247001,2279000,31999,False,175,scaffold_4
26,2284001,2340000,55999,False,175,scaffold_4
27,2342001,2461000,118999,False,175,scaffold_4
28,2476001,2582000,105999,False,175,scaffold_4
29,2599001,2635000,35999,False,175,scaffold_4
30,3040001,3065000,24999,False,175,scaffold_4
31,3089001,3128000,38999,False,175,scaffold_4
32,3334001,3761000,426999,False,175,scaffold_4
33,4062001,4078000,15999,False,175,scaffold_4
34,4709001,4735000,25999,False,175,scaffold_4
35,4900001,4985000,84999,False,175,scaffold_4
36,5171001,5224000,52999,False,175,scaffold_4
37,5300001,5409000,108999,False,175,scaffold_4
38,5475001,5506000,30999,False,175,scaffold_4
39,5514001,5784000,269999,False,175,scaffold_4
40,5786001,5828000,41999,False,175,scaffold_4
41,6148001,6197000,48999,False,175,scaffold_4
42,7036001,7079000,42999,False,175,scaffold_4
43,7192001,7304000,111999,False,175,scaffold_4
44,8847001,9699000,851999,False,175,scaffold_4
45,9700001,9845951,145950,True,175,scaffold_4
0,319001,368000,48999,False,175,scaffold_5
1,458001,523000,64999,False,175,scaffold_5
2,933001,947000,13999,False,175,scaffold_5
3,2477001,2492000,14999,False,175,scaffold_5
4,2509001,2515000,5999,False,175,scaffold_5
5,2516001,2527000,10999,False,175,scaffold_5
6,2554001,2581000,26999,False,175,scaffold_5
7,2599001,2801000,201999,False,175,scaffold_5
8,2816001,2893000,76999,False,175,scaffold_5
9,3129001,3188000,58999,False,175,scaffold_5
10,3217001,3518000,300999,False,175,scaffold_5
11,3619001,3653000,33999,False,175,scaffold_5
12,3834001,3858000,23999,False,175,scaffold_5
13,3963001,4101000,137999,False,175,scaffold_5
14,4118001,4221000,102999,False,175,scaffold_5
15,4232001,4321000,88999,False,175,scaffold_5
16,4444001,4507000,62999,False,175,scaffold_5
17,4599001,4857000,257999,False,175,scaffold_5
18,4893001,4918000,24999,False,175,scaffold_5
19,5258001,5345000,86999,False,175,scaffold_5
20,5693001,5737000,43999,False,175,scaffold_5
21,6408001,6660000,251999,False,175,scaffold_5
22,6889001,6906000,16999,False,175,scaffold_5
23,7169001,7218000,48999,False,175,scaffold_5
24,7455001,7513000,57999,False,175,scaffold_5
25,7547001,7654000,106999,False,175,scaffold_5
26,8554001,8616000,61999,False,175,scaffold_5
27,8654001,8689000,34999,False,175,scaffold_5
28,8713001,9364176,651175,True,175,scaffold_5
0,25001,38000,12999,False,175,scaffold_6
1,77001,121000,43999,False,175,scaffold_6
2,162001,210000,47999,False,175,scaffold_6
3,242001,252000,9999,False,175,scaffold_6
4,267001,288000,20999,False,175,scaffold_6
5,1233001,1262000,28999,False,175,scaffold_6
6,1479001,1546000,66999,False,175,scaffold_6
7,2030001,2083000,52999,False,175,scaffold_6
8,2130001,2212000,81999,False,175,scaffold_6
9,2242001,2284000,41999,False,175,scaffold_6
10,2371001,2654000,282999,False,175,scaffold_6
11,2655001,2849000,193999,False,175,scaffold_6
12,2928001,3017000,88999,False,175,scaffold_6
13,3098001,3175000,76999,False,175,scaffold_6
14,3220001,3765000,544999,False,175,scaffold_6
15,3884001,3913000,28999,False,175,scaffold_6
16,4018001,4072000,53999,False,175,scaffold_6
17,4089001,4195000,105999,False,175,scaffold_6
18,5560001,5586000,25999,False,175,scaffold_6
19,5596001,5637000,40999,False,175,scaffold_6
20,5917001,5973000,55999,False,175,scaffold_6
21,6009001,6060000,50999,False,175,scaffold_6
22,6124001,6148000,23999,False,175,scaffold_6
23,6776001,6804000,27999,False,175,scaffold_6
24,7263001,7339000,75999,False,175,scaffold_6
25,7382001,7436000,53999,False,175,scaffold_6
26,7547001,8268281,721280,True,175,scaffold_6
0,323001,509000,185999,False,175,scaffold_7
1,647001,677000,29999,False,175,scaffold_7
2,709001,736000,26999,False,175,scaffold_7
3,763001,829000,65999,False,175,scaffold_7
4,859001,864000,4999,False,175,scaffold_7
5,982001,1044000,61999,False,175,scaffold_7
6,1068001,1124000,55999,False,175,scaffold_7
7,1191001,1512000,320999,False,175,scaffold_7
8,1588001,1689000,100999,False,175,scaffold_7
9,3296001,3313000,16999,False,175,scaffold_7
10,3325001,3341000,15999,False,175,scaffold_7
11,3342001,3392000,49999,False,175,scaffold_7
12,3520001,3659000,138999,False,175,scaffold_7
13,3717001,3808000,90999,False,175,scaffold_7
14,3914001,3965000,50999,False,175,scaffold_7
15,4414001,4512000,97999,False,175,scaffold_7
16,4560001,4604000,43999,False,175,scaffold_7
17,4628001,4832000,203999,False,175,scaffold_7
18,4982001,4994000,11999,False,175,scaffold_7
19,5034001,5149000,114999,False,175,scaffold_7
20,5495001,5537000,41999,False,175,scaffold_7
21,6569001,6582000,12999,False,175,scaffold_7
22,6604001,6659000,54999,False,175,scaffold_7
23,6757001,6796000,38999,False,175,scaffold_7
24,6954001,7270000,315999,False,175,scaffold_7
25,7271001,7502216,231215,True,175,scaffold_7
0,30001,85000,54999,False,175,scaffold_8
1,1860001,1934000,73999,False,175,scaffold_8
2,2092001,2135000,42999,False,175,scaffold_8
3,2424001,2528000,103999,False,175,scaffold_8
4,2650001,2699000,48999,False,175,scaffold_8
5,2701001,2841000,139999,False,175,scaffold_8
6,3058001,3556000,497999,False,175,scaffold_8
7,3577001,3614000,36999,False,175,scaffold_8
8,3615001,3927000,311999,False,175,scaffold_8
9,3928001,3953000,24999,False,175,scaffold_8
10,4038001,4106000,67999,False,175,scaffold_8
11,4173001,4221000,47999,False,175,scaffold_8
12,4400001,4432000,31999,False,175,scaffold_8
13,5068001,5136000,67999,False,175,scaffold_8
14,5196001,5241000,44999,False,175,scaffold_8
15,6327001,6334544,7543,True,175,scaffold_8
0,121001,138000,16999,False,175,scaffold_9
1,366001,411000,44999,False,175,scaffold_9
2,413001,434000,20999,False,175,scaffold_9
3,481001,531000,49999,False,175,scaffold_9
4,547001,561000,13999,False,175,scaffold_9
5,671001,697000,25999,False,175,scaffold_9
6,731001,742000,10999,False,175,scaffold_9
7,815001,846000,30999,False,175,scaffold_9
8,850001,864000,13999,False,175,scaffold_9
9,873001,986000,112999,False,175,scaffold_9
10,987001,995000,7999,False,175,scaffold_9
11,1001001,1032000,30999,False,175,scaffold_9
12,1034001,1085000,50999,False,175,scaffold_9
13,1087001,1164000,76999,False,175,scaffold_9
14,1312001,1377000,64999,False,175,scaffold_9
15,2601001,2615000,13999,False,175,scaffold_9
16,2737001,2824000,86999,False,175,scaffold_9
17,2872001,3381000,508999,False,175,scaffold_9
18,3383001,5107000,1723999,False,175,scaffold_9
19,5112001,5115000,2999,False,175,scaffold_9
20,5116001,5238000,121999,False,175,scaffold_9
21,5239001,5298000,58999,False,175,scaffold_9
22,5300001,6263000,962999,False,175,scaffold_9
23,6266001,6331288,65287,True,175,scaffold_9
0,1,228000,227999,True,175,scaffold_10
1,280001,369000,88999,False,175,scaffold_10
2,371001,406000,34999,False,175,scaffold_10
3,472001,585000,112999,False,175,scaffold_10
4,603001,649000,45999,False,175,scaffold_10
5,650001,795000,144999,False,175,scaffold_10
6,811001,877000,65999,False,175,scaffold_10
7,888001,916000,27999,False,175,scaffold_10
8,924001,962000,37999,False,175,scaffold_10
9,1073001,1112000,38999,False,175,scaffold_10
10,1126001,1152000,25999,False,175,scaffold_10
11,1606001,1675000,68999,False,175,scaffold_10
12,2346001,2393000,46999,False,175,scaffold_10
13,4061001,4093000,31999,False,175,scaffold_10
14,4445001,4462000,16999,False,175,scaffold_10
15,4467001,4502000,34999,False,175,scaffold_10
16,4515001,4549000,33999,False,175,scaffold_10
17,4554001,4562000,7999,False,175,scaffold_10
18,4563001,4597000,33999,False,175,scaffold_10
19,4734001,4776000,41999,False,175,scaffold_10
20,4798001,4824000,25999,False,175,scaffold_10
21,4828001,4846000,17999,False,175,scaffold_10
22,4848001,4851000,2999,False,175,scaffold_10
0,9001,68000,58999,False,175,scaffold_11
1,69001,109000,39999,False,175,scaffold_11
2,132001,167000,34999,False,175,scaffold_11
3,169001,193000,23999,False,175,scaffold_11
4,213001,236000,22999,False,175,scaffold_11
5,240001,252000,11999,False,175,scaffold_11
6,419001,431000,11999,False,175,scaffold_11
7,433001,455000,21999,False,175,scaffold_11
8,648001,656000,7999,False,175,scaffold_11
9,1028001,1034000,5999,False,175,scaffold_11
10,2703001,2875000,171999,False,175,scaffold_11
11,2977001,3023000,45999,False,175,scaffold_11
12,3058001,3133000,74999,False,175,scaffold_11
13,3188001,3325000,136999,False,175,scaffold_11
14,3326001,3383000,56999,False,175,scaffold_11
15,3553001,3651000,97999,False,175,scaffold_11
16,3704001,3930000,225999,False,175,scaffold_11
17,4008001,4073000,64999,False,175,scaffold_11
18,4301001,4710000,408999,False,175,scaffold_11
19,4713001,4766820,53819,True,175,scaffold_11
0,1,737000,736999,True,175,scaffold_12
1,741001,1469000,727999,False,175,scaffold_12
2,2492001,2493000,999,False,175,scaffold_12
3,2571001,2621000,49999,False,175,scaffold_12
4,2625001,2647000,21999,False,175,scaffold_12
0,1,391000,390999,True,176,scaffold_1
1,408001,446000,37999,False,176,scaffold_1
2,482001,499000,16999,False,176,scaffold_1
3,553001,643000,89999,False,176,scaffold_1
4,686001,756000,69999,False,176,scaffold_1
5,1056001,1078000,21999,False,176,scaffold_1
6,1271001,1294000,22999,False,176,scaffold_1
7,1606001,1660000,53999,False,176,scaffold_1
8,1661001,1697000,35999,False,176,scaffold_1
9,1769001,1893000,123999,False,176,scaffold_1
10,1918001,1932000,13999,False,176,scaffold_1
11,1941001,1964000,22999,False,176,scaffold_1
12,1965001,1984000,18999,False,176,scaffold_1
13,1988001,1994000,5999,False,176,scaffold_1
14,2355001,2414000,58999,False,176,scaffold_1
15,2447001,2607000,159999,False,176,scaffold_1
16,2663001,2687000,23999,False,176,scaffold_1
17,2715001,2746000,30999,False,176,scaffold_1
18,2878001,2928000,49999,False,176,scaffold_1
19,3047001,3088000,40999,False,176,scaffold_1
20,3174001,3209000,34999,False,176,scaffold_1
21,3419001,3499000,79999,False,176,scaffold_1
22,3547001,3622000,74999,False,176,scaffold_1
23,3719001,3879000,159999,False,176,scaffold_1
24,3902001,4032000,129999,False,176,scaffold_1
25,4062001,4113000,50999,False,176,scaffold_1
26,4314001,4371000,56999,False,176,scaffold_1
27,4717001,4791000,73999,False,176,scaffold_1
28,4796001,4810000,13999,False,176,scaffold_1
29,4925001,4997000,71999,False,176,scaffold_1
30,5084001,5110000,25999,False,176,scaffold_1
31,5481001,5511000,29999,False,176,scaffold_1
32,5534001,5592000,57999,False,176,scaffold_1
33,5852001,5912000,59999,False,176,scaffold_1
34,6108001,6245000,136999,False,176,scaffold_1
35,6246001,6578000,331999,False,176,scaffold_1
36,6640001,6656000,15999,False,176,scaffold_1
37,7037001,7247000,209999,False,176,scaffold_1
38,7248001,7588000,339999,False,176,scaffold_1
39,7590001,8656000,1065999,False,176,scaffold_1
40,8658001,9584000,925999,False,176,scaffold_1
41,9586001,10368000,781999,False,176,scaffold_1
42,10460001,10642000,181999,False,176,scaffold_1
43,10662001,10764000,101999,False,176,scaffold_1
44,10835001,10858000,22999,False,176,scaffold_1
45,10919001,10940000,20999,False,176,scaffold_1
46,11350001,11403000,52999,False,176,scaffold_1
47,11405001,11535000,129999,False,176,scaffold_1
48,11549001,11880000,330999,False,176,scaffold_1
49,11882001,11962000,79999,False,176,scaffold_1
50,12184001,12243000,58999,False,176,scaffold_1
51,12358001,12396000,37999,False,176,scaffold_1
52,12652001,12758000,105999,False,176,scaffold_1
53,12775001,12889000,113999,False,176,scaffold_1
54,12914001,12947000,32999,False,176,scaffold_1
55,12965001,13047000,81999,False,176,scaffold_1
56,13094001,13213000,118999,False,176,scaffold_1
57,13346001,13431000,84999,False,176,scaffold_1
58,13517001,13587000,69999,False,176,scaffold_1
59,14291001,14313000,21999,False,176,scaffold_1
0,1,17000,16999,True,176,scaffold_2
1,43001,48000,4999,False,176,scaffold_2
2,84001,91000,6999,False,176,scaffold_2
3,93001,159000,65999,False,176,scaffold_2
4,168001,177000,8999,False,176,scaffold_2
5,250001,288000,37999,False,176,scaffold_2
6,297001,318000,20999,False,176,scaffold_2
7,332001,374000,41999,False,176,scaffold_2
8,707001,739000,31999,False,176,scaffold_2
9,989001,1013000,23999,False,176,scaffold_2
10,1691001,1714000,22999,False,176,scaffold_2
11,2085001,2101000,15999,False,176,scaffold_2
12,2336001,2636000,299999,False,176,scaffold_2
13,2652001,2689000,36999,False,176,scaffold_2
14,2694001,2747000,52999,False,176,scaffold_2
15,2766001,2788000,21999,False,176,scaffold_2
16,2819001,2857000,37999,False,176,scaffold_2
17,2868001,3021000,152999,False,176,scaffold_2
18,3022001,3056000,33999,False,176,scaffold_2
19,3331001,3344000,12999,False,176,scaffold_2
20,3369001,3393000,23999,False,176,scaffold_2
21,3449001,3487000,37999,False,176,scaffold_2
22,3754001,3790000,35999,False,176,scaffold_2
23,4243001,4322000,78999,False,176,scaffold_2
24,4342001,4409000,66999,False,176,scaffold_2
25,4472001,4790000,317999,False,176,scaffold_2
26,4793001,4810000,16999,False,176,scaffold_2
27,4891001,4961000,69999,False,176,scaffold_2
28,5019001,5104000,84999,False,176,scaffold_2
29,5286001,5315000,28999,False,176,scaffold_2
30,5371001,5393000,21999,False,176,scaffold_2
31,5413001,5558000,144999,False,176,scaffold_2
32,5606001,5740000,133999,False,176,scaffold_2
33,5840001,5888000,47999,False,176,scaffold_2
34,5915001,6054000,138999,False,176,scaffold_2
35,6108001,6189000,80999,False,176,scaffold_2
36,6233001,6330000,96999,False,176,scaffold_2
37,6331001,6352000,20999,False,176,scaffold_2
38,6383001,6465000,81999,False,176,scaffold_2
39,6510001,6627000,116999,False,176,scaffold_2
40,6796001,6962000,165999,False,176,scaffold_2
41,7015001,7038000,22999,False,176,scaffold_2
42,7091001,7241000,149999,False,176,scaffold_2
43,7331001,7477000,145999,False,176,scaffold_2
44,7563001,7697000,133999,False,176,scaffold_2
45,7786001,8285000,498999,False,176,scaffold_2
46,8286001,8313000,26999,False,176,scaffold_2
47,8331001,8333000,1999,False,176,scaffold_2
48,8335001,8345000,9999,False,176,scaffold_2
49,8346001,8455000,108999,False,176,scaffold_2
50,8465001,8494000,28999,False,176,scaffold_2
51,8495001,8563000,67999,False,176,scaffold_2
52,8619001,8649000,29999,False,176,scaffold_2
53,8987001,9064000,76999,False,176,scaffold_2
54,9146001,9175000,28999,False,176,scaffold_2
55,9329001,9382000,52999,False,176,scaffold_2
56,9576001,9625000,48999,False,176,scaffold_2
57,9673001,9690000,16999,False,176,scaffold_2
58,9835001,9905000,69999,False,176,scaffold_2
59,10187001,10205000,17999,False,176,scaffold_2
60,11396001,11503000,106999,False,176,scaffold_2
61,11519001,11789000,269999,False,176,scaffold_2
0,353001,360000,6999,False,176,scaffold_3
1,529001,539000,9999,False,176,scaffold_3
2,795001,901000,105999,False,176,scaffold_3
3,2007001,2108000,100999,False,176,scaffold_3
4,2109001,2118000,8999,False,176,scaffold_3
5,2265001,2340000,74999,False,176,scaffold_3
6,2464001,2533000,68999,False,176,scaffold_3
7,3729001,3860000,130999,False,176,scaffold_3
8,3862001,3898000,35999,False,176,scaffold_3
9,4097001,4403000,305999,False,176,scaffold_3
10,4409001,4456000,46999,False,176,scaffold_3
11,4458001,4516000,57999,False,176,scaffold_3
12,4547001,4577000,29999,False,176,scaffold_3
13,4637001,4721000,83999,False,176,scaffold_3
14,4865001,4904000,38999,False,176,scaffold_3
15,5164001,5209000,44999,False,176,scaffold_3
16,5254001,5272000,17999,False,176,scaffold_3
17,5379001,5450000,70999,False,176,scaffold_3
18,5804001,5946000,141999,False,176,scaffold_3
19,5976001,6020000,43999,False,176,scaffold_3
20,6513001,6585000,71999,False,176,scaffold_3
21,6660001,6700000,39999,False,176,scaffold_3
22,6769001,6809000,39999,False,176,scaffold_3
23,6909001,6962000,52999,False,176,scaffold_3
24,6963001,7097000,133999,False,176,scaffold_3
25,7230001,7445000,214999,False,176,scaffold_3
26,7482001,7563000,80999,False,176,scaffold_3
27,7682001,7909000,226999,False,176,scaffold_3
28,7910001,7935000,24999,False,176,scaffold_3
29,8121001,8156000,34999,False,176,scaffold_3
30,8183001,8253000,69999,False,176,scaffold_3
31,8398001,8527000,128999,False,176,scaffold_3
32,8575001,8596000,20999,False,176,scaffold_3
33,8604001,8628000,23999,False,176,scaffold_3
34,9005001,9081000,75999,False,176,scaffold_3
35,9964001,9997000,32999,False,176,scaffold_3
36,10064001,10101000,36999,False,176,scaffold_3
37,10281001,10304000,22999,False,176,scaffold_3
38,10445001,10458000,12999,False,176,scaffold_3
39,10461001,10488000,26999,False,176,scaffold_3
40,10494001,10571000,76999,False,176,scaffold_3
41,10580001,10859000,278999,False,176,scaffold_3
42,10860001,10960000,99999,False,176,scaffold_3
43,10961001,11182071,221070,True,176,scaffold_3
0,17001,32000,14999,False,176,scaffold_4
1,49001,112000,62999,False,176,scaffold_4
2,113001,115000,1999,False,176,scaffold_4
3,120001,151000,30999,False,176,scaffold_4
4,153001,215000,61999,False,176,scaffold_4
5,217001,279000,61999,False,176,scaffold_4
6,283001,353000,69999,False,176,scaffold_4
7,355001,374000,18999,False,176,scaffold_4
8,375001,380000,4999,False,176,scaffold_4
9,389001,410000,20999,False,176,scaffold_4
10,412001,425000,12999,False,176,scaffold_4
11,426001,592000,165999,False,176,scaffold_4
12,593001,607000,13999,False,176,scaffold_4
13,609001,691000,81999,False,176,scaffold_4
14,1028001,1042000,13999,False,176,scaffold_4
15,1087001,1097000,9999,False,176,scaffold_4
16,1099001,1110000,10999,False,176,scaffold_4
17,1112001,1198000,85999,False,176,scaffold_4
18,1199001,1208000,8999,False,176,scaffold_4
19,1210001,1226000,15999,False,176,scaffold_4
20,1254001,1279000,24999,False,176,scaffold_4
21,1283001,1463000,179999,False,176,scaffold_4
22,1464001,1597000,132999,False,176,scaffold_4
23,1609001,1611000,1999,False,176,scaffold_4
24,1613001,2112000,498999,False,176,scaffold_4
25,2211001,2268000,56999,False,176,scaffold_4
26,2269001,2279000,9999,False,176,scaffold_4
27,2282001,2461000,178999,False,176,scaffold_4
28,2476001,2524000,47999,False,176,scaffold_4
29,2525001,2638000,112999,False,176,scaffold_4
30,2934001,2968000,33999,False,176,scaffold_4
31,3084001,3129000,44999,False,176,scaffold_4
32,3177001,3219000,41999,False,176,scaffold_4
33,3228001,3320000,91999,False,176,scaffold_4
34,3334001,3809000,474999,False,176,scaffold_4
35,3939001,3952000,12999,False,176,scaffold_4
36,4058001,4072000,13999,False,176,scaffold_4
37,4249001,4305000,55999,False,176,scaffold_4
38,4709001,4737000,27999,False,176,scaffold_4
39,4900001,5105000,204999,False,176,scaffold_4
40,5168001,5210000,41999,False,176,scaffold_4
41,5288001,5440000,151999,False,176,scaffold_4
42,5470001,5506000,35999,False,176,scaffold_4
43,5515001,5784000,268999,False,176,scaffold_4
44,5786001,5825000,38999,False,176,scaffold_4
45,5867001,5958000,90999,False,176,scaffold_4
46,6068001,6112000,43999,False,176,scaffold_4
47,6145001,6195000,49999,False,176,scaffold_4
48,6282001,6294000,11999,False,176,scaffold_4
49,6615001,6617000,1999,False,176,scaffold_4
50,6769001,6817000,47999,False,176,scaffold_4
51,6899001,6924000,24999,False,176,scaffold_4
52,6950001,6995000,44999,False,176,scaffold_4
53,7034001,7124000,89999,False,176,scaffold_4
54,7135001,7323000,187999,False,176,scaffold_4
55,7865001,7874000,8999,False,176,scaffold_4
56,8097001,8112000,14999,False,176,scaffold_4
57,8730001,9699000,968999,False,176,scaffold_4
58,9700001,9845951,145950,True,176,scaffold_4
0,1,16000,15999,True,176,scaffold_5
1,189001,204000,14999,False,176,scaffold_5
2,321001,428000,106999,False,176,scaffold_5
3,462001,524000,61999,False,176,scaffold_5
4,673001,698000,24999,False,176,scaffold_5
5,933001,947000,13999,False,176,scaffold_5
6,2258001,2317000,58999,False,176,scaffold_5
7,2349001,2365000,15999,False,176,scaffold_5
8,2384001,2411000,26999,False,176,scaffold_5
9,2473001,2500000,26999,False,176,scaffold_5
10,2508001,2515000,6999,False,176,scaffold_5
11,2549001,2980000,430999,False,176,scaffold_5
12,3052001,3065000,12999,False,176,scaffold_5
13,3096001,3439000,342999,False,176,scaffold_5
14,3442001,3512000,69999,False,176,scaffold_5
15,3615001,3659000,43999,False,176,scaffold_5
16,3718001,3805000,86999,False,176,scaffold_5
17,3841001,3972000,130999,False,176,scaffold_5
18,3973001,4101000,127999,False,176,scaffold_5
19,4123001,4222000,98999,False,176,scaffold_5
20,4227001,4321000,93999,False,176,scaffold_5
21,4396001,4526000,129999,False,176,scaffold_5
22,4574001,4936000,361999,False,176,scaffold_5
23,4953001,5108000,154999,False,176,scaffold_5
24,5216001,5398000,181999,False,176,scaffold_5
25,5498001,5529000,30999,False,176,scaffold_5
26,5698001,5737000,38999,False,176,scaffold_5
27,5808001,5826000,17999,False,176,scaffold_5
28,5857001,5906000,48999,False,176,scaffold_5
29,6408001,6666000,257999,False,176,scaffold_5
30,6759001,6815000,55999,False,176,scaffold_5
31,6886001,6906000,19999,False,176,scaffold_5
32,7034001,7084000,49999,False,176,scaffold_5
33,7167001,7243000,75999,False,176,scaffold_5
34,7293001,7329000,35999,False,176,scaffold_5
35,7406001,7445000,38999,False,176,scaffold_5
36,7454001,7512000,57999,False,176,scaffold_5
37,7559001,7750000,190999,False,176,scaffold_5
38,7780001,7873000,92999,False,176,scaffold_5
39,8024001,8049000,24999,False,176,scaffold_5
40,8092001,8171000,78999,False,176,scaffold_5
41,8258001,8266000,7999,False,176,scaffold_5
42,8435001,8469000,33999,False,176,scaffold_5
43,8550001,8618000,67999,False,176,scaffold_5
44,8639001,8687000,47999,False,176,scaffold_5
45,8695001,9109000,413999,False,176,scaffold_5
46,9110001,9230000,119999,False,176,scaffold_5
47,9231001,9364176,133175,True,176,scaffold_5
0,42001,74000,31999,False,176,scaffold_6
1,77001,112000,34999,False,176,scaffold_6
2,148001,209000,60999,False,176,scaffold_6
3,239001,253000,13999,False,176,scaffold_6
4,1157001,1193000,35999,False,176,scaffold_6
5,1229001,1266000,36999,False,176,scaffold_6
6,1269001,1309000,39999,False,176,scaffold_6
7,1431001,1583000,151999,False,176,scaffold_6
8,1658001,1690000,31999,False,176,scaffold_6
9,1832001,1906000,73999,False,176,scaffold_6
10,2025001,2104000,78999,False,176,scaffold_6
11,2127001,2201000,73999,False,176,scaffold_6
12,2237001,2283000,45999,False,176,scaffold_6
13,2314001,2863000,548999,False,176,scaffold_6
14,2927001,3050000,122999,False,176,scaffold_6
15,3073001,3201000,127999,False,176,scaffold_6
16,3221001,3363000,141999,False,176,scaffold_6
17,3394001,3806000,411999,False,176,scaffold_6
18,3879001,3916000,36999,False,176,scaffold_6
19,3966001,4005000,38999,False,176,scaffold_6
20,4017001,4195000,177999,False,176,scaffold_6
21,5554001,5647000,92999,False,176,scaffold_6
22,5932001,5971000,38999,False,176,scaffold_6
23,5989001,6108000,118999,False,176,scaffold_6
24,6124001,6198000,73999,False,176,scaffold_6
25,6255001,6278000,22999,False,176,scaffold_6
26,6766001,6806000,39999,False,176,scaffold_6
27,6813001,6858000,44999,False,176,scaffold_6
28,6923001,6940000,16999,False,176,scaffold_6
29,6972001,7006000,33999,False,176,scaffold_6
30,7165001,7348000,182999,False,176,scaffold_6
31,7382001,7443000,60999,False,176,scaffold_6
32,7446001,7487000,40999,False,176,scaffold_6
33,7545001,8040000,494999,False,176,scaffold_6
34,8041001,8268281,227280,True,176,scaffold_6
0,48001,56000,7999,False,176,scaffold_7
1,310001,340000,29999,False,176,scaffold_7
2,342001,508000,165999,False,176,scaffold_7
3,580001,603000,22999,False,176,scaffold_7
4,654001,736000,81999,False,176,scaffold_7
5,740001,753000,12999,False,176,scaffold_7
6,762001,841000,78999,False,176,scaffold_7
7,875001,948000,72999,False,176,scaffold_7
8,949001,963000,13999,False,176,scaffold_7
9,964001,1044000,79999,False,176,scaffold_7
10,1048001,1104000,55999,False,176,scaffold_7
11,1105001,1123000,17999,False,176,scaffold_7
12,1190001,1460000,269999,False,176,scaffold_7
13,1461001,1512000,50999,False,176,scaffold_7
14,1586001,1690000,103999,False,176,scaffold_7
15,2136001,2159000,22999,False,176,scaffold_7
16,2747001,2759000,11999,False,176,scaffold_7
17,2851001,2886000,34999,False,176,scaffold_7
18,3296001,3401000,104999,False,176,scaffold_7
19,3498001,3838000,339999,False,176,scaffold_7
20,3918001,3969000,50999,False,176,scaffold_7
21,4021001,4081000,59999,False,176,scaffold_7
22,4082001,4117000,34999,False,176,scaffold_7
23,4324001,4378000,53999,False,176,scaffold_7
24,4403001,4515000,111999,False,176,scaffold_7
25,4547001,4611000,63999,False,176,scaffold_7
26,4635001,4911000,275999,False,176,scaffold_7
27,4978001,5149000,170999,False,176,scaffold_7
28,5420001,5444000,23999,False,176,scaffold_7
29,5468001,5538000,69999,False,176,scaffold_7
30,6129001,6235000,105999,False,176,scaffold_7
31,6261001,6370000,108999,False,176,scaffold_7
32,6412001,6433000,20999,False,176,scaffold_7
33,6466001,6488000,21999,False,176,scaffold_7
34,6601001,6685000,83999,False,176,scaffold_7
35,6751001,6798000,46999,False,176,scaffold_7
36,6953001,7270000,316999,False,176,scaffold_7
37,7271001,7502216,231215,True,176,scaffold_7
0,1,6000,5999,True,176,scaffold_8
1,38001,64000,25999,False,176,scaffold_8
2,66001,89000,22999,False,176,scaffold_8
3,1379001,1422000,42999,False,176,scaffold_8
4,1563001,1647000,83999,False,176,scaffold_8
5,1670001,1719000,48999,False,176,scaffold_8
6,1825001,1989000,163999,False,176,scaffold_8
7,2087001,2143000,55999,False,176,scaffold_8
8,2335001,2590000,254999,False,176,scaffold_8
9,2644001,2683000,38999,False,176,scaffold_8
10,2739001,2844000,104999,False,176,scaffold_8
11,3057001,3612000,554999,False,176,scaffold_8
12,3615001,3953000,337999,False,176,scaffold_8
13,4013001,4124000,110999,False,176,scaffold_8
14,4170001,4260000,89999,False,176,scaffold_8
15,4331001,4433000,101999,False,176,scaffold_8
16,4566001,4644000,77999,False,176,scaffold_8
17,4813001,4875000,61999,False,176,scaffold_8
18,5076001,5241000,164999,False,176,scaffold_8
19,5521001,5596000,74999,False,176,scaffold_8
20,5650001,5696000,45999,False,176,scaffold_8
21,6329001,6334544,5543,True,176,scaffold_8
0,1,18000,17999,True,176,scaffold_9
1,109001,118000,8999,False,176,scaffold_9
2,121001,138000,16999,False,176,scaffold_9
3,270001,276000,5999,False,176,scaffold_9
4,298001,315000,16999,False,176,scaffold_9
5,366001,405000,38999,False,176,scaffold_9
6,407001,411000,3999,False,176,scaffold_9
7,413001,434000,20999,False,176,scaffold_9
8,476001,531000,54999,False,176,scaffold_9
9,643001,659000,15999,False,176,scaffold_9
10,660001,665000,4999,False,176,scaffold_9
11,671001,697000,25999,False,176,scaffold_9
12,815001,842000,26999,False,176,scaffold_9
13,872001,986000,113999,False,176,scaffold_9
14,988001,995000,6999,False,176,scaffold_9
15,998001,1007000,8999,False,176,scaffold_9
16,1009001,1085000,75999,False,176,scaffold_9
17,1087001,1161000,73999,False,176,scaffold_9
18,1237001,1257000,19999,False,176,scaffold_9
19,1312001,1377000,64999,False,176,scaffold_9
20,1749001,1810000,60999,False,176,scaffold_9
21,2596001,2650000,53999,False,176,scaffold_9
22,2730001,3381000,650999,False,176,scaffold_9
23,3383001,5073000,1689999,False,176,scaffold_9
24,5074001,5110000,35999,False,176,scaffold_9
25,5112001,5115000,2999,False,176,scaffold_9
26,5116001,5298000,181999,False,176,scaffold_9
27,5300001,5489000,188999,False,176,scaffold_9
28,5493001,5746000,252999,False,176,scaffold_9
29,5748001,6331288,583287,True,176,scaffold_9
0,1,402000,401999,True,176,scaffold_10
1,416001,482000,65999,False,176,scaffold_10
2,483001,582000,98999,False,176,scaffold_10
3,602001,963000,360999,False,176,scaffold_10
4,1087001,1145000,57999,False,176,scaffold_10
5,1603001,1668000,64999,False,176,scaffold_10
6,2087001,2107000,19999,False,176,scaffold_10
7,2346001,2362000,15999,False,176,scaffold_10
8,2798001,2813000,14999,False,176,scaffold_10
9,4051001,4112000,60999,False,176,scaffold_10
10,4191001,4211000,19999,False,176,scaffold_10
11,4334001,4358000,23999,False,176,scaffold_10
12,4443001,4466000,22999,False,176,scaffold_10
13,4467001,4502000,34999,False,176,scaffold_10
14,4503001,4513000,9999,False,176,scaffold_10
15,4515001,4548000,32999,False,176,scaffold_10
16,4554001,4562000,7999,False,176,scaffold_10
17,4565001,4596000,30999,False,176,scaffold_10
18,4700001,4715000,14999,False,176,scaffold_10
19,4716001,4719000,2999,False,176,scaffold_10
20,4734001,4751000,16999,False,176,scaffold_10
21,4752001,4767000,14999,False,176,scaffold_10
22,4798001,4825000,26999,False,176,scaffold_10
23,4828001,4843000,14999,False,176,scaffold_10
0,14001,95000,80999,False,176,scaffold_11
1,132001,167000,34999,False,176,scaffold_11
2,169001,235000,65999,False,176,scaffold_11
3,296001,321000,24999,False,176,scaffold_11
4,366001,394000,27999,False,176,scaffold_11
5,419001,431000,11999,False,176,scaffold_11
6,648001,656000,7999,False,176,scaffold_11
7,1423001,1426000,2999,False,176,scaffold_11
8,1474001,1477000,2999,False,176,scaffold_11
9,2325001,2498000,172999,False,176,scaffold_11
10,2701001,2880000,178999,False,176,scaffold_11
11,2969001,3019000,49999,False,176,scaffold_11
12,3082001,3159000,76999,False,176,scaffold_11
13,3184001,3383000,198999,False,176,scaffold_11
14,3409001,3477000,67999,False,176,scaffold_11
15,3524001,3934000,409999,False,176,scaffold_11
16,3952001,4160000,207999,False,176,scaffold_11
17,4182001,4211000,28999,False,176,scaffold_11
18,4257001,4710000,452999,False,176,scaffold_11
19,4713001,4766820,53819,True,176,scaffold_11
0,1,816000,815999,True,176,scaffold_12
1,817001,1495000,677999,False,176,scaffold_12
2,1543001,1586000,42999,False,176,scaffold_12
3,1717001,1762000,44999,False,176,scaffold_12
4,2571001,2624000,52999,False,176,scaffold_12
5,2625001,2635000,9999,False,176,scaffold_12
6,2685001,2699000,13999,False,176,scaffold_12
7,2700001,2708000,7999,False,176,scaffold_12
0,1,340000,339999,True,177,scaffold_1
1,482001,498000,15999,False,177,scaffold_1
2,629001,642000,12999,False,177,scaffold_1
3,687001,743000,55999,False,177,scaffold_1
4,1870001,1890000,19999,False,177,scaffold_1
5,1954001,1964000,9999,False,177,scaffold_1
6,1965001,1984000,18999,False,177,scaffold_1
7,2448001,2466000,17999,False,177,scaffold_1
8,2472001,2518000,45999,False,177,scaffold_1
9,2726001,2746000,19999,False,177,scaffold_1
10,2906001,2924000,17999,False,177,scaffold_1
11,2990001,3019000,28999,False,177,scaffold_1
12,3706001,3734000,27999,False,177,scaffold_1
13,3915001,3941000,25999,False,177,scaffold_1
14,4307001,4354000,46999,False,177,scaffold_1
15,4925001,4998000,72999,False,177,scaffold_1
16,5089001,5105000,15999,False,177,scaffold_1
17,5482001,5521000,38999,False,177,scaffold_1
18,6108001,6126000,17999,False,177,scaffold_1
19,6128001,6153000,24999,False,177,scaffold_1
20,6228001,6380000,151999,False,177,scaffold_1
21,6384001,6507000,122999,False,177,scaffold_1
22,6542001,6569000,26999,False,177,scaffold_1
23,7039001,7247000,207999,False,177,scaffold_1
24,7248001,7583000,334999,False,177,scaffold_1
25,7590001,8488000,897999,False,177,scaffold_1
26,8490001,8656000,165999,False,177,scaffold_1
27,8658001,9584000,925999,False,177,scaffold_1
28,9587001,10355000,767999,False,177,scaffold_1
29,10450001,10640000,189999,False,177,scaffold_1
30,10846001,10858000,11999,False,177,scaffold_1
31,11340001,11508000,167999,False,177,scaffold_1
32,11645001,11704000,58999,False,177,scaffold_1
33,11740001,11822000,81999,False,177,scaffold_1
34,11883001,11941000,57999,False,177,scaffold_1
35,12184001,12206000,21999,False,177,scaffold_1
36,12653001,12723000,69999,False,177,scaffold_1
37,12795001,12823000,27999,False,177,scaffold_1
38,12824001,12884000,59999,False,177,scaffold_1
39,13146001,13211000,64999,False,177,scaffold_1
40,13349001,13403000,53999,False,177,scaffold_1
0,93001,159000,65999,False,177,scaffold_2
1,168001,177000,8999,False,177,scaffold_2
2,258001,265000,6999,False,177,scaffold_2
3,313001,318000,4999,False,177,scaffold_2
4,332001,374000,41999,False,177,scaffold_2
5,1018001,1027000,8999,False,177,scaffold_2
6,2404001,2415000,10999,False,177,scaffold_2
7,2458001,2538000,79999,False,177,scaffold_2
8,2661001,2689000,27999,False,177,scaffold_2
9,2694001,2745000,50999,False,177,scaffold_2
10,2883001,2897000,13999,False,177,scaffold_2
11,2994001,3013000,18999,False,177,scaffold_2
12,3172001,3186000,13999,False,177,scaffold_2
13,4537001,4580000,42999,False,177,scaffold_2
14,4919001,4933000,13999,False,177,scaffold_2
15,5021001,5054000,32999,False,177,scaffold_2
16,5455001,5471000,15999,False,177,scaffold_2
17,5491001,5514000,22999,False,177,scaffold_2
18,5658001,5693000,34999,False,177,scaffold_2
19,6261001,6338000,76999,False,177,scaffold_2
20,6411001,6446000,34999,False,177,scaffold_2
21,6591001,6628000,36999,False,177,scaffold_2
22,7063001,7088000,24999,False,177,scaffold_2
23,7331001,7478000,146999,False,177,scaffold_2
24,7491001,7518000,26999,False,177,scaffold_2
25,7632001,7699000,66999,False,177,scaffold_2
26,7786001,7850000,63999,False,177,scaffold_2
27,7987001,8161000,173999,False,177,scaffold_2
28,8206001,8245000,38999,False,177,scaffold_2
29,8260001,8313000,52999,False,177,scaffold_2
30,8331001,8333000,1999,False,177,scaffold_2
31,8335001,8344000,8999,False,177,scaffold_2
32,8346001,8389000,42999,False,177,scaffold_2
33,8436001,8453000,16999,False,177,scaffold_2
34,8509001,8562000,52999,False,177,scaffold_2
35,9349001,9381000,31999,False,177,scaffold_2
36,9677001,9695000,17999,False,177,scaffold_2
37,11367001,11373000,5999,False,177,scaffold_2
38,11560001,11591000,30999,False,177,scaffold_2
39,11592001,11619000,26999,False,177,scaffold_2
40,11621001,11786000,164999,False,177,scaffold_2
0,51001,55000,3999,False,177,scaffold_3
1,618001,647000,28999,False,177,scaffold_3
2,798001,901000,102999,False,177,scaffold_3
3,2076001,2107000,30999,False,177,scaffold_3
4,2291001,2322000,30999,False,177,scaffold_3
5,2464001,2533000,68999,False,177,scaffold_3
6,3261001,3266000,4999,False,177,scaffold_3
7,3832001,3891000,58999,False,177,scaffold_3
8,4108001,4230000,121999,False,177,scaffold_3
9,4243001,4397000,153999,False,177,scaffold_3
10,4417001,4506000,88999,False,177,scaffold_3
11,4547001,4559000,11999,False,177,scaffold_3
12,4571001,4578000,6999,False,177,scaffold_3
13,5991001,6015000,23999,False,177,scaffold_3
14,6662001,6694000,31999,False,177,scaffold_3
15,6910001,6954000,43999,False,177,scaffold_3
16,6980001,7092000,111999,False,177,scaffold_3
17,7146001,7157000,10999,False,177,scaffold_3
18,7522001,7556000,33999,False,177,scaffold_3
19,7692001,7798000,105999,False,177,scaffold_3
20,7822001,7857000,34999,False,177,scaffold_3
21,8235001,8253000,17999,False,177,scaffold_3
22,8462001,8510000,47999,False,177,scaffold_3
23,8574001,8594000,19999,False,177,scaffold_3
24,9968001,10004000,35999,False,177,scaffold_3
25,10461001,10473000,11999,False,177,scaffold_3
26,10593001,11165000,571999,False,177,scaffold_3
0,48001,88000,39999,False,177,scaffold_4
1,147001,151000,3999,False,177,scaffold_4
2,169001,215000,45999,False,177,scaffold_4
3,217001,226000,8999,False,177,scaffold_4
4,288001,304000,15999,False,177,scaffold_4
5,325001,344000,18999,False,177,scaffold_4
6,355001,374000,18999,False,177,scaffold_4
7,404001,425000,20999,False,177,scaffold_4
8,429001,466000,36999,False,177,scaffold_4
9,510001,571000,60999,False,177,scaffold_4
10,608001,647000,38999,False,177,scaffold_4
11,649001,659000,9999,False,177,scaffold_4
12,674001,691000,16999,False,177,scaffold_4
13,1053001,1063000,9999,False,177,scaffold_4
14,1082001,1086000,3999,False,177,scaffold_4
15,1121001,1198000,76999,False,177,scaffold_4
16,1199001,1208000,8999,False,177,scaffold_4
17,1265001,1279000,13999,False,177,scaffold_4
18,1283001,1309000,25999,False,177,scaffold_4
19,1372001,1598000,225999,False,177,scaffold_4
20,1749001,1849000,99999,False,177,scaffold_4
21,1850001,1863000,12999,False,177,scaffold_4
22,1904001,1957000,52999,False,177,scaffold_4
23,1958001,1977000,18999,False,177,scaffold_4
24,2247001,2281000,33999,False,177,scaffold_4
25,2284001,2310000,25999,False,177,scaffold_4
26,2312001,2340000,27999,False,177,scaffold_4
27,2476001,2571000,94999,False,177,scaffold_4
28,2620001,2635000,14999,False,177,scaffold_4
29,3339001,3350000,10999,False,177,scaffold_4
30,3386001,3756000,369999,False,177,scaffold_4
31,4901001,4920000,18999,False,177,scaffold_4
32,5176001,5221000,44999,False,177,scaffold_4
33,5341001,5379000,37999,False,177,scaffold_4
34,5482001,5506000,23999,False,177,scaffold_4
35,5514001,5590000,75999,False,177,scaffold_4
36,5604001,5685000,80999,False,177,scaffold_4
37,5697001,5784000,86999,False,177,scaffold_4
38,5786001,5818000,31999,False,177,scaffold_4
39,6145001,6194000,48999,False,177,scaffold_4
40,6804001,6817000,12999,False,177,scaffold_4
41,6892001,6923000,30999,False,177,scaffold_4
42,7154001,7166000,11999,False,177,scaffold_4
43,7209001,7272000,62999,False,177,scaffold_4
44,7644001,7664000,19999,False,177,scaffold_4
45,8845001,8872000,26999,False,177,scaffold_4
46,8874001,9699000,824999,False,177,scaffold_4
47,9711001,9845951,134950,True,177,scaffold_4
0,195001,204000,8999,False,177,scaffold_5
1,296001,299000,2999,False,177,scaffold_5
2,318001,397000,78999,False,177,scaffold_5
3,455001,480000,24999,False,177,scaffold_5
4,2264001,2279000,14999,False,177,scaffold_5
5,2625001,2681000,55999,False,177,scaffold_5
6,2698001,2738000,39999,False,177,scaffold_5
7,2813001,2868000,54999,False,177,scaffold_5
8,3128001,3184000,55999,False,177,scaffold_5
9,3278001,3400000,121999,False,177,scaffold_5
10,3452001,3511000,58999,False,177,scaffold_5
11,3962001,4101000,138999,False,177,scaffold_5
12,4118001,4179000,60999,False,177,scaffold_5
13,4181001,4199000,17999,False,177,scaffold_5
14,4447001,4504000,56999,False,177,scaffold_5
15,4603001,4662000,58999,False,177,scaffold_5
16,4691001,4737000,45999,False,177,scaffold_5
17,4789001,4809000,19999,False,177,scaffold_5
18,4811001,4861000,49999,False,177,scaffold_5
19,5258001,5274000,15999,False,177,scaffold_5
20,5286001,5346000,59999,False,177,scaffold_5
21,5348001,5354000,5999,False,177,scaffold_5
22,6409001,6438000,28999,False,177,scaffold_5
23,6451001,6464000,12999,False,177,scaffold_5
24,7373001,7386000,12999,False,177,scaffold_5
25,7579001,7609000,29999,False,177,scaffold_5
26,8258001,8263000,4999,False,177,scaffold_5
27,8730001,9364176,634175,True,177,scaffold_5
0,79001,84000,4999,False,177,scaffold_6
1,86001,113000,26999,False,177,scaffold_6
2,240001,253000,12999,False,177,scaffold_6
3,267001,293000,25999,False,177,scaffold_6
4,786001,797000,10999,False,177,scaffold_6
5,1235001,1259000,23999,False,177,scaffold_6
6,1284001,1315000,30999,False,177,scaffold_6
7,1478001,1546000,67999,False,177,scaffold_6
8,2035001,2065000,29999,False,177,scaffold_6
9,2126001,2178000,51999,False,177,scaffold_6
10,2371001,2653000,281999,False,177,scaffold_6
11,2718001,2859000,140999,False,177,scaffold_6
12,2934001,3009000,74999,False,177,scaffold_6
13,3097001,3170000,72999,False,177,scaffold_6
14,3223001,3274000,50999,False,177,scaffold_6
15,3467001,3767000,299999,False,177,scaffold_6
16,3973001,3996000,22999,False,177,scaffold_6
17,4107001,4193000,85999,False,177,scaffold_6
18,6009001,6087000,77999,False,177,scaffold_6
19,7281001,7339000,57999,False,177,scaffold_6
20,7545001,7636000,90999,False,177,scaffold_6
21,7641001,8268281,627280,True,177,scaffold_6
0,1,8000,7999,True,177,scaffold_7
1,169001,171000,1999,False,177,scaffold_7
2,177001,184000,6999,False,177,scaffold_7
3,309001,340000,30999,False,177,scaffold_7
4,342001,409000,66999,False,177,scaffold_7
5,410001,508000,97999,False,177,scaffold_7
6,706001,736000,29999,False,177,scaffold_7
7,740001,753000,12999,False,177,scaffold_7
8,763001,826000,62999,False,177,scaffold_7
9,868001,872000,3999,False,177,scaffold_7
10,875001,885000,9999,False,177,scaffold_7
11,887001,908000,20999,False,177,scaffold_7
12,983001,1025000,41999,False,177,scaffold_7
13,1071001,1122000,50999,False,177,scaffold_7
14,1190001,1477000,286999,False,177,scaffold_7
15,1478001,1512000,33999,False,177,scaffold_7
16,1588001,1693000,104999,False,177,scaffold_7
17,3356001,3370000,13999,False,177,scaffold_7
18,3520001,3610000,89999,False,177,scaffold_7
19,3624001,3661000,36999,False,177,scaffold_7
20,3690001,3797000,106999,False,177,scaffold_7
21,3917001,3933000,15999,False,177,scaffold_7
22,4416001,4531000,114999,False,177,scaffold_7
23,4560001,4681000,120999,False,177,scaffold_7
24,5035001,5149000,113999,False,177,scaffold_7
25,5472001,5536000,63999,False,177,scaffold_7
26,5608001,5628000,19999,False,177,scaffold_7
27,6261001,6281000,19999,False,177,scaffold_7
28,6983001,7146000,162999,False,177,scaffold_7
29,7147001,7502216,355215,True,177,scaffold_7
0,37001,64000,26999,False,177,scaffold_8
1,66001,85000,18999,False,177,scaffold_8
2,722001,724000,1999,False,177,scaffold_8
3,1859001,1900000,40999,False,177,scaffold_8
4,1901001,1931000,29999,False,177,scaffold_8
5,2428001,2469000,40999,False,177,scaffold_8
6,2492001,2533000,40999,False,177,scaffold_8
7,2536001,2549000,12999,False,177,scaffold_8
8,2650001,2683000,32999,False,177,scaffold_8
9,2798001,2842000,43999,False,177,scaffold_8
10,3058001,3148000,89999,False,177,scaffold_8
11,3150001,3529000,378999,False,177,scaffold_8
12,3577001,3614000,36999,False,177,scaffold_8
13,3615001,3887000,271999,False,177,scaffold_8
14,3888001,3947000,58999,False,177,scaffold_8
15,4012001,4101000,88999,False,177,scaffold_8
16,4172001,4221000,48999,False,177,scaffold_8
17,5195001,5231000,35999,False,177,scaffold_8
18,5579001,5595000,15999,False,177,scaffold_8
19,6329001,6334544,5543,True,177,scaffold_8
0,1001,22000,20999,False,177,scaffold_9
1,109001,118000,8999,False,177,scaffold_9
2,272001,276000,3999,False,177,scaffold_9
3,300001,315000,14999,False,177,scaffold_9
4,319001,334000,14999,False,177,scaffold_9
5,366001,411000,44999,False,177,scaffold_9
6,413001,434000,20999,False,177,scaffold_9
7,485001,531000,45999,False,177,scaffold_9
8,547001,561000,13999,False,177,scaffold_9
9,652001,665000,12999,False,177,scaffold_9
10,671001,690000,18999,False,177,scaffold_9
11,815001,847000,31999,False,177,scaffold_9
12,850001,854000,3999,False,177,scaffold_9
13,855001,864000,8999,False,177,scaffold_9
14,885001,986000,100999,False,177,scaffold_9
15,987001,996000,8999,False,177,scaffold_9
16,1010001,1031000,20999,False,177,scaffold_9
17,1035001,1085000,49999,False,177,scaffold_9
18,1087001,1150000,62999,False,177,scaffold_9
19,1151001,1164000,12999,False,177,scaffold_9
20,1312001,1377000,64999,False,177,scaffold_9
21,1600001,1606000,5999,False,177,scaffold_9
22,1766001,1804000,37999,False,177,scaffold_9
23,2598001,2616000,17999,False,177,scaffold_9
24,2737001,2759000,21999,False,177,scaffold_9
25,2781001,2803000,21999,False,177,scaffold_9
26,2870001,3381000,510999,False,177,scaffold_9
27,3383001,3387000,3999,False,177,scaffold_9
28,3388001,5107000,1718999,False,177,scaffold_9
29,5112001,5115000,2999,False,177,scaffold_9
30,5116001,5238000,121999,False,177,scaffold_9
31,5239001,5298000,58999,False,177,scaffold_9
32,5299001,5490000,190999,False,177,scaffold_9
33,5493001,6331288,838287,True,177,scaffold_9
0,1,215000,214999,True,177,scaffold_10
1,371001,405000,33999,False,177,scaffold_10
2,458001,482000,23999,False,177,scaffold_10
3,530001,583000,52999,False,177,scaffold_10
4,603001,641000,37999,False,177,scaffold_10
5,677001,795000,117999,False,177,scaffold_10
6,890001,921000,30999,False,177,scaffold_10
7,923001,963000,39999,False,177,scaffold_10
8,1073001,1112000,38999,False,177,scaffold_10
9,3264001,3268000,3999,False,177,scaffold_10
10,4052001,4086000,33999,False,177,scaffold_10
11,4154001,4174000,19999,False,177,scaffold_10
12,4527001,4548000,20999,False,177,scaffold_10
13,4554001,4562000,7999,False,177,scaffold_10
14,4565001,4596000,30999,False,177,scaffold_10
15,4752001,4766000,13999,False,177,scaffold_10
16,4768001,4776000,7999,False,177,scaffold_10
17,4791001,4797000,5999,False,177,scaffold_10
18,4798001,4824000,25999,False,177,scaffold_10
19,4828001,4843000,14999,False,177,scaffold_10
20,4848001,4861000,12999,False,177,scaffold_10
21,4862001,4866973,4972,True,177,scaffold_10
0,10001,87000,76999,False,177,scaffold_11
1,132001,167000,34999,False,177,scaffold_11
2,169001,236000,66999,False,177,scaffold_11
3,240001,253000,12999,False,177,scaffold_11
4,419001,427000,7999,False,177,scaffold_11
5,637001,656000,18999,False,177,scaffold_11
6,1423001,1426000,2999,False,177,scaffold_11
7,2745001,2795000,49999,False,177,scaffold_11
8,2807001,2874000,66999,False,177,scaffold_11
9,3059001,3071000,11999,False,177,scaffold_11
10,3193001,3254000,60999,False,177,scaffold_11
11,3327001,3383000,55999,False,177,scaffold_11
12,3745001,3836000,90999,False,177,scaffold_11
13,3837001,3921000,83999,False,177,scaffold_11
14,3996001,4056000,59999,False,177,scaffold_11
15,4134001,4159000,24999,False,177,scaffold_11
16,4320001,4372000,51999,False,177,scaffold_11
17,4390001,4456000,65999,False,177,scaffold_11
18,4457001,4708000,250999,False,177,scaffold_11
19,4713001,4766820,53819,True,177,scaffold_11
0,1,737000,736999,True,177,scaffold_12
1,739001,1255000,515999,False,177,scaffold_12
2,1278001,1357000,78999,False,177,scaffold_12
3,1718001,1733000,14999,False,177,scaffold_12
4,2571001,2617000,45999,False,177,scaffold_12
0,1,340000,339999,True,178,scaffold_1
1,482001,498000,15999,False,178,scaffold_1
2,571001,640000,68999,False,178,scaffold_1
3,686001,757000,70999,False,178,scaffold_1
4,1280001,1292000,11999,False,178,scaffold_1
5,1819001,1899000,79999,False,178,scaffold_1
6,1962001,1964000,1999,False,178,scaffold_1
7,1965001,1984000,18999,False,178,scaffold_1
8,2449001,2524000,74999,False,178,scaffold_1
9,2721001,2745000,23999,False,178,scaffold_1
10,3174001,3209000,34999,False,178,scaffold_1
11,3574001,3622000,47999,False,178,scaffold_1
12,3714001,3736000,21999,False,178,scaffold_1
13,4003001,4030000,26999,False,178,scaffold_1
14,4061001,4111000,49999,False,178,scaffold_1
15,4317001,4354000,36999,False,178,scaffold_1
16,4709001,4741000,31999,False,178,scaffold_1
17,4796001,4812000,15999,False,178,scaffold_1
18,4927001,5022000,94999,False,178,scaffold_1
19,5087001,5114000,26999,False,178,scaffold_1
20,5436001,5450000,13999,False,178,scaffold_1
21,5481001,5512000,30999,False,178,scaffold_1
22,5536001,5569000,32999,False,178,scaffold_1
23,6108001,6153000,44999,False,178,scaffold_1
24,6154001,6177000,22999,False,178,scaffold_1
25,6228001,6500000,271999,False,178,scaffold_1
26,6542001,6567000,24999,False,178,scaffold_1
27,7038001,7247000,208999,False,178,scaffold_1
28,7248001,7588000,339999,False,178,scaffold_1
29,7590001,8656000,1065999,False,178,scaffold_1
30,8658001,9584000,925999,False,178,scaffold_1
31,9586001,10353000,766999,False,178,scaffold_1
32,10461001,10639000,177999,False,178,scaffold_1
33,10832001,10857000,24999,False,178,scaffold_1
34,11356001,11512000,155999,False,178,scaffold_1
35,11609001,11951000,341999,False,178,scaffold_1
36,12183001,12202000,18999,False,178,scaffold_1
37,12652001,12723000,70999,False,178,scaffold_1
38,12775001,12888000,112999,False,178,scaffold_1
39,12969001,13001000,31999,False,178,scaffold_1
40,13095001,13144000,48999,False,178,scaffold_1
41,13153001,13211000,57999,False,178,scaffold_1
42,13347001,13404000,56999,False,178,scaffold_1
43,13562001,13580000,17999,False,178,scaffold_1
44,14285001,14307000,21999,False,178,scaffold_1
0,21001,48000,26999,False,178,scaffold_2
1,131001,159000,27999,False,178,scaffold_2
2,168001,177000,8999,False,178,scaffold_2
3,303001,318000,14999,False,178,scaffold_2
4,332001,374000,41999,False,178,scaffold_2
5,2336001,2600000,263999,False,178,scaffold_2
6,2647001,2689000,41999,False,178,scaffold_2
7,2694001,2746000,51999,False,178,scaffold_2
8,2878001,2900000,21999,False,178,scaffold_2
9,2999001,3008000,8999,False,178,scaffold_2
10,3027001,3044000,16999,False,178,scaffold_2
11,3176001,3185000,8999,False,178,scaffold_2
12,3363001,3388000,24999,False,178,scaffold_2
13,3450001,3466000,15999,False,178,scaffold_2
14,3754001,3783000,28999,False,178,scaffold_2
15,4243001,4276000,32999,False,178,scaffold_2
16,4389001,4409000,19999,False,178,scaffold_2
17,4426001,4459000,32999,False,178,scaffold_2
18,4520001,4657000,136999,False,178,scaffold_2
19,4783001,4790000,6999,False,178,scaffold_2
20,4908001,4959000,50999,False,178,scaffold_2
21,5020001,5104000,83999,False,178,scaffold_2
22,5187001,5223000,35999,False,178,scaffold_2
23,5381001,5390000,8999,False,178,scaffold_2
24,5414001,5517000,102999,False,178,scaffold_2
25,5626001,5644000,17999,False,178,scaffold_2
26,5658001,5757000,98999,False,178,scaffold_2
27,6259001,6351000,91999,False,178,scaffold_2
28,6593001,6630000,36999,False,178,scaffold_2
29,7005001,7038000,32999,False,178,scaffold_2
30,7340001,7418000,77999,False,178,scaffold_2
31,7449001,7473000,23999,False,178,scaffold_2
32,7491001,7518000,26999,False,178,scaffold_2
33,7563001,7697000,133999,False,178,scaffold_2
34,7785001,7887000,101999,False,178,scaffold_2
35,7934001,8136000,201999,False,178,scaffold_2
36,8261001,8313000,51999,False,178,scaffold_2
37,8331001,8333000,1999,False,178,scaffold_2
38,8335001,8344000,8999,False,178,scaffold_2
39,8346001,8389000,42999,False,178,scaffold_2
40,8416001,8453000,36999,False,178,scaffold_2
41,8509001,8562000,52999,False,178,scaffold_2
42,9147001,9181000,33999,False,178,scaffold_2
43,9602001,9621000,18999,False,178,scaffold_2
44,11525001,11785000,259999,False,178,scaffold_2
0,51001,55000,3999,False,178,scaffold_3
1,346001,349000,2999,False,178,scaffold_3
2,528001,539000,10999,False,178,scaffold_3
3,799001,900000,100999,False,178,scaffold_3
4,2084001,2107000,22999,False,178,scaffold_3
5,2288001,2335000,46999,False,178,scaffold_3
6,2486001,2533000,46999,False,178,scaffold_3
7,4097001,4397000,299999,False,178,scaffold_3
8,4417001,4518000,100999,False,178,scaffold_3
9,4546001,4559000,12999,False,178,scaffold_3
10,4652001,4679000,26999,False,178,scaffold_3
11,5977001,6023000,45999,False,178,scaffold_3
12,6911001,6962000,50999,False,178,scaffold_3
13,6963001,7034000,70999,False,178,scaffold_3
14,7035001,7098000,62999,False,178,scaffold_3
15,7367001,7398000,30999,False,178,scaffold_3
16,7449001,7457000,7999,False,178,scaffold_3
17,7518001,7557000,38999,False,178,scaffold_3
18,7683001,7854000,170999,False,178,scaffold_3
19,8175001,8253000,77999,False,178,scaffold_3
20,8460001,8527000,66999,False,178,scaffold_3
21,8574001,8594000,19999,False,178,scaffold_3
22,9967001,9996000,28999,False,178,scaffold_3
23,10061001,10086000,24999,False,178,scaffold_3
24,10461001,10485000,23999,False,178,scaffold_3
25,10551001,10571000,19999,False,178,scaffold_3
26,10580001,10969000,388999,False,178,scaffold_3
27,10970001,10998000,27999,False,178,scaffold_3
28,10999001,11162000,162999,False,178,scaffold_3
0,11001,13000,1999,False,178,scaffold_4
1,14001,16000,1999,False,178,scaffold_4
2,48001,88000,39999,False,178,scaffold_4
3,132001,146000,13999,False,178,scaffold_4
4,147001,151000,3999,False,178,scaffold_4
5,155001,215000,59999,False,178,scaffold_4
6,217001,226000,8999,False,178,scaffold_4
7,246001,266000,19999,False,178,scaffold_4
8,355001,374000,18999,False,178,scaffold_4
9,375001,380000,4999,False,178,scaffold_4
10,412001,425000,12999,False,178,scaffold_4
11,429001,498000,68999,False,178,scaffold_4
12,548001,592000,43999,False,178,scaffold_4
13,593001,606000,12999,False,178,scaffold_4
14,608001,691000,82999,False,178,scaffold_4
15,701001,714000,12999,False,178,scaffold_4
16,1122001,1136000,13999,False,178,scaffold_4
17,1137001,1208000,70999,False,178,scaffold_4
18,1210001,1226000,15999,False,178,scaffold_4
19,1283001,1336000,52999,False,178,scaffold_4
20,1355001,1596000,240999,False,178,scaffold_4
21,1613001,1848000,234999,False,178,scaffold_4
22,1849001,2000000,150999,False,178,scaffold_4
23,2211001,2268000,56999,False,178,scaffold_4
24,2269001,2280000,10999,False,178,scaffold_4
25,2284001,2340000,55999,False,178,scaffold_4
26,2342001,2352000,9999,False,178,scaffold_4
27,2476001,2578000,101999,False,178,scaffold_4
28,2599001,2635000,35999,False,178,scaffold_4
29,2940001,2959000,18999,False,178,scaffold_4
30,3089001,3127000,37999,False,178,scaffold_4
31,3336001,3760000,423999,False,178,scaffold_4
32,4907001,5047000,139999,False,178,scaffold_4
33,5169001,5224000,54999,False,178,scaffold_4
34,5475001,5506000,30999,False,178,scaffold_4
35,5515001,5784000,268999,False,178,scaffold_4
36,5786001,5819000,32999,False,178,scaffold_4
37,6178001,6191000,12999,False,178,scaffold_4
38,6906001,6995000,88999,False,178,scaffold_4
39,7036001,7080000,43999,False,178,scaffold_4
40,7225001,7323000,97999,False,178,scaffold_4
41,7641001,7665000,23999,False,178,scaffold_4
42,8846001,9148000,301999,False,178,scaffold_4
43,9149001,9699000,549999,False,178,scaffold_4
44,9703001,9845951,142950,True,178,scaffold_4
0,189001,204000,14999,False,178,scaffold_5
1,319001,326000,6999,False,178,scaffold_5
2,327001,382000,54999,False,178,scaffold_5
3,462001,487000,24999,False,178,scaffold_5
4,508001,523000,14999,False,178,scaffold_5
5,933001,947000,13999,False,178,scaffold_5
6,2475001,2493000,17999,False,178,scaffold_5
7,2551001,2797000,245999,False,178,scaffold_5
8,2816001,2841000,24999,False,178,scaffold_5
9,2842001,2871000,28999,False,178,scaffold_5
10,3133001,3186000,52999,False,178,scaffold_5
11,3217001,3248000,30999,False,178,scaffold_5
12,3309001,3511000,201999,False,178,scaffold_5
13,3962001,4101000,138999,False,178,scaffold_5
14,4118001,4219000,100999,False,178,scaffold_5
15,4301001,4322000,20999,False,178,scaffold_5
16,4446001,4520000,73999,False,178,scaffold_5
17,4602001,4857000,254999,False,178,scaffold_5
18,4892001,4918000,25999,False,178,scaffold_5
19,5249001,5267000,17999,False,178,scaffold_5
20,5287001,5346000,58999,False,178,scaffold_5
21,6507001,6578000,70999,False,178,scaffold_5
22,6590001,6653000,62999,False,178,scaffold_5
23,7373001,7387000,13999,False,178,scaffold_5
24,7555001,7619000,63999,False,178,scaffold_5
25,7622001,7665000,42999,False,178,scaffold_5
26,8415001,8470000,54999,False,178,scaffold_5
27,8553001,8616000,62999,False,178,scaffold_5
28,8674001,8689000,14999,False,178,scaffold_5
29,8713001,9364176,651175,True,178,scaffold_5
0,78001,84000,5999,False,178,scaffold_6
1,86001,112000,25999,False,178,scaffold_6
2,240001,253000,12999,False,178,scaffold_6
3,1235001,1263000,27999,False,178,scaffold_6
4,1478001,1547000,68999,False,178,scaffold_6
5,1843001,1901000,57999,False,178,scaffold_6
6,2026001,2087000,60999,False,178,scaffold_6
7,2130001,2169000,38999,False,178,scaffold_6
8,2236001,2283000,46999,False,178,scaffold_6
9,2334001,2595000,260999,False,178,scaffold_6
10,2596001,2653000,56999,False,178,scaffold_6
11,2657001,2695000,37999,False,178,scaffold_6
12,2720001,2780000,59999,False,178,scaffold_6
13,2781001,2851000,69999,False,178,scaffold_6
14,2933001,3035000,101999,False,178,scaffold_6
15,3115001,3191000,75999,False,178,scaffold_6
16,3222001,3301000,78999,False,178,scaffold_6
17,3394001,3765000,370999,False,178,scaffold_6
18,3882001,3913000,30999,False,178,scaffold_6
19,4017001,4066000,48999,False,178,scaffold_6
20,4082001,4194000,111999,False,178,scaffold_6
21,6021001,6082000,60999,False,178,scaffold_6
22,7271001,7340000,68999,False,178,scaffold_6
23,7389001,7436000,46999,False,178,scaffold_6
24,7562001,7673000,110999,False,178,scaffold_6
25,7684001,8268281,584280,True,178,scaffold_6
0,13001,34000,20999,False,178,scaffold_7
1,323001,340000,16999,False,178,scaffold_7
2,342001,509000,166999,False,178,scaffold_7
3,572001,577000,4999,False,178,scaffold_7
4,692001,736000,43999,False,178,scaffold_7
5,763001,827000,63999,False,178,scaffold_7
6,859001,864000,4999,False,178,scaffold_7
7,868001,945000,76999,False,178,scaffold_7
8,964001,980000,15999,False,178,scaffold_7
9,982001,1044000,61999,False,178,scaffold_7
10,1203001,1512000,308999,False,178,scaffold_7
11,1588001,1688000,99999,False,178,scaffold_7
12,3326001,3370000,43999,False,178,scaffold_7
13,3523001,3661000,137999,False,178,scaffold_7
14,3749001,3809000,59999,False,178,scaffold_7
15,4325001,4361000,35999,False,178,scaffold_7
16,4415001,4534000,118999,False,178,scaffold_7
17,4658001,4682000,23999,False,178,scaffold_7
18,4692001,4820000,127999,False,178,scaffold_7
19,5001001,5030000,28999,False,178,scaffold_7
20,5031001,5144000,112999,False,178,scaffold_7
21,5483001,5536000,52999,False,178,scaffold_7
22,5608001,5627000,18999,False,178,scaffold_7
23,6954001,7502216,548215,True,178,scaffold_7
0,67001,85000,17999,False,178,scaffold_8
1,93001,101000,7999,False,178,scaffold_8
2,2444001,2512000,67999,False,178,scaffold_8
3,2651001,2683000,31999,False,178,scaffold_8
4,2738001,2844000,105999,False,178,scaffold_8
5,3058001,3551000,492999,False,178,scaffold_8
6,3581001,3612000,30999,False,178,scaffold_8
7,3615001,3936000,320999,False,178,scaffold_8
8,4037001,4092000,54999,False,178,scaffold_8
9,4206001,4220000,13999,False,178,scaffold_8
10,5096001,5136000,39999,False,178,scaffold_8
11,5186001,5241000,54999,False,178,scaffold_8
12,5580001,5594000,13999,False,178,scaffold_8
13,5655001,5695000,39999,False,178,scaffold_8
14,6329001,6334544,5543,True,178,scaffold_8
0,366001,411000,44999,False,178,scaffold_9
1,413001,434000,20999,False,178,scaffold_9
2,484001,531000,46999,False,178,scaffold_9
3,548001,561000,12999,False,178,scaffold_9
4,671001,697000,25999,False,178,scaffold_9
5,731001,741000,9999,False,178,scaffold_9
6,816001,842000,25999,False,178,scaffold_9
7,886001,986000,99999,False,178,scaffold_9
8,987001,995000,7999,False,178,scaffold_9
9,1009001,1031000,21999,False,178,scaffold_9
10,1037001,1086000,48999,False,178,scaffold_9
11,1087001,1150000,62999,False,178,scaffold_9
12,1151001,1164000,12999,False,178,scaffold_9
13,1312001,1377000,64999,False,178,scaffold_9
14,1599001,1610000,10999,False,178,scaffold_9
15,1759001,1791000,31999,False,178,scaffold_9
16,2598001,2673000,74999,False,178,scaffold_9
17,2737001,2837000,99999,False,178,scaffold_9
18,2844001,3381000,536999,False,178,scaffold_9
19,3383001,4663000,1279999,False,178,scaffold_9
20,4664001,5107000,442999,False,178,scaffold_9
21,5112001,5115000,2999,False,178,scaffold_9
22,5116001,5298000,181999,False,178,scaffold_9
23,5300001,5490000,189999,False,178,scaffold_9
24,5492001,6331288,839287,True,178,scaffold_9
0,1,201000,200999,True,178,scaffold_10
1,286001,321000,34999,False,178,scaffold_10
2,339001,357000,17999,False,178,scaffold_10
3,372001,414000,41999,False,178,scaffold_10
4,415001,440000,24999,False,178,scaffold_10
5,472001,482000,9999,False,178,scaffold_10
6,483001,577000,93999,False,178,scaffold_10
7,596001,797000,200999,False,178,scaffold_10
8,814001,839000,24999,False,178,scaffold_10
9,891001,921000,29999,False,178,scaffold_10
10,923001,955000,31999,False,178,scaffold_10
11,1073001,1146000,72999,False,178,scaffold_10
12,2088001,2102000,13999,False,178,scaffold_10
13,2346001,2368000,21999,False,178,scaffold_10
14,4052001,4084000,31999,False,178,scaffold_10
15,4154001,4174000,19999,False,178,scaffold_10
16,4444001,4462000,17999,False,178,scaffold_10
17,4467001,4477000,9999,False,178,scaffold_10
18,4478001,4502000,23999,False,178,scaffold_10
19,4503001,4513000,9999,False,178,scaffold_10
20,4515001,4523000,7999,False,178,scaffold_10
21,4526001,4547000,20999,False,178,scaffold_10
22,4565001,4597000,31999,False,178,scaffold_10
23,4734001,4776000,41999,False,178,scaffold_10
24,4798001,4824000,25999,False,178,scaffold_10
25,4827001,4840000,12999,False,178,scaffold_10
26,4848001,4861000,12999,False,178,scaffold_10
27,4865001,4866973,1972,True,178,scaffold_10
0,10001,92000,81999,False,178,scaffold_11
1,149001,167000,17999,False,178,scaffold_11
2,169001,191000,21999,False,178,scaffold_11
3,213001,235000,21999,False,178,scaffold_11
4,296001,318000,21999,False,178,scaffold_11
5,419001,431000,11999,False,178,scaffold_11
6,648001,656000,7999,False,178,scaffold_11
7,1025001,1034000,8999,False,178,scaffold_11
8,1423001,1426000,2999,False,178,scaffold_11
9,2700001,2874000,173999,False,178,scaffold_11
10,3095001,3130000,34999,False,178,scaffold_11
11,3185001,3251000,65999,False,178,scaffold_11
12,3327001,3383000,55999,False,178,scaffold_11
13,3565001,3652000,86999,False,178,scaffold_11
14,3704001,3721000,16999,False,178,scaffold_11
15,3744001,3932000,187999,False,178,scaffold_11
16,4009001,4160000,150999,False,178,scaffold_11
17,4318001,4710000,391999,False,178,scaffold_11
18,4712001,4766820,54819,True,178,scaffold_11
0,1,857000,856999,True,178,scaffold_12
1,865001,1431000,565999,False,178,scaffold_12
2,1720001,1733000,12999,False,178,scaffold_12
3,2571001,2619000,47999,False,178,scaffold_12
0,1,342000,341999,True,179,scaffold_1
1,482001,498000,15999,False,179,scaffold_1
2,571001,643000,71999,False,179,scaffold_1
3,686001,712000,25999,False,179,scaffold_1
4,726001,759000,32999,False,179,scaffold_1
5,1283001,1292000,8999,False,179,scaffold_1
6,1951001,1964000,12999,False,179,scaffold_1
7,1965001,1984000,18999,False,179,scaffold_1
8,2729001,2746000,16999,False,179,scaffold_1
9,3180001,3208000,27999,False,179,scaffold_1
10,3387001,3390000,2999,False,179,scaffold_1
11,3714001,3736000,21999,False,179,scaffold_1
12,3916001,3941000,24999,False,179,scaffold_1
13,4064001,4112000,47999,False,179,scaffold_1
14,4315001,4354000,38999,False,179,scaffold_1
15,4928001,4983000,54999,False,179,scaffold_1
16,5094001,5109000,14999,False,179,scaffold_1
17,5483001,5511000,27999,False,179,scaffold_1
18,6108001,6153000,44999,False,179,scaffold_1
19,6154001,6177000,22999,False,179,scaffold_1
20,6228001,6381000,152999,False,179,scaffold_1
21,6384001,6454000,69999,False,179,scaffold_1
22,6471001,6509000,37999,False,179,scaffold_1
23,6543001,6562000,18999,False,179,scaffold_1
24,7038001,7247000,208999,False,179,scaffold_1
25,7248001,7589000,340999,False,179,scaffold_1
26,7590001,8656000,1065999,False,179,scaffold_1
27,8658001,9584000,925999,False,179,scaffold_1
28,9586001,10356000,769999,False,179,scaffold_1
29,10461001,10633000,171999,False,179,scaffold_1
30,10740001,10753000,12999,False,179,scaffold_1
31,10835001,10858000,22999,False,179,scaffold_1
32,11352001,11505000,152999,False,179,scaffold_1
33,11614001,11940000,325999,False,179,scaffold_1
34,12184001,12226000,41999,False,179,scaffold_1
35,12666001,12722000,55999,False,179,scaffold_1
36,12786001,12888000,101999,False,179,scaffold_1
37,13113001,13211000,97999,False,179,scaffold_1
38,13347001,13404000,56999,False,179,scaffold_1
0,21001,48000,26999,False,179,scaffold_2
1,93001,159000,65999,False,179,scaffold_2
2,168001,177000,8999,False,179,scaffold_2
3,332001,374000,41999,False,179,scaffold_2
4,2336001,2358000,21999,False,179,scaffold_2
5,2404001,2424000,19999,False,179,scaffold_2
6,2441001,2553000,111999,False,179,scaffold_2
7,2660001,2689000,28999,False,179,scaffold_2
8,2694001,2742000,47999,False,179,scaffold_2
9,2777001,2788000,10999,False,179,scaffold_2
10,3455001,3462000,6999,False,179,scaffold_2
11,3759001,3783000,23999,False,179,scaffold_2
12,4385001,4409000,23999,False,179,scaffold_2
13,4521001,4554000,32999,False,179,scaffold_2
14,4606001,4653000,46999,False,179,scaffold_2
15,4918001,4947000,28999,False,179,scaffold_2
16,5021001,5061000,39999,False,179,scaffold_2
17,5081001,5104000,22999,False,179,scaffold_2
18,5370001,5395000,24999,False,179,scaffold_2
19,5491001,5514000,22999,False,179,scaffold_2
20,5672001,5758000,85999,False,179,scaffold_2
21,6261001,6351000,89999,False,179,scaffold_2
22,6592001,6628000,35999,False,179,scaffold_2
23,7017001,7038000,20999,False,179,scaffold_2
24,7439001,7472000,32999,False,179,scaffold_2
25,7572001,7697000,124999,False,179,scaffold_2
26,7786001,7889000,102999,False,179,scaffold_2
27,7934001,7965000,30999,False,179,scaffold_2
28,7991001,8161000,169999,False,179,scaffold_2
29,8265001,8297000,31999,False,179,scaffold_2
30,8331001,8333000,1999,False,179,scaffold_2
31,8335001,8345000,9999,False,179,scaffold_2
32,8509001,8560000,50999,False,179,scaffold_2
33,11367001,11372000,4999,False,179,scaffold_2
34,11526001,11786000,259999,False,179,scaffold_2
0,1,2000,1999,True,179,scaffold_3
1,51001,55000,3999,False,179,scaffold_3
2,798001,901000,102999,False,179,scaffold_3
3,2085001,2108000,22999,False,179,scaffold_3
4,2290001,2321000,30999,False,179,scaffold_3
5,2487001,2533000,45999,False,179,scaffold_3
6,3824001,3839000,14999,False,179,scaffold_3
7,4108001,4385000,276999,False,179,scaffold_3
8,4418001,4518000,99999,False,179,scaffold_3
9,4547001,4558000,10999,False,179,scaffold_3
10,4658001,4674000,15999,False,179,scaffold_3
11,5990001,6010000,19999,False,179,scaffold_3
12,6910001,6961000,50999,False,179,scaffold_3
13,6979001,7078000,98999,False,179,scaffold_3
14,7151001,7157000,5999,False,179,scaffold_3
15,7522001,7556000,33999,False,179,scaffold_3
16,7692001,7755000,62999,False,179,scaffold_3
17,7818001,7839000,20999,False,179,scaffold_3
18,8184001,8253000,68999,False,179,scaffold_3
19,8462001,8527000,64999,False,179,scaffold_3
20,8575001,8594000,18999,False,179,scaffold_3
21,9968001,10000000,31999,False,179,scaffold_3
22,10461001,10483000,21999,False,179,scaffold_3
23,10494001,10501000,6999,False,179,scaffold_3
24,10587001,10895000,307999,False,179,scaffold_3
25,10896001,11058000,161999,False,179,scaffold_3
26,11059001,11162000,102999,False,179,scaffold_3
0,11001,13000,1999,False,179,scaffold_4
1,17001,32000,14999,False,179,scaffold_4
2,49001,88000,38999,False,179,scaffold_4
3,155001,215000,59999,False,179,scaffold_4
4,217001,226000,8999,False,179,scaffold_4
5,248001,266000,17999,False,179,scaffold_4
6,289001,310000,20999,False,179,scaffold_4
7,355001,370000,14999,False,179,scaffold_4
8,412001,425000,12999,False,179,scaffold_4
9,429001,498000,68999,False,179,scaffold_4
10,542001,592000,49999,False,179,scaffold_4
11,608001,661000,52999,False,179,scaffold_4
12,670001,691000,20999,False,179,scaffold_4
13,701001,714000,12999,False,179,scaffold_4
14,1121001,1136000,14999,False,179,scaffold_4
15,1137001,1170000,32999,False,179,scaffold_4
16,1199001,1208000,8999,False,179,scaffold_4
17,1210001,1226000,15999,False,179,scaffold_4
18,1254001,1262000,7999,False,179,scaffold_4
19,1265001,1279000,13999,False,179,scaffold_4
20,1283001,1336000,52999,False,179,scaffold_4
21,1372001,1595000,222999,False,179,scaffold_4
22,1749001,1849000,99999,False,179,scaffold_4
23,1850001,1863000,12999,False,179,scaffold_4
24,1930001,1957000,26999,False,179,scaffold_4
25,1958001,2000000,41999,False,179,scaffold_4
26,2269001,2279000,9999,False,179,scaffold_4
27,2284001,2310000,25999,False,179,scaffold_4
28,2311001,2339000,27999,False,179,scaffold_4
29,2476001,2568000,91999,False,179,scaffold_4
30,3336001,3591000,254999,False,179,scaffold_4
31,3592001,3615000,22999,False,179,scaffold_4
32,3676001,3760000,83999,False,179,scaffold_4
33,4943001,4995000,51999,False,179,scaffold_4
34,5193001,5223000,29999,False,179,scaffold_4
35,5475001,5506000,30999,False,179,scaffold_4
36,5514001,5620000,105999,False,179,scaffold_4
37,5659001,5784000,124999,False,179,scaffold_4
38,5786001,5825000,38999,False,179,scaffold_4
39,6145001,6197000,51999,False,179,scaffold_4
40,6803001,6817000,13999,False,179,scaffold_4
41,6902001,6924000,21999,False,179,scaffold_4
42,6969001,6989000,19999,False,179,scaffold_4
43,7038001,7061000,22999,False,179,scaffold_4
44,8844001,9138000,293999,False,179,scaffold_4
45,9139001,9699000,559999,False,179,scaffold_4
46,9703001,9845951,142950,True,179,scaffold_4
0,319001,368000,48999,False,179,scaffold_5
1,463001,523000,59999,False,179,scaffold_5
2,668001,680000,11999,False,179,scaffold_5
3,933001,947000,13999,False,179,scaffold_5
4,2565001,2730000,164999,False,179,scaffold_5
5,2816001,2870000,53999,False,179,scaffold_5
6,3133001,3185000,51999,False,179,scaffold_5
7,3322001,3511000,188999,False,179,scaffold_5
8,3973001,4101000,127999,False,179,scaffold_5
9,4120001,4219000,98999,False,179,scaffold_5
10,4446001,4483000,36999,False,179,scaffold_5
11,4601001,4666000,64999,False,179,scaffold_5
12,4691001,4717000,25999,False,179,scaffold_5
13,4788001,4862000,73999,False,179,scaffold_5
14,4904001,4922000,17999,False,179,scaffold_5
15,5250001,5274000,23999,False,179,scaffold_5
16,5318001,5346000,27999,False,179,scaffold_5
17,6409001,6420000,10999,False,179,scaffold_5
18,6510001,6566000,55999,False,179,scaffold_5
19,7454001,7484000,29999,False,179,scaffold_5
20,7622001,7654000,31999,False,179,scaffold_5
21,8730001,9363000,632999,False,179,scaffold_5
22,9364001,9364176,175,True,179,scaffold_5
0,79001,84000,4999,False,179,scaffold_6
1,86001,112000,25999,False,179,scaffold_6
2,247001,253000,5999,False,179,scaffold_6
3,1479001,1546000,66999,False,179,scaffold_6
4,2023001,2087000,63999,False,179,scaffold_6
5,2129001,2169000,39999,False,179,scaffold_6
6,2369001,2595000,225999,False,179,scaffold_6
7,2596001,2653000,56999,False,179,scaffold_6
8,2661001,2691000,29999,False,179,scaffold_6
9,2712001,2729000,16999,False,179,scaffold_6
10,2731001,2851000,119999,False,179,scaffold_6
11,2933001,3014000,80999,False,179,scaffold_6
12,3095001,3179000,83999,False,179,scaffold_6
13,3223001,3301000,77999,False,179,scaffold_6
14,3400001,3428000,27999,False,179,scaffold_6
15,3462001,3766000,303999,False,179,scaffold_6
16,3898001,3913000,14999,False,179,scaffold_6
17,4018001,4065000,46999,False,179,scaffold_6
18,4080001,4194000,113999,False,179,scaffold_6
19,6010001,6061000,50999,False,179,scaffold_6
20,7269001,7336000,66999,False,179,scaffold_6
21,7391001,7435000,43999,False,179,scaffold_6
22,7562001,7673000,110999,False,179,scaffold_6
23,7688001,7717000,28999,False,179,scaffold_6
24,7734001,7787000,52999,False,179,scaffold_6
25,7811001,8268281,457280,True,179,scaffold_6
0,1,8000,7999,True,179,scaffold_7
1,13001,34000,20999,False,179,scaffold_7
2,50001,60000,9999,False,179,scaffold_7
3,323001,340000,16999,False,179,scaffold_7
4,342001,508000,165999,False,179,scaffold_7
5,554001,563000,8999,False,179,scaffold_7
6,571001,577000,5999,False,179,scaffold_7
7,706001,753000,46999,False,179,scaffold_7
8,764001,809000,44999,False,179,scaffold_7
9,859001,864000,4999,False,179,scaffold_7
10,989001,1044000,54999,False,179,scaffold_7
11,1074001,1081000,6999,False,179,scaffold_7
12,1191001,1512000,320999,False,179,scaffold_7
13,1588001,1695000,106999,False,179,scaffold_7
14,3325001,3369000,43999,False,179,scaffold_7
15,3598001,3650000,51999,False,179,scaffold_7
16,4433001,4517000,83999,False,179,scaffold_7
17,4635001,4737000,101999,False,179,scaffold_7
18,4979001,4998000,18999,False,179,scaffold_7
19,5000001,5112000,111999,False,179,scaffold_7
20,5487001,5537000,49999,False,179,scaffold_7
21,6954001,7270000,315999,False,179,scaffold_7
22,7271001,7502216,231215,True,179,scaffold_7
0,67001,85000,17999,False,179,scaffold_8
1,2492001,2533000,40999,False,179,scaffold_8
2,2536001,2552000,15999,False,179,scaffold_8
3,2652001,2683000,30999,False,179,scaffold_8
4,2742001,2756000,13999,False,179,scaffold_8
5,2813001,2844000,30999,False,179,scaffold_8
6,3060001,3525000,464999,False,179,scaffold_8
7,3584001,3614000,29999,False,179,scaffold_8
8,3615001,3913000,297999,False,179,scaffold_8
9,4037001,4085000,47999,False,179,scaffold_8
10,5198001,5238000,39999,False,179,scaffold_8
11,5579001,5597000,17999,False,179,scaffold_8
12,6329001,6334544,5543,True,179,scaffold_8
0,109001,117000,7999,False,179,scaffold_9
1,121001,137000,15999,False,179,scaffold_9
2,304001,316000,11999,False,179,scaffold_9
3,374001,411000,36999,False,179,scaffold_9
4,413001,425000,11999,False,179,scaffold_9
5,502001,531000,28999,False,179,scaffold_9
6,652001,665000,12999,False,179,scaffold_9
7,671001,697000,25999,False,179,scaffold_9
8,732001,742000,9999,False,179,scaffold_9
9,815001,842000,26999,False,179,scaffold_9
10,873001,986000,112999,False,179,scaffold_9
11,988001,999000,10999,False,179,scaffold_9
12,1010001,1085000,74999,False,179,scaffold_9
13,1087001,1164000,76999,False,179,scaffold_9
14,1312001,1377000,64999,False,179,scaffold_9
15,2599001,2616000,16999,False,179,scaffold_9
16,2782001,2803000,20999,False,179,scaffold_9
17,2874001,3381000,506999,False,179,scaffold_9
18,3383001,5099000,1715999,False,179,scaffold_9
19,5101001,5107000,5999,False,179,scaffold_9
20,5112001,5114000,1999,False,179,scaffold_9
21,5116001,5237000,120999,False,179,scaffold_9
22,5239001,5298000,58999,False,179,scaffold_9
23,5300001,5490000,189999,False,179,scaffold_9
24,5492001,6331288,839287,True,179,scaffold_9
0,1,200000,199999,True,179,scaffold_10
1,375001,406000,30999,False,179,scaffold_10
2,472001,482000,9999,False,179,scaffold_10
3,483001,575000,91999,False,179,scaffold_10
4,616001,751000,134999,False,179,scaffold_10
5,783001,794000,10999,False,179,scaffold_10
6,888001,916000,27999,False,179,scaffold_10
7,924001,962000,37999,False,179,scaffold_10
8,1073001,1113000,39999,False,179,scaffold_10
9,2145001,2169000,23999,False,179,scaffold_10
10,2346001,2368000,21999,False,179,scaffold_10
11,4051001,4092000,40999,False,179,scaffold_10
12,4154001,4174000,19999,False,179,scaffold_10
13,4445001,4462000,16999,False,179,scaffold_10
14,4467001,4477000,9999,False,179,scaffold_10
15,4527001,4548000,20999,False,179,scaffold_10
16,4576001,4595000,18999,False,179,scaffold_10
17,4734001,4751000,16999,False,179,scaffold_10
18,4752001,4766000,13999,False,179,scaffold_10
19,4798001,4824000,25999,False,179,scaffold_10
20,4828001,4843000,14999,False,179,scaffold_10
21,4848001,4861000,12999,False,179,scaffold_10
22,4865001,4866973,1972,True,179,scaffold_10
0,10001,33000,22999,False,179,scaffold_11
1,42001,93000,50999,False,179,scaffold_11
2,124001,128000,3999,False,179,scaffold_11
3,149001,167000,17999,False,179,scaffold_11
4,169001,189000,19999,False,179,scaffold_11
5,213001,235000,21999,False,179,scaffold_11
6,240001,247000,6999,False,179,scaffold_11
7,419001,431000,11999,False,179,scaffold_11
8,648001,656000,7999,False,179,scaffold_11
9,949001,951000,1999,False,179,scaffold_11
10,1028001,1034000,5999,False,179,scaffold_11
11,1423001,1426000,2999,False,179,scaffold_11
12,1474001,1477000,2999,False,179,scaffold_11
13,2701001,2864000,162999,False,179,scaffold_11
14,3189001,3293000,103999,False,179,scaffold_11
15,3327001,3383000,55999,False,179,scaffold_11
16,3702001,3722000,19999,False,179,scaffold_11
17,3744001,3933000,188999,False,179,scaffold_11
18,4317001,4710000,392999,False,179,scaffold_11
19,4712001,4766820,54819,True,179,scaffold_11
0,1,387000,386999,True,179,scaffold_12
1,403001,542000,138999,False,179,scaffold_12
2,582001,856000,273999,False,179,scaffold_12
3,865001,1360000,494999,False,179,scaffold_12
4,1376001,1430000,53999,False,179,scaffold_12
5,2571001,2610000,38999,False,179,scaffold_12
6,2685001,2698000,12999,False,179,scaffold_12
0,1,392000,391999,True,180,scaffold_1
1,482001,498000,15999,False,180,scaffold_1
2,571001,643000,71999,False,180,scaffold_1
3,686001,712000,25999,False,180,scaffold_1
4,725001,756000,30999,False,180,scaffold_1
5,1269001,1292000,22999,False,180,scaffold_1
6,1809001,1901000,91999,False,180,scaffold_1
7,1950001,1964000,13999,False,180,scaffold_1
8,1965001,1981000,15999,False,180,scaffold_1
9,2353001,2421000,67999,False,180,scaffold_1
10,2447001,2516000,68999,False,180,scaffold_1
11,2564001,2583000,18999,False,180,scaffold_1
12,2723001,2744000,20999,False,180,scaffold_1
13,2952001,3029000,76999,False,180,scaffold_1
14,3174001,3184000,9999,False,180,scaffold_1
15,3191001,3213000,21999,False,180,scaffold_1
16,3450001,3482000,31999,False,180,scaffold_1
17,3539001,3640000,100999,False,180,scaffold_1
18,3704001,3882000,177999,False,180,scaffold_1
19,3902001,4012000,109999,False,180,scaffold_1
20,4062001,4151000,88999,False,180,scaffold_1
21,4312001,4355000,42999,False,180,scaffold_1
22,4709001,4781000,71999,False,180,scaffold_1
23,4927001,5025000,97999,False,180,scaffold_1
24,5097001,5116000,18999,False,180,scaffold_1
25,5480001,5512000,31999,False,180,scaffold_1
26,5534001,5570000,35999,False,180,scaffold_1
27,5856001,5917000,60999,False,180,scaffold_1
28,6108001,6151000,42999,False,180,scaffold_1
29,6165001,6183000,17999,False,180,scaffold_1
30,6207001,6300000,92999,False,180,scaffold_1
31,6324001,6381000,56999,False,180,scaffold_1
32,6384001,6414000,29999,False,180,scaffold_1
33,6415001,6555000,139999,False,180,scaffold_1
34,6636001,6658000,21999,False,180,scaffold_1
35,6837001,6852000,14999,False,180,scaffold_1
36,7037001,7204000,166999,False,180,scaffold_1
37,7206001,7247000,40999,False,180,scaffold_1
38,7248001,7589000,340999,False,180,scaffold_1
39,7590001,8220000,629999,False,180,scaffold_1
40,8221001,8374000,152999,False,180,scaffold_1
41,8375001,8656000,280999,False,180,scaffold_1
42,8658001,8721000,62999,False,180,scaffold_1
43,8722001,8771000,48999,False,180,scaffold_1
44,8772001,9114000,341999,False,180,scaffold_1
45,9115001,9490000,374999,False,180,scaffold_1
46,9492001,9584000,91999,False,180,scaffold_1
47,9586001,10356000,769999,False,180,scaffold_1
48,10460001,10641000,180999,False,180,scaffold_1
49,10729001,10757000,27999,False,180,scaffold_1
50,10838001,10857000,18999,False,180,scaffold_1
51,11278001,11501000,222999,False,180,scaffold_1
52,11550001,11776000,225999,False,180,scaffold_1
53,11789001,11964000,174999,False,180,scaffold_1
54,12184001,12202000,17999,False,180,scaffold_1
55,12398001,12453000,54999,False,180,scaffold_1
56,12652001,12926000,273999,False,180,scaffold_1
57,13024001,13048000,23999,False,180,scaffold_1
58,13113001,13212000,98999,False,180,scaffold_1
59,13346001,13431000,84999,False,180,scaffold_1
0,22001,48000,25999,False,180,scaffold_2
1,100001,159000,58999,False,180,scaffold_2
2,168001,177000,8999,False,180,scaffold_2
3,297001,318000,20999,False,180,scaffold_2
4,332001,374000,41999,False,180,scaffold_2
5,732001,739000,6999,False,180,scaffold_2
6,2087001,2111000,23999,False,180,scaffold_2
7,2315001,2335000,19999,False,180,scaffold_2
8,2336001,2374000,37999,False,180,scaffold_2
9,2403001,2549000,145999,False,180,scaffold_2
10,2570001,2602000,31999,False,180,scaffold_2
11,2661001,2689000,27999,False,180,scaffold_2
12,2693001,2738000,44999,False,180,scaffold_2
13,2868001,2900000,31999,False,180,scaffold_2
14,3332001,3344000,11999,False,180,scaffold_2
15,3451001,3467000,15999,False,180,scaffold_2
16,4388001,4409000,20999,False,180,scaffold_2
17,4426001,4457000,30999,False,180,scaffold_2
18,4473001,4669000,195999,False,180,scaffold_2
19,4714001,4768000,53999,False,180,scaffold_2
20,4917001,4966000,48999,False,180,scaffold_2
21,5014001,5065000,50999,False,180,scaffold_2
22,5080001,5104000,23999,False,180,scaffold_2
23,5199001,5222000,22999,False,180,scaffold_2
24,5256001,5280000,23999,False,180,scaffold_2
25,5285001,5314000,28999,False,180,scaffold_2
26,5348001,5393000,44999,False,180,scaffold_2
27,5413001,5480000,66999,False,180,scaffold_2
28,5490001,5560000,69999,False,180,scaffold_2
29,5619001,5757000,137999,False,180,scaffold_2
30,5840001,5892000,51999,False,180,scaffold_2
31,5907001,6057000,149999,False,180,scaffold_2
32,6261001,6330000,68999,False,180,scaffold_2
33,6384001,6406000,21999,False,180,scaffold_2
34,6408001,6449000,40999,False,180,scaffold_2
35,6595001,6637000,41999,False,180,scaffold_2
36,6940001,7035000,94999,False,180,scaffold_2
37,7076001,7096000,19999,False,180,scaffold_2
38,7340001,7463000,122999,False,180,scaffold_2
39,7491001,7518000,26999,False,180,scaffold_2
40,7548001,7561000,12999,False,180,scaffold_2
41,7563001,7700000,136999,False,180,scaffold_2
42,7777001,7886000,108999,False,180,scaffold_2
43,7933001,7956000,22999,False,180,scaffold_2
44,7975001,8233000,257999,False,180,scaffold_2
45,8261001,8313000,51999,False,180,scaffold_2
46,8340001,8345000,4999,False,180,scaffold_2
47,8346001,8458000,111999,False,180,scaffold_2
48,8463001,8494000,30999,False,180,scaffold_2
49,8495001,8563000,67999,False,180,scaffold_2
50,9006001,9096000,89999,False,180,scaffold_2
51,9140001,9169000,28999,False,180,scaffold_2
52,9319001,9342000,22999,False,180,scaffold_2
53,9428001,9468000,39999,False,180,scaffold_2
54,9674001,9690000,15999,False,180,scaffold_2
55,10481001,10504000,22999,False,180,scaffold_2
56,11026001,11065000,38999,False,180,scaffold_2
57,11366001,11384000,17999,False,180,scaffold_2
58,11519001,11740000,220999,False,180,scaffold_2
59,11742001,11775000,32999,False,180,scaffold_2
60,11776001,11802476,26475,True,180,scaffold_2
0,1,2000,1999,True,180,scaffold_3
1,51001,55000,3999,False,180,scaffold_3
2,798001,901000,102999,False,180,scaffold_3
3,1163001,1190000,26999,False,180,scaffold_3
4,2015001,2107000,91999,False,180,scaffold_3
5,2110001,2116000,5999,False,180,scaffold_3
6,2284001,2336000,51999,False,180,scaffold_3
7,2482001,2533000,50999,False,180,scaffold_3
8,2716001,2757000,40999,False,180,scaffold_3
9,3262001,3275000,12999,False,180,scaffold_3
10,3770001,3821000,50999,False,180,scaffold_3
11,3822001,3836000,13999,False,180,scaffold_3
12,4097001,4399000,301999,False,180,scaffold_3
13,4418001,4521000,102999,False,180,scaffold_3
14,4568001,4578000,9999,False,180,scaffold_3
15,5494001,5506000,11999,False,180,scaffold_3
16,5808001,5943000,134999,False,180,scaffold_3
17,5976001,6024000,47999,False,180,scaffold_3
18,6640001,6698000,57999,False,180,scaffold_3
19,6742001,6779000,36999,False,180,scaffold_3
20,6887001,6962000,74999,False,180,scaffold_3
21,6963001,7032000,68999,False,180,scaffold_3
22,7051001,7097000,45999,False,180,scaffold_3
23,7254001,7315000,60999,False,180,scaffold_3
24,7336001,7373000,36999,False,180,scaffold_3
25,7374001,7398000,23999,False,180,scaffold_3
26,7519001,7556000,36999,False,180,scaffold_3
27,7577001,7631000,53999,False,180,scaffold_3
28,7693001,7790000,96999,False,180,scaffold_3
29,7819001,7857000,37999,False,180,scaffold_3
30,8027001,8114000,86999,False,180,scaffold_3
31,8174001,8253000,78999,False,180,scaffold_3
32,8462001,8526000,63999,False,180,scaffold_3
33,8575001,8594000,18999,False,180,scaffold_3
34,9004001,9075000,70999,False,180,scaffold_3
35,9878001,9905000,26999,False,180,scaffold_3
36,9967001,10000000,32999,False,180,scaffold_3
37,10066001,10084000,17999,False,180,scaffold_3
38,10277001,10302000,24999,False,180,scaffold_3
39,10461001,10485000,23999,False,180,scaffold_3
40,10548001,11034000,485999,False,180,scaffold_3
41,11036001,11168000,131999,False,180,scaffold_3
0,11001,13000,1999,False,180,scaffold_4
1,17001,32000,14999,False,180,scaffold_4
2,48001,88000,39999,False,180,scaffold_4
3,120001,151000,30999,False,180,scaffold_4
4,155001,215000,59999,False,180,scaffold_4
5,217001,226000,8999,False,180,scaffold_4
6,248001,261000,12999,False,180,scaffold_4
7,289001,343000,53999,False,180,scaffold_4
8,355001,374000,18999,False,180,scaffold_4
9,412001,425000,12999,False,180,scaffold_4
10,429001,505000,75999,False,180,scaffold_4
11,510001,592000,81999,False,180,scaffold_4
12,593001,606000,12999,False,180,scaffold_4
13,608001,693000,84999,False,180,scaffold_4
14,1087001,1097000,9999,False,180,scaffold_4
15,1102001,1104000,1999,False,180,scaffold_4
16,1112001,1136000,23999,False,180,scaffold_4
17,1137001,1226000,88999,False,180,scaffold_4
18,1236001,1253000,16999,False,180,scaffold_4
19,1254001,1263000,8999,False,180,scaffold_4
20,1265001,1279000,13999,False,180,scaffold_4
21,1283001,1337000,53999,False,180,scaffold_4
22,1357001,1599000,241999,False,180,scaffold_4
23,1609001,1611000,1999,False,180,scaffold_4
24,1613001,2068000,454999,False,180,scaffold_4
25,2073001,2099000,25999,False,180,scaffold_4
26,2142001,2181000,38999,False,180,scaffold_4
27,2251001,2280000,28999,False,180,scaffold_4
28,2284001,2310000,25999,False,180,scaffold_4
29,2311001,2471000,159999,False,180,scaffold_4
30,2476001,2581000,104999,False,180,scaffold_4
31,2601001,2635000,33999,False,180,scaffold_4
32,2917001,2967000,49999,False,180,scaffold_4
33,3090001,3127000,36999,False,180,scaffold_4
34,3334001,3766000,431999,False,180,scaffold_4
35,3865001,3890000,24999,False,180,scaffold_4
36,4051001,4076000,24999,False,180,scaffold_4
37,4909001,4982000,72999,False,180,scaffold_4
38,4983001,5054000,70999,False,180,scaffold_4
39,5178001,5224000,45999,False,180,scaffold_4
40,5300001,5410000,109999,False,180,scaffold_4
41,5470001,5506000,35999,False,180,scaffold_4
42,5515001,5784000,268999,False,180,scaffold_4
43,5786001,5818000,31999,False,180,scaffold_4
44,5927001,5963000,35999,False,180,scaffold_4
45,6148001,6197000,48999,False,180,scaffold_4
46,6213001,6296000,82999,False,180,scaffold_4
47,6615001,6617000,1999,False,180,scaffold_4
48,6789001,6817000,27999,False,180,scaffold_4
49,6902001,6924000,21999,False,180,scaffold_4
50,6950001,6984000,33999,False,180,scaffold_4
51,7036001,7062000,25999,False,180,scaffold_4
52,7192001,7304000,111999,False,180,scaffold_4
53,7352001,7404000,51999,False,180,scaffold_4
54,7861001,7908000,46999,False,180,scaffold_4
55,7985001,8001000,15999,False,180,scaffold_4
56,8844001,9699000,854999,False,180,scaffold_4
57,9703001,9788000,84999,False,180,scaffold_4
58,9789001,9845951,56950,True,180,scaffold_4
0,141001,174000,32999,False,180,scaffold_5
1,191001,204000,12999,False,180,scaffold_5
2,327001,368000,40999,False,180,scaffold_5
3,463001,524000,60999,False,180,scaffold_5
4,933001,947000,13999,False,180,scaffold_5
5,2258001,2278000,19999,False,180,scaffold_5
6,2478001,2492000,13999,False,180,scaffold_5
7,2563001,2869000,305999,False,180,scaffold_5
8,3130001,3263000,132999,False,180,scaffold_5
9,3277001,3512000,234999,False,180,scaffold_5
10,3616001,3662000,45999,False,180,scaffold_5
11,3718001,3754000,35999,False,180,scaffold_5
12,3963001,4101000,137999,False,180,scaffold_5
13,4105001,4328000,222999,False,180,scaffold_5
14,4446001,4520000,73999,False,180,scaffold_5
15,4573001,4737000,163999,False,180,scaffold_5
16,4791001,4861000,69999,False,180,scaffold_5
17,4892001,4922000,29999,False,180,scaffold_5
18,5218001,5275000,56999,False,180,scaffold_5
19,5278001,5345000,66999,False,180,scaffold_5
20,5697001,5738000,40999,False,180,scaffold_5
21,6406001,6441000,34999,False,180,scaffold_5
22,6481001,6669000,187999,False,180,scaffold_5
23,6881001,6905000,23999,False,180,scaffold_5
24,7035001,7083000,47999,False,180,scaffold_5
25,7170001,7243000,72999,False,180,scaffold_5
26,7552001,7611000,58999,False,180,scaffold_5
27,7622001,7683000,60999,False,180,scaffold_5
28,8435001,8460000,24999,False,180,scaffold_5
29,8571001,8616000,44999,False,180,scaffold_5
30,8660001,8688000,27999,False,180,scaffold_5
31,8713001,9364176,651175,True,180,scaffold_5
0,86001,114000,27999,False,180,scaffold_6
1,267001,297000,29999,False,180,scaffold_6
2,308001,333000,24999,False,180,scaffold_6
3,1283001,1302000,18999,False,180,scaffold_6
4,1447001,1548000,100999,False,180,scaffold_6
5,1557001,1583000,25999,False,180,scaffold_6
6,1795001,1905000,109999,False,180,scaffold_6
7,2023001,2088000,64999,False,180,scaffold_6
8,2126001,2211000,84999,False,180,scaffold_6
9,2319001,2522000,202999,False,180,scaffold_6
10,2523001,2635000,111999,False,180,scaffold_6
11,2636001,2872000,235999,False,180,scaffold_6
12,2927001,2980000,52999,False,180,scaffold_6
13,2983001,3017000,33999,False,180,scaffold_6
14,3078001,3177000,98999,False,180,scaffold_6
15,3223001,3366000,142999,False,180,scaffold_6
16,3406001,3434000,27999,False,180,scaffold_6
17,3461001,3806000,344999,False,180,scaffold_6
18,3810001,3867000,56999,False,180,scaffold_6
19,3878001,3918000,39999,False,180,scaffold_6
20,3966001,3993000,26999,False,180,scaffold_6
21,4017001,4071000,53999,False,180,scaffold_6
22,4080001,4176000,95999,False,180,scaffold_6
23,5585001,5636000,50999,False,180,scaffold_6
24,5939001,5970000,30999,False,180,scaffold_6
25,6021001,6089000,67999,False,180,scaffold_6
26,6162001,6190000,27999,False,180,scaffold_6
27,6770001,6804000,33999,False,180,scaffold_6
28,6899001,6942000,42999,False,180,scaffold_6
29,7184001,7248000,63999,False,180,scaffold_6
30,7267001,7337000,69999,False,180,scaffold_6
31,7384001,7436000,51999,False,180,scaffold_6
32,7541001,7745000,203999,False,180,scaffold_6
33,7747001,8268281,521280,True,180,scaffold_6
0,50001,57000,6999,False,180,scaffold_7
1,306001,340000,33999,False,180,scaffold_7
2,342001,509000,166999,False,180,scaffold_7
3,571001,579000,7999,False,180,scaffold_7
4,649001,753000,103999,False,180,scaffold_7
5,763001,809000,45999,False,180,scaffold_7
6,810001,829000,18999,False,180,scaffold_7
7,830001,843000,12999,False,180,scaffold_7
8,953001,966000,12999,False,180,scaffold_7
9,968001,979000,10999,False,180,scaffold_7
10,982001,1039000,56999,False,180,scaffold_7
11,1072001,1101000,28999,False,180,scaffold_7
12,1190001,1512000,321999,False,180,scaffold_7
13,1591001,1693000,101999,False,180,scaffold_7
14,3348001,3404000,55999,False,180,scaffold_7
15,3498001,3568000,69999,False,180,scaffold_7
16,3569001,3619000,49999,False,180,scaffold_7
17,3620001,3662000,41999,False,180,scaffold_7
18,3663001,3692000,28999,False,180,scaffold_7
19,3717001,3767000,49999,False,180,scaffold_7
20,4029001,4062000,32999,False,180,scaffold_7
21,4334001,4362000,27999,False,180,scaffold_7
22,4415001,4476000,60999,False,180,scaffold_7
23,4477001,4512000,34999,False,180,scaffold_7
24,4546001,4595000,48999,False,180,scaffold_7
25,4630001,4792000,161999,False,180,scaffold_7
26,4982001,5030000,47999,False,180,scaffold_7
27,5031001,5084000,52999,False,180,scaffold_7
28,5085001,5148000,62999,False,180,scaffold_7
29,5483001,5537000,53999,False,180,scaffold_7
30,6601001,6675000,73999,False,180,scaffold_7
31,6955001,7247000,291999,False,180,scaffold_7
32,7248001,7472000,223999,False,180,scaffold_7
33,7473001,7502216,29215,True,180,scaffold_7
0,67001,85000,17999,False,180,scaffold_8
1,96001,101000,4999,False,180,scaffold_8
2,869001,871000,1999,False,180,scaffold_8
3,1630001,1646000,15999,False,180,scaffold_8
4,1856001,1931000,74999,False,180,scaffold_8
5,1942001,1978000,35999,False,180,scaffold_8
6,2076001,2151000,74999,False,180,scaffold_8
7,2355001,2399000,43999,False,180,scaffold_8
8,2422001,2525000,102999,False,180,scaffold_8
9,2646001,2683000,36999,False,180,scaffold_8
10,2741001,2841000,99999,False,180,scaffold_8
11,3033001,3451000,417999,False,180,scaffold_8
12,3453001,3556000,102999,False,180,scaffold_8
13,3577001,3612000,34999,False,180,scaffold_8
14,3615001,4095000,479999,False,180,scaffold_8
15,4172001,4226000,53999,False,180,scaffold_8
16,5083001,5241000,157999,False,180,scaffold_8
17,5521001,5595000,73999,False,180,scaffold_8
18,5651001,5695000,43999,False,180,scaffold_8
19,6327001,6334544,7543,True,180,scaffold_8
0,368001,411000,42999,False,180,scaffold_9
1,413001,434000,20999,False,180,scaffold_9
2,486001,531000,44999,False,180,scaffold_9
3,548001,563000,14999,False,180,scaffold_9
4,654001,659000,4999,False,180,scaffold_9
5,660001,665000,4999,False,180,scaffold_9
6,670001,696000,25999,False,180,scaffold_9
7,814001,842000,27999,False,180,scaffold_9
8,885001,986000,100999,False,180,scaffold_9
9,987001,996000,8999,False,180,scaffold_9
10,1009001,1031000,21999,False,180,scaffold_9
11,1035001,1085000,49999,False,180,scaffold_9
12,1087001,1150000,62999,False,180,scaffold_9
13,1151001,1165000,13999,False,180,scaffold_9
14,1311001,1378000,66999,False,180,scaffold_9
15,2598001,2618000,19999,False,180,scaffold_9
16,2744001,2811000,66999,False,180,scaffold_9
17,2844001,2995000,150999,False,180,scaffold_9
18,2996001,3115000,118999,False,180,scaffold_9
19,3117001,3176000,58999,False,180,scaffold_9
20,3177001,3381000,203999,False,180,scaffold_9
21,3383001,5094000,1710999,False,180,scaffold_9
22,5095001,5107000,11999,False,180,scaffold_9
23,5112001,5115000,2999,False,180,scaffold_9
24,5116001,5298000,181999,False,180,scaffold_9
25,5301001,6331288,1030287,True,180,scaffold_9
0,1,414000,413999,True,180,scaffold_10
1,415001,482000,66999,False,180,scaffold_10
2,494001,585000,90999,False,180,scaffold_10
3,596001,795000,198999,False,180,scaffold_10
4,888001,979000,90999,False,180,scaffold_10
5,1058001,1069000,10999,False,180,scaffold_10
6,1073001,1145000,71999,False,180,scaffold_10
7,1605001,1661000,55999,False,180,scaffold_10
8,2269001,2295000,25999,False,180,scaffold_10
9,2346001,2415000,68999,False,180,scaffold_10
10,3117001,3133000,15999,False,180,scaffold_10
11,4065001,4086000,20999,False,180,scaffold_10
12,4154001,4174000,19999,False,180,scaffold_10
13,4234001,4249000,14999,False,180,scaffold_10
14,4316001,4325000,8999,False,180,scaffold_10
15,4329001,4365000,35999,False,180,scaffold_10
16,4443001,4462000,18999,False,180,scaffold_10
17,4467001,4513000,45999,False,180,scaffold_10
18,4527001,4548000,20999,False,180,scaffold_10
19,4716001,4732000,15999,False,180,scaffold_10
20,4733001,4766000,32999,False,180,scaffold_10
21,4768001,4776000,7999,False,180,scaffold_10
22,4798001,4824000,25999,False,180,scaffold_10
23,4827001,4843000,15999,False,180,scaffold_10
24,4848001,4861000,12999,False,180,scaffold_10
25,4865001,4866973,1972,True,180,scaffold_10
0,9001,92000,82999,False,180,scaffold_11
1,132001,167000,34999,False,180,scaffold_11
2,169001,191000,21999,False,180,scaffold_11
3,214001,235000,20999,False,180,scaffold_11
4,419001,431000,11999,False,180,scaffold_11
5,433001,450000,16999,False,180,scaffold_11
6,648001,656000,7999,False,180,scaffold_11
7,1028001,1034000,5999,False,180,scaffold_11
8,1403001,1409000,5999,False,180,scaffold_11
9,2701001,2877000,175999,False,180,scaffold_11
10,2953001,3013000,59999,False,180,scaffold_11
11,3060001,3147000,86999,False,180,scaffold_11
12,3193001,3384000,190999,False,180,scaffold_11
13,3433001,3483000,49999,False,180,scaffold_11
14,3552001,3651000,98999,False,180,scaffold_11
15,3706001,3720000,13999,False,180,scaffold_11
16,3745001,3864000,118999,False,180,scaffold_11
17,3882001,3934000,51999,False,180,scaffold_11
18,4011001,4071000,59999,False,180,scaffold_11
19,4113001,4161000,47999,False,180,scaffold_11
20,4180001,4215000,34999,False,180,scaffold_11
21,4265001,4710000,444999,False,180,scaffold_11
22,4712001,4719000,6999,False,180,scaffold_11
23,4720001,4766820,46819,True,180,scaffold_11
0,1,15000,14999,True,180,scaffold_12
1,16001,856000,839999,False,180,scaffold_12
2,865001,978000,112999,False,180,scaffold_12
3,979001,1208000,228999,False,180,scaffold_12
4,1209001,1447000,237999,False,180,scaffold_12
5,1717001,1733000,15999,False,180,scaffold_12
6,2571001,2618000,46999,False,180,scaffold_12
0,1,35000,34999,True,181,scaffold_1
1,39001,373000,333999,False,181,scaffold_1
2,482001,502000,19999,False,181,scaffold_1
3,571001,642000,70999,False,181,scaffold_1
4,687001,756000,68999,False,181,scaffold_1
5,1272001,1292000,19999,False,181,scaffold_1
6,1616001,1660000,43999,False,181,scaffold_1
7,1661001,1670000,8999,False,181,scaffold_1
8,1812001,1899000,86999,False,181,scaffold_1
9,1916001,1935000,18999,False,181,scaffold_1
10,1950001,1964000,13999,False,181,scaffold_1
11,1965001,1982000,16999,False,181,scaffold_1
12,2364001,2399000,34999,False,181,scaffold_1
13,2449001,2531000,81999,False,181,scaffold_1
14,2547001,2578000,30999,False,181,scaffold_1
15,2715001,2747000,31999,False,181,scaffold_1
16,2983001,3071000,87999,False,181,scaffold_1
17,3103001,3111000,7999,False,181,scaffold_1
18,3419001,3425000,5999,False,181,scaffold_1
19,3446001,3625000,178999,False,181,scaffold_1
20,3702001,3875000,172999,False,181,scaffold_1
21,3901001,3941000,39999,False,181,scaffold_1
22,4001001,4030000,28999,False,181,scaffold_1
23,4062001,4159000,96999,False,181,scaffold_1
24,4314001,4350000,35999,False,181,scaffold_1
25,4913001,4995000,81999,False,181,scaffold_1
26,5039001,5060000,20999,False,181,scaffold_1
27,5087001,5119000,31999,False,181,scaffold_1
28,5164001,5191000,26999,False,181,scaffold_1
29,5481001,5511000,29999,False,181,scaffold_1
30,5535001,5570000,34999,False,181,scaffold_1
31,5852001,5879000,26999,False,181,scaffold_1
32,5898001,5910000,11999,False,181,scaffold_1
33,6108001,6177000,68999,False,181,scaffold_1
34,6202001,6318000,115999,False,181,scaffold_1
35,6331001,6380000,48999,False,181,scaffold_1
36,6384001,6561000,176999,False,181,scaffold_1
37,6629001,6660000,30999,False,181,scaffold_1
38,7037001,7424000,386999,False,181,scaffold_1
39,7426001,7583000,156999,False,181,scaffold_1
40,7590001,7642000,51999,False,181,scaffold_1
41,7643001,8401000,757999,False,181,scaffold_1
42,8402001,8656000,253999,False,181,scaffold_1
43,8658001,8672000,13999,False,181,scaffold_1
44,8674001,9382000,707999,False,181,scaffold_1
45,9383001,9584000,200999,False,181,scaffold_1
46,9586001,10017000,430999,False,181,scaffold_1
47,10018001,10365000,346999,False,181,scaffold_1
48,10460001,10630000,169999,False,181,scaffold_1
49,10663001,10764000,100999,False,181,scaffold_1
50,10835001,10857000,21999,False,181,scaffold_1
51,11017001,11030000,12999,False,181,scaffold_1
52,11340001,11503000,162999,False,181,scaffold_1
53,11550001,11964000,413999,False,181,scaffold_1
54,12182001,12244000,61999,False,181,scaffold_1
55,12382001,12396000,13999,False,181,scaffold_1
56,12425001,12462000,36999,False,181,scaffold_1
57,12636001,12722000,85999,False,181,scaffold_1
58,12775001,12879000,103999,False,181,scaffold_1
59,12974001,13002000,27999,False,181,scaffold_1
60,13094001,13216000,121999,False,181,scaffold_1
61,13345001,13399000,53999,False,181,scaffold_1
62,13570001,13581000,10999,False,181,scaffold_1
63,14290001,14307000,16999,False,181,scaffold_1
0,27001,48000,20999,False,181,scaffold_2
1,93001,100000,6999,False,181,scaffold_2
2,101001,159000,57999,False,181,scaffold_2
3,165001,176000,10999,False,181,scaffold_2
4,297001,318000,20999,False,181,scaffold_2
5,338001,374000,35999,False,181,scaffold_2
6,458001,476000,17999,False,181,scaffold_2
7,731001,739000,7999,False,181,scaffold_2
8,1017001,1025000,7999,False,181,scaffold_2
9,1975001,1982000,6999,False,181,scaffold_2
10,2085001,2111000,25999,False,181,scaffold_2
11,2324001,2335000,10999,False,181,scaffold_2
12,2336001,2373000,36999,False,181,scaffold_2
13,2453001,2609000,155999,False,181,scaffold_2
14,2653001,2689000,35999,False,181,scaffold_2
15,2693001,2746000,52999,False,181,scaffold_2
16,2766001,2787000,20999,False,181,scaffold_2
17,2875001,2928000,52999,False,181,scaffold_2
18,2972001,3046000,73999,False,181,scaffold_2
19,3273001,3282000,8999,False,181,scaffold_2
20,3359001,3411000,51999,False,181,scaffold_2
21,3451001,3488000,36999,False,181,scaffold_2
22,3754001,3785000,30999,False,181,scaffold_2
23,4127001,4149000,21999,False,181,scaffold_2
24,4294001,4321000,26999,False,181,scaffold_2
25,4381001,4407000,25999,False,181,scaffold_2
26,4434001,4553000,118999,False,181,scaffold_2
27,4554001,4765000,210999,False,181,scaffold_2
28,4781001,4790000,8999,False,181,scaffold_2
29,4793001,4810000,16999,False,181,scaffold_2
30,4911001,4961000,49999,False,181,scaffold_2
31,5021001,5067000,45999,False,181,scaffold_2
32,5080001,5106000,25999,False,181,scaffold_2
33,5172001,5222000,49999,False,181,scaffold_2
34,5257001,5276000,18999,False,181,scaffold_2
35,5285001,5315000,29999,False,181,scaffold_2
36,5368001,5558000,189999,False,181,scaffold_2
37,5608001,5757000,148999,False,181,scaffold_2
38,5839001,5891000,51999,False,181,scaffold_2
39,5907001,5959000,51999,False,181,scaffold_2
40,6005001,6058000,52999,False,181,scaffold_2
41,6069001,6081000,11999,False,181,scaffold_2
42,6125001,6140000,14999,False,181,scaffold_2
43,6244001,6352000,107999,False,181,scaffold_2
44,6409001,6462000,52999,False,181,scaffold_2
45,6593001,6628000,34999,False,181,scaffold_2
46,6827001,6886000,58999,False,181,scaffold_2
47,7005001,7038000,32999,False,181,scaffold_2
48,7064001,7087000,22999,False,181,scaffold_2
49,7106001,7218000,111999,False,181,scaffold_2
50,7286001,7321000,34999,False,181,scaffold_2
51,7331001,7465000,133999,False,181,scaffold_2
52,7491001,7504000,12999,False,181,scaffold_2
53,7548001,7562000,13999,False,181,scaffold_2
54,7567001,7622000,54999,False,181,scaffold_2
55,7623001,7650000,26999,False,181,scaffold_2
56,7651001,7699000,47999,False,181,scaffold_2
57,7785001,8194000,408999,False,181,scaffold_2
58,8195001,8314000,118999,False,181,scaffold_2
59,8346001,8454000,107999,False,181,scaffold_2
60,8509001,8563000,53999,False,181,scaffold_2
61,8803001,8836000,32999,False,181,scaffold_2
62,9159001,9169000,9999,False,181,scaffold_2
63,9348001,9381000,32999,False,181,scaffold_2
64,9411001,9495000,83999,False,181,scaffold_2
65,9560001,9622000,61999,False,181,scaffold_2
66,10229001,10244000,14999,False,181,scaffold_2
67,11047001,11068000,20999,False,181,scaffold_2
68,11368001,11467000,98999,False,181,scaffold_2
69,11470001,11498000,27999,False,181,scaffold_2
70,11552001,11785000,232999,False,181,scaffold_2
0,51001,55000,3999,False,181,scaffold_3
1,618001,638000,19999,False,181,scaffold_3
2,798001,901000,102999,False,181,scaffold_3
3,2010001,2108000,97999,False,181,scaffold_3
4,2111001,2116000,4999,False,181,scaffold_3
5,2265001,2339000,73999,False,181,scaffold_3
6,2415001,2428000,12999,False,181,scaffold_3
7,2485001,2533000,47999,False,181,scaffold_3
8,3681001,3696000,14999,False,181,scaffold_3
9,3755001,3892000,136999,False,181,scaffold_3
10,4098001,4398000,299999,False,181,scaffold_3
11,4420001,4517000,96999,False,181,scaffold_3
12,4637001,4686000,48999,False,181,scaffold_3
13,4778001,4810000,31999,False,181,scaffold_3
14,5253001,5279000,25999,False,181,scaffold_3
15,5804001,5918000,113999,False,181,scaffold_3
16,5919001,5953000,33999,False,181,scaffold_3
17,5990001,6020000,29999,False,181,scaffold_3
18,6498001,6579000,80999,False,181,scaffold_3
19,6662001,6807000,144999,False,181,scaffold_3
20,6909001,6962000,52999,False,181,scaffold_3
21,6979001,7090000,110999,False,181,scaffold_3
22,7115001,7157000,41999,False,181,scaffold_3
23,7228001,7305000,76999,False,181,scaffold_3
24,7333001,7402000,68999,False,181,scaffold_3
25,7483001,7556000,72999,False,181,scaffold_3
26,7677001,7798000,120999,False,181,scaffold_3
27,7816001,7841000,24999,False,181,scaffold_3
28,8031001,8070000,38999,False,181,scaffold_3
29,8085001,8101000,15999,False,181,scaffold_3
30,8185001,8253000,67999,False,181,scaffold_3
31,8334001,8352000,17999,False,181,scaffold_3
32,8427001,8525000,97999,False,181,scaffold_3
33,8574001,8594000,19999,False,181,scaffold_3
34,9020001,9075000,54999,False,181,scaffold_3
35,9967001,10005000,37999,False,181,scaffold_3
36,10040001,10105000,64999,False,181,scaffold_3
37,10524001,10547000,22999,False,181,scaffold_3
38,10548001,11166000,617999,False,181,scaffold_3
0,46001,88000,41999,False,181,scaffold_4
1,120001,146000,25999,False,181,scaffold_4
2,147001,151000,3999,False,181,scaffold_4
3,155001,215000,59999,False,181,scaffold_4
4,217001,226000,8999,False,181,scaffold_4
5,227001,239000,11999,False,181,scaffold_4
6,243001,278000,34999,False,181,scaffold_4
7,290001,305000,14999,False,181,scaffold_4
8,318001,343000,24999,False,181,scaffold_4
9,355001,374000,18999,False,181,scaffold_4
10,375001,410000,34999,False,181,scaffold_4
11,412001,425000,12999,False,181,scaffold_4
12,429001,502000,72999,False,181,scaffold_4
13,547001,574000,26999,False,181,scaffold_4
14,578001,592000,13999,False,181,scaffold_4
15,593001,606000,12999,False,181,scaffold_4
16,608001,691000,82999,False,181,scaffold_4
17,1137001,1208000,70999,False,181,scaffold_4
18,1210001,1226000,15999,False,181,scaffold_4
19,1254001,1262000,7999,False,181,scaffold_4
20,1264001,1280000,15999,False,181,scaffold_4
21,1283001,1335000,51999,False,181,scaffold_4
22,1370001,1591000,220999,False,181,scaffold_4
23,1613001,1712000,98999,False,181,scaffold_4
24,1764001,1799000,34999,False,181,scaffold_4
25,1801001,1849000,47999,False,181,scaffold_4
26,1904001,1987000,82999,False,181,scaffold_4
27,2016001,2068000,51999,False,181,scaffold_4
28,2073001,2100000,26999,False,181,scaffold_4
29,2210001,2246000,35999,False,181,scaffold_4
30,2247001,2281000,33999,False,181,scaffold_4
31,2283001,2340000,56999,False,181,scaffold_4
32,2403001,2461000,57999,False,181,scaffold_4
33,2480001,2634000,153999,False,181,scaffold_4
34,2926001,2966000,39999,False,181,scaffold_4
35,3090001,3124000,33999,False,181,scaffold_4
36,3205001,3267000,61999,False,181,scaffold_4
37,3338001,3755000,416999,False,181,scaffold_4
38,4055001,4073000,17999,False,181,scaffold_4
39,4899001,5041000,141999,False,181,scaffold_4
40,5169001,5246000,76999,False,181,scaffold_4
41,5247001,5378000,130999,False,181,scaffold_4
42,5446001,5506000,59999,False,181,scaffold_4
43,5530001,5784000,253999,False,181,scaffold_4
44,5786001,5855000,68999,False,181,scaffold_4
45,6148001,6195000,46999,False,181,scaffold_4
46,6213001,6307000,93999,False,181,scaffold_4
47,6615001,6617000,1999,False,181,scaffold_4
48,6798001,6817000,18999,False,181,scaffold_4
49,6902001,6924000,21999,False,181,scaffold_4
50,7028001,7102000,73999,False,181,scaffold_4
51,7192001,7323000,130999,False,181,scaffold_4
52,7636001,7665000,28999,False,181,scaffold_4
53,8846001,9699000,852999,False,181,scaffold_4
54,9700001,9845951,145950,True,181,scaffold_4
0,1,4000,3999,True,181,scaffold_5
1,127001,165000,37999,False,181,scaffold_5
2,190001,204000,13999,False,181,scaffold_5
3,318001,392000,73999,False,181,scaffold_5
4,471001,524000,52999,False,181,scaffold_5
5,934001,947000,12999,False,181,scaffold_5
6,1062001,1068000,5999,False,181,scaffold_5
7,2106001,2117000,10999,False,181,scaffold_5
8,2473001,2500000,26999,False,181,scaffold_5
9,2502001,2515000,12999,False,181,scaffold_5
10,2549001,2875000,325999,False,181,scaffold_5
11,2942001,3010000,67999,False,181,scaffold_5
12,3120001,3513000,392999,False,181,scaffold_5
13,3622001,3661000,38999,False,181,scaffold_5
14,3717001,3747000,29999,False,181,scaffold_5
15,3962001,4220000,257999,False,181,scaffold_5
16,4246001,4376000,129999,False,181,scaffold_5
17,4445001,4523000,77999,False,181,scaffold_5
18,4596001,4751000,154999,False,181,scaffold_5
19,4752001,4810000,57999,False,181,scaffold_5
20,4811001,4857000,45999,False,181,scaffold_5
21,4883001,4926000,42999,False,181,scaffold_5
22,4971001,4991000,19999,False,181,scaffold_5
23,5056001,5097000,40999,False,181,scaffold_5
24,5261001,5273000,11999,False,181,scaffold_5
25,5289001,5346000,56999,False,181,scaffold_5
26,5498001,5528000,29999,False,181,scaffold_5
27,5698001,5739000,40999,False,181,scaffold_5
28,6408001,6652000,243999,False,181,scaffold_5
29,6883001,6907000,23999,False,181,scaffold_5
30,7168001,7234000,65999,False,181,scaffold_5
31,7339001,7360000,20999,False,181,scaffold_5
32,7454001,7513000,58999,False,181,scaffold_5
33,7526001,7658000,131999,False,181,scaffold_5
34,8259001,8280000,20999,False,181,scaffold_5
35,8554001,8597000,42999,False,181,scaffold_5
36,8659001,8688000,28999,False,181,scaffold_5
37,8714001,9364176,650175,True,181,scaffold_5
0,86001,120000,33999,False,181,scaffold_6
1,162001,210000,47999,False,181,scaffold_6
2,239001,253000,13999,False,181,scaffold_6
3,267001,341000,73999,False,181,scaffold_6
4,965001,1025000,59999,False,181,scaffold_6
5,1237001,1255000,17999,False,181,scaffold_6
6,1438001,1544000,105999,False,181,scaffold_6
7,1657001,1713000,55999,False,181,scaffold_6
8,1818001,1906000,87999,False,181,scaffold_6
9,2026001,2100000,73999,False,181,scaffold_6
10,2121001,2211000,89999,False,181,scaffold_6
11,2255001,2285000,29999,False,181,scaffold_6
12,2317001,2653000,335999,False,181,scaffold_6
13,2655001,2867000,211999,False,181,scaffold_6
14,2928001,3026000,97999,False,181,scaffold_6
15,3078001,3195000,116999,False,181,scaffold_6
16,3216001,3366000,149999,False,181,scaffold_6
17,3394001,3806000,411999,False,181,scaffold_6
18,3877001,3931000,53999,False,181,scaffold_6
19,3964001,4033000,68999,False,181,scaffold_6
20,4103001,4193000,89999,False,181,scaffold_6
21,4954001,4993000,38999,False,181,scaffold_6
22,6020001,6086000,65999,False,181,scaffold_6
23,6144001,6188000,43999,False,181,scaffold_6
24,6762001,6804000,41999,False,181,scaffold_6
25,6830001,6856000,25999,False,181,scaffold_6
26,7222001,7342000,119999,False,181,scaffold_6
27,7392001,7443000,50999,False,181,scaffold_6
28,7541001,8262000,720999,False,181,scaffold_6
0,298001,341000,42999,False,181,scaffold_7
1,342001,508000,165999,False,181,scaffold_7
2,571001,576000,4999,False,181,scaffold_7
3,580001,584000,3999,False,181,scaffold_7
4,625001,639000,13999,False,181,scaffold_7
5,649001,674000,24999,False,181,scaffold_7
6,706001,735000,28999,False,181,scaffold_7
7,740001,753000,12999,False,181,scaffold_7
8,764001,809000,44999,False,181,scaffold_7
9,859001,864000,4999,False,181,scaffold_7
10,865001,884000,18999,False,181,scaffold_7
11,888001,898000,9999,False,181,scaffold_7
12,899001,945000,45999,False,181,scaffold_7
13,950001,963000,12999,False,181,scaffold_7
14,982001,1044000,61999,False,181,scaffold_7
15,1048001,1099000,50999,False,181,scaffold_7
16,1190001,1512000,321999,False,181,scaffold_7
17,1588001,1689000,100999,False,181,scaffold_7
18,2417001,2420000,2999,False,181,scaffold_7
19,2933001,2953000,19999,False,181,scaffold_7
20,3325001,3403000,77999,False,181,scaffold_7
21,3520001,3839000,318999,False,181,scaffold_7
22,3880001,3939000,58999,False,181,scaffold_7
23,4027001,4080000,52999,False,181,scaffold_7
24,4332001,4368000,35999,False,181,scaffold_7
25,4428001,4484000,55999,False,181,scaffold_7
26,4548001,4806000,257999,False,181,scaffold_7
27,4978001,5149000,170999,False,181,scaffold_7
28,5483001,5555000,71999,False,181,scaffold_7
29,6129001,6204000,74999,False,181,scaffold_7
30,6752001,6792000,39999,False,181,scaffold_7
31,6954001,7057000,102999,False,181,scaffold_7
32,7058001,7502216,444215,True,181,scaffold_7
0,2001,6000,3999,False,181,scaffold_8
1,31001,85000,53999,False,181,scaffold_8
2,93001,101000,7999,False,181,scaffold_8
3,342001,355000,12999,False,181,scaffold_8
4,1697001,1719000,21999,False,181,scaffold_8
5,1855001,1931000,75999,False,181,scaffold_8
6,2058001,2146000,87999,False,181,scaffold_8
7,2223001,2399000,175999,False,181,scaffold_8
8,2444001,2533000,88999,False,181,scaffold_8
9,2646001,2683000,36999,False,181,scaffold_8
10,2684001,2758000,73999,False,181,scaffold_8
11,2798001,2844000,45999,False,181,scaffold_8
12,3023001,3125000,101999,False,181,scaffold_8
13,3126001,3550000,423999,False,181,scaffold_8
14,3577001,3612000,34999,False,181,scaffold_8
15,3615001,3944000,328999,False,181,scaffold_8
16,4034001,4111000,76999,False,181,scaffold_8
17,4173001,4269000,95999,False,181,scaffold_8
18,4330001,4368000,37999,False,181,scaffold_8
19,4400001,4415000,14999,False,181,scaffold_8
20,4896001,4915000,18999,False,181,scaffold_8
21,5076001,5240000,163999,False,181,scaffold_8
22,5528001,5595000,66999,False,181,scaffold_8
23,5650001,5694000,43999,False,181,scaffold_8
0,2001,13000,10999,False,181,scaffold_9
1,109001,119000,9999,False,181,scaffold_9
2,121001,138000,16999,False,181,scaffold_9
3,271001,276000,4999,False,181,scaffold_9
4,299001,316000,16999,False,181,scaffold_9
5,319001,411000,91999,False,181,scaffold_9
6,413001,434000,20999,False,181,scaffold_9
7,483001,531000,47999,False,181,scaffold_9
8,548001,562000,13999,False,181,scaffold_9
9,660001,665000,4999,False,181,scaffold_9
10,671001,710000,38999,False,181,scaffold_9
11,817001,843000,25999,False,181,scaffold_9
12,886001,986000,99999,False,181,scaffold_9
13,987001,996000,8999,False,181,scaffold_9
14,1001001,1007000,5999,False,181,scaffold_9
15,1009001,1031000,21999,False,181,scaffold_9
16,1035001,1160000,124999,False,181,scaffold_9
17,1291001,1305000,13999,False,181,scaffold_9
18,1308001,1377000,68999,False,181,scaffold_9
19,1487001,1499000,11999,False,181,scaffold_9
20,1764001,1790000,25999,False,181,scaffold_9
21,2601001,2616000,14999,False,181,scaffold_9
22,2737001,3381000,643999,False,181,scaffold_9
23,3383001,5107000,1723999,False,181,scaffold_9
24,5109001,5111000,1999,False,181,scaffold_9
25,5112001,5238000,125999,False,181,scaffold_9
26,5239001,5298000,58999,False,181,scaffold_9
27,5300001,5463000,162999,False,181,scaffold_9
28,5464001,5490000,25999,False,181,scaffold_9
29,5492001,6331288,839287,True,181,scaffold_9
0,1,481000,480999,True,181,scaffold_10
1,483001,584000,100999,False,181,scaffold_10
2,603001,640000,36999,False,181,scaffold_10
3,652001,796000,143999,False,181,scaffold_10
4,810001,980000,169999,False,181,scaffold_10
5,1073001,1122000,48999,False,181,scaffold_10
6,2142001,2170000,27999,False,181,scaffold_10
7,2266001,2292000,25999,False,181,scaffold_10
8,2346001,2366000,19999,False,181,scaffold_10
9,2565001,2585000,19999,False,181,scaffold_10
10,4002001,4011000,8999,False,181,scaffold_10
11,4053001,4093000,39999,False,181,scaffold_10
12,4155001,4173000,17999,False,181,scaffold_10
13,4334001,4430000,95999,False,181,scaffold_10
14,4433001,4462000,28999,False,181,scaffold_10
15,4467001,4502000,34999,False,181,scaffold_10
16,4507001,4513000,5999,False,181,scaffold_10
17,4527001,4547000,19999,False,181,scaffold_10
18,4554001,4562000,7999,False,181,scaffold_10
19,4565001,4597000,31999,False,181,scaffold_10
20,4734001,4776000,41999,False,181,scaffold_10
21,4791001,4796000,4999,False,181,scaffold_10
22,4798001,4824000,25999,False,181,scaffold_10
23,4828001,4861000,32999,False,181,scaffold_10
24,4862001,4866973,4972,True,181,scaffold_10
0,9001,68000,58999,False,181,scaffold_11
1,69001,88000,18999,False,181,scaffold_11
2,132001,167000,34999,False,181,scaffold_11
3,169001,212000,42999,False,181,scaffold_11
4,214001,235000,20999,False,181,scaffold_11
5,296001,311000,14999,False,181,scaffold_11
6,419001,431000,11999,False,181,scaffold_11
7,647001,656000,8999,False,181,scaffold_11
8,2192001,2210000,17999,False,181,scaffold_11
9,2700001,2743000,42999,False,181,scaffold_11
10,2744001,2876000,131999,False,181,scaffold_11
11,2977001,3019000,41999,False,181,scaffold_11
12,3084001,3291000,206999,False,181,scaffold_11
13,3327001,3383000,55999,False,181,scaffold_11
14,3560001,3651000,90999,False,181,scaffold_11
15,3744001,3971000,226999,False,181,scaffold_11
16,4004001,4160000,155999,False,181,scaffold_11
17,4262001,4386000,123999,False,181,scaffold_11
18,4394001,4766820,372819,True,181,scaffold_11
0,1,666000,665999,True,181,scaffold_12
1,667001,1486000,818999,False,181,scaffold_12
2,1719001,1733000,13999,False,181,scaffold_12
3,2353001,2361000,7999,False,181,scaffold_12
4,2571001,2613000,41999,False,181,scaffold_12
5,2689001,2708000,18999,False,181,scaffold_12
6,2710001,2721000,10999,False,181,scaffold_12
